Id,Label,timeset,modularity_class,indegree,outdegree,Degree
0,DrMonkeyLove,,18,183,283,466
1,democritus,,20,7,6,13
2,sileegranny,,18,9,15,24
3,paulocoelho,,13,8,2,10
4,antichrist,,19,322,114,436
5,arrezzo,,42,1,9,10
6,JayGodse,,20,1,1,2
7,soniabegonia,,1,30,43,73
8,cinnamongreen,,18,6,23,29
9,inforte,,20,32,6,38
10,johnself,,31,142,144,286
11,lazyliberal,,32,2,3,5
12,alouise,,8,3,2,5
13,illiterature,,31,10,8,18
14,theghoul,,18,58,65,123
15,esobelle,,11,2,5,7
16,roadtoreality,,13,2,5,7
17,HelenLove,,14,1,2,3
18,waterbabies3,,32,21,26,47
19,JanneVee,,20,63,78,141
20,StaceyTheGirl,,0,30,44,74
21,pstone,,0,9,15,24
22,rachkovsky,,34,3,2,5
23,shiftkey,,30,16,23,39
24,poppafuze,,20,20,40,60
25,Softcode,,34,1,1,2
26,maek,,0,1,3,4
27,villy,,0,1,7,8
28,PurpleDingo,,18,43,79,122
29,junaru,,32,47,68,115
30,MetaStockTools,,22,3,4,7
31,sirg3,,20,1,9,10
32,mgcmrkr,,20,11,10,21
33,paullyjunge,,13,6,8,14
34,sholynaty,,1,27,24,51
35,qbproger,,20,23,24,47
36,2424,,31,99,146,245
37,psiber,,13,24,7,31
38,malcolmbastien,,30,1,2,3
39,tekp2,,13,1,1,2
40,philgibbins,,20,1,1,2
41,BOOYAKASHAA,,39,1,2,3
42,landylord,,31,4,1,5
43,zobdos,,18,25,46,71
44,tomasarson,,29,1,1,2
45,OutcastKnight,,18,3,7,10
46,netizenbane,,43,4,8,12
47,robertrade,,18,4,3,7
48,mjc4y,,13,1,5,6
49,pointee,,20,1,1,2
50,Makido,,19,4,6,10
51,slapshot,,19,176,138,314
52,lavilas,,18,30,45,75
53,brian_jaress,,20,25,39,64
54,gresham,,18,22,4,26
55,goolies,,35,1,5,6
56,pjabrennan,,19,1,2,3
57,parappayo,,20,1,2,3
58,knorby,,1,20,36,56
59,namdas,,6,12,2,14
60,factor0,,29,5,11,16
61,NewJersey,,16,1,3,4
62,emresaglam,,22,26,42,68
63,gosidracer,,16,4,4,8
64,hotmailfan,,19,13,12,25
65,karma__whore,,29,1,1,2
66,danielnapierski,,19,2,4,6
67,machrider,,20,244,361,605
68,kumaram16,,13,282,16,298
69,jmcwright,,6,8,14,22
70,Gersh54,,1,83,63,146
71,IanSteph,,1,20,55,75
72,mph11,,13,3,2,5
73,IncrediblyWrongMan,,12,1,1,2
74,steinmb,,32,14,22,36
75,alexs,,20,313,332,645
76,kkoozzz,,1,3,3,6
77,maryhunt,,19,5,7,12
78,benuntu,,13,15,25,40
79,beckermt,,42,672,1109,1781
80,engtech,,20,20,3,23
81,OMG_my_BABY,,0,20,67,87
82,nicodaemos,,20,10,12,22
83,mattmac55,,13,4,1,5
84,jailbeta,,0,45,1,46
85,silencergroup,,13,613,635,1248
86,lordasrael,,20,3,3,6
87,SixtoMercedes,,1,8,23,31
88,smackmestoopid,,22,5,10,15
89,databus,,20,4,6,10
90,demon_hunter,,4,1,2,3
91,captnanonymous,,5,1,1,2
92,gimeit,,22,314,407,721
93,soul1239,,19,17,20,37
94,gruven,,19,122,1,123
95,akshayxyz,,32,3,7,10
96,DPhil,,18,235,5,240
97,scerevisme,,20,3,3,6
98,fdgonthier,,20,8,3,11
99,opzori,,39,1,2,3
100,acharlwood,,17,1,2,3
101,Triscuit,,14,1,1,2
102,spartman,,30,1,3,4
103,milksop,,20,19,18,37
104,jryde3031,,13,40,17,57
105,bentlegen,,20,6,1,7
106,miguel9614,,20,13,10,23
107,trim17,,1,33,32,65
108,MarkEst1973,,20,2,3,5
109,menolikey,,13,98,143,241
110,poolplyr27,,17,2,1,3
111,csl,,20,95,53,148
112,buddav,,18,2,6,8
113,ThisIsNotYourMango,,19,3,1,4
114,munan,,19,25,109,134
115,Slango,,1,1,14,15
116,wwarner,,35,3,1,4
117,jdhore1,,20,5,11,16
118,tekkou,,31,7,8,15
119,JHallam,,18,18,2,20
120,locuester,,20,45,30,75
121,akhavr,,20,1,1,2
122,spankbot,,19,2,2,4
123,Kiram,,1,143,32,175
124,babasave,,18,1,1,2
125,darklotus,,20,1,1,2
126,aubradley84,,42,3,2,5
127,CorporalClegg68,,18,24,33,57
128,foldsworkthatway,,20,1,1,2
129,bwana914,,1,3,1,4
130,aarohanb,,30,2,1,3
131,squarehappy,,1,35,55,90
132,farnsey,,41,4,7,11
133,hypn0toad,,27,2,4,6
134,mitcjm,,31,21,18,39
135,adamv,,20,117,204,321
136,DonEvenTryDude,,31,1,2,3
137,brownb2,,13,12,12,24
138,Eviljoe,,23,6,13,19
139,burkadurka,,20,32,48,80
140,xerogod,,19,157,290,447
141,PFinn,,18,9,7,16
142,ours,,22,336,786,1122
143,lkap13,,5,3,4,7
144,ozzilee,,20,121,88,209
145,metalchick666,,18,2,7,9
146,abcd156,,13,1,1,2
147,alznto,,36,2,2,4
148,mjg58,,10,1,2,3
149,Polyrhythm,,29,8,23,31
150,akadit,,41,13,1,14
151,Claymation,,19,20,2,22
152,kkoo,,31,1,1,2
153,ketjapo,,13,9,1,10
154,nhavar,,13,14,38,52
155,cdaniel1,,18,19,8,27
156,ih8dems,,3,2,2,4
157,tomtermite,,19,11,12,23
158,nu303,,32,6,2,8
159,Pussy_Magnet,,1,111,82,193
160,jizzlies,,13,20,106,126
161,SelmaBouvier,,13,8,6,14
162,hypnofrog,,19,11,20,31
163,godawgs7,,43,10,4,14
164,socks,,43,526,361,887
165,hs4x,,42,1468,1743,3211
166,keikun17,,42,184,39,223
167,scruffy1,,20,3,1,4
168,twomashi,,20,22,21,43
169,martinvanburen,,20,4,3,7
170,spiegel101,,0,1,1,2
171,Captain,,20,19,26,45
172,biledemon85,,18,3,7,10
173,10923829038,,31,2,4,6
174,randomd00d,,43,9,13,22
175,badonkadonk,,1,5,3,8
176,zoba,,12,11,11,22
177,snoofwho,,20,2,4,6
178,svero6,,31,9,9,18
179,gerran,,32,112,54,166
180,Doeke,,22,279,331,610
181,consumer,,18,3,6,9
182,masterfap,,19,8,18,26
183,citricking,,19,6,8,14
184,GetToTheKarateChoppa,,43,828,914,1742
185,DDragon,,30,1,1,2
186,cyanblue,,13,3,2,5
187,sidartha,,0,39,9,48
188,DukeOfZhou,,34,21,63,84
189,rmbjspd,,12,38,18,56
190,designerbay,,13,79,30,109
191,LiLaBell,,1,1,2,3
192,waspinator,,0,1,7,8
193,loruz,,18,20,30,50
194,geekboysf,,18,16,33,49
195,puto,,19,4,12,16
196,excoriator,,4,15,11,26
197,kragshot,,32,110,203,313
198,g8or8de,,31,1,6,7
199,deadmantizwalking,,21,379,810,1189
200,dondiscounto,,20,10,14,24
201,Crito,,39,140,221,361
202,makemearedcape,,18,103,99,202
203,raganwald,,20,256,110,366
204,shiro,,41,6,13,19
205,drjekel_mrhyde,,1,2,6,8
206,diffraction,,19,98,83,181
207,babsglaxo,,12,1,3,4
208,AbVag,,13,47,84,131
209,23049873409,,14,2,1,3
210,megiston,,32,8,1,9
211,DavidCaruso,,22,27,17,44
212,Alpha_Chimp,,19,17,42,59
213,bnelson,,6,47,54,101
214,markfoster24,,18,124,16,140
215,briannagriffin,,1,26,18,44
216,dsandler,,20,177,213,390
217,christiangoldberg,,0,1,1,2
218,dspeyer,,32,9,9,18
219,gyruss,,19,27,4,31
220,idono,,13,26,17,43
221,thesals,,1,1,2,3
222,superwinky,,1,102,181,283
223,tyllwin,,8,1,1,2
224,GiantBatFart,,18,650,64,714
225,thedkl,,20,6,7,13
226,sork,,19,8,8,16
227,Celt,,31,1,1,2
228,DragonMist,,0,2,4,6
229,000zero,,20,1,1,2
230,audj,,13,6,5,11
231,symbioticintheory,,18,21,35,56
232,rod_von_hugenstein,,22,4,2,6
233,satha92,,18,12,25,37
234,fetiere,,1,3,1,4
235,nutzzzz,,13,8,19,27
236,justinasaurusrex,,15,1,1,2
237,kukkuzejt,,18,11,7,18
238,scylla,,19,297,177,474
239,JWEIS87,,19,24,61,85
240,scottv,,13,2,4,6
241,jordanhowe56,,1,16,10,26
242,geiger253,,19,211,281,492
243,ificanbefrank,,22,6,11,17
244,Uncle_Erik,,32,12,12,24
245,dbldn,,5,5,5,10
246,kahi,,18,6,7,13
247,cl191,,18,13,5,18
248,orSKAsm,,18,62,27,89
249,allenmunroe,,3,16,11,27
250,monesy,,32,187,498,685
251,jasonb,,20,21,1,22
252,mamid,,30,21,27,48
253,FigBug,,18,9,3,12
254,adazzle,,1,22,34,56
255,Carlos_Slim,,29,1,1,2
256,sucksatperl,,20,2,1,3
257,inigo_montoya_,,43,2,2,4
258,ttul,,20,4,5,9
259,cezar,,34,116,235,351
260,caljza,,1,1,1,2
261,HathNoro,,18,5,8,13
262,TechStuff,,43,6,16,22
263,phlllpy,,3,3,2,5
264,moobyseviltwin,,19,31,61,92
265,bordeau,,1,1,1,2
266,kvilla,,32,7,16,23
267,NakedTonyDanza,,1,508,472,980
268,charleyface,,18,25,60,85
269,Blnd2Spll,,32,210,38,248
270,SlippyZ,,4,1,1,2
271,denyde,,18,1,1,2
272,bl00dninja,,18,5,9,14
273,eleni_h,,34,1,2,3
274,typo180,,22,109,141,250
275,lagartoflojo,,14,1,1,2
276,cameron_penn,,42,2,1,3
277,lickyfy,,13,233,16,249
278,pigwolley,,20,2,4,6
279,lrknapp,,1,32,16,48
280,tunah,,31,92,195,287
281,j3ffr3y,,1,43,12,55
282,NightChaos,,3,1,1,2
283,dill0n,,18,22,10,32
284,luigi96,,20,1,1,2
285,me2i81,,20,64,101,165
286,davecardwell,,4,3,5,8
287,bordlin,,1,35,1,36
288,nickshel81,,34,1,3,4
289,_shift,,18,14,23,37
290,SpaceCaesar,,19,54,7,61
291,evabin,,13,295,4,299
292,benb24,,5,14,3,17
293,lentil,,20,2,3,5
294,chibigoten,,13,11,9,20
295,AdamTReineke,,20,27,14,41
296,NJScorpio,,13,191,70,261
297,fishwert,,20,7,8,15
298,robisbell,,12,33,71,104
299,ixampl,,32,5,5,10
300,s2b,,32,1,1,2
301,DecodedFromSpace,,18,5,12,17
302,neave,,1,6,1,7
303,absoluteskeptic,,32,23,27,50
304,alphabeat,,22,1713,1434,3147
305,falcojr,,33,8,17,25
306,pornking,,13,2,1,3
307,kamaelian,,20,2,5,7
308,idealsorstrategy,,1,4,2,6
309,camgnostic,,6,40,44,84
310,ducky3tjh,,13,47,2,49
311,Waylander1970,,20,6,3,9
312,AlonzoFyfe,,32,1,5,6
313,aieee,,20,12,11,23
314,LapsedPacifist,,13,293,809,1102
315,nocam,,19,1,6,7
316,rawrz,,18,4,2,6
317,mdoddr,,18,158,234,392
318,exponent,,20,5,2,7
319,egibson,,18,83,41,124
320,algernon_inc,,31,1,1,2
321,noisydissonance,,18,12,14,26
322,inputnamehere,,1,23,21,44
323,mvonballmo,,22,49,55,104
324,z3niMAGiNE,,6,2,1,3
325,Sle,,42,401,729,1130
326,rrabbit,,18,10,12,22
327,Morrac,,13,2,3,5
328,TheEighties,,5,1,1,2
329,teamonkey,,20,39,23,62
330,amijot,,1,69,20,89
331,koko775,,20,34,42,76
332,twopoint718,,20,42,66,108
333,pyro2927,,1,209,240,449
334,jackcrow,,19,9,10,19
335,b34nz,,19,1567,1759,3326
336,nsfx,,1,8,2,10
337,birdmanx35,,1,69,5,74
338,chris789,,5,1127,17,1144
339,rocksteady,,43,6,2,8
340,hejog,,22,92,146,238
341,nafai,,20,14,26,40
342,mancunian,,31,112,183,295
343,alfadana,,34,1,3,4
344,lyric6a,,18,47,32,79
345,swytz,,13,2,8,10
346,bis,,32,3,7,10
347,I_R_BABOON,,30,3,1,4
348,crackron,,12,7,16,23
349,appleaday,,19,170,84,254
350,popechunk,,19,7,8,15
351,wvhillbilly,,13,3,1,4
352,CapslockSpamLover,,19,1,1,2
353,muyuu,,12,51,90,141
354,WendyThomas,,5,147,23,170
355,copyland1,,22,1,1,2
356,ncod,,19,13,19,32
357,rubes68,,18,1,1,2
358,garyp714,,19,2213,1409,3622
359,drpgq,,30,3,7,10
360,Mantaar,,20,66,57,123
361,gjahnke,,12,2,1,3
362,flyinggnome,,34,71,116,187
363,TerrorBanana,,6,27,46,73
364,clankboomsteam,,31,3,4,7
365,Master_Kush,,22,4,4,8
366,smart33,,13,11,4,15
367,mattbc,,30,4,5,9
368,hadashi,,0,25,43,68
369,radiofloyd,,22,37,2,39
370,onecartel,,18,5,13,18
371,mueller2004,,26,4,3,7
372,FaceCake,,4,1,2,3
373,noahbk,,19,3,4,7
374,dactylic,,1,1,1,2
375,id10tjoeuser,,31,44,43,87
376,The_Gage,,1,16,21,37
377,vanzan,,31,358,315,673
378,blackmouth,,11,2,2,4
379,doctabu,,1,64,63,127
380,andrewlinn,,13,50,34,84
381,FatBanker,,22,2,7,9
382,lanewin,,40,2,1,3
383,washi,,31,5,5,10
384,hgunited,,13,2,1,3
385,MphsBlues,,34,9,19,28
386,bubblepeak,,31,12,7,19
387,WHITEvsBLACK,,18,3,4,7
388,matthcx,,31,1,1,2
389,untitled1,,1,39,6,45
390,Hilko,,12,97,186,283
391,zacdenver,,13,347,990,1337
392,talatfakhri007,,20,51,16,67
393,micahville,,43,2,7,9
394,fimblo,,20,19,22,41
395,djinsomniac,,19,25,42,67
396,guntharg,,31,1,1,2
397,magnerash,,13,1,1,2
398,toml,,18,14,15,29
399,upchuk,,18,613,49,662
400,sewiv,,22,54,60,114
401,inspire,,19,50,31,81
402,teetow,,18,66,117,183
403,brerrabbit,,18,1,6,7
404,aristus,,20,16,6,22
405,TheNonReligiousPope,,18,331,553,884
406,mery1,,1,9,14,23
407,dupeduperson,,0,64,10,74
408,markedtrees,,20,224,368,592
409,deftmatt,,13,1,2,3
410,RMTV,,30,1,2,3
411,graciouspatty,,13,4,9,13
412,Scariot,,13,3,9,12
413,jhart3,,42,15,15,30
414,dehue,,1,7,6,13
415,limi,,20,6,11,17
416,bishopazrael,,19,38,26,64
417,fnord123,,20,496,564,1060
418,kingchiron,,19,56,67,123
419,oh_hello,,22,1,1,2
420,treezequeen,,19,1,1,2
421,wrangler1390,,9,4,5,9
422,random2927350238,,20,28,26,54
423,crypticgeek,,22,1,2,3
424,killa7,,18,2,4,6
425,AVISINGH,,18,26,33,59
426,theotherspectacle,,42,2,2,4
427,snakespm,,10,15,10,25
428,chaunymony,,18,67,71,138
429,eznet,,20,1,6,7
430,rondogfy,,18,2,2,4
431,eliot99,,13,61,68,129
432,saintflibble,,29,1,1,2
433,wowbagger,,43,19,32,51
434,WerewolvesRancheros,,43,160,265,425
435,furby1234,,8,3,1,4
436,jaybeehere954,,13,1,2,3
437,mrreddit,,18,14,19,33
438,snowmizuh,,0,9,8,17
439,trebnoj,,1,16,10,26
440,plexux,,18,6,1,7
441,sadisticmidget,,5,5,10,15
442,masonba,,32,92,29,121
443,Kerguidou,,14,27,18,45
444,_Sarah_Palin_,,18,2,1,3
445,random523075097253,,1,1,1,2
446,STDOUBT,,43,70,91,161
447,Michael_Jackson,,17,4,4,8
448,natebmiller,,18,2,3,5
449,Wo1ke,,31,780,967,1747
450,dannyapplesauce,,32,55,73,128
451,2ndGuardsTankArmy,,31,132,161,293
452,GoodyUK,,12,668,8,676
453,skinner696,,34,72,19,91
454,glitch83,,13,19,33,52
455,johnland,,13,29,34,63
456,ch4os1337,,34,5,9,14
457,itx,,32,6,1,7
458,msiekkinen,,13,172,56,228
459,nihilite,,0,270,367,637
460,kruetz,,20,7,12,19
461,MrMasterplan,,18,2,5,7
462,kly,,18,20,26,46
463,realmojo,,20,25,3,28
464,theoneupdownstairs,,41,1,5,6
465,out_of_memory,,0,2,2,4
466,method77,,19,12,19,31
467,turbofisk,,0,47,70,117
468,initnull,,13,22,2,24
469,harley96,,0,2,2,4
470,lequack,,19,8,11,19
471,readergirl,,31,95,124,219
472,datamyte,,36,2,6,8
473,AngryBadger,,18,94,99,193
474,adal-cft,,13,1,4,5
475,endosquid,,20,4,3,7
476,notasockpuppet,,40,1,1,2
477,phildawes,,20,6,6,12
478,cigr,,19,251,63,314
479,pyrefyre,,40,10,9,19
480,werther,,19,30,40,70
481,mrm52,,1,21,4,25
482,scottys0,,5,2,1,3
483,rez0,,10,7,14,21
484,mrmoneda,,6,1,1,2
485,rainmanjam,,5,16,34,50
486,5-4-3-2-1,,4,4,2,6
487,CountSessine,,31,18,9,27
488,turf1600,,13,1,1,2
489,firexq,,0,5,5,10
490,angelwild327,,14,4,4,8
491,autopilot,,0,4,4,8
492,grepthis,,43,3,4,7
493,onehand,,19,34,79,113
494,gaur,,22,5,2,7
495,popfly10,,20,8,8,16
496,KipBond,,19,105,124,229
497,RickyP,,31,707,944,1651
498,ckup619,,18,6,2,8
499,ozsynergy,,15,10,12,22
500,urimyknife,,18,2,1,3
501,hatcat,,1,126,224,350
502,giboyeux,,19,2,2,4
503,Gadfly222,,27,6,8,14
504,VelvetElvis,,1,386,353,739
505,FloGiston,,13,149,294,443
506,Jey_Lux,,6,18,35,53
507,BenjaminFranklin,,13,9,5,14
508,DSLJohn,,13,183,124,307
509,1100,,1,237,471,708
510,Sargos,,20,81,43,124
511,mnotme,,18,419,150,569
512,patched,,20,7,1,8
513,Ferretbot,,4,31,38,69
514,Phonicsey,,18,234,29,263
515,ghiotion,,19,29,29,58
516,bashar1209,,1,26,36,62
517,cskinned,,18,2,5,7
518,freshhawk,,20,17,23,40
519,jeremy_degroot,,41,81,90,171
520,jezebean,,19,16,7,23
521,pthatcher,,20,9,11,20
522,sullivat,,18,2,1,3
523,kbob,,20,20,17,37
524,ih8mondays,,20,15,20,35
525,whoami24601,,0,20,1,21
526,cartooncorpse,,19,647,1588,2235
527,gaaaah,,12,1,3,4
528,qedanne,,20,26,8,34
529,NeoName,,23,1,1,2
530,quuxly,,20,13,22,35
531,rubenshakkamacher,,19,107,208,315
532,mrpeenut24,,22,439,364,803
533,grrlychck,,31,2,2,4
534,IStateTheObvious,,13,67,82,149
535,tinyfoot,,43,2,1,3
536,epicgeek,,42,368,490,858
537,nbuster,,31,45,44,89
538,klackty,,20,19,27,46
539,holyboot,,6,32,3,35
540,boringlove,,22,44,77,121
541,elocbej,,34,28,7,35
542,nunyabidness,,8,1,1,2
543,Seele,,20,340,446,786
544,subinf,,19,17,36,53
545,texan01,,43,2,7,9
546,gravlax,,4,1,2,3
547,7of7,,20,13,8,21
548,monkeySpibb,,20,15,12,27
549,dronebee,,31,8,3,11
550,bvimo,,18,36,91,127
551,motts,,32,4,4,8
552,SerdarArgic,,27,3,2,5
553,hiramp,,12,2,1,3
554,CockerRabbit,,41,1,1,2
555,doctor_shim,,22,123,239,362
556,emptycircles,,13,2,3,5
557,senorcool,,34,1,5,6
558,spitonmars,,18,12,10,22
559,ImNotWhoISayIAm,,1,4,3,7
560,GodTheFather,,18,5,9,14
561,dontmodmedownbro,,31,3,2,5
562,certifiablepsycho,,1,59,36,95
563,daev,,13,126,65,191
564,Ruskerdax,,1,7,8,15
565,amjadanwar,,20,2,1,3
566,dorsey,,19,66,22,88
567,gjaulwes,,13,7,14,21
568,3n7r0py,,13,518,130,648
569,josefek,,19,13,12,25
570,goodgoblin,,43,4,5,9
571,myndas,,22,16,12,28
572,gentlefood3,,18,3,2,5
573,redditer008,,13,3,4,7
574,sanbikinoraion,,1,63,77,140
575,LuckyLion,,1,7,6,13
576,vegan__zombie,,34,2,2,4
577,madonix,,13,284,10,294
578,mr2,,20,8,3,11
579,smans,,19,10,7,17
580,walbold,,30,2,1,3
581,yzeone,,18,6,2,8
582,wabberjockey,,13,33,46,79
583,11eleven11,,0,3,6,9
584,dottieroot,,12,3,1,4
585,monstermunch,,20,226,185,411
586,wjeconsultant,,16,27,5,32
587,amos_olson,,18,22,16,38
588,bangles,,0,49,72,121
589,y0haN,,42,22,28,50
590,elmayimbe,,5,2,8,10
591,Faluzure,,30,3,7,10
592,selstice,,18,17,31,48
593,Xodmoe,,32,13,18,31
594,StarvingAfricanChild,,8,14,10,24
595,mocharain,,18,6,2,8
596,oldjimsteele,,19,33,35,68
597,TopOBopYop,,18,1,4,5
598,orbhota,,43,307,567,874
599,fungstyle,,18,1,3,4
600,wideawakewesley,,42,1,5,6
601,afoo42,,20,74,24,98
602,alicereddit,,5,4,13,17
603,davodrums,,19,285,105,390
604,akoltek,,30,1,1,2
605,lavendula13,,13,394,887,1281
606,pedropants,,4,6,5,11
607,syphondex,,30,1,1,2
608,elmicha,,22,4,10,14
609,shackilj2,,34,1,2,3
610,jpark,,13,118,105,223
611,jeremed,,1,1,2,3
612,jazzyjaffa,,39,14,15,29
613,Grantismo,,18,10,13,23
614,KangOl,,20,15,11,26
615,underthelinux,,1,190,242,432
616,Ehran,,12,38,95,133
617,N432SEAN,,43,3,4,7
618,crunchynaan,,32,2,1,3
619,johndoesnt,,13,3,5,8
620,mikethomas84,,42,18,3,21
621,ckwop,,20,72,44,116
622,mhudson,,22,1,1,2
623,toona03,,34,1,3,4
624,fionawallace,,18,13,31,44
625,Eiii333,,22,229,279,508
626,0ddb411,,13,12,4,16
627,alteran1,,1,33,49,82
628,hummir,,6,23,8,31
629,Trucoto,,32,7,11,18
630,zerogirl,,43,7,6,13
631,slaur,,19,410,150,560
632,juventuscadillac,,32,23,19,42
633,eketros,,30,2,3,5
634,vertexoflife,,20,5,5,10
635,CommodoreGuff,,1,10,9,19
636,celsy,,14,1,2,3
637,Kallahan11,,22,26,61,87
638,fdkxjskdkle,,20,24,13,37
639,fdsads13s,,31,1,1,2
640,mystikphish,,32,6,7,13
641,trutru,,20,73,70,143
642,hamilmyemil,,8,3,4,7
643,KuroiDegu,,43,2,2,4
644,MeanStreak,,19,26,47,73
645,laverabe,,13,18,29,47
646,cicadabug,,19,3,1,4
647,sudo_cmd,,1,10,11,21
648,loumf,,20,33,39,72
649,StevieDee,,43,1,6,7
650,david_bowie,,18,3,2,5
651,SnowLeopard,,1,111,97,208
652,missRose,,1,56,39,95
653,rua2006,,26,3,1,4
654,repotorp,,13,4,8,12
655,digitalhijinks,,13,35,77,112
656,weezerfan,,14,2,5,7
657,reflorance,,31,1,1,2
658,collinwilliams,,0,111,12,123
659,r42,,29,13,24,37
660,padfoot7,,18,179,139,318
661,lilkatana,,18,14,12,26
662,sblanky,,36,2,1,3
663,Sauwan,,19,616,176,792
664,death_eater,,1,5,4,9
665,yeahjim,,43,3,11,14
666,gmsc,,22,27,14,41
667,Rastid,,31,216,219,435
668,puss,,13,139,42,181
669,bcardarella,,20,15,21,36
670,Santa_Clause,,43,4,3,7
671,mcvoy,,20,2,1,3
672,watts,,18,31,41,72
673,ehird,,20,358,496,854
674,laudinum,,18,44,74,118
675,sliksvelte,,1,3,3,6
676,nimbusnacho,,18,322,322,644
677,ciph3r,,20,1,1,2
678,jouwuitvaart,,13,7,3,10
679,devotee,,43,1,2,3
680,DCAdams,,1,4,8,12
681,obdurak,,20,379,294,673
682,CapRuger,,13,2,3,5
683,duklapragueawaykit,,20,12,8,20
684,thetreat,,1,245,198,443
685,JimboBob,,30,5,6,11
686,brg99,,18,2,1,3
687,iwadon,,41,1,4,5
688,ContentWithOurDecay,,1,316,773,1089
689,whit537,,32,8,4,12
690,QuesoPantera,,0,216,166,382
691,tene,,20,12,12,24
692,clickonthenat,,19,7,19,26
693,xii,,22,54,71,125
694,sniurkst,,19,1,2,3
695,ozzymet7,,19,44,21,65
696,kikaerter,,20,237,448,685
697,pohart,,13,31,72,103
698,keenemaverick,,43,165,197,362
699,Efflux,,1,39,38,77
700,foxbat,,42,163,112,275
701,Timbit42,,20,6,2,8
702,dopplerdog,,15,301,373,674
703,PigglyWiggly,,19,8,1,9
704,eris_amazing,,12,12,21,33
705,alexo05,,18,16,1,17
706,robingrrl,,18,10,11,21
707,fuckbuddy,,9,369,542,911
708,leode,,31,2,2,4
709,xianz,,6,5,7,12
710,sodillen,,27,1,3,4
711,ozymandiask,,22,5,3,8
712,2speed,,4,3,3,6
713,Ms_Bungle,,9,1,1,2
714,rememberingtiger,,13,20,1,21
715,rory007,,0,1,1,2
716,KingLeonidas,,43,1,1,2
717,03495803598,,20,8,7,15
718,DeePsix,,32,17,22,39
719,danstar,,6,1,1,2
720,IHUsol,,19,21,14,35
721,nevesis,,19,483,618,1101
722,Getalookatthis,,13,1,2,3
723,Contractionator,,20,7,7,14
724,vegasmacguy,,29,1,2,3
725,Niggers_Are_Stupid,,12,1,3,4
726,stringerbell,,19,225,291,516
727,stever1975,,20,3,7,10
728,TooStoop,,1,4,4,8
729,cameronoremac,,32,13,9,22
730,blarmystoned,,40,35,6,41
731,DJZ,,29,5,13,18
732,sente,,1,4,6,10
733,ItzVektor,,0,21,66,87
734,Plummit1,,7,2,5,7
735,FarmerBorn,,40,2,4,6
736,lunchladydoris2,,13,216,345,561
737,xoil13,,43,12,9,21
738,dsknsl,,15,2,1,3
739,camdenz,,13,7,4,11
740,m1kael,,19,51,52,103
741,ObamaKerryJr,,13,8,8,16
742,Seekin,,32,52,62,114
743,JohnnyMax,,20,1,1,2
744,KayEss,,20,40,52,92
745,longlivereddit,,13,42,1,43
746,negatiiv,,0,1,9,10
747,calis,,18,235,309,544
748,anti_1337,,34,3,7,10
749,ipeev,,20,297,262,559
750,Michael_Ian_Black,,31,5,1,6
751,jailbreak,,12,10,9,19
752,peter_norths_child,,1,269,86,355
753,scofus,,34,105,132,237
754,NukeAJewForAllah,,1,1,2,3
755,speaker219,,1,35,48,83
756,LusciousChaos,,3,3,2,5
757,dat529,,19,13,13,26
758,snapetom,,29,14,7,21
759,pbrettb,,13,1,6,7
760,coderjoe,,1,9,20,29
761,gir99,,31,22,15,37
762,alekseyportland,,31,1,1,2
763,lamb2theslaughter,,29,1,3,4
764,michaelGregoire,,13,10,21,31
765,novatexboard,,14,3,1,4
766,jakfrost,,13,2,4,6
767,ilovestuff,,5,1,1,2
768,FuzzyLogick,,18,69,193,262
769,saritate,,13,3,3,6
770,Hewus,,15,36,29,65
771,Guanxinet,,34,10,10,20
772,JonathanEllis,,19,2,4,6
773,fusebox13,,0,7,14,21
774,brondsem,,20,1,1,2
775,psignosis,,34,124,111,235
776,mdot,,22,3,4,7
777,abzde,,20,15,20,35
778,riddle_duck,,1,15,24,39
779,treo700P,,32,2,10,12
780,JustinZ,,27,3,8,11
781,mindspike,,13,10,4,14
782,DearBurt,,18,205,315,520
783,ngcazz,,18,111,251,362
784,warpdragon,,0,2,1,3
785,steveysjs,,5,1,7,8
786,TTDaVeTT,,42,1,1,2
787,paran0ide,,20,53,2,55
788,Rupan,,42,1,1,2
789,clintisiceman,,18,302,430,732
790,deadwisdom,,5,162,154,316
791,ComplexEmergency,,31,33,74,107
792,sta_n_sane,,19,16,41,57
793,csmiths,,6,6,10,16
794,whitegirlhere,,1,1,1,2
795,crescendolls,,13,1,5,6
796,poeir,,22,210,245,455
797,Allectus,,42,79,94,173
798,MiguelPT,,32,6,1,7
799,ikoss,,27,18,37,55
800,the_sparrow,,22,164,14,178
801,distirot,,43,4,4,8
802,lookingiswrong,,18,82,115,197
803,UloPe,,20,13,14,27
804,aroris,,31,9,4,13
805,ryanh42,,18,4,11,15
806,Enoxice,,1,209,315,524
807,monjurul,,12,1,2,3
808,tsunamisteve,,6,6,5,11
809,damienkhunter,,13,6,2,8
810,thebigguy62,,31,7,8,15
811,gorillamime,,18,14,6,20
812,waxo,,4,2,1,3
813,diziak,,34,4,5,9
814,dtelad11,,22,65,36,101
815,jack_proletariat,,12,1,1,2
816,mhd,,20,223,192,415
817,robstah,,43,1,2,3
818,burstgoof,,12,2,1,3
819,mvalente,,20,9,4,13
820,CarbonFiberUnderwear,,23,4,2,6
821,rssjunkie,,29,2,4,6
822,gamkiyaarov,,28,7,17,24
823,paulnomad,,34,39,9,48
824,LaptopLogic,,13,3,4,7
825,shackett,,0,2,4,6
826,Neoncow,,43,275,565,840
827,Mattbot5000,,20,2,4,6
828,walkindude,,22,1,1,2
829,tempestbrewer,,22,1,1,2
830,lani0,,43,2,27,29
831,igneus,,5,4,2,6
832,Churn,,18,329,350,679
833,jw4wywna,,5,1,1,2
834,WindowsVistaOutreach,,4,12,1,13
835,dunit01,,13,1,2,3
836,WisenUp,,0,129,189,318
837,mattshields,,19,2,6,8
838,stop___grammar_time,,18,36,42,78
839,ngileadi,,12,2,2,4
840,DiffeeOnline,,19,41,3,44
841,mehwoot,,7,14,12,26
842,milinz,,15,2,1,3
843,kthakar,,20,12,10,22
844,cyince,,31,86,89,175
845,dilap,,20,11,13,24
846,kbio89,,43,1,2,3
847,natalieorphan,,26,1,2,3
848,vit1701,,28,3,5,8
849,johnthedrunk,,18,183,315,498
850,Pxorp,,19,384,416,800
851,lyte,,36,5,4,9
852,my_pw_is_1234,,18,21,26,47
853,ex-stasis,,30,16,13,29
854,wageslave,,19,1113,1258,2371
855,jomynow,,19,50,32,82
856,Redpin,,30,8,18,26
857,ekizz,,18,120,95,215
858,Ysolde,,13,5,11,16
859,gwenny,,34,2,3,5
860,Crash-D,,37,1,2,3
861,PissPoorLogic,,28,8,6,14
862,random5280752309725,,20,7,4,11
863,CiRU5,,31,4,4,8
864,jasonmc,,20,5,3,8
865,ritar_hylon,,29,1,1,2
866,maefly2,,13,133,87,220
867,stu9000,,20,13,21,34
868,dlgdyer,,13,6,5,11
869,8bitsince86,,13,2,2,4
870,Zoethor2,,1,19,44,63
871,migsho,,22,1,2,3
872,bugninja,,32,77,32,109
873,glowinthedark,,18,102,149,251
874,cbre88x,,1,1,1,2
875,simc,,20,12,1,13
876,jaystile,,32,5,1,6
877,shan4350,,13,4,15,19
878,squarehipster,,2,5,5,10
879,kthakore,,20,8,4,12
880,spiffypants,,0,4,7,11
881,darmstrong,,29,2,2,4
882,clina83,,21,1,2,3
883,YJ2k2,,30,70,67,137
884,rivy,,18,19,62,81
885,campbe79,,20,30,27,57
886,fortunado,,32,1,1,2
887,ctraganos,,13,8,6,14
888,hrj,,42,1,3,4
889,justafed,,20,3,2,5
890,FokkeNews,,13,609,1013,1622
891,tanjuska,,5,7,3,10
892,bonecows,,18,2,5,7
893,Hubso,,22,595,674,1269
894,dav,,32,2,7,9
895,bluefish29,,18,4,1,5
896,math0ne,,39,7,5,12
897,AccordionGuy,,20,6,4,10
898,mash5,,13,48,10,58
899,earscoolbreeze,,13,14,36,50
900,Jedidiah,,19,6,9,15
901,greenmt,,13,3,4,7
902,rockintom99,,41,1,2,3
903,dhibbit,,1,248,266,514
904,aberrant,,22,159,139,298
905,Father_Pleger,,5,1,1,2
906,lilhurt38,,9,1,3,4
907,BloodJunkie,,32,233,6,239
908,num42,,1,1,1,2
909,TheRealStick,,0,139,5,144
910,RonBarrackMcCain,,19,1,1,2
911,Zaxxis,,31,40,44,84
912,svonnah,,1,91,98,189
913,bone,,20,10,10,20
914,almafa,,20,10,11,21
915,dbsmoker,,18,195,460,655
916,jamongkad,,20,6,8,14
917,lebski88,,20,125,183,308
918,lilmul123,,18,257,80,337
919,Laburno,,14,1,3,4
920,jryde303,,13,12,5,17
921,hjklqa,,4,2,3,5
922,sassansanei,,30,22,21,43
923,built,,22,3,6,9
924,bcropper,,23,1,1,2
925,gnit,,22,3,6,9
926,farktronix,,1,4,6,10
927,damagingd,,18,17,4,21
928,thegayestmanalive,,20,2,1,3
929,stoobe,,19,24,10,34
930,icantbemoreoriginal,,6,1,2,3
931,schallau,,6,9,11,20
932,chrozz,,5,36,101,137
933,vsizikov,,20,3,4,7
934,flutie,,4,2,4,6
935,internet_enthusiast,,22,3,8,11
936,nordicwinter,,18,39,65,104
937,magv,,20,31,40,71
938,dac69,,1,1,8,9
939,bobobo,,13,73,163,236
940,speedkissdrink,,10,2,1,3
941,karlhungis,,32,1,1,2
942,ragingkenbo,,17,264,115,379
943,cadillacvandal,,30,1,1,2
944,karth95,,30,2,1,3
945,seanm27,,13,225,325,550
946,shalaby,,18,14,20,34
947,WurzelGummidge,,18,55,63,118
948,SPINKTRONIX,,20,2,4,6
949,inthesky,,32,23,34,57
950,RayWestsWife,,1,1,1,2
951,brsmnky007,,13,12,9,21
952,karlb,,20,1,3,4
953,mindvault,,20,37,51,88
954,srtor,,13,8,37,45
955,piz0wn,,41,1,2,3
956,DIYromania,,18,162,149,311
957,brains1919,,29,1,1,2
958,vegasdoesvegas,,18,11,24,35
959,raqm,,1,22,1,23
960,mdolon,,4,11,8,19
961,a1phanumeric,,18,61,72,133
962,Felz,,32,8,13,21
963,saidwhat,,18,13,10,23
964,frugalgeek,,19,2,1,3
965,breals,,19,7,9,16
966,cliks,,18,221,1,222
967,banjaxed,,20,33,25,58
968,huerequeque,,1,33,84,117
969,kordless,,20,97,117,214
970,JEdwardFuck,,20,2,3,5
971,Ensynoptic,,1,5,13,18
972,mbot01,,18,5,10,15
973,btacoder,,31,16,8,24
974,gotekix,,22,24,32,56
975,bookwyrm,,41,10,14,24
976,tokyomonster,,31,2,4,6
977,nfiedel,,20,4,5,9
978,spaniardforMcCain,,19,3,2,5
979,extant,,0,3,8,11
980,qruokgs,,30,6,3,9
981,Jadedseeker,,27,1,1,2
982,rushtrack,,12,27,22,49
983,kooshball,,18,7,4,11
984,skaman607,,1,6,9,15
985,troll666,,19,25,48,73
986,cheysuli,,6,80,122,202
987,gschizas,,20,107,129,236
988,Visconti,,13,70,11,81
989,Tkeo,,34,1,1,2
990,roodammy44,,22,3,10,13
991,natey90210,,13,4,2,6
992,handick,,29,18,1,19
993,orip,,20,10,10,20
994,SolidEnder,,26,1,3,4
995,fvf,,20,29,51,80
996,hilbert,,19,149,12,161
997,beataya,,28,1,2,3
998,bloopsie,,32,2,12,14
999,lavistadad,,19,15,26,41
1000,alanlewis,,42,24,27,51
1001,music-box-love,,31,8,6,14
1002,seanpercival,,5,1,1,2
1003,AdamJacobMuller,,10,1,2,3
1004,braq24,,18,14,2,16
1005,woowah,,30,50,17,67
1006,rhymevigilante,,17,1,2,3
1007,arthurrr,,6,5,9,14
1008,jasenlee,,13,93,201,294
1009,midloviking,,14,1,1,2
1010,7oby,,14,4575,3476,8051
1011,davida_usa,,31,506,218,724
1012,kmand,,6,18,18,36
1013,X-Destruction,,18,6,14,20
1014,bloghog,,41,1,1,2
1015,drys,,30,1,2,3
1016,flawless_knockoff,,22,15,17,32
1017,gary_ragel,,18,2,2,4
1018,hectorhector,,1,181,213,394
1019,canonicalform,,19,14,27,41
1020,funkygreenthing,,19,9,17,26
1021,badlittoboy,,19,1,1,2
1022,rickardg,,20,3,3,6
1023,jdrama83,,30,118,117,235
1024,battlebarge,,30,1,1,2
1025,thingsofinterest,,19,4,5,9
1026,lambright,,13,3,14,17
1027,dohastmich,,18,11,17,28
1028,jkerwin,,19,194,212,406
1029,bulletsvshumans,,4,115,157,272
1030,mikesalsa100,,31,1,1,2
1031,IkoIkoComic2,,13,4,1,5
1032,Decon,,4,12,21,33
1033,massiveone,,31,1,1,2
1034,socash,,14,1,1,2
1035,missingpersonator,,13,13,13,26
1036,slade311,,20,1,1,2
1037,demonllama,,18,1,1,2
1038,flydog,,19,13,13,26
1039,webnrrd2k,,6,206,480,686
1040,bmm6o,,20,2,5,7
1041,ClientNine,,0,2,3,5
1042,reegmo,,12,1,2,3
1043,lowingae,,4,5,6,11
1044,dutchkabuki,,31,1,1,2
1045,markvand,,13,923,289,1212
1046,wpgbrownie,,20,113,55,168
1047,dkamkar,,13,10,1,11
1048,irancrude,,32,1,1,2
1049,abey,,13,2,1,3
1050,texasf,,1,13,14,27
1051,eleventruth,,27,2,6,8
1052,guns-14,,31,1,3,4
1053,pigalien,,19,3,8,11
1054,prolificsage,,32,34,92,126
1055,Joke_Criminal,,31,3,3,6
1056,johnnymccain,,13,1,2,3
1057,iamthespoke,,19,2,8,10
1058,ethan103,,43,1,1,2
1059,Joeeezee,,23,2,3,5
1060,Ricapar,,0,8,9,17
1061,badjedi,,1,1,1,2
1062,keithj,,19,7,13,20
1063,freibooter,,31,7,8,15
1064,paganini,,43,15,14,29
1065,brnews,,20,3,4,7
1066,sensiable,,18,58,14,72
1067,mg1313,,20,5,5,10
1068,christophersisk,,32,15,1,16
1069,electricsheep14,,8,7,18,25
1070,lodossheros,,3,7,14,21
1071,Duke999R,,15,8,17,25
1072,yike5,,38,2,1,3
1073,TheKingofEngland,,18,2,3,5
1074,smap,,19,5,10,15
1075,dixi,,20,49,5,54
1076,bothari2,,20,1,3,4
1077,bunny4e,,18,20,23,43
1078,telesphore4,,13,3,4,7
1079,gulpadoodle,,43,8,11,19
1080,northsidebill,,6,1,1,2
1081,draxter,,12,12,4,16
1082,lizhenry,,8,5,1,6
1083,ps6000,,43,24,11,35
1084,thorstadt,,42,1,1,2
1085,uhk,,20,26,2,28
1086,mr1337,,43,12,22,34
1087,breach_of_etiquette,,20,91,30,121
1088,50clint,,17,1,1,2
1089,timmyrich,,12,18,34,52
1090,mahdroo,,13,6,7,13
1091,batsbyfiresidebright,,34,11,15,26
1092,Floodzie,,32,59,24,83
1093,deadtime,,20,3,7,10
1094,pingkai,,3,3,3,6
1095,kettlecorn,,42,2,1,3
1096,mrWolf,,7,3,1,4
1097,backbowls,,0,15,19,34
1098,belovedkid,,31,36,34,70
1099,timo1023,,20,108,83,191
1100,Scoo,,32,10,17,27
1101,topgear55,,31,1,3,4
1102,Kalvin,,34,39,47,86
1103,BlackFlag,,0,26,26,52
1104,JohnMcCain,,13,20,27,47
1105,mdonahoe,,34,16,34,50
1106,danastasi,,0,15,24,39
1107,fr0chu,,20,24,13,37
1108,prognost,,1,15,26,41
1109,jlebrech,,34,2,2,4
1110,trippppp,,43,2,4,6
1111,MainlandX,,1,214,295,509
1112,Rawkit77,,13,76,5,81
1113,asciimo,,18,5,4,9
1114,AliasHandler,,18,1638,672,2310
1115,Ronin_301,,1,5,12,17
1116,Fiserfully,,3,63,78,141
1117,eldub,,19,79,115,194
1118,aragon127,,34,175,245,420
1119,qlinux,,20,1,1,2
1120,david,,20,95,161,256
1121,Stever89,,12,5,7,12
1122,tweaqslug,,34,18,31,49
1123,georgefrick,,19,159,275,434
1124,jpdemers,,22,401,723,1124
1125,joker123456,,31,4,7,11
1126,lesigh,,13,15,15,30
1127,zen53,,5,35,10,45
1128,sbbath,,0,9,25,34
1129,xmashatstand,,18,18,47,65
1130,Lukifer,,31,216,224,440
1131,farts,,11,4,3,7
1132,halmcelroy,,20,3,8,11
1133,jaie,,31,2,4,6
1134,klownthekiller,,1,2,8,10
1135,mrstrictling,,11,3,1,4
1136,carfey,,20,7,12,19
1137,Dubkiller,,18,8,18,26
1138,jessicaC,,5,12,3,15
1139,pldgnoauthority,,18,136,29,165
1140,joshosaur,,19,1,1,2
1141,myheaditches,,18,148,199,347
1142,maybemorris,,4,1,1,2
1143,theoryofevrythng,,31,44,109,153
1144,xiaomiao,,7,1,1,2
1145,SlyRax,,31,1,1,2
1146,Tugger,,29,2,1,3
1147,bloodrosey,,19,81,85,166
1148,xavierromin,,19,2,7,9
1149,jxmac,,18,25,73,98
1150,gruntbug,,5,4,1,5
1151,not-smart,,20,1,1,2
1152,hackmiester,,22,1,1,2
1153,walkingpeas,,19,4,4,8
1154,nztim,,19,5,1,6
1155,avinash,,20,3,2,5
1156,wilwith1l,,18,54,138,192
1157,strano,,20,6,1,7
1158,ojii-san,,30,13,12,25
1159,munky_g,,19,107,305,412
1160,mrIvan,,13,3,1,4
1161,humorfreak,,18,4,3,7
1162,amoore,,20,62,44,106
1163,AngryProfessor,,19,16,12,28
1164,lars_,,20,86,83,169
1165,edkopp4,,9,40,77,117
1166,monsieurlee,,22,37,25,62
1167,tooooobs,,20,36,45,81
1168,Thepher,,18,148,324,472
1169,WheeeeThePeople,,19,10,16,26
1170,arkoner,,22,14,7,21
1171,bjorgen,,1,6,2,8
1172,guntotingliberal,,3,482,532,1014
1173,frankwit,,13,8,1,9
1174,idlepeon,,6,50,59,109
1175,Roosta,,18,65,42,107
1176,hampusl,,18,3,5,8
1177,gobama99,,0,40,48,88
1178,quirk,,41,2,6,8
1179,aaronblohowiak,,20,2,6,8
1180,patt,,30,123,131,254
1181,pap3rw8,,43,35,6,41
1182,topheavy_burnsides,,18,5,11,16
1183,kahrn,,0,11,9,20
1184,lobotomir,,22,38,42,80
1185,morner,,19,316,345,661
1186,srgerm,,10,10,17,27
1187,PumpyChowdown,,18,15,47,62
1188,jonnybfromcle,,1,93,144,237
1189,chaosfarmer,,22,2,1,3
1190,HRHLizi2,,31,1,1,2
1191,a7244270,,18,1,9,10
1192,heathen13,,19,11,11,22
1193,keano,,39,1,2,3
1194,Limoner32,,0,36,11,47
1195,ballsoflakes,,34,2,5,7
1196,na_confederation,,30,9,9,18
1197,sphivo,,20,1,2,3
1198,ilikebbq,,13,79,110,189
1199,canuckmoose,,10,1,4,5
1200,bitchmac,,13,1,1,2
1201,preved,,13,20,14,34
1202,numbato,,15,5,7,12
1203,jackass15,,13,1,1,2
1204,bluetiger,,13,1,3,4
1205,bluestorm,,20,11,18,29
1206,NoControl,,11,1036,1709,2745
1207,fueltank,,13,2,3,5
1208,seany,,18,63,55,118
1209,residual,,18,3,7,10
1210,bigpook,,18,84,134,218
1211,caisersoze,,13,41,4,45
1212,fm909,,5,17,44,61
1213,mwaller,,18,7,9,16
1214,kl116004,,13,13,8,21
1215,artiface,,19,114,201,315
1216,Zendo,,20,1,1,2
1217,peteru,,19,65,50,115
1218,miken1157,,43,2,4,6
1219,predication3,,19,5,3,8
1220,lt_k,,30,2,2,4
1221,rockss65,,1,18,3,21
1222,kleinbl00,,1,330,385,715
1223,kubrickfan799,,19,5,9,14
1224,qubitsu,,0,18,2,20
1225,strwrsxprt,,34,1,2,3
1226,lnxaddct,,20,4,6,10
1227,hixsonj,,43,7,7,14
1228,HK-47,,6,3,2,5
1229,jc13,,0,2,1,3
1230,spangborn,,22,4,3,7
1231,ladibug31480,,4,4,1,5
1232,kiwistem,,12,1,3,4
1233,tiff_seattle,,0,50,51,101
1234,crapuser639,,31,2,3,5
1235,weenaak,,4,1,1,2
1236,wash67,,5,8,6,14
1237,madcowtricks,,34,2,1,3
1238,Ridcully,,31,4,2,6
1239,eOgas,,22,523,809,1332
1240,CamelToeElvis,,0,9,23,32
1241,mebb,,0,72,4,76
1242,supercap,,41,4,9,13
1243,Irishdsf,,5,76,16,92
1244,ianakori,,5,1,1,2
1245,FrogDickTheSecond,,42,1,3,4
1246,ayrnieu,,29,789,1026,1815
1247,boldo,,23,4,1,5
1248,foolsville,,13,1,1,2
1249,computer_hacker,,11,2,1,3
1250,Kinax,,4,1,2,3
1251,Etchii,,1,107,212,319
1252,onecelledcreature,,18,44,86,130
1253,Mignon,,20,9,22,31
1254,nolimitdomains,,13,5,1,6
1255,lassahnjs,,0,6,3,9
1256,Terribly,,1,1,3,4
1257,Jenry,,0,225,23,248
1258,swedishjames,,18,3,11,14
1259,alkoholik,,13,68,32,100
1260,latrov,,15,86,43,129
1261,wikipedia_guy,,0,6,4,10
1262,JohnTesh,,19,8,12,20
1263,nkteam,,18,55,10,65
1264,peterbuldge,,18,1,7,8
1265,psychonumber1,,13,3,3,6
1266,THE_END_OF_THE_WORLD,,8,2,2,4
1267,b-schroeder,,17,1,1,2
1268,erokar,,20,14,14,28
1269,lensfocus,,39,1,2,3
1270,dhess,,20,3,4,7
1271,vang3lis,,20,23,21,44
1272,ringzero,,20,39,29,68
1273,fresh_custard,,18,1,1,2
1274,hazexp,,20,13,15,28
1275,fueledbyrage,,20,1,1,2
1276,GiddyMonkey,,32,15,35,50
1277,Sucks2BU,,42,88,4,92
1278,All24,,13,74,91,165
1279,jeremybscott,,19,35,40,75
1280,Shawn1141,,19,1,2,3
1281,cactushair,,18,92,2,94
1282,peter_b123,,19,45,151,196
1283,RaspberryTang,,13,341,211,552
1284,latent,,20,2,1,3
1285,kencleanair,,10,2,2,4
1286,necrecious,,20,57,63,120
1287,kle216,,19,75,10,85
1288,nO0b,,20,7,15,22
1289,yuletide,,32,17,1,18
1290,masteroftheuniverse,,19,18,46,64
1291,Monotonousblob,,18,2,5,7
1292,fairbeauty1,,5,1,3,4
1293,sustydev,,13,9,9,18
1294,McHuff,,5,51,138,189
1295,Kook_Leto,,19,4,9,13
1296,hudsonheckyl,,3,3,5,8
1297,Fallout911,,18,12,44,56
1298,wmoxam,,20,24,44,68
1299,dave,,32,355,334,689
1300,bsmeteronhigh,,13,24,49,73
1301,heffsta,,18,145,50,195
1302,orlandosflorida,,19,1,1,2
1303,Sixark,,34,81,1,82
1304,Lamaocan,,31,1,1,2
1305,rense,,43,17,23,40
1306,shizzy0,,13,302,412,714
1307,Rincewind_nl,,5,2,4,6
1308,sine_nomen,,20,9,1,10
1309,etherkiller,,19,20,26,46
1310,oblivion19,,42,5,2,7
1311,HappyHarry,,36,1,1,2
1312,txlonghorn_02,,13,8,11,19
1313,absolutsyd,,5,59,211,270
1314,Mystic11,,18,8,14,22
1315,beerinhand,,0,10,5,15
1316,hilla02,,18,4,4,8
1317,jarv,,7,5,2,7
1318,reallyoldguy,,18,3,2,5
1319,awag22,,18,107,186,293
1320,snowballs,,20,13,14,27
1321,etoleb,,7,12,3,15
1322,Inquisition,,10,105,182,287
1323,a1icey,,34,47,86,133
1324,Gennocid,,5,4,1,5
1325,UniqueUsername,,18,13,29,42
1326,ImNotaGDspammer,,8,1,1,2
1327,freryetw,,12,2,2,4
1328,cohesion,,32,149,119,268
1329,PyroMyrmidon,,19,17,40,57
1330,dbeaart,,29,1,5,6
1331,homeless,,13,3,7,10
1332,evanspw,,18,3,2,5
1333,fubo,,4,317,369,686
1334,fearnloathing,,32,25,66,91
1335,ercax,,20,6,22,28
1336,demic,,18,3,3,6
1337,FellowConspirator,,31,117,100,217
1338,3rdfoundation,,34,97,95,192
1339,ubergeek09,,5,2,14,16
1340,TheNessman,,13,2,3,5
1341,plasmon,,13,69,106,175
1342,jedman,,13,4,2,6
1343,csimpkins,,20,5,3,8
1344,citizen1nsn,,32,17,33,50
1345,ahy1,,20,27,6,33
1346,tridium,,8,69,52,121
1347,viota,,43,17,50,67
1348,wwwwho,,19,3,8,11
1349,stephenv,,13,139,198,337
1350,solid-one-love,,19,22,25,47
1351,coolslug,,18,12,5,17
1352,T_C,,28,7,4,11
1353,prasoc,,5,20,48,68
1354,Jwinky,,32,13,10,23
1355,ismokeluckystrike,,12,9,21,30
1356,fsniper,,11,1,1,2
1357,cl4rk3,,32,13,8,21
1358,jaiden0,,23,1,1,2
1359,Allein,,29,1,2,3
1360,ericatha,,22,61,79,140
1361,Mistress_Dee,,13,1,1,2
1362,KirinDave,,20,19,11,30
1363,winstonfahrenheit,,19,9,27,36
1364,solust,,18,29,35,64
1365,SHIT_YEAH,,15,2,2,4
1366,ha1f,,20,8,5,13
1367,pinkbiff,,30,4,12,16
1368,just4this,,13,352,511,863
1369,KruncH,,18,4,10,14
1370,mark445,,43,523,441,964
1371,wilef,,18,1,1,2
1372,leadingzero,,19,1,1,2
1373,zacthecuch,,22,2,1,3
1374,woty,,11,1,1,2
1375,lanceusa,,22,40,5,45
1376,ande1352,,13,3,5,8
1377,mynameinyourblood,,19,48,57,105
1378,JimEngland,,31,8,6,14
1379,OfficerTandy,,0,4,7,11
1380,reddittidder,,13,15,39,54
1381,roxy317,,13,2,2,4
1382,trickster_brat,,39,1,1,2
1383,plubiuz,,13,35,9,44
1384,pmendoza,,30,1,1,2
1385,ZMoney,,34,7,4,11
1386,SarahLee,,13,1077,251,1328
1387,jbstjohn,,20,152,262,414
1388,enpth,,32,1,1,2
1389,techmaniac,,18,9,39,48
1390,a_dog,,14,3,1,4
1391,wagadugo,,0,25,35,60
1392,tubaplayer,,19,2,1,3
1393,Spammi,,31,1,1,2
1394,dunderjeep,,13,2,3,5
1395,wscottfuller,,18,1,4,5
1396,cgarvie,,0,4,5,9
1397,Aerek,,22,64,105,169
1398,GreatBigThing,,3,94,179,273
1399,Detroiter7,,14,2,2,4
1400,muffinman,,20,87,155,242
1401,carpetbowl,,18,42,128,170
1402,pdaddyo,,1,42,34,76
1403,DCScrap,,18,968,29,997
1404,Dzazter,,10,282,409,691
1405,neoyoda,,6,2,1,3
1406,asleepsheeple,,15,3,2,5
1407,TheFrigginArchitect,,13,2,2,4
1408,xasey,,33,10,13,23
1409,Achorny,,13,6,6,12
1410,itspitpat,,1,24,19,43
1411,k4_pacific,,34,300,356,656
1412,mindslight,,20,348,550,898
1413,captainamericaballs,,19,17,34,51
1414,Redditor-in-Chief,,34,6,8,14
1415,workpsyche,,19,4,1,5
1416,mvbma,,19,264,291,555
1417,dryice,,32,778,809,1587
1418,memmek2k,,20,1,1,2
1419,potatogun,,18,126,250,376
1420,mowza,,28,413,675,1088
1421,ctiberius,,13,179,131,310
1422,Lotr1212,,1,15,10,25
1423,kennyidaho,,13,18,30,48
1424,wednesdayjx,,18,23,74,97
1425,grizzledoldster,,19,3,1,4
1426,marblestatus,,18,1,3,4
1427,seanomenon,,18,46,87,133
1428,BBTKnowMore,,13,9,1,10
1429,vizard5,,20,13,10,23
1430,drewjr,,17,22,3,25
1431,benreesman,,20,3,1,4
1432,daveinacave,,19,16,28,44
1433,foreclo2,,13,5,1,6
1434,eggo,,12,106,114,220
1435,ntennies,,29,5,1,6
1436,C4C7Ll5,,33,1,2,3
1437,annabelle919,,19,4,1,5
1438,denkers,,5,1,1,2
1439,themysteriousx,,20,2,3,5
1440,zedority,,13,128,65,193
1441,flipz4,,34,2,7,9
1442,thehomeskillet,,34,10,11,21
1443,phylk,,1,3,9,12
1444,zone,,43,53,21,74
1445,chunhan,,41,1,1,2
1446,jairedmiluhr,,30,1,1,2
1447,lobby,,10,2,2,4
1448,Mythrilfan,,22,739,1001,1740
1449,lator,,18,1,2,3
1450,SocialismFTW,,19,2,3,5
1451,steve70638,,31,46,43,89
1452,sundaryourfriend,,20,58,37,95
1453,tuxrules,,13,1,1,2
1454,cameronj,,13,7,5,12
1455,Lythos,,21,5,3,8
1456,jellicle88,,18,25,56,81
1457,hereticam,,13,7,1,8
1458,johnkrukslovechild,,18,22,16,38
1459,Nickfury101,,19,7,4,11
1460,zurich0371,,18,76,11,87
1461,sammyo,,31,13,28,41
1462,Thulsa790,,42,8,14,22
1463,foundring,,19,3,5,8
1464,Prog,,13,3,3,6
1465,jnk,,1,126,175,301
1466,eyebee,,19,6,14,20
1467,Metatron,,22,19,27,46
1468,kermuj,,19,19,9,28
1469,dreambucket,,22,29,51,80
1470,jr20,,18,3,1,4
1471,Dipsomaniac,,15,3,8,11
1472,godlesspinko,,43,728,791,1519
1473,RobertPaulsen,,18,205,381,586
1474,joshu,,20,15,14,29
1475,DoctorVenkman,,36,34,35,69
1476,pencilo,,13,3,8,11
1477,ShroomAngel,,20,2,10,12
1478,Stern1,,19,5,7,12
1479,julialopez,,16,1,4,5
1480,Sisinono,,19,6,7,13
1481,Asgeir,,20,7,6,13
1482,timotheo,,31,2,4,6
1483,guille_hoardings,,20,2,3,5
1484,ljl430,,42,64,15,79
1485,crazybrit,,22,6,13,19
1486,NickCatal,,19,62,115,177
1487,chipnaan,,20,9,8,17
1488,IM_A_REPTILIAN,,13,157,12,169
1489,keshavkhera,,5,17,3,20
1490,oilisfordummies,,18,16,18,34
1491,multi,,13,297,9,306
1492,adragons,,22,57,40,97
1493,thomaschau,,20,2,1,3
1494,tmd,,20,2,4,6
1495,cryblood,,18,72,64,136
1496,diego_moita,,18,4,5,9
1497,shatteredverve,,18,5,5,10
1498,liketolaugh,,18,14,1,15
1499,Gholas,,1,27,18,45
1500,sl123,,18,8,1,9
1501,mtrainor79,,3,7,2,9
1502,jumbalo,,20,17,34,51
1503,stuarthalloway,,20,3,3,6
1504,davidjang,,19,1,1,2
1505,sushruta,,18,65,100,165
1506,0ctane,,20,7,9,16
1507,HurricaneDITKA,,18,3,10,13
1508,To6oP,,43,15,9,24
1509,linkgirl,,13,423,369,792
1510,chroniq,,42,107,57,164
1511,XJXRXVX,,18,84,130,214
1512,vangelos,,29,12,5,17
1513,orthey,,34,21,19,40
1514,troygilbert,,13,5,3,8
1515,cashikami,,6,5,6,11
1516,naringas,,34,40,81,121
1517,dsplabs,,20,10,6,16
1518,Old_School_Patriot,,13,11,9,20
1519,zenn,,35,1,1,2
1520,Demostheneez,,31,85,136,221
1521,iamdink,,18,4,9,13
1522,kjiutr6,,4,1,2,3
1523,cizzop,,18,6,15,21
1524,realdeal99,,13,21,8,29
1525,Guybrush_Threepwood,,22,200,269,469
1526,Oswego,,32,1,1,2
1527,LilGator,,16,65,93,158
1528,blackartdepot,,19,2,2,4
1529,skinnydog777,,13,1,1,2
1530,elimtevir,,13,22,63,85
1531,halax,,20,1,6,7
1532,runehog,,8,1,1,2
1533,reader123,,13,38,3,41
1534,kimad,,1,43,50,93
1535,skarpio,,13,1,1,2
1536,crosstan,,20,7,8,15
1537,Roxinos,,17,231,274,505
1538,toadfoot,,20,7,7,14
1539,skycheng,,34,241,5,246
1540,aranazo,,31,37,62,99
1541,radoslav87,,32,36,70,106
1542,offat9,,18,327,230,557
1543,d41d8cd98f00b204e980,,8,51,62,113
1544,p1mrx,,22,64,98,162
1545,peterpawan,,32,8,6,14
1546,stubble,,22,174,301,475
1547,pdox,,15,5,7,12
1548,pikaboy259,,5,166,253,419
1549,edheaded,,32,20,3,23
1550,confus,,12,46,75,121
1551,McCainisLying,,9,3,1,4
1552,memsisthefuture,,1,387,632,1019
1553,gbacon,,19,802,857,1659
1554,pbraham,,43,1,1,2
1555,glomek,,20,65,75,140
1556,zengonzo,,31,9,15,24
1557,torv,,28,1,2,3
1558,viciouspictures,,0,124,72,196
1559,larsarus,,42,1,3,4
1560,wildeye,,20,190,313,503
1561,Shana4Liberty,,13,166,9,175
1562,the_champion_of_meh,,32,4,7,11
1563,xxNovaNN,,29,2,3,5
1564,elimisteve,,13,8,3,11
1565,flyingwok,,12,4,5,9
1566,slickmax,,15,1,2,3
1567,dilibau,,36,10,4,14
1568,samuraisam,,20,5,19,24
1569,dodgepong,,1,5,4,9
1570,Prohibitoid,,14,2,2,4
1571,pl0nk,,20,17,22,39
1572,mrbubblesort,,18,45,4,49
1573,GetToTheKarateChoppo,,43,1,1,2
1574,wtfitsjared,,13,9,11,20
1575,Capacitor,,32,1,1,2
1576,beanmosheen,,5,28,65,93
1577,c0mputar,,10,15,10,25
1578,EtherCJ,,18,83,160,243
1579,mckimberley,,13,6,2,8
1580,Gunde,,20,2,7,9
1581,st_gulik,,22,607,932,1539
1582,chinasmith,,13,28,15,43
1583,SuperDuperNNasdf2,,12,3,12,15
1584,Arramol,,14,2,8,10
1585,steven807,,20,9,7,16
1586,themoemoth,,42,2,2,4
1587,sasquatchsucca,,18,15,25,40
1588,davidluxury,,13,6,7,13
1589,PjDrolet,,19,1,4,5
1590,jairzinho,,30,4,19,23
1591,gor56,,18,33,57,90
1592,lurk-n-go,,20,1,1,2
1593,Kojak4,,20,1,1,2
1594,heathn,,32,1,1,2
1595,ttoyooka,,0,52,48,100
1596,TheMorningWoody,,4,12,1,13
1597,fv__,,13,6,2,8
1598,kangarooman,,14,1,2,3
1599,pbz,,20,4,4,8
1600,curlymo,,19,2,14,16
1601,robotman,,5,50,62,112
1602,Yappahgo,,18,4,6,10
1603,thethinktank,,5,1,1,2
1604,backside,,0,2,3,5
1605,big000000,,5,1,10,11
1606,littlejohn68,,19,1,1,2
1607,lawrencem49,,20,1,3,4
1608,thax,,29,310,378,688
1609,quietinhere,,36,1,1,2
1610,SerpentJoe,,34,27,39,66
1611,vkny88,,18,14,5,19
1612,hangonasec,,31,3,2,5
1613,Capitain_Blob,,20,24,23,47
1614,wbeavis,,43,347,473,820
1615,adamwisky,,21,9,5,14
1616,subsumption,,18,1,1,2
1617,monkeyboyhero,,22,4,1,5
1618,jawknee530i,,18,371,533,904
1619,blkangel,,30,41,49,90
1620,fbk,,20,17,27,44
1621,CharlesBronson,,19,1,3,4
1622,jaysin420,,6,2,2,4
1623,bunjamins,,18,2,2,4
1624,dpirotte,,7,2,2,4
1625,xtassin,,22,16,15,31
1626,sarah_p,,1,1,1,2
1627,stilljosh,,18,2,2,4
1628,brokenladder,,20,3,8,11
1629,NadsatBrat,,1,649,1016,1665
1630,scottintx,,18,1,2,3
1631,blatherman,,13,2,4,6
1632,LiquidHAL,,31,71,67,138
1633,Sako13,,22,10,7,17
1634,ditdah,,13,4,4,8
1635,tphyahoo,,20,86,110,196
1636,saladmander,,43,1,1,2
1637,doxiegrl1,,22,246,370,616
1638,trokker,,40,2,2,4
1639,BobRoss,,1,2,6,8
1640,hobowine,,14,2,1,3
1641,redbits,,8,28,54,82
1642,fatty1380,,34,3,1,4
1643,njbartlett,,20,6,11,17
1644,scottc42,,18,36,14,50
1645,dixie_recht,,5,3,18,21
1646,subfrowns,,18,2,4,6
1647,trisw,,32,1,1,2
1648,kevintmckay,,13,4,3,7
1649,tia-marie,,43,112,40,152
1650,metallicabreath,,7,25,33,58
1651,diggrox,,19,21,26,47
1652,Bonzidave,,8,72,117,189
1653,somedorkygam3r,,12,15,1,16
1654,socialarchetype,,43,2,2,4
1655,kdubbfive,,4,1,1,2
1656,Biso,,23,2,4,6
1657,stlnjv,,43,235,169,404
1658,jpworld,,28,3,1,4
1659,binarybandit92,,20,18,19,37
1660,dwbenfield,,1,1,3,4
1661,Kiltec,,20,9,6,15
1662,Pirate_Angel,,20,3,9,12
1663,antirock,,20,4,4,8
1664,thenumba1negro,,1,24,27,51
1665,bscald0,,22,87,33,120
1666,Nisuz,,19,3,12,15
1667,q4all,,20,3,1,4
1668,ChrisRathman,,20,25,40,65
1669,omegaworks,,33,24,39,63
1670,abominator,,36,1,2,3
1671,tootie,,10,360,379,739
1672,TuxedoMax,,1,10,27,37
1673,Z11,,18,1,6,7
1674,spectacle,,31,6,7,13
1675,815was_a_lost_plane,,0,3,2,5
1676,QuotidianTorture,,32,2,3,5
1677,brlewis,,19,27,10,37
1678,fredfoobar,,30,36,36,72
1679,rickrollbountydoit,,22,5,5,10
1680,BushIsThe12thCylon,,4,123,221,344
1681,PeterRabbit456,,13,257,300,557
1682,ishseminal,,13,57,19,76
1683,mtappenden,,22,5,9,14
1684,mrstickman,,18,3,17,20
1685,jasontstein,,32,3,2,5
1686,kgrandia,,5,67,6,73
1687,outofbandii,,22,14,18,32
1688,niiiick,,8,2,2,4
1689,alehbye,,14,12,24,36
1690,velco,,20,22,23,45
1691,jpricher,,20,38,100,138
1692,ewwwwwwwwwwwwwwwwwww,,8,9,18,27
1693,rodbegbie,,12,6,10,16
1694,mongo_the_tiny,,8,1,2,3
1695,secretjohnson,,39,2,1,3
1696,plasmafire,,18,857,230,1087
1697,bellemae,,26,2,1,3
1698,colombiansmile,,1,1,2,3
1699,artost,,20,16,7,23
1700,LalaBristow,,5,2,6,8
1701,gutter,,20,6,1,7
1702,conundri,,19,180,323,503
1703,willdonovan,,20,1,1,2
1704,readerbeedj,,13,23,19,42
1705,shaman66,,13,7,28,35
1706,cooliegodsend,,18,17,16,33
1707,polexa,,34,33,34,67
1708,dafones,,18,73,111,184
1709,MrKittyKat,,31,1,1,2
1710,xternal,,18,40,86,126
1711,k-anon,,6,4,5,9
1712,govenator,,18,9,24,33
1713,steezus,,18,4,5,9
1714,kissmygrits,,10,23,34,57
1715,shortflood,,19,3,6,9
1716,CalibreneGuru,,17,2,2,4
1717,hungryhungryhippo,,14,154,174,328
1718,monogatari,,31,5,3,8
1719,alextalaat,,18,36,1,37
1720,argily,,34,73,75,148
1721,Radica1Faith,,1,12,14,26
1722,taikutsu,,18,2,8,10
1723,misses_the_point,,19,1,3,4
1724,eakius,,13,99,150,249
1725,Francky,,13,1,1,2
1726,SnoodDude,,19,1,1,2
1727,tcpip4lyfe,,1,458,428,886
1728,benkentaust,,15,7,3,10
1729,airless_microwave,,13,1,1,2
1730,Syphor,,20,1,9,10
1731,some101,,22,5,1,6
1732,toofishes,,20,3,3,6
1733,BuboTitan,,19,176,152,328
1734,late_at_nine,,18,10,12,22
1735,stepcut251,,20,7,20,27
1736,cjcarino,,42,45,2,47
1737,aurispector,,41,42,40,82
1738,kissinger,,43,7,15,22
1739,raofwumfs,,41,75,175,250
1740,Luntic,,19,19,3,22
1741,AlexPeake,,20,2,2,4
1742,hunululisjuys,,22,11,3,14
1743,javallone,,1,3,5,8
1744,blowback,,31,207,368,575
1745,ianesque,,18,2,4,6
1746,kenyabob,,18,35,8,43
1747,spaceman,,15,42,29,71
1748,gastlygem,,21,1,2,3
1749,Acglaphotis,,1,149,244,393
1750,ivoryball,,19,8,8,16
1751,wenfri,,0,13,12,25
1752,NeoTrot,,29,22,14,36
1753,67tim07crews11,,20,7,9,16
1754,notasaon,,20,255,363,618
1755,kgemini22,,6,1,1,2
1756,mikez31,,18,1,2,3
1757,masonium,,20,10,8,18
1758,daschan,,22,2,2,4
1759,oneiryn,,4,18,22,40
1760,jsomers,,32,4,3,7
1761,jo-lilore,,13,326,2,328
1762,ElvisKitagawa,,19,35,5,40
1763,aDancingHobo,,34,1,1,2
1764,joejag,,20,2,2,4
1765,PhenomenJan,,30,19,28,47
1766,scottieboy,,10,2,2,4
1767,mtheaded1159,,20,23,1,24
1768,sgtpeppers,,43,29,55,84
1769,evildead,,19,117,22,139
1770,cabrian,,22,3,10,13
1771,Nightowl7777,,12,6,12,18
1772,szeiger,,20,9,11,20
1773,AndrewBenton,,34,131,139,270
1774,johnaman,,19,160,44,204
1775,elsup,,22,2,1,3
1776,Lionhearted,,13,79,7,86
1777,GreeNova,,1,1,2,3
1778,Bloodlustt,,10,526,955,1481
1779,ThisISAgentSmith,,32,2,1,3
1780,jalamabob,,13,2,1,3
1781,morbidfriends,,22,26,35,61
1782,masterofshadows,,32,5,9,14
1783,fwporretto,,31,116,171,287
1784,mkultra42,,18,60,6,66
1785,futureheaded,,18,1,5,6
1786,bugcoder,,30,18,11,29
1787,Sirened,,13,12,2,14
1788,antneon,,11,8,3,11
1789,dtardif,,34,101,193,294
1790,reformed_digger,,17,1,1,2
1791,thereddgunn,,19,8,18,26
1792,zacwhite,,13,5,11,16
1793,phleef,,13,42,29,71
1794,RudyGiuliani,,19,535,45,580
1795,sardaukar,,39,10,10,20
1796,todm,,35,1,1,2
1797,ausfahrt,,18,2,4,6
1798,messer,,42,2,10,12
1799,rakkar,,19,13,6,19
1800,supaflyrmg,,18,95,132,227
1801,kbntly,,30,10,13,23
1802,yungJoc,,0,79,132,211
1803,tahpot,,1,8,1,9
1804,garygnu,,18,55,86,141
1805,prefixmag,,5,2,1,3
1806,Stemp,,32,2,1,3
1807,scrumbud,,18,56,37,93
1808,jegan414,,13,23,3,26
1809,BOFH139,,1,50,88,138
1810,boyreporter,,1,6,17,23
1811,zanglin,,32,5,3,8
1812,memevirus,,0,13,10,23
1813,ptorrone,,15,2,2,4
1814,petekmit,,19,6,2,8
1815,Morgmeat,,14,1,3,4
1816,RazzleFrazzle,,32,32,4,36
1817,WombatBob,,13,4,2,6
1818,mrjoshzombie,,18,9,17,26
1819,heyrey,,18,69,97,166
1820,huggles,,5,1,2,3
1821,cheeeeese,,18,8,13,21
1822,dark79,,1,1,1,2
1823,countingthedays,,18,52,101,153
1824,srich001,,20,1,1,2
1825,manchaugog,,8,13,28,41
1826,Halaster,,18,8,11,19
1827,vtecno_geek,,42,3,6,9
1828,wulfen,,18,2,2,4
1829,kindablue,,13,31,1,32
1830,lookslikethatsjailb8,,18,7,10,17
1831,intelslick,,13,435,60,495
1832,discreet,,19,2,3,5
1833,Sixteenbit,,18,15,33,48
1834,__pino__,,43,2,1,3
1835,san00bie,,19,206,211,417
1836,nevare,,20,32,50,82
1837,calanya,,31,4,1,5
1838,ecoconservant,,0,6,2,8
1839,sour_dave,,13,8,6,14
1840,dasony,,6,26,40,66
1841,kstar,,32,12,23,35
1842,tlongg81,,1,2,1,3
1843,n0name,,20,1,1,2
1844,mathrick,,20,69,110,179
1845,Doc_Lee,,19,56,85,141
1846,walkman,,17,11,15,26
1847,HubbleTelescope,,12,1,1,2
1848,YouFail,,10,6,5,11
1849,jthomasmoore,,13,6,14,20
1850,newbill123,,20,123,210,333
1851,Guessed,,32,1,2,3
1852,andybigs,,34,569,29,598
1853,brainwashed,,20,6,13,19
1854,scottdeto,,43,5,1,6
1855,OsakaWilson,,1,317,599,916
1856,brijeshnairan,,31,19,9,28
1857,Jim_in_Buffalo,,32,155,264,419
1858,duruq,,20,94,132,226
1859,mspmac,,6,1,5,6
1860,daledinkler,,30,592,494,1086
1861,davelog,,18,4,15,19
1862,typographics,,33,28,12,40
1863,karen1,,13,6,4,10
1864,gorillamaski,,21,8,3,11
1865,cain141,,42,3,2,5
1866,deanfearce,,19,5,3,8
1867,yayyay,,8,1,1,2
1868,darwin57,,9,1,1,2
1869,haseman,,13,138,33,171
1870,twocent,,34,37,50,87
1871,Groat,,42,34,18,52
1872,jbscott,,19,19,38,57
1873,prodaea,,1,2,7,9
1874,radhruin,,19,432,226,658
1875,qtoo,,19,192,29,221
1876,shann,,35,1,1,2
1877,mysn607,,22,1,1,2
1878,MadScientist420,,34,684,690,1374
1879,unusable,,17,1,1,2
1880,laughingwater,,18,2,18,20
1881,violetnightshade,,34,30,58,88
1882,justgeekin,,11,6,3,9
1883,deeringc,,20,10,12,22
1884,cloudsdrive,,18,1,7,8
1885,hatedigg,,18,8,19,27
1886,behooved,,1,17,23,40
1887,chandelirious,,39,1,1,2
1888,mangoboy,,8,1,3,4
1889,pede83,,42,1,3,4
1890,mudsonjar,,18,8,3,11
1891,Kaelosian,,31,1,1,2
1892,mrhymer,,3,7,5,12
1893,_unxzst_,,0,118,19,137
1894,deafbybeheading,,20,11,26,37
1895,bradeeoh,,22,1,2,3
1896,TriciaMcMillan,,19,2,2,4
1897,gnugnu,,20,2,2,4
1898,stormid,,19,6,10,16
1899,Sophophilic,,6,1,3,4
1900,Stonecipher,,13,83,7,90
1901,boe2,,13,19,62,81
1902,historyisaweapon,,31,5,3,8
1903,chriseaker,,14,2,1,3
1904,ctheory,,19,34,43,77
1905,tdiman,,34,13,12,25
1906,whynotsmile,,18,1,3,4
1907,vega1,,18,14,3,17
1908,timrink,,13,3,5,8
1909,SirSie,,22,1,2,3
1910,samwitt1984,,1,5,16,21
1911,dubski,,18,1,2,3
1912,ruetama,,31,2,1,3
1913,Exist_To_Resist,,22,1,2,3
1914,myrthe,,6,2,2,4
1915,nooblar,,4,25,29,54
1916,vashman,,18,37,51,88
1917,D-Bo,,18,9,3,12
1918,Betmenko,,20,7,1,8
1919,DonSlice,,18,58,35,93
1920,Arguron,,13,80,109,189
1921,clruss,,34,11,27,38
1922,aik,,34,34,44,78
1923,d3ns,,31,39,71,110
1924,NoSurrender,,32,2,5,7
1925,swisscreme,,13,58,39,97
1926,zosimus,,10,2,1,3
1927,ochs,,20,34,27,61
1928,Rostasky,,4,4,6,10
1929,Toothjunkie,,30,1,1,2
1930,nanaki,,13,2,6,8
1931,zeeta6,,9,93,137,230
1932,sirrach,,34,1,2,3
1933,AdjectiveNounNumber,,20,18,10,28
1934,forsaken,,20,4,4,8
1935,greenascanbe,,19,860,158,1018
1936,thevanishedlady,,19,31,51,82
1937,sreguera,,18,2,4,6
1938,crutch,,20,46,42,88
1939,thetrek,,12,1,1,2
1940,mwwilliams,,6,339,280,619
1941,mhunt346,,19,7,5,12
1942,tomel,,20,113,232,345
1943,09amw,,30,1,3,4
1944,frakilk,,18,20,17,37
1945,BudgingMidget,,1,2,3,5
1946,x00x11,,13,1,1,2
1947,GhostWithToast,,0,210,97,307
1948,sixtyten,,4,11,23,34
1949,kemiller,,20,24,23,47
1950,tecknopuppy,,19,3,4,7
1951,DEA_Officer,,43,1,1,2
1952,neighbor78,,13,1,1,2
1953,JimDabell,,20,212,256,468
1954,qwzx,,40,1,2,3
1955,mikemol,,20,131,92,223
1956,baraqiyal,,18,14,12,26
1957,bagge,,32,21,33,54
1958,BuffaloTimesN,,18,2,4,6
1959,dama9ed,,18,4,8,12
1960,dakatabri,,18,51,50,101
1961,ParanoidVet,,1,5,1,6
1962,redundor,,43,7,7,14
1963,flightlessbird,,43,49,25,74
1964,diamondchild,,19,8,5,13
1965,daelstorm,,32,6,6,12
1966,glide1,,20,22,27,49
1967,clickmagnet,,9,101,147,248
1968,mcho19,,18,2,8,10
1969,saparatus,,0,11,8,19
1970,galimi,,13,28,66,94
1971,gibsonan,,13,1,1,2
1972,amishengineer,,43,82,162,244
1973,phetrs,,0,1,2,3
1974,pettyjesus,,18,32,36,68
1975,DaveBr,,28,2,3,5
1976,Oak,,0,252,502,754
1977,CampusTour,,19,697,921,1618
1978,scubabbl,,13,9,20,29
1979,ramunenke,,16,39,64,103
1980,hellotim,,12,3,4,7
1981,tehroflmaoer,,29,3,5,8
1982,digitalxn3,,1,1,1,2
1983,barrettvogel,,43,20,17,37
1984,crashingthrough,,16,9,13,22
1985,luce7,,43,58,76,134
1986,aajkl,,43,8,1,9
1987,MoBe,,31,38,77,115
1988,josefk,,43,2,4,6
1989,wonderhat,,12,64,80,144
1990,giantfez,,1,3,3,6
1991,spaceman0,,1,82,28,110
1992,eh123abc,,1,2,1,3
1993,gmn17,,14,2,4,6
1994,mactaggart,,13,27,62,89
1995,everyonesacritic,,13,13,2,15
1996,osiris99,,31,120,132,252
1997,HotSmegma,,13,11,34,45
1998,_eight,,20,2,2,4
1999,dpgtfc,,34,183,333,516
2000,DoktorJ,,19,6,10,16
2001,impactguy,,26,185,1,186
2002,BaronVonBeefstrong,,16,1,1,2
2003,ruediger,,20,8,1,9
2004,whtevn,,17,45,68,113
2005,iiB,,31,26,22,48
2006,chris_radcliff,,18,4,12,16
2007,zBard,,20,79,103,182
2008,westenskow,,12,1,4,5
2009,dawg,,19,47,44,91
2010,easelmen,,32,10,1,11
2011,erinhiggins,,31,8,6,14
2012,chexmex222,,1,1,3,4
2013,someweirdsin,,18,2,8,10
2014,mustafaDeref,,8,1,1,2
2015,rpm087,,20,3,7,10
2016,danderson42,,20,2,5,7
2017,DaringYoungMan,,8,1,2,3
2018,cyanide,,20,14,11,25
2019,rexhamilton,,42,1,3,4
2020,swagohome,,19,724,859,1583
2021,heyadayo,,20,1,1,2
2022,nickem,,13,16,34,50
2023,d0minique,,18,11,17,28
2024,jusooho,,19,48,66,114
2025,hammudi,,19,36,5,41
2026,PSIAII,,5,5,5,10
2027,hiddentiger,,3,1,1,2
2028,DerMetzgermeister,,0,21,22,43
2029,0drew0,,0,49,84,133
2030,ariatorus,,30,1,2,3
2031,california_roll,,13,1,1,2
2032,satayboy,,20,10,12,22
2033,w000t,,13,86,81,167
2034,orabox,,19,56,70,126
2035,billgordon,,6,1,3,4
2036,defendthyself,,17,20,4,24
2037,casaubon,,19,258,218,476
2038,sdraz,,18,130,99,229
2039,orange_abc99,,20,1,1,2
2040,reddworm,,19,3,2,5
2041,mxaz,,7,2,5,7
2042,BradNerderman,,18,15,4,19
2043,laufwerkfehler,,5,7,35,42
2044,billbacon,,19,462,772,1234
2045,Masi,,19,506,110,616
2046,mcarlin2,,19,8,5,13
2047,mafen,,12,2,2,4
2048,infectedroot,,18,31,30,61
2049,Saitek,,18,4,8,12
2050,jrd2828,,13,11,15,26
2051,nerdoncall,,20,18,17,35
2052,walen,,18,13,14,27
2053,joeshlub,,18,34,47,81
2054,engwar,,43,89,119,208
2055,pissedofftwice,,23,1,1,2
2056,minium,,0,1,7,8
2057,rustyiron,,19,6,8,14
2058,PHermas,,18,14,49,63
2059,Daemmerung,,20,11,20,31
2060,beforetimetherewasme,,31,210,75,285
2061,LGBTnews,,34,7,1,8
2062,chabreck,,18,81,120,201
2063,atticus,,19,9,7,16
2064,kylman5000,,31,10,14,24
2065,truthhurts28,,13,2,3,5
2066,hatrickon,,0,6,3,9
2067,amjithr,,1,1,1,2
2068,therealtman,,19,9,6,15
2069,l-rs2,,22,60,96,156
2070,bad_at_puns,,0,9,9,18
2071,RalfN,,20,457,697,1154
2072,BiffBaxter,,32,6,1,7
2073,iarenuu,,22,11,2,13
2074,jev,,1,1,3,4
2075,IntnsRed,,13,157,101,258
2076,Bobiloco,,18,8,3,11
2077,vmas,,19,465,221,686
2078,rafiss,,1,10,4,14
2079,handjor,,19,3,1,4
2080,kristyntx,,12,8,11,19
2081,kkenn,,43,8,9,17
2082,smazsyr,,0,561,5,566
2083,pink_vicky,,18,26,4,30
2084,berenthemortal,,5,1,2,3
2085,kevinliebrock,,19,16,10,26
2086,BobbyTables,,20,3,5,8
2087,dgorley,,34,23,3,26
2088,redelfairy,,19,1,1,2
2089,goghi,,15,94,1,95
2090,ramen,,20,40,32,72
2091,crizznaig,,0,1,2,3
2092,steve43,,32,5,5,10
2093,Assumer,,18,1,2,3
2094,theoodone,,42,2,2,4
2095,Gibbwake,,19,453,414,867
2096,dualboot,,30,3,8,11
2097,lobido,,18,116,337,453
2098,sokercap,,0,9,2,11
2099,DrDutch,,32,3,5,8
2100,bornholtz,,13,18,18,36
2101,technopriestess,,28,1,2,3
2102,Mortikhi,,34,552,444,996
2103,epicRelic,,1,730,734,1464
2104,newsfrommars,,19,14,3,17
2105,ts4z,,34,2,1,3
2106,aayers,,19,1,2,3
2107,aped69,,43,1,1,2
2108,stormo,,4,2,1,3
2109,bobzibub,,31,124,210,334
2110,octoquake,,31,14,15,29
2111,Dunce,,0,22,39,61
2112,GottaGetMyFix,,34,7,5,12
2113,sexymuff69,,19,42,69,111
2114,sammyc,,1,17,24,41
2115,Rickler,,31,210,284,494
2116,twosents,,32,1,2,3
2117,tsunam,,18,40,5,45
2118,aaaahoy,,18,95,21,116
2119,julan,,20,6,7,13
2120,whatisthis8,,1,51,35,86
2121,theboyracer99,,43,283,290,573
2122,SpaceManY3k,,32,4,8,12
2123,srpatterson,,9,21,1,22
2124,stinger_,,18,20,40,60
2125,whatwedo,,10,791,1136,1927
2126,theduckchaser,,32,4,9,13
2127,boesman,,43,23,23,46
2128,vilerman,,20,29,1,30
2129,LauraJane,,32,13,15,28
2130,dushan42,,19,2,3,5
2131,dry_answer,,43,1,8,9
2132,shotinthedark21,,18,72,29,101
2133,em500,,13,21,29,50
2134,mihnealucian,,5,8,10,18
2135,Schrodie,,13,3,12,15
2136,gogogo,,41,17,36,53
2137,x00x,,18,10,19,29
2138,DCDave,,18,4,4,8
2139,andygood,,0,122,213,335
2140,thehighercritic,,22,66,111,177
2141,jackdied,,20,1,2,3
2142,moopanda,,31,3,1,4
2143,nelsonscheung,,1,108,178,286
2144,blinking81,,34,5,3,8
2145,enkara,,13,4,1,5
2146,king3vbo,,30,1,2,3
2147,kiwifish,,34,26,35,61
2148,meigwilym,,34,14,34,48
2149,pipegrep,,32,39,35,74
2150,chelslp,,43,7,9,16
2151,ximxam,,20,9,31,40
2152,UnderGod,,32,6,3,9
2153,fooboo,,4,2,1,3
2154,AmyGrace,,1,21,35,56
2155,bgtees,,13,19,13,32
2156,TheHardWay,,1,48,31,79
2157,zebragoat,,29,1,3,4
2158,pandoraslove,,13,4,2,6
2159,allrum,,43,40,7,47
2160,a_mother,,31,2,1,3
2161,mikemongo,,19,38,3,41
2162,FadedReality,,22,37,42,79
2163,foobazbar,,8,3,4,7
2164,moush,,13,234,553,787
2165,ScornForSega,,35,427,426,853
2166,chaosopher,,18,10,6,16
2167,humpcunian,,14,4,2,6
2168,Stepbasin,,13,34,3,37
2169,mookid,,22,1,1,2
2170,podobuzz,,10,15,15,30
2171,kdavidson,,19,1,1,2
2172,maggiet,,5,8,15,23
2173,warsawpact,,43,18,36,54
2174,sleepingcow,,6,13,13,26
2175,g1c9,,31,79,11,90
2176,sourdiesel12,,8,70,33,103
2177,MontegoBarbados,,18,41,57,98
2178,AlterEgo96,,1,4,4,8
2179,maennes,,43,3,8,11
2180,brizal,,0,2,1,3
2181,TaxExempt,,13,49,40,89
2182,shellacked,,2,2,3,5
2183,jmeasley,,13,280,1,281
2184,kiyonisis,,19,4,4,8
2185,DarkShikari,,20,136,102,238
2186,kaelan_,,20,21,13,34
2187,NSCoder,,18,3,5,8
2188,hessian,,43,59,58,117
2189,kurt165749,,13,6,12,18
2190,nads,,19,15,33,48
2191,techhstuff,,19,2,2,4
2192,malavel,,13,436,501,937
2193,greenelf,,20,1,3,4
2194,taciturnman3,,26,1,1,2
2195,srini91,,19,22,17,39
2196,earstwiley,,19,12,24,36
2197,rovot,,22,1,4,5
2198,slappywhyte,,18,109,47,156
2199,superfurryanimals,,18,22,22,44
2200,ddwoske,,20,5,6,11
2201,flash357,,13,3,7,10
2202,shokk,,19,76,190,266
2203,sluchee,,34,2,2,4
2204,lolbang,,19,89,102,191
2205,valjean,,19,3,4,7
2206,scackmanta,,32,1,1,2
2207,sob062571,,19,143,33,176
2208,CanYouRead,,0,1,1,2
2209,derxob,,22,1,1,2
2210,nikkomega,,5,20,24,44
2211,marko34,,13,75,43,118
2212,The-Cold-Truth,,19,21,14,35
2213,flyingfox,,20,34,49,83
2214,kanigsson,,20,1,2,3
2215,xjacklynx,,6,4,3,7
2216,scblock,,18,4,7,11
2217,hammerzeit,,13,11,23,34
2218,tarafitz,,42,1,1,2
2219,ratherawesome,,18,36,40,76
2220,N080dy,,29,2,1,3
2221,Nopis10,,32,4,10,14
2222,RogersLeap,,19,6,3,9
2223,barrietoronto,,13,2,1,3
2224,mariopazi,,0,22,3,25
2225,reversekilled,,6,10,17,27
2226,wha22,,22,21,33,54
2227,quietmonkey,,13,11,15,26
2228,minnend,,13,3,2,5
2229,xdrunkagainx,,43,31,18,49
2230,POKEMONE,,19,95,109,204
2231,doot,,1,45,54,99
2232,rmalheiro,,13,6,9,15
2233,cslewisster,,32,2,3,5
2234,jabab,,22,8,14,22
2235,SIMPLEMODEL,,20,2,4,6
2236,The_Gobbler,,3,16,31,47
2237,Nailz75253,,34,5,4,9
2238,frankenstrat,,13,20,2,22
2239,yangmao,,41,4,1,5
2240,Mineralwater,,32,231,497,728
2241,paulswhite,,13,1,5,6
2242,lingeek,,8,2,3,5
2243,Stinky107,,5,1,1,2
2244,grifon1981,,31,7,5,12
2245,bgutierrez,,1,12,4,16
2246,harsenal,,41,1,1,2
2247,rzax2,,22,15,7,22
2248,oneirist,,1,3,1,4
2249,boycottthesimpsons,,4,7,21,28
2250,wrong_verb,,31,5,6,11
2251,kaiserbun,,18,2,2,4
2252,mcphat,,20,1,1,2
2253,bkibbey,,18,5,1,6
2254,orchestra,,1,41,29,70
2255,imquez,,13,132,184,316
2256,LynnByrne,,19,2,1,3
2257,ethanji,,13,5,4,9
2258,MakiNavaja,,32,24,34,58
2259,pisceandelusions,,22,1,1,2
2260,fotd42,,32,4,4,8
2261,i0110110,,18,1,1,2
2262,ender_wiggin,,1,94,10,104
2263,Roger_the_Shrubber,,3,1,1,2
2264,10111111101111110110,,16,3,1,4
2265,zedvaint,,31,67,87,154
2266,GTroy,,13,1,1,2
2267,pascha,,19,260,321,581
2268,brey,,31,19,5,24
2269,AlisonWiley,,34,2,4,6
2270,SirFoxx,,22,5,10,15
2271,linuxrules,,19,8,21,29
2272,ObamDsntCarAbtWhtPpl,,10,23,32,55
2273,JeffDaiell,,19,4,3,7
2274,jmgregory,,13,19,18,37
2275,frequency528,,43,45,52,97
2276,Daesleepr0,,15,11,37,48
2277,scienceguy8m,,22,16,1,17
2278,airdrumma,,18,3,6,9
2279,spiritjoy,,13,9,8,17
2280,banker,,20,2,1,3
2281,indeh,,19,14,18,32
2282,mpg1453,,13,6,1,7
2283,DarthMacgyver,,20,7,6,13
2284,thatguyryan,,18,19,21,40
2285,Caraes_Naur,,13,259,371,630
2286,LiberalDemocrat,,19,88,170,258
2287,DrBrian,,42,227,390,617
2288,SharkUW,,22,27,38,65
2289,rdtiii,,1,11,9,20
2290,Boojum,,20,52,100,152
2291,hometownmarkup,,19,2,4,6
2292,csb92376,,29,10,10,20
2293,justoman,,10,12,12,24
2294,catch23,,20,279,366,645
2295,nairn,,19,2,5,7
2296,fooka,,43,139,2,141
2297,frankenfurter,,20,25,19,44
2298,arcadefiery,,32,85,58,143
2299,fun2sail,,19,43,15,58
2300,numpy,,31,1,6,7
2301,TheSighGuy,,42,4,1,5
2302,gnathon,,34,131,161,292
2303,NaK,,0,28,42,70
2304,batterseapower,,20,14,11,25
2305,ch33sehead,,1,46,85,131
2306,damagednoob,,20,49,20,69
2307,justinmeister,,10,113,112,225
2308,stephenodonnell,,13,6,1,7
2309,googlepeakoil,,34,17,40,57
2310,howwedoit08,,3,1,2,3
2311,kingrooster,,6,68,77,145
2312,issacg,,43,1,2,3
2313,gwoade,,20,3,3,6
2314,zefalt,,43,4,5,9
2315,redkevin,,14,6,2,8
2316,kickstand,,34,389,632,1021
2317,davedarwin,,1,56,21,77
2318,shortshire,,18,3,5,8
2319,aDk_,,3,2,1,3
2320,shaurz,,20,346,590,936
2321,JHackamack,,20,4,1,5
2322,1kHz,,20,13,3,16
2323,blahbah,,31,7,3,10
2324,joebeeson,,8,1,1,2
2325,jabberwocky2k,,22,1,8,9
2326,akinoyeshua,,1,73,166,239
2327,CarolLastNameRetract,,34,1,2,3
2328,Emphasiser,,19,47,59,106
2329,Tgg161,,6,18,16,34
2330,DrunkenAsshole,,43,270,436,706
2331,Xi_Heather,,36,1,1,2
2332,rieux,,31,282,421,703
2333,lunaisgay,,32,2,1,3
2334,canb88,,22,1,1,2
2335,maasanova,,13,4,2,6
2336,shortsightedsid,,0,20,32,52
2337,pjamieson,,33,1,1,2
2338,DanDixon,,32,16,8,24
2339,pockets576,,43,5,2,7
2340,quotidian,,13,2,5,7
2341,sanfranman,,18,52,110,162
2342,Avielus,,1,7,9,16
2343,DeRien,,43,16,9,25
2344,spanishfranks,,15,16,19,35
2345,yomama10,,4,2,1,3
2346,onlylove,,8,1,2,3
2347,Nimbokwezer,,18,57,93,150
2348,Chris_Gammell,,34,27,15,42
2349,caseye,,9,1,1,2
2350,mitama,,39,1,1,2
2351,avonsfive,,1,1,1,2
2352,johnwallis42,,13,173,429,602
2353,cbroberts,,29,247,230,477
2354,springy,,32,12,12,24
2355,NotJohnWayne,,22,1,1,2
2356,_black,,43,513,112,625
2357,kidwei,,12,1,2,3
2358,fairlyodd,,22,60,47,107
2359,imaredditalien,,13,13,9,22
2360,Ressotami,,34,4,1,5
2361,arabascato,,31,5,6,11
2362,NolanVoid,,3,34,63,97
2363,ayradv,,31,3,1,4
2364,MDGeist,,3,4,10,14
2365,slemmons,,8,13,16,29
2366,badave,,27,55,72,127
2367,gleapsite,,1,83,136,219
2368,ruppinwedle,,18,11,10,21
2369,randynavara,,34,1,2,3
2370,SonOfDenny,,9,107,55,162
2371,knightwhosaysni,,20,6,11,17
2372,NoUseForAName,,42,6,3,9
2373,pimple,,40,5,3,8
2374,flazz,,20,28,35,63
2375,peediddie,,13,12,27,39
2376,forzaruler,,14,95,88,183
2377,poots,,19,19,28,47
2378,ITJ,,31,1,1,2
2379,cypherpunk,,30,1,4,5
2380,kyle8ch,,19,1,1,2
2381,NMW,,1,56,67,123
2382,saffir,,7,137,146,283
2383,ampersand100,,18,3,4,7
2384,garageguru,,18,27,36,63
2385,philipnelson,,11,2,1,3
2386,jennekat17,,32,23,36,59
2387,cortlandjim,,13,3,4,7
2388,hazmatzz,,32,17,2,19
2389,cuddles666,,34,286,311,597
2390,meta-joke-explainer,,22,2,2,4
2391,thethirdi,,18,115,46,161
2392,poorwhitetrash,,19,15,46,61
2393,cohortq,,13,21,23,44
2394,babsies,,6,3,1,4
2395,DrLegoHari,,1,119,20,139
2396,gromgull,,22,27,24,51
2397,savutano,,18,37,86,123
2398,wretcheddawn,,13,6,15,21
2399,anon500,,18,1,1,2
2400,closetgeekshow,,18,88,143,231
2401,mfw,,15,1,2,3
2402,drhelcel,,19,1,2,3
2403,tocano,,13,4,1,5
2404,superportal,,30,1,1,2
2405,jontce,,23,2,1,3
2406,SlowX,,22,1,1,2
2407,mikeobe,,18,4,10,14
2408,freexe,,31,315,417,732
2409,goon12,,20,13,6,19
2410,xbudex,,20,1,4,5
2411,TonyReaves,,12,87,79,166
2412,shridhar,,35,1,3,4
2413,openeyed,,22,3,7,10
2414,nonono2,,31,18,20,38
2415,MPinsky,,22,6,7,13
2416,sustainedkrunk,,20,1,1,2
2417,andrewwise,,13,66,1,67
2418,fatcockmike,,19,2,7,9
2419,mcbob58,,19,9,52,61
2420,prettycreatures,,15,1,4,5
2421,TimeIsTissue,,18,3,7,10
2422,Captain_Science,,14,1,4,5
2423,gsg,,20,81,129,210
2424,gmanolatos,,32,7,1,8
2425,WillH,,18,3,9,12
2426,Ethan,,19,3,2,5
2427,welaaahh,,32,1,1,2
2428,dodus,,19,397,757,1154
2429,sorakiu,,5,18,22,40
2430,jesseeme,,18,293,59,352
2431,Garathon,,18,24,72,96
2432,rube203,,18,2,4,6
2433,TheBowerbird,,10,183,250,433
2434,lincolnp,,7,1,1,2
2435,ReiToei,,12,329,455,784
2436,kamikasei,,0,18,27,45
2437,fudditi,,22,1,1,2
2438,SecDef,,28,91,209,300
2439,AliBabaHimself,,15,1,1,2
2440,rayhan314,,43,8,14,22
2441,Slowbro,,14,8,4,12
2442,cyfdecyf,,20,1,2,3
2443,mbanana,,0,189,168,357
2444,punkgeek,,8,173,133,306
2445,archonon,,19,3,1,4
2446,reisender,,19,3,8,11
2447,McNally,,18,5,10,15
2448,Chevron,,18,3,6,9
2449,abrownpearn,,19,1,1,2
2450,golgote,,34,1,3,4
2451,RiceBallAttack,,13,20,3,23
2452,beast_in_black,,18,33,78,111
2453,eggmanx3,,32,1,2,3
2454,especkman,,20,6,16,22
2455,faceless1_14,,20,87,35,122
2456,ciudadcentral,,19,7,4,11
2457,flashkiller,,0,3,3,6
2458,jrdche,,13,63,5,68
2459,didnt_read_article,,19,4,2,6
2460,fangs,,20,1,1,2
2461,CarolynAB,,19,8,4,12
2462,writeman4450,,5,1,1,2
2463,politicalbath,,18,5,3,8
2464,woadwarrior,,20,27,42,69
2465,rlvis,,18,3,3,6
2466,thinkingserious,,34,35,8,43
2467,litebox,,31,20,25,45
2468,cidreflux,,18,6,1,7
2469,AmericaFYeah,,13,12,21,33
2470,shar1,,20,1,1,2
2471,olegv40,,14,59,25,84
2472,itscoming,,13,23,38,61
2473,chrissa,,18,16,27,43
2474,CableNewsie,,13,9,4,13
2475,robotnewyork,,9,1,5,6
2476,Aborted_Fetus_Eero,,18,3,3,6
2477,Etan,,19,35,77,112
2478,nooneelse,,22,303,601,904
2479,fuliginosus,,42,85,68,153
2480,cenderis,,20,1,5,6
2481,luckyfish,,23,2,2,4
2482,AROSSA,,31,5,14,19
2483,erikd,,20,86,70,156
2484,Anonyxmouse,,13,4,1,5
2485,kpagiamtzis,,43,2,1,3
2486,geebower,,13,2,10,12
2487,shazbaz,,19,100,166,266
2488,icdapoakr,,1,27,57,84
2489,mrfrostee,,43,2,1,3
2490,whiskeyjack,,20,17,12,29
2491,devlinrose,,1,10,3,13
2492,carlEdwards,,32,2,5,7
2493,big_nah,,22,11,6,17
2494,fzzzy,,20,6,18,24
2495,speedmx1,,13,13,4,17
2496,keeto,,42,1,1,2
2497,bokin,,5,52,130,182
2498,benjamin_button,,13,1,4,5
2499,annihilist,,13,10,6,16
2500,socialdude,,42,2,1,3
2501,fatlester,,5,13,18,31
2502,RaepRaepRaep,,19,100,69,169
2503,synae,,18,61,157,218
2504,sTigre,,9,10,15,25
2505,Silent_Paws,,18,69,73,142
2506,mlibbrecht,,12,3,3,6
2507,red22,,31,1,1,2
2508,BasketCase,,14,68,65,133
2509,pervezalammzn,,5,3,3,6
2510,jomama,,19,198,381,579
2511,galets,,20,1,5,6
2512,davidoc,,5,6,5,11
2513,robotsdoingphysics,,31,65,80,145
2514,Delslayer,,18,22,35,57
2515,JGailor,,18,32,37,69
2516,oldenglishbastard,,12,2,3,5
2517,smellycoat,,1,33,29,62
2518,MoonDogLeft,,13,3,1,4
2519,issacsullivan,,18,57,94,151
2520,Prozen,,20,9,6,15
2521,p3k,,18,30,44,74
2522,reddy4luv,,0,4,20,24
2523,giggity,,1,25,44,69
2524,Izdoy,,42,11,25,36
2525,pleasedeleteme,,6,2,3,5
2526,gerp,,18,42,67,109
2527,andralex,,20,16,15,31
2528,King_Canute,,5,103,119,222
2529,miyakohouou,,20,499,538,1037
2530,trevorx2500,,13,15,40,55
2531,treyethan,,22,1,2,3
2532,raouldukeesq,,19,869,1244,2113
2533,Dennis_im_30,,8,2,3,5
2534,sdsdsdsdsd,,6,212,195,407
2535,Zero_Dogg,,32,1,1,2
2536,StuffMaster,,20,16,27,43
2537,wingzeromkii,,1,7,10,17
2538,thelastkey,,31,14,12,26
2539,Dr_Schrodinger,,1,86,113,199
2540,comatose_kid,,13,2,1,3
2541,circletimessquare,,31,67,83,150
2542,troubledwine,,31,47,36,83
2543,gaiseric,,34,25,12,37
2544,floatingorb,,34,1,2,3
2545,FlatTownRunner,,8,1,1,2
2546,Batduck,,42,2,1,3
2547,transcendent,,5,47,81,128
2548,Sleepytime,,13,19,10,29
2549,fernandotakai,,18,13,17,30
2550,elliottc,,5,118,3,121
2551,PanglossAlberta,,30,48,87,135
2552,jwrey,,13,2,1,3
2553,drob003,,19,3,1,4
2554,anusrape,,20,73,33,106
2555,Forevamackin487,,18,1,3,4
2556,donewithdigg,,13,1,2,3
2557,gvfordo,,18,100,16,116
2558,mash3,,13,54,22,76
2559,afokenr,,12,27,17,44
2560,redditcanhelpme,,2,6,5,11
2561,s34hunt,,12,4,3,7
2562,bmbufalo,,40,1,2,3
2563,gasolino,,13,1,1,2
2564,ghettoleet,,1,24,26,50
2565,xoe,,32,6,8,14
2566,originalplankster,,14,3,8,11
2567,ish2189,,19,9,21,30
2568,antispork,,20,2,1,3
2569,leoburg,,13,5,4,9
2570,dccrowe,,13,7,1,8
2571,dirtyoldtown,,20,3,6,9
2572,pje,,20,17,32,49
2573,jaybee2,,18,131,267,398
2574,rbilsbor,,18,3,2,5
2575,thatswhatyouget,,1,74,96,170
2576,Prepaidguy,,20,5,7,12
2577,Jesus-H-Christ,,32,17,8,25
2578,giggzy,,4,1,3,4
2579,stevo1984,,18,11,6,17
2580,mecurdius,,18,8,9,17
2581,nathanj,,20,1,4,5
2582,lordjebus,,5,239,169,408
2583,kingsal,,34,3,7,10
2584,dessmond,,32,3,10,13
2585,slackinfux,,19,142,369,511
2586,gnewf,,20,2,4,6
2587,houdini,,20,23,53,76
2588,b_moore49,,5,2,2,4
2589,kevans2,,13,5,11,16
2590,streambag,,2,5,3,8
2591,filesalot,,20,288,352,640
2592,aim2free,,20,322,546,868
2593,Garage_Dragon,,36,7,2,9
2594,sajohnson,,32,7,8,15
2595,wyleslie,,22,14,25,39
2596,iheartartoo,,1,21,17,38
2597,malpensante,,10,2,8,10
2598,thechikinguy,,19,9,26,35
2599,sammamish,,19,6,1,7
2600,richy_rich,,6,2,1,3
2601,Stormwind_Edward,,18,5,6,11
2602,David_H,,1,65,40,105
2603,el0rg,,1,160,230,390
2604,ZhuangZ1,,32,1,1,2
2605,JohnnyCash,,12,6,1,7
2606,kevlarsuit,,20,8,9,17
2607,thespace,,19,45,68,113
2608,mellowmonk,,18,614,217,831
2609,donttaseme,,1,1191,1597,2788
2610,holyscience,,1,7,2,9
2611,RIAA_,,19,8,11,19
2612,PleaseBeSerious,,18,1,2,3
2613,boogh,,20,15,1,16
2614,gmoose,,19,2,14,16
2615,codeismightier,,20,8,4,12
2616,stankfrank,,6,1,1,2
2617,freya_b,,19,10,3,13
2618,Qwirk,,43,134,188,322
2619,whatismyoldpassword,,22,22,35,57
2620,Peregrination,,34,6,5,11
2621,PhillyJT,,0,2,1,3
2622,ecb29,,29,1,2,3
2623,notirk,,6,17,8,25
2624,CapnSupermarket,,22,3,8,11
2625,nemethee,,1,2,1,3
2626,brennus,,1,76,33,109
2627,ArtVandelay,,0,42,28,70
2628,retsknurt,,1,132,142,274
2629,argherna,,20,9,30,39
2630,bipedalshark,,31,11,7,18
2631,demebeu,,20,3,4,7
2632,dadavinci,,0,17,16,33
2633,buvljak,,0,72,4,76
2634,cbeck287,,0,353,570,923
2635,chicken001,,42,5,5,10
2636,fiv3isaliv3,,18,25,55,80
2637,ebbinghaus,,20,34,2,36
2638,boo97,,34,3,2,5
2639,andieh05,,8,6,3,9
2640,greyfinch,,20,19,10,29
2641,anachronic,,6,715,1092,1807
2642,ClockworkSparrow,,20,10,1,11
2643,theposthumousluger,,34,2,1,3
2644,NUDITY,,22,7,8,15
2645,omghax1337,,19,29,1,30
2646,mrmikewikowski,,19,157,17,174
2647,acfm,,41,57,22,79
2648,suradesign,,5,2,1,3
2649,robertos11,,5,205,7,212
2650,akuhn,,20,10,13,23
2651,thelmick,,19,9,13,22
2652,Astly2,,18,9,2,11
2653,dzhuang,,31,1,1,2
2654,SeBBBe,,12,34,57,91
2655,cheekyisgreat,,13,25,1,26
2656,HankHill,,0,2,3,5
2657,plehar,,13,23,48,71
2658,pitchik,,19,7,6,13
2659,Trundys,,14,3,2,5
2660,jwinter,,20,7,10,17
2661,raisondecalcul,,18,21,21,42
2662,Caffinated1,,18,1,3,4
2663,tttodayjunior,,0,11,3,14
2664,manualoverride,,10,3,4,7
2665,sgnlzo,,20,4,2,6
2666,HAL-9000,,36,1,2,3
2667,zombiereagan,,28,1,1,2
2668,dustball,,18,159,20,179
2669,Deficit5,,3,3,2,5
2670,AesopRock,,34,1,2,3
2671,begawk,,13,50,5,55
2672,hennell,,43,373,352,725
2673,Ultra200,,0,1,2,3
2674,mablo,,32,2,1,3
2675,jameswharam,,19,3,12,15
2676,spyguitar,,34,36,45,81
2677,scientologist2,,8,2012,764,2776
2678,headswine,,13,194,5,199
2679,emlot,,20,80,177,257
2680,nuajman,,1,3,1,4
2681,cerebrum,,32,47,46,93
2682,winetype,,36,2,1,3
2683,carvman,,13,5,1,6
2684,eternalegg,,22,2,1,3
2685,nihilo,,20,4,5,9
2686,yeu,,20,1,2,3
2687,robotbutler,,13,127,51,178
2688,Happy_Phantom,,13,6,38,44
2689,cGt2099,,5,6,2,8
2690,cyberpop,,34,14,28,42
2691,random5097325097235,,20,17,20,37
2692,CoachZed,,22,18,22,40
2693,somuch2see,,13,121,51,172
2694,hillscottc,,18,2,1,3
2695,MaLaCoiD,,34,19,15,34
2696,galactus,,41,16,1,17
2697,fearphage,,20,2,4,6
2698,someguy9,,18,1,9,10
2699,potsdarn,,13,2,1,3
2700,Apewithtools,,29,1,2,3
2701,vijitnair,,34,13,6,19
2702,spiffage,,31,7,18,25
2703,Ahnteis,,42,352,554,906
2704,JanieJones,,5,4,7,11
2705,etherghost,,31,14,21,35
2706,hrtattx,,1,287,223,510
2707,RespondsToMostReplys,,32,7,10,17
2708,tigeba,,19,2,3,5
2709,maniacnf,,18,62,115,177
2710,iceberg,,1,45,50,95
2711,fikustree,,13,46,94,140
2712,SeaweedWater,,13,7,1,8
2713,ajness,,32,10,14,24
2714,Trogdor420,,42,37,41,78
2715,pgquiles,,20,18,5,23
2716,iqisimportant,,3,3,2,5
2717,blehh,,1,1,2,3
2718,JustJulie,,18,2,2,4
2719,neur1,,43,5,9,14
2720,meor,,30,3,2,5
2721,notjfk,,6,4,3,7
2722,ebartels,,14,3,6,9
2723,brintoul,,20,243,465,708
2724,uberhanz,,20,5,14,19
2725,dekz,,18,2,2,4
2726,inDglass,,19,36,7,43
2727,sgt_pepper,,14,1,2,3
2728,Tuscarosa,,5,9,18,27
2729,awilke,,13,29,20,49
2730,rilliam,,34,1,1,2
2731,gnolnalla,,1,6,11,17
2732,super4pi,,18,8,1,9
2733,joelieberman,,22,7,9,16
2734,mrt181,,1,1,1,2
2735,Kaizyn,,20,45,43,88
2736,gauchopuro,,22,4,4,8
2737,LongInTheTooth,,30,13,11,24
2738,lukurdi,,42,1,2,3
2739,SparkyFox,,32,12,1,13
2740,Sabremesh,,32,345,508,853
2741,leeon,,34,4,3,7
2742,lawschoolbound,,13,4,9,13
2743,simontzu,,19,3,3,6
2744,troupe,,5,1,3,4
2745,misterov,,19,11,12,23
2746,kipi,,20,77,67,144
2747,DashingLeech,,30,271,252,523
2748,JustinCEO,,19,10,16,26
2749,marcstober,,20,6,2,8
2750,thedragon4453,,22,180,222,402
2751,cthulhu_forprez,,32,9,16,25
2752,PoopMcPooperson,,39,1,2,3
2753,skywagon,,13,2,3,5
2754,1917777,,18,241,311,552
2755,xiguo,,28,8,10,18
2756,domfosnz,,5,12,24,36
2757,jtrask,,34,2,6,8
2758,frost12,,6,3,2,5
2759,space_cadet00,,18,3,2,5
2760,aliasforspam,,34,46,19,65
2761,bendotc,,20,7,12,19
2762,pheen,,18,7,11,18
2763,landoncz,,20,2,3,5
2764,coldlizard,,20,24,17,41
2765,imnotauser,,18,21,50,71
2766,ninjatune,,19,137,12,149
2767,buZZRd,,18,60,117,177
2768,weare138,,6,8,7,15
2769,dorkyasian,,18,20,15,35
2770,atomictoaster,,18,81,58,139
2771,nmorse,,1,1,1,2
2772,mulcher,,10,81,167,248
2773,liminal,,18,5,1,6
2774,mcosta,,20,10,21,31
2775,Mordor,,13,87,136,223
2776,shastapete,,43,5,8,13
2777,kelvie,,20,81,128,209
2778,msoren,,18,1,3,4
2779,T3hTao,,32,2,3,5
2780,bagel702,,18,32,23,55
2781,friend2007,,43,62,1,63
2782,dumbdumbguy,,13,2,1,3
2783,nzodd,,34,1,7,8
2784,siljeal,,42,3,9,12
2785,blayne,,20,29,89,118
2786,asinglenet,,20,28,1,29
2787,ginowhitaker,,18,164,214,378
2788,ryanh29,,31,1130,972,2102
2789,luckysara,,43,6,4,10
2790,millstone,,20,605,593,1198
2791,skratchx,,13,4,12,16
2792,ambassadorofkwan,,27,13,18,31
2793,pygmyshrew,,32,20,44,64
2794,loquedesea,,22,8,14,22
2795,SkyFrostSalvo,,18,12,16,28
2796,alx1507,,36,6,8,14
2797,DTanner,,30,226,102,328
2798,wilsonp,,20,10,12,22
2799,darthmdh,,15,89,177,266
2800,brohemoth,,22,46,76,122
2801,phoeniks,,1,46,59,105
2802,cathiedsquared,,31,1,3,4
2803,gams,,22,1,1,2
2804,OrangePlus,,19,334,542,876
2805,michael2l,,42,1,4,5
2806,tezcat,,12,3,2,5
2807,doody,,31,412,693,1105
2808,jncamilo,,19,14,7,21
2809,MrWoohoo,,22,241,561,802
2810,PlacentaJuan,,31,3,4,7
2811,ShiningSnowFlake,,11,3,2,5
2812,antidrug_drug,,12,86,96,182
2813,saukrates,,1,8,9,17
2814,safe_q,,22,7,17,24
2815,jamesmhall76,,14,5,3,8
2816,noram256,,20,11,31,42
2817,reddit4Jesus,,1,2,1,3
2818,locodonkey,,11,2,1,3
2819,Demur,,31,3,4,7
2820,staiano,,13,490,722,1212
2821,carontheking,,1,59,1,60
2822,tubbo,,27,2,6,8
2823,drmaxpower,,18,172,312,484
2824,hadiwinata,,17,1,1,2
2825,cian,,20,4,2,6
2826,jfray2,,18,3,3,6
2827,myerscarpenter,,20,3,4,7
2828,billy_maize,,31,4,1,5
2829,Uchikoma,,20,7,1,8
2830,ramaesi,,34,10,13,23
2831,fearsofgun,,13,172,185,357
2832,IN_DA_BUTT,,19,27,10,37
2833,cptnlazer,,0,1059,44,1103
2834,pvtshoebox,,4,1,3,4
2835,benz8574,,13,135,21,156
2836,phunge,,20,3,2,5
2837,doyu,,10,1,1,2
2838,zeee,,0,2,3,5
2839,confirm,,4,4,5,9
2840,yaffytaffy,,26,1,1,2
2841,hairstyled676,,22,4,1,5
2842,gevander,,19,7,18,25
2843,mrqcho,,0,3,3,6
2844,kex,,19,1,2,3
2845,ssjjss,,43,95,72,167
2846,abhz79,,20,4,3,7
2847,ekmather,,18,29,79,108
2848,bockris,,20,41,28,69
2849,Fireball,,18,547,586,1133
2850,gashirasucksdick,,13,6,5,11
2851,mydodger,,13,112,143,255
2852,redreplicant,,6,211,220,431
2853,d0od,,19,80,88,168
2854,Pahjci,,20,2,1,3
2855,dmfdmf,,13,38,49,87
2856,megagurka,,13,1,1,2
2857,RagnarDanneskjold,,32,278,109,387
2858,dhawal,,12,2,5,7
2859,311ncubus,,12,2,8,10
2860,thomaslee,,20,7,12,19
2861,layman,,31,42,62,104
2862,honus,,0,99,165,264
2863,Aniceathiest,,30,1,3,4
2864,bazoople,,29,312,366,678
2865,itodd,,19,54,72,126
2866,jaminunit,,19,11,1,12
2867,MyCutePetPics,,18,4,14,18
2868,ynohoo,,34,97,142,239
2869,groove1880,,31,8,10,18
2870,morr0350,,0,15,27,42
2871,smokeboat,,34,25,32,57
2872,SFBrit,,5,2,1,3
2873,esubasi,,8,1,1,2
2874,xoxer,,20,9,20,29
2875,NJWilcats,,22,1,1,2
2876,Zenofex,,42,6,2,8
2877,joefish1984,,42,1,4,5
2878,jamesqua,,31,32,32,64
2879,Chrys,,20,2,1,3
2880,biggiesmells,,19,2,4,6
2881,Criffer,,20,23,41,64
2882,megalodon,,31,23,24,47
2883,feeboo,,18,98,135,233
2884,thee-ass,,5,4,8,12
2885,dylansylvester,,29,2,1,3
2886,perryc,,18,11,2,13
2887,pratik4newworld,,20,9,1,10
2888,dila813,,36,1,1,2
2889,bpiraeus,,13,57,86,143
2890,HairyHoudini,,20,1,2,3
2891,paleofuturist,,1,2,1,3
2892,g0taclue,,13,242,392,634
2893,BarryGoldwatersGhost,,31,5,6,11
2894,rws,,19,1,2,3
2895,lyaunzbe,,20,15,26,41
2896,ironkurton,,19,2,1,3
2897,bluelobster,,19,15,18,33
2898,apapitrat,,19,4,1,5
2899,MissSatan,,0,1,3,4
2900,value23,,29,1,1,2
2901,noknockers,,20,2,3,5
2902,NateNizzle,,18,2,3,5
2903,stopthelefty,,13,2,1,3
2904,elefantstn,,20,2,5,7
2905,Actius,,32,264,390,654
2906,chap1girl,,18,3,1,4
2907,hotfuzz86,,36,24,23,47
2908,rewirez5940,,42,124,40,164
2909,patrozoo,,18,8,28,36
2910,gplaya2323,,18,27,3,30
2911,myearsmyears,,34,101,8,109
2912,detroitsongbird,,16,3,1,4
2913,reddit983,,20,4,7,11
2914,lonbpl,,18,6,7,13
2915,Naptosis,,32,5,8,13
2916,clintschaff,,18,1,3,4
2917,bigeyedeer,,41,1,2,3
2918,blackdoor,,20,13,13,26
2919,mancxvi,,13,9,11,20
2920,stronglikedan,,5,362,567,929
2921,hsfrey,,34,327,429,756
2922,slsanity,,0,1,1,2
2923,noegoman100,,12,6,21,27
2924,waffl,,42,2,2,4
2925,Shawty_Lo,,18,5,4,9
2926,nashaw,,0,2,1,3
2927,dudeman1,,13,1,1,2
2928,swblacksheep,,13,3,4,7
2929,freelancelot,,31,1,1,2
2930,jaymancer,,13,2,4,6
2931,ariana333,,19,154,21,175
2932,Internet-Tough-Guy,,4,2,2,4
2933,cd6020,,13,133,230,363
2934,ckwing,,10,290,366,656
2935,jmorrowwork,,20,1,1,2
2936,chub79,,20,90,155,245
2937,Dikaiosyne,,34,6,14,20
2938,ronsta,,13,73,127,200
2939,andrewbirkett,,20,8,1,9
2940,thecookiemaker,,19,4,1,5
2941,nokturnal,,1,1,7,8
2942,buddha067,,9,1,2,3
2943,iuyterw,,18,1,1,2
2944,ironmonkey,,13,92,149,241
2945,moneyprinter,,19,610,812,1422
2946,ttarchal,,20,2,3,5
2947,ejp1082,,19,1771,686,2457
2948,neoumlaut,,8,2,2,4
2949,reddit-man-junior,,34,2,3,5
2950,sillythewilly,,1,2,2,4
2951,geeker87,,20,14,19,33
2952,Foxfulness,,1,5,6,11
2953,os10,,18,3,2,5
2954,nebogeo,,20,4,4,8
2955,scoops22,,18,13,9,22
2956,ShauRobi69652,,7,37,36,73
2957,DeltaEchoMike,,43,35,54,89
2958,femalenumber101,,18,1,14,15
2959,homegrown,,18,17,2,19
2960,E_mE,,20,2,2,4
2961,cockasaurus,,0,5,35,40
2962,mike_burck,,1,7,4,11
2963,takita787,,18,291,15,306
2964,RonPaulSpambot,,19,50,69,119
2965,nillawafer,,39,3,7,10
2966,triana_south,,19,4,27,31
2967,swight74,,18,34,28,62
2968,razeetg,,20,3,5,8
2969,N4N4KI,,18,15,10,25
2970,fontbase,,31,3,16,19
2971,willcode4beer,,20,38,21,59
2972,mfdba,,13,75,35,110
2973,Diode,,32,1,1,2
2974,Ac3,,18,34,69,103
2975,lucidvegas,,18,39,83,122
2976,Trinket,,19,12,3,15
2977,Juan234,,42,52,52,104
2978,qliedtke,,18,4,1,5
2979,plexxonic,,1,2,3,5
2980,asdfprou,,1,7,1,8
2981,upcguy,,6,4,6,10
2982,fauxXenophanes,,0,27,97,124
2983,pasht,,43,131,167,298
2984,reddi_vedder,,9,1,1,2
2985,dearmansoor,,18,134,10,144
2986,TheMop,,12,1,1,2
2987,harry3864,,13,2,13,15
2988,dedzone2k,,12,7,9,16
2989,LauraMars,,43,2,2,4
2990,daveydave,,19,39,57,96
2991,scoobynz,,15,4,4,8
2992,mikehayes19,,18,95,8,103
2993,etruscan,,22,94,111,205
2994,hangelinajolie,,18,1,1,2
2995,mrgee,,22,10,2,12
2996,wwgtam8,,19,3,3,6
2997,IAmCelery,,1,5,9,14
2998,lensflare,,21,1,2,3
2999,richarddixon,,7,2,7,9
3000,St3v3n777,,19,1,1,2
3001,haruspex,,11,24,32,56
3002,dontgoatsemebro,,3,366,655,1021
3003,fkrueger,,20,1,1,2
3004,mellowchimp,,19,6,11,17
3005,emullet,,20,7,12,19
3006,hydralisk,,31,104,100,204
3007,GunOfSod,,32,29,47,76
3008,mad1234,,15,8,6,14
3009,brownhound,,22,14,18,32
3010,chefjeremy,,31,1,1,2
3011,miramardesign,,22,2,1,3
3012,frazzled35,,34,3,1,4
3013,krayle,,43,8,1,9
3014,jpcx01,,20,7,5,12
3015,eclectro,,19,158,290,448
3016,stimuluspackage,,2,3,9,12
3017,jueskin,,3,5,7,12
3018,Basketbasket,,19,2,1,3
3019,jjj52,,0,2,1,3
3020,0gleth0rpe,,36,138,229,367
3021,schabot,,30,72,81,153
3022,angelahayden,,5,3,3,6
3023,wtfx20004,,1,11,22,33
3024,NoMoreREPUGS,,19,9,13,22
3025,barney54,,31,213,185,398
3026,jewlicious,,0,7,1,8
3027,hulio99,,39,114,163,277
3028,escherfan,,20,34,25,59
3029,benkapa,,31,5,8,13
3030,dodgyd55,,12,9,47,56
3031,hjfreyer,,12,2,3,5
3032,underdog45,,43,1,1,2
3033,irfanmp,,18,624,37,661
3034,chollida1,,20,128,190,318
3035,scheisse_adc,,43,11,19,30
3036,caracter_2,,18,7,2,9
3037,GrrlScientist,,18,432,11,443
3038,jeneni,,42,1,2,3
3039,spectrusery,,1,43,45,88
3040,master-chief,,21,111,34,145
3041,Jungo,,13,1,1,2
3042,arrdev7,,18,13,21,34
3043,Tw1zzler,,5,1,4,5
3044,karmakazi,,13,7,6,13
3045,milliganpierce,,43,63,78,141
3046,jaznova,,6,8,14,22
3047,masako9,,20,3,4,7
3048,titusthefox,,18,7,2,9
3049,yairchu,,31,174,375,549
3050,lapalam,,19,94,65,159
3051,tshelton,,20,2,2,4
3052,alexw,,19,7,12,19
3053,ExAm,,18,42,60,102
3054,zippppp,,13,10,15,25
3055,running_bowels,,31,1,1,2
3056,RightBleeding,,43,80,127,207
3057,mrmagoo,,9,1,2,3
3058,chrisgon,,13,7,1,8
3059,youtellme8,,11,1,1,2
3060,Pensador,,41,2,5,7
3061,bensussman,,43,1,6,7
3062,alacrity,,13,67,100,167
3063,bananahands,,18,8,12,20
3064,makenshi,,1,37,50,87
3065,rooshw,,34,81,90,171
3066,alhes,,1,2,3,5
3067,nineoclock,,19,131,238,369
3068,katyalaia,,17,3,1,4
3069,ucfmike,,18,10,1,11
3070,Tomasfoolery,,18,52,115,167
3071,iDaniel,,18,8,26,34
3072,lianos,,20,46,75,121
3073,drphil1066,,18,15,11,26
3074,sensor,,13,73,159,232
3075,mortenaa,,20,396,65,461
3076,sgnmac,,20,2,3,5
3077,gpmvdc,,30,2,3,5
3078,avibryant,,20,18,23,41
3079,jaycee2145,,43,1,1,2
3080,Thumperings,,22,292,596,888
3081,PeopleEatTastyAnimal,,19,123,203,326
3082,daxxxer,,20,3,7,10
3083,Liface,,23,2,1,3
3084,Nomaken,,32,2,7,9
3085,Energysync,,6,20,15,35
3086,edcrypt,,20,2,6,8
3087,gathersuccess,,5,1,1,2
3088,DoyleOwl,,19,10,13,23
3089,crenansen,,43,3,2,5
3090,yargaroo,,0,1,2,3
3091,thanksjerk,,32,45,55,100
3092,musicaldonkey,,18,12,25,37
3093,larrytheliquid,,20,3,3,6
3094,ctro82,,19,60,100,160
3095,XaosTX,,13,48,14,62
3096,twanvl,,20,23,30,53
3097,madefromcheese,,26,15,21,36
3098,sivoneall,,13,3,1,4
3099,willzager,,36,1,1,2
3100,tripleg,,13,266,561,827
3101,AoP,,1,397,362,759
3102,Learned_Handjob,,28,4,3,7
3103,GarbageDonkey,,18,1,4,5
3104,lysistrata,,14,34,38,72
3105,ewout,,20,1,1,2
3106,vanel,,13,4,3,7
3107,qqyh2,,43,5,4,9
3108,maineac,,34,135,129,264
3109,gonzabaleta,,19,1,1,2
3110,noblethrasher,,20,22,33,55
3111,platyperl,,5,41,51,92
3112,stunt_penguin,,22,369,628,997
3113,none1234,,18,36,54,90
3114,ThreadRuiner,,19,37,4,41
3115,Miglin,,4,4,12,16
3116,mbergesonjr,,13,19,2,21
3117,stephenthemay,,40,22,17,39
3118,BanX,,18,134,23,157
3119,falien,,20,2,5,7
3120,ladamesansmerci,,30,76,45,121
3121,Snatchbuckler,,42,6,13,19
3122,devindotcom,,18,2,9,11
3123,spidersfrommars,,39,15,14,29
3124,ebcak,,13,64,8,72
3125,lethalbeef,,18,21,30,51
3126,slark,,33,3,9,12
3127,sleepytree,,31,5,6,11
3128,hiker,,20,9,7,16
3129,smedley42,,19,41,121,162
3130,lespea,,20,176,246,422
3131,internuts_tough_gay,,14,2,7,9
3132,pr1mu5,,1,181,123,304
3133,rasterized,,32,6,5,11
3134,alexott,,20,1,3,4
3135,eyestosky,,43,6,3,9
3136,dundundunn,,32,11,13,24
3137,ssassi7,,31,204,128,332
3138,lvbronco,,17,2,1,3
3139,FlieGerFaUstMe262,,3,3,3,6
3140,tylerjames,,32,51,50,101
3141,Remember711,,0,45,97,142
3142,UpIn08,,13,78,51,129
3143,jaskew,,1,5,4,9
3144,right_behind_you,,22,34,35,69
3145,Baraq_Hussayni_Osama,,26,10,8,18
3146,BigJuiceMan,,18,8,12,20
3147,FamousSeamus,,13,8,1,9
3148,danratherfoe,,19,17,35,52
3149,r0x0r,,20,20,4,24
3150,Cappy-chan,,12,116,150,266
3151,delibaltas,,18,13,15,28
3152,sillyme,,17,8,19,27
3153,sjovaag,,1,12,22,34
3154,ZachSka87,,18,191,178,369
3155,thebigcheeze,,18,70,3,73
3156,jakobscudder,,8,2,1,3
3157,cnwb,,15,284,69,353
3158,trvr,,19,543,462,1005
3159,blindpilot,,18,15,16,31
3160,Buckbeak,,32,2,1,3
3161,bombat,,42,12,10,22
3162,TheGeneral,,1,51,89,140
3163,mybetterhalf,,18,22,49,71
3164,sadfaceman,,12,6,12,18
3165,rehpargotohp,,20,68,87,155
3166,Gatecrasher,,18,265,301,566
3167,washort,,20,194,270,464
3168,Joe091,,29,20,30,50
3169,optiontrader1138,,13,169,247,416
3170,vexx,,34,16,18,34
3171,Gmonkeylouie,,1,176,218,394
3172,justkeith,,5,10,17,27
3173,randy12,,11,3,3,6
3174,Alpha-Toxic,,4,29,26,55
3175,cliffm,,12,2,2,4
3176,chumpsucker,,19,6,10,16
3177,jackityjackyjackjack,,19,1,1,2
3178,pensword,,18,20,22,42
3179,apfelmus,,20,44,61,105
3180,USuckAss,,19,5,4,9
3181,xrobau,,43,61,81,142
3182,kallumama,,43,3,4,7
3183,Adrewmc,,19,189,441,630
3184,Street_Justice,,1,2,4,6
3185,ctallis,,10,4,1,5
3186,Jimmers1231,,18,187,143,330
3187,evilada,,1,233,182,415
3188,jimbo340,,18,7,7,14
3189,skullnibbler,,1,1,13,14
3190,schmick,,28,2,3,5
3191,scratchyNutz,,10,30,77,107
3192,dkeehn,,3,2,1,3
3193,cfbolz,,20,15,32,47
3194,chupame,,19,227,624,851
3195,mydiggisbig,,3,6,5,11
3196,arogal,,18,6,8,14
3197,nullchris,,14,1,2,3
3198,Kayin_Angel,,32,47,80,127
3199,reddawn2,,20,3,1,4
3200,StopTheWorld,,6,2,2,4
3201,johntitor,,4,1,1,2
3202,Poddo,,1,1,1,2
3203,selfthis,,43,35,34,69
3204,BigRodInPhilly,,32,2,1,3
3205,noseybonk,,20,1,1,2
3206,juststopit,,19,35,81,116
3207,pyegar,,13,23,2,25
3208,4th_reddit_account,,19,35,14,49
3209,notmynick,,13,4,1,5
3210,redditer027,,31,1,1,2
3211,megatrons07,,33,1,2,3
3212,Contron,,19,39,91,130
3213,trashly,,19,1,2,3
3214,demosthenes2010,,19,10,16,26
3215,tryp,,20,23,15,38
3216,underthesun,,12,32,17,49
3217,insanewriters,,42,79,29,108
3218,theoclast,,0,28,33,61
3219,laputan,,0,1,1,2
3220,AeroEngrAndMBA,,19,34,30,64
3221,henryk,,20,66,61,127
3222,moodswung,,13,8,12,20
3223,paygun,,19,30,42,72
3224,Bemfica,,32,1,1,2
3225,jjdmol,,20,217,312,529
3226,jaltena,,19,7,8,15
3227,Ringo48,,20,141,137,278
3228,tm82,,31,25,35,60
3229,stoosdood,,13,22,5,27
3230,GrandImperial,,1,10,10,20
3231,xnormajeanx,,13,253,227,480
3232,yesno305,,1,1,1,2
3233,resurge,,20,14,21,35
3234,Dillenger69,,34,234,464,698
3235,JaggedOne,,18,143,146,289
3236,aceoage,,43,1,9,10
3237,Pewpewarrows,,31,1,1,2
3238,banditski,,30,217,209,426
3239,sbsb27,,2,48,55,103
3240,alteredboy,,32,3,3,6
3241,battamer,,34,1,1,2
3242,lxstwrt,,12,15,1,16
3243,barbosaurus,,31,16,33,49
3244,Paperthin,,22,42,31,73
3245,cowboybebop,,0,1,1,2
3246,SamMcreedy,,13,1,2,3
3247,alex4nder,,20,26,23,49
3248,Swaddle,,35,1,1,2
3249,narcoleptic,,18,3,2,5
3250,sjbildermann,,0,19,32,51
3251,sjs,,20,417,822,1239
3252,tigerlily1770,,31,1,1,2
3253,RonPauI,,19,2,2,4
3254,benvolio_otter,,22,5,14,19
3255,saveferris,,19,39,51,90
3256,metawhat,,16,49,48,97
3257,fedaykin3dfx,,18,42,50,92
3258,JohnBoyRed,,12,1,3,4
3259,azdesign,,18,1,2,3
3260,naturebeau,,0,1,1,2
3261,ViperStrike085,,20,56,59,115
3262,BobKelsoCox,,20,2,1,3
3263,bubol,,18,3,3,6
3264,river-wind,,29,26,56,82
3265,fdisc0,,0,110,50,160
3266,arnoooooo,,43,48,122,170
3267,kofman,,20,2,2,4
3268,DougsNews,,32,89,31,120
3269,ookaay,,5,1,2,3
3270,bonsaitree,,32,1,2,3
3271,narwhal,,19,1,3,4
3272,itsinthebook,,32,2,3,5
3273,hotweiss,,42,64,89,153
3274,MasterScrat,,20,200,77,277
3275,alloashley,,20,5,2,7
3276,spen,,22,2,2,4
3277,forkystick,,1,2,7,9
3278,ygduf,,12,47,98,145
3279,optical,,42,74,183,257
3280,cbucket,,19,59,140,199
3281,low_key,,1,3,4,7
3282,sexdiary,,30,4,4,8
3283,maringa,,1,3,3,6
3284,MattVortex,,1,2,3,5
3285,chriton227,,13,1,1,2
3286,BrotherSeamus,,13,170,280,450
3287,kathrynmac,,14,19,34,53
3288,chapati,,5,6,3,9
3289,vgatsby,,12,8,16,24
3290,infiity,,8,1,4,5
3291,bassvocal,,20,38,59,97
3292,vandesande,,1,1,1,2
3293,thagsimmons,,22,33,64,97
3294,anon_for_this_time,,20,49,2,51
3295,saachi,,20,16,42,58
3296,mdeckert,,1,134,226,360
3297,eslav,,18,33,9,42
3298,RedPS,,15,93,39,132
3299,dMage,,18,22,28,50
3300,Fishav,,1,24,6,30
3301,shabda,,20,38,15,53
3302,tokenirishman,,20,1,1,2
3303,eatpizza,,13,1,8,9
3304,Captain_Ligature,,20,96,148,244
3305,alhernan,,19,2,1,3
3306,CaptGeek,,22,1,1,2
3307,diogames,,31,711,1127,1838
3308,mikexstudios,,22,9,12,21
3309,vansrikanth,,13,3,3,6
3310,deedee55,,18,27,47,74
3311,normanmehmeh,,20,10,4,14
3312,goodluckngoodnight,,19,4,2,6
3313,Lothy,,5,6,7,13
3314,GOPDogVomit,,13,57,74,131
3315,jerepjohnson,,42,14,11,25
3316,mcj,,1,42,50,92
3317,linton300,,11,61,6,67
3318,hamsealer,,1,1,1,2
3319,basic0,,22,161,136,297
3320,mkomo,,18,1,1,2
3321,bill_the_lizard,,20,5,12,17
3322,brianobush,,31,5,5,10
3323,cweaver,,22,563,862,1425
3324,redrover,,0,214,368,582
3325,scottmweaver,,0,1,1,2
3326,elTito,,31,2,6,8
3327,huginn,,22,262,322,584
3328,ilganeli,,16,2,3,5
3329,godskitchen,,20,68,41,109
3330,enterrupt,,12,1,18,19
3331,momerath,,18,41,49,90
3332,notm3tosay,,1,1,1,2
3333,the_incoherent_puppy,,6,1,3,4
3334,Chris7mas,,20,42,1,43
3335,cahuenga,,13,373,7,380
3336,tautologies,,1,3,2,5
3337,pkhagah,,31,8,9,17
3338,te_anau,,32,16,52,68
3339,perezhiltonadsucks,,18,11,23,34
3340,timbernerslee,,20,2,2,4
3341,BlitzCraig,,0,83,7,90
3342,bojangles69,,18,41,46,87
3343,TheNinthDoctor,,35,1,2,3
3344,TheFreshPrince,,13,1,1,2
3345,GorillaJ,,13,27,42,69
3346,nubtard,,42,2,5,7
3347,jdharper,,43,23,18,41
3348,maczer,,20,1,2,3
3349,Mezzanine,,18,11,57,68
3350,dwalthour,,1,15,11,26
3351,edmccaffrey,,20,35,63,98
3352,LycanElite,,18,24,43,67
3353,ekow2kn3,,18,6,15,21
3354,hairstyleee,,31,1,1,2
3355,stomach_cancer,,8,1,1,2
3356,hoodafukru,,22,29,23,52
3357,handsoffme,,32,36,36,72
3358,popefelix,,10,23,32,55
3359,thesweetness,,18,5,1,6
3360,Varnu,,31,7,4,11
3361,bushisaterrorist,,19,54,62,116
3362,omegaxm,,42,15,5,20
3363,giantrobot,,20,10,18,28
3364,StaticSignal,,22,5,6,11
3365,lhimalcolm,,32,12,15,27
3366,neobob,,13,6,16,22
3367,jbarnosky,,1,62,77,139
3368,bgovern,,13,100,117,217
3369,peoplehater,,19,26,39,65
3370,helgim,,2,1,5,6
3371,AlbertSchweitzer,,36,2,3,5
3372,kylegetsspam,,1,175,94,269
3373,CRUISECONTROLLER,,19,106,282,388
3374,gandhikahn,,42,22,30,52
3375,jonas_24,,22,1,1,2
3376,kensway,,14,3,1,4
3377,athelred,,4,1,1,2
3378,mr_gadget,,5,7,5,12
3379,quirkyfemme,,30,9,2,11
3380,3legcat,,20,13,14,27
3381,bmhatfield,,16,6,1,7
3382,PharmacistMike,,43,1,4,5
3383,renegadeofunk,,34,17,10,27
3384,uniteduntied,,19,4,2,6
3385,funktio,,20,26,22,48
3386,akabaka,,1,41,15,56
3387,ThomasPtacek,,20,204,204,408
3388,tobytroy,,42,27,32,59
3389,quadropelegit,,22,1,1,2
3390,weez09,,18,32,109,141
3391,kcin,,9,4,1,5
3392,daneatdirt,,1,14,20,34
3393,seba,,20,12,9,21
3394,bunyip,,19,33,33,66
3395,unic0rnz,,18,42,109,151
3396,sdragon,,20,2,2,4
3397,Lusy,,1,39,58,97
3398,danalb,,19,8,12,20
3399,SparxNet,,20,138,18,156
3400,GeneDoc,,34,1,1,2
3401,central_scrutinizer,,20,1,1,2
3402,zerothehero,,20,4,5,9
3403,tamb,,0,17,64,81
3404,taylortsides,,19,4,10,14
3405,ruscher,,13,3,2,5
3406,abramsv,,43,2,3,5
3407,cuerty,,20,1,4,5
3408,conorkirk,,28,4,7,11
3409,metzby,,20,91,82,173
3410,jodes,,15,347,282,629
3411,FrankBattaglia,,2,393,576,969
3412,coldwarrior,,19,374,541,915
3413,kojac,,43,10,3,13
3414,vkashen,,36,7,4,11
3415,psychoman365,,31,2,4,6
3416,fisch003,,20,4,7,11
3417,tizar,,17,7,4,11
3418,mocean,,13,2,5,7
3419,skeener,,1,37,115,152
3420,jmt123,,13,54,35,89
3421,georgeoscarbluth,,18,136,130,266
3422,sabrinag321,,31,8,9,17
3423,whitelightbrown,,18,54,43,97
3424,shawnvv,,13,19,6,25
3425,cyantific,,18,477,700,1177
3426,jasondigitized,,10,2,1,3
3427,ooohthatsnice,,20,3,2,5
3428,aeiou,,13,22,1,23
3429,waltz,,7,3,5,8
3430,kimrader,,19,6,5,11
3431,sjanssen,,20,50,65,115
3432,sadmep,,3,2,3,5
3433,jmillikin,,20,105,107,212
3434,LokiFoo,,30,1,2,3
3435,bytehead,,12,1,1,2
3436,startnowclickhere,,19,4,4,8
3437,zenspider,,20,34,27,61
3438,skylark9,,19,6,4,10
3439,kur1,,19,8,15,23
3440,pitstopper,,13,3,6,9
3441,Docktorno,,19,5,17,22
3442,shevegen,,20,2,9,11
3443,flamey,,13,33,5,38
3444,Uberg33k,,1,38,53,91
3445,LeviDon,,13,393,528,921
3446,behindblondiepark,,34,172,1,173
3447,zachalexander,,32,35,14,49
3448,missysue,,16,93,128,221
3449,UnionSoldier,,14,1,4,5
3450,I_Dont_Get_It,,22,1,3,4
3451,ToasTeh,,22,35,42,77
3452,codeblind,,19,23,53,76
3453,anth023,,18,1,1,2
3454,Burlapin,,1,636,382,1018
3455,eertognam,,19,5,6,11
3456,adoofus,,19,41,55,96
3457,booboopbedoop,,13,77,28,105
3458,neophrenologist,,32,17,20,37
3459,mcbambam,,32,15,18,33
3460,julenissen,,31,13,28,41
3461,SyncMoster,,19,2,3,5
3462,glblguy,,20,3,2,5
3463,spillz,,31,5,5,10
3464,pbradley,,18,121,254,375
3465,etor,,18,29,39,68
3466,Zeonix,,43,4,4,8
3467,lamontsf,,13,59,73,132
3468,DanHalen,,13,246,376,622
3469,wolfm79,,31,5,3,8
3470,normal1,,31,1,2,3
3471,itsourdecision,,18,2,1,3
3472,kitestramuort,,1,60,29,89
3473,DCGaymer,,34,87,205,292
3474,theEnzyteGuy,,13,16,23,39
3475,spangl,,17,1,1,2
3476,boardergeek,,13,10,1,11
3477,kuhllax24,,10,3,2,5
3478,hundredpercentjuice,,20,13,11,24
3479,sir-pinski,,22,3,7,10
3480,Anomander,,18,500,608,1108
3481,NotADoctor,,20,4,3,7
3482,mom-bot,,13,165,72,237
3483,civilians,,29,2,1,3
3484,gsf,,13,9,4,13
3485,petrasvilkas,,16,1,1,2
3486,jaggederest,,20,1062,1748,2810
3487,bevets,,30,7,6,13
3488,iiso,,1,1,2,3
3489,Godhelpus,,1,6,11,17
3490,licnyc,,32,36,40,76
3491,warrior007,,5,1,6,7
3492,bob_chinn,,19,1,1,2
3493,klasbas,,29,2,9,11
3494,patrissimo,,0,1,1,2
3495,RyanSmith,,13,46,58,104
3496,witten,,20,135,106,241
3497,ztay,,19,7,21,28
3498,psygurd,,20,2,5,7
3499,tronk,,18,10,15,25
3500,Captian_Oblivious,,18,36,23,59
3501,JoeSki42,,18,46,45,91
3502,cneemo,,30,3,5,8
3503,Mr_Shipwreck,,34,5,6,11
3504,ohashi,,18,3,1,4
3505,baconatedwaffle,,15,3,1,4
3506,wjyoung,,26,4,5,9
3507,AllSeeingMind,,4,1,1,2
3508,boodaa,,5,124,10,134
3509,rastan,,15,2,8,10
3510,ssflanders,,43,2,1,3
3511,freemti,,31,28,46,74
3512,oakium9,,42,2,2,4
3513,cr1swell,,18,59,101,160
3514,curt94,,20,1,3,4
3515,howaboutnow,,13,1,1,2
3516,Zombine,,20,44,70,114
3517,g33k,,14,5,9,14
3518,defigio,,4,1,2,3
3519,satori_moment,,30,14,27,41
3520,Anthem26,,22,11,20,31
3521,dallen,,43,137,187,324
3522,mythosmc,,18,2,11,13
3523,enricopulatzo,,20,2,2,4
3524,Rickasaurus,,20,9,4,13
3525,Her0savestheday,,6,3,120,123
3526,iveL,,18,4,11,15
3527,robsell,,8,1,2,3
3528,rhombusface,,19,1,3,4
3529,usr,,43,106,181,287
3530,HazeCore,,18,25,60,85
3531,brodieface,,18,2,10,12
3532,lighthoused,,19,1,1,2
3533,Tali99,,6,5,1,6
3534,ZimShady,,43,4,3,7
3535,khbryant,,5,4,2,6
3536,orblivion,,21,565,749,1314
3537,leftcoaster,,20,1,1,2
3538,digiterata,,13,18,18,36
3539,Action_Girl,,14,2,1,3
3540,UKUSA,,36,1,1,2
3541,clutterme,,19,6,2,8
3542,n1tw1t,,42,11,14,25
3543,cultofheather,,3,1,2,3
3544,PdxTu,,20,3,5,8
3545,lansen,,18,59,59,118
3546,gonecatfishin,,18,203,405,608
3547,executivemonkey,,0,641,982,1623
3548,unclenerd,,32,9,11,20
3549,majehire,,5,1,3,4
3550,SERIOUSCAT,,4,8,10,18
3551,arndiuz,,28,4,8,12
3552,muyoso,,31,110,88,198
3553,nixuseleven,,1,288,261,549
3554,frozenfire,,32,248,163,411
3555,blw121,,13,85,23,108
3556,obeyme,,8,1,1,2
3557,lattakia,,18,3,1,4
3558,VAGINAMAN,,20,3,6,9
3559,deadapostle,,32,2,5,7
3560,dsuarezv,,20,12,4,16
3561,Backhandzeus,,5,1,3,4
3562,miklosb,,0,3,3,6
3563,caddo07,,19,237,7,244
3564,mrcytizen,,31,7,12,19
3565,uberazzi,,13,118,23,141
3566,phaedrustc,,31,2,1,3
3567,moonballer,,22,73,57,130
3568,paulcynic,,32,74,6,80
3569,paralogical,,17,12,2,14
3570,perfeng702,,28,1,1,2
3571,MacBookForMe,,5,9,1,10
3572,shade73,,13,1,1,2
3573,joshuafkon,,32,3,1,4
3574,Unnat,,31,2,6,8
3575,Dawnfall,,31,5,8,13
3576,pearofducks,,13,1,1,2
3577,Janizzary,,3,1,2,3
3578,urmom,,10,3,6,9
3579,ChaosMotor,,19,141,260,401
3580,cymbalrush,,18,80,171,251
3581,werdtothenerd,,18,15,8,23
3582,found-it,,19,3,1,4
3583,zzt711,,32,10,18,28
3584,maxd,,18,274,372,646
3585,Tontomicon,,31,3,3,6
3586,roundeyeddog,,42,30,6,36
3587,bassmaster,,20,1,1,2
3588,waya1,,18,254,88,342
3589,rifleman_maynard,,31,7,10,17
3590,dodgyboat,,5,42,18,60
3591,Tuna-Fish2,,20,62,92,154
3592,wildwilly,,0,10,25,35
3593,sobe86,,43,14,10,24
3594,pretentiousdouchebag,,20,7,3,10
3595,Ramulus,,4,2,2,4
3596,fieldmouse,,12,2,1,3
3597,popcult,,13,663,60,723
3598,spot35,,22,192,308,500
3599,supersaw,,22,289,440,729
3600,Dzune,,27,3,5,8
3601,dip,,43,89,4,93
3602,Amish_Redditor,,29,2,3,5
3603,obamamama08,,19,6,2,8
3604,stephencelis,,20,9,20,29
3605,MysteriousCraic,,31,1,1,2
3606,rikbrown,,32,3,4,7
3607,RevLoveJoy,,42,148,165,313
3608,did_you_know_that,,19,12,14,26
3609,pind02,,13,29,30,59
3610,azzer,,20,2,1,3
3611,dpinkal,,18,2,1,3
3612,alexbear,,13,34,68,102
3613,placebo96799,,13,1,2,3
3614,vanyali,,19,5,12,17
3615,DarkFenix,,0,24,14,38
3616,whitecracker,,13,73,4,77
3617,rjray,,32,11,7,18
3618,TheGood,,18,236,509,745
3619,Shroomsoup,,42,92,120,212
3620,bildstein,,12,2,2,4
3621,Moebus,,32,3,2,5
3622,hhg,,14,1,2,3
3623,bobshush,,1,245,317,562
3624,Felugah,,32,19,30,49
3625,fakeplasticme,,32,86,106,192
3626,fuzzybassoon,,0,1,1,2
3627,facetheglue,,18,98,74,172
3628,karma_chameleon,,1,275,385,660
3629,slutshirt,,0,1,3,4
3630,eye_josh,,43,3,6,9
3631,losl,,1,43,54,97
3632,redscarab,,1,2,5,7
3633,Dongski,,6,3,4,7
3634,Arcen,,34,3,1,4
3635,DustyMuffin,,1,7,10,17
3636,TastesLikeChicken,,4,3,2,5
3637,wKen,,34,8,11,19
3638,kuwabara02,,12,10,7,17
3639,khayber,,22,279,425,704
3640,agent_orange,,20,5,3,8
3641,danpatsa,,11,6,5,11
3642,TheParanoidAndroid,,22,14,43,57
3643,fiftytwo,,34,1,1,2
3644,Phirazo,,13,27,21,48
3645,dooh,,19,2,16,18
3646,HenryTheMegalomanic,,8,4,1,5
3647,lounge_chair,,20,2,6,8
3648,tyeh26,,12,13,12,25
3649,kettal,,36,57,78,135
3650,trollforkarma,,34,8,7,15
3651,matty_b,,43,15,26,41
3652,timin,,13,1,2,3
3653,c0dep0et,,20,3,7,10
3654,garyteeth,,32,1,2,3
3655,madcaesar,,18,54,90,144
3656,darkry,,20,21,30,51
3657,danschu63,,13,2,7,9
3658,jlgkcghjdghj,,12,5,6,11
3659,gabaghoul,,6,1,1,2
3660,benhoyt,,20,223,50,273
3661,al420,,17,2,4,6
3662,parsa033,,8,7,3,10
3663,degustivespa,,0,18,34,52
3664,rocky79,,41,8,9,17
3665,joe_shmoe11111,,18,35,71,106
3666,tits_n_acidd,,16,7,11,18
3667,insert-meme,,19,190,351,541
3668,lateralus,,13,98,60,158
3669,frickinamazing,,22,15,10,25
3670,ClackAttack,,30,49,57,106
3671,xrokka,,4,1,1,2
3672,daveread,,13,42,66,108
3673,ptang,,27,1,2,3
3674,stlouisbrowns,,13,698,586,1284
3675,kabr,,4,11,14,25
3676,totobird357,,13,1,1,2
3677,Data_Storm,,13,2,7,9
3678,captainfwiffo,,20,50,68,118
3679,liu212,,18,2,1,3
3680,DrRobert,,28,11,16,27
3681,-funroll-loops,,4,1,1,2
3682,gocubs80,,1,8,12,20
3683,ninjaidd,,30,8,4,12
3684,BlackMarketer,,19,38,29,67
3685,rachelmc,,30,1,1,2
3686,Roark,,19,753,276,1029
3687,mentaldent,,16,2,13,15
3688,lunk,,43,60,68,128
3689,burnteternal,,4,11,9,20
3690,213435,,19,7,6,13
3691,digp,,43,1,1,2
3692,renderedpixel,,19,1,2,3
3693,scrapper,,34,133,184,317
3694,jmcqk6,,23,297,452,749
3695,baconfish,,18,20,41,61
3696,bonecrusher,,20,3,2,5
3697,davars,,20,3,6,9
3698,barakatbarakat,,31,14,20,34
3699,fakeplastic,,20,5,6,11
3700,JuanHughJorgan,,39,1,3,4
3701,Queenbee310,,1,1,3,4
3702,Hipgnosis,,1,35,86,121
3703,freed,,26,3,2,5
3704,username0000,,31,4,1,5
3705,inredditland,,31,1,1,2
3706,jeremytrash,,1,17,3,20
3707,Oleander,,0,32,32,64
3708,rbercian,,0,1,2,3
3709,BoggleBrain,,1,47,47,94
3710,cosmid,,6,182,322,504
3711,doubtingthomas,,20,56,81,137
3712,ohmohm,,0,12,17,29
3713,doctord,,22,1,2,3
3714,aliweb,,8,257,43,300
3715,kikonja,,18,385,46,431
3716,kit8642,,19,1,1,2
3717,wunderboy,,19,44,48,92
3718,ashdog137,,36,5,8,13
3719,2468ben,,19,4,10,14
3720,maggs,,19,1,1,2
3721,teyc,,20,90,128,218
3722,frogking,,43,473,1097,1570
3723,beza1e1,,20,372,279,651
3724,RiMiBe,,0,265,395,660
3725,evansims,,5,1,1,2
3726,Jmjonkman,,18,24,26,50
3727,PhullAdder,,0,1,2,3
3728,cosmosis,,5,2,1,3
3729,timothyjc,,39,33,26,59
3730,KelliBusey,,19,1,1,2
3731,ybad,,15,67,75,142
3732,rothgar24,,0,19,45,64
3733,butterscotch,,43,11,9,20
3734,cranus,,13,2,1,3
3735,rteyhdhgh,,18,6,5,11
3736,ScreamingSkull,,18,18,26,44
3737,thejapanesegeek,,19,8,5,13
3738,antfarmerbob,,3,1,1,2
3739,otiose321,,30,65,16,81
3740,donkey_lz,,20,3,6,9
3741,ryouba,,18,45,41,86
3742,zemoo,,19,4,2,6
3743,redpassport,,42,7,12,19
3744,orestes19,,20,6,9,15
3745,cefm,,19,694,1220,1914
3746,bustardy,,31,2,5,7
3747,zootm,,20,45,78,123
3748,synrb,,13,7,8,15
3749,cliche,,38,151,142,293
3750,ChewableFood,,34,6,9,15
3751,kubutulur,,31,233,451,684
3752,xdj,,13,26,79,105
3753,EeyoreTKC,,19,38,44,82
3754,stewie81,,22,2,2,4
3755,lobut,,8,203,319,522
3756,oddsouls,,15,92,148,240
3757,savetheconstitution,,31,2,1,3
3758,concini,,13,289,126,415
3759,hassanh21,,43,58,52,110
3760,t4k3n,,8,2,1,3
3761,sabut,,20,11,12,23
3762,toskius,,38,2,1,3
3763,tst1212,,19,5,8,13
3764,hoboy,,13,1,1,2
3765,CrAppleton,,42,1,1,2
3766,heheman3000,,32,1,1,2
3767,StrictlyPlatonic,,18,2,2,4
3768,tripa,,20,30,33,63
3769,bearythebear,,18,40,51,91
3770,wjackson,,31,22,35,57
3771,dividebyz3r0,,20,1,1,2
3772,Sabretooth,,20,6,7,13
3773,informatech,,18,7,8,15
3774,MegaMonkeyManExtreme,,18,5,23,28
3775,Obscuro,,34,3,4,7
3776,Kaessa,,13,72,134,206
3777,Jasn,,12,2,3,5
3778,badcop666,,19,3,2,5
3779,Stay521,,29,1,1,2
3780,andycwb,,6,3,1,4
3781,InternetHateMachin3,,1,43,62,105
3782,roadcoach,,13,1,1,2
3783,cwicket,,19,23,31,54
3784,Sharkyx,,5,233,29,262
3785,sethaldridge,,39,2,1,3
3786,hueypriest,,18,112,47,159
3787,alex_tokai,,22,1,1,2
3788,I_Am_Reason,,6,4,2,6
3789,moserware,,20,74,13,87
3790,nova20,,18,26,24,50
3791,tommycli,,32,21,28,49
3792,rabidgolffan,,0,1,1,2
3793,lemonge,,20,12,17,29
3794,arunmail,,13,1,1,2
3795,therapy,,20,460,605,1065
3796,gardensnake,,19,13,33,46
3797,arrogantworm,,13,1,2,3
3798,hillahilla,,29,20,21,41
3799,wordmunger,,43,2,2,4
3800,dillhole,,1,1,1,2
3801,Callahan121,,18,6,10,16
3802,candeewolf,,32,2,2,4
3803,smurphy,,20,1,1,2
3804,youchoose2,,34,79,229,308
3805,craigtechno,,30,2,1,3
3806,abdul15,,13,1,1,2
3807,Humels,,6,2,1,3
3808,epic_fail_guy,,30,218,234,452
3809,melp,,18,2,4,6
3810,jacastillo,,13,10,11,21
3811,Rick_Roll,,19,18,2,20
3812,Orange007,,1,10,7,17
3813,danstuken,,20,8,4,12
3814,nakp88d,,22,39,48,87
3815,namsilat,,18,106,16,122
3816,kefs,,18,1048,134,1182
3817,boredzo,,20,1004,1360,2364
3818,ErnestHemingway,,13,4,17,21
3819,joebeone,,19,1,2,3
3820,ashayh,,32,11,20,31
3821,ardenr,,0,50,78,128
3822,TimJBart,,18,77,14,91
3823,honeg,,19,191,369,560
3824,allyrx7,,14,4,4,8
3825,moosetime1230330,,33,1,2,3
3826,Epivalent,,31,1,3,4
3827,100pushups,,5,4,10,14
3828,zerofive1,,31,38,65,103
3829,vinsewah,,9,7,4,11
3830,IRBTGISRUNBYTHEGOVT,,1,1,1,2
3831,technosaur,,19,383,456,839
3832,BONUS_,,20,5,1,6
3833,netcmd,,18,17,15,32
3834,ronin712,,19,2,2,4
3835,f4k3pl4stic,,42,1,1,2
3836,slenderdog,,19,176,369,545
3837,mdikkema,,28,1,1,2
3838,mkmahar,,43,11,6,17
3839,ngl,,1,1,13,14
3840,borommakot,,1,1,4,5
3841,hissiliconsoul,,1,35,38,73
3842,Beem,,0,2,2,4
3843,TheNeoCity,,13,22,15,37
3844,uncbabie,,34,11,10,21
3845,kilven,,20,3,9,12
3846,skullduggery,,18,1,4,5
3847,salmacis,,31,20,16,36
3848,pssh99,,1,18,13,31
3849,FST,,31,113,196,309
3850,followvirgil,,31,141,32,173
3851,blobert,,1,42,66,108
3852,dssvo,,20,45,64,109
3853,Katie89,,18,7,6,13
3854,Sku,,8,45,36,81
3855,newgrl,,22,74,92,166
3856,Amblikai,,32,4,8,12
3857,ecalos,,43,4,16,20
3858,sanman,,31,8,7,15
3859,wiraqcza,,29,2,3,5
3860,blumby,,43,1,2,3
3861,fdat,,13,59,83,142
3862,Redkiteflying,,13,14,18,32
3863,jib,,20,344,518,862
3864,melvingant,,19,17,3,20
3865,MeenXo,,31,25,26,51
3866,gnat,,20,2,3,5
3867,booris,,19,4,4,8
3868,therve,,10,1,2,3
3869,laynehobby,,20,2,1,3
3870,orange_cat,,31,1,4,5
3871,Olduvai_Joe,,23,1,2,3
3872,asssphinctersayswhat,,9,2,2,4
3873,cybergen,,1,169,89,258
3874,darth_brooks,,19,144,199,343
3875,johnb,,20,206,200,406
3876,mossgard,,32,6,25,31
3877,daemen,,30,2,3,5
3878,underpantsgnome,,21,1,4,5
3879,Neikos,,18,9,20,29
3880,Jengu,,20,35,50,85
3881,TJHookor,,18,49,51,100
3882,blogger8888,,19,2,3,5
3883,apl,,5,1,3,4
3884,Boolean,,42,33,23,56
3885,pedromccarthy,,14,1,1,2
3886,satertek,,12,482,472,954
3887,GoatTnder,,13,42,15,57
3888,hags99,,13,1,1,2
3889,earthgirl46,,12,2,3,5
3890,scramer,,43,7,16,23
3891,ozyman,,18,10,26,36
3892,slf67,,1,65,56,121
3893,mr_w,,18,29,25,54
3894,enken,,20,2,2,4
3895,KDoggers,,32,1,1,2
3896,jeanfitzgerald,,19,70,121,191
3897,gvsteve,,19,674,684,1358
3898,alexf3ng,,0,1,2,3
3899,efrique,,32,23,3,26
3900,ManInFall,,29,1,3,4
3901,zmigliozzi,,19,163,288,451
3902,gthank,,20,866,169,1035
3903,piperatom,,4,6,13,19
3904,holyzomg,,20,5,3,8
3905,davejl,,5,138,30,168
3906,mickyg,,41,1,1,2
3907,javasucks,,19,261,496,757
3908,robotoast,,18,55,95,150
3909,benben_liu88,,41,1,1,2
3910,nomad_tavern,,29,1,1,2
3911,axord,,19,991,1949,2940
3912,aaslos,,1,11,2,13
3913,AngryRepublican,,28,271,420,691
3914,riomx,,5,5,1,6
3915,landshark,,14,2,4,6
3916,napoleonmonkey,,3,1,1,2
3917,AllGood,,13,85,71,156
3918,umairmalik,,18,2,2,4
3919,willyloman,,8,4,1,5
3920,charliepage,,42,15,3,18
3921,naltex,,1,23,40,63
3922,eljimador,,36,1,1,2
3923,ccutler69,,19,32,52,84
3924,bgraves,,1,7,6,13
3925,ubuntumaniac,,20,1,1,2
3926,mamasaige,,18,1,1,2
3927,d_i_z_z_y_k,,18,72,23,95
3928,gyanguru,,19,13,14,27
3929,Ryethe,,42,15,21,36
3930,YaYaLuvsCupcakes,,19,5,1,6
3931,amtb,,1,1,1,2
3932,NeoGeo,,34,3,1,4
3933,Shizlanski,,43,1,2,3
3934,urklan,,18,2,2,4
3935,hex,,20,82,86,168
3936,anonyreddit,,31,1,4,5
3937,twokie,,3,1,2,3
3938,jackband1t,,1,134,45,179
3939,User832,,20,6,6,12
3940,rbobic,,19,8,11,19
3941,iox,,20,1,2,3
3942,njzero,,19,39,73,112
3943,fuchsm2002,,5,1,1,2
3944,odinfire,,13,22,17,39
3945,adamc,,20,47,68,115
3946,cji,,18,4,6,10
3947,gles0000,,34,1,3,4
3948,Leprecon,,43,249,370,619
3949,pleasenodoitlive,,0,9,4,13
3950,eftrescue,,13,2,3,5
3951,alphakappa,,43,113,65,178
3952,epc123,,18,26,31,57
3953,kendetroit,,1,1,2,3
3954,NejimakiDori,,31,2,3,5
3955,MarshallBanana,,20,1320,1778,3098
3956,bobbysmith007,,1,53,89,142
3957,coldkodiak,,31,38,45,83
3958,tehdanish,,20,1,2,3
3959,orenbenkiki,,20,8,4,12
3960,dzer0,,22,28,40,68
3961,pdsull,,31,4,4,8
3962,Gnolfo,,17,6,2,8
3963,muffsquirt,,13,22,41,63
3964,pumpupthevolume,,31,141,135,276
3965,aleister,,39,2,2,4
3966,zbrock,,20,16,8,24
3967,TravisMc,,22,2,5,7
3968,frunt,,43,209,243,452
3969,cavedave,,20,1557,374,1931
3970,supajames,,14,20,21,41
3971,aewiel,,3,3,7,10
3972,lonjerpc,,20,146,160,306
3973,celebritythinspo,,18,14,4,18
3974,jspam,,18,61,32,93
3975,jasonpo,,19,25,29,54
3976,imagineapuddle,,5,26,19,45
3977,gq_bag,,19,7,6,13
3978,gribbit,,18,5,4,9
3979,ensignsteve,,18,5,29,34
3980,shopcat,,12,272,480,752
3981,insidious,,18,1,1,2
3982,argoff,,13,673,768,1441
3983,robbiefoster,,18,4,4,8
3984,gim69,,31,9,8,17
3985,huwr,,33,1,1,2
3986,hgielrehtaeh,,34,465,423,888
3987,Stange,,42,28,21,49
3988,wimpyanonymous,,15,3,1,4
3989,Rock42,,32,2,3,5
3990,brickbybrick,,20,7,8,15
3991,jeaguilar,,16,13,25,38
3992,watergeese,,32,154,106,260
3993,muthawenchez,,20,1,1,2
3994,gregwont,,19,1018,4,1022
3995,niia,,42,1,3,4
3996,adbachman,,20,4,6,10
3997,sinsio,,19,1,2,3
3998,CoastOfYemen,,31,69,41,110
3999,jaydoubleyou,,19,6,7,13
4000,JackRB,,13,1,2,3
4001,mvhughes,,34,11,20,31
4002,frap,,20,3,3,6
4003,VoteMcCain,,17,1,3,4
4004,melangeau,,18,5,4,9
4005,dereschai,,0,1,1,2
4006,Omikron,,19,1044,1044,2088
4007,omarsdroog,,34,1,2,3
4008,hypermog,,18,24,21,45
4009,uksydibasv,,30,99,55,154
4010,skionxb,,18,1267,27,1294
4011,nkm1981,,13,4,5,9
4012,barneystephens,,18,225,73,298
4013,steadyrock,,10,3,1,4
4014,variablast,,6,1,2,3
4015,reddy-kilowatt,,2,4,14,18
4016,SunriseProgrammer,,31,5,7,12
4017,dkj1953,,14,1,1,2
4018,erreon,,34,77,33,110
4019,Dr_Faustus,,31,12,11,23
4020,kefex,,20,109,54,163
4021,iIrishjon,,1,2,4,6
4022,bokepr,,19,1,1,2
4023,skoof,,31,3,3,6
4024,preilly,,20,2,3,5
4025,catfood,,43,3,3,6
4026,bluemeep,,22,24,28,52
4027,webfiend,,13,39,100,139
4028,apostleofhustle,,18,29,57,86
4029,kanakaishou,,42,69,119,188
4030,CaptainAdjective,,19,13,10,23
4031,jongala,,18,7,11,18
4032,SmurfyX,,43,31,51,82
4033,stjohns,,20,10,13,23
4034,VitaminH,,12,58,85,143
4035,wutzurproblem,,19,98,219,317
4036,minerva78,,13,22,21,43
4037,cammycam,,13,5,5,10
4038,zpincus,,20,6,9,15
4039,Soelle,,19,1,1,2
4040,DEPROGRAM_YOUR_MIND,,31,18,13,31
4041,Itarilde,,43,10,29,39
4042,Marmiteontoast,,19,2,4,6
4043,harley99,,22,2,4,6
4044,Andronicus,,22,1,1,2
4045,thequicksilver,,1,7,6,13
4046,redwinging,,18,3,6,9
4047,withnail,,3,3,1,4
4048,mtbkeg,,19,2,1,3
4049,yoda133113,,13,67,89,156
4050,crucialfelix,,13,123,149,272
4051,dangerous_eric,,43,6,1,7
4052,karmasux080130,,19,4,9,13
4053,leoh,,10,4,2,6
4054,lolmanzorz,,18,117,99,216
4055,inCider,,29,22,28,50
4056,lispy,,20,16,22,38
4057,SidDithers,,32,6,1,7
4058,bjrn,,20,23,7,30
4059,gummo,,43,1,2,3
4060,vmsmith,,19,7,5,12
4061,haterexterminator,,29,2,1,3
4062,SuperKing,,22,219,349,568
4063,veryhman,,18,18,1,19
4064,Arnfred,,8,17,15,32
4065,easyhistory,,13,187,386,573
4066,mnemone,,28,5,9,14
4067,frugaldutchman,,18,5,16,21
4068,bayblab,,43,1,1,2
4069,suyuri,,34,1,3,4
4070,blmurch,,13,79,171,250
4071,ntba,,1,1,1,2
4072,thewibbler,,18,13,8,21
4073,caguy,,18,1,1,2
4074,newsguy2005,,13,8,1,9
4075,mdavis11487,,1,4,8,12
4076,ateall,,34,2,1,3
4077,FatLoser,,0,54,9,63
4078,dereklyons,,18,8,11,19
4079,SaLted_peanUTs,,19,9,8,17
4080,rdmorley,,18,66,78,144
4081,kylestryker,,19,7,7,14
4082,Hess10,,35,1,1,2
4083,Shade00a00,,22,31,44,75
4084,mitoe,,1,155,95,250
4085,Timmetie,,43,95,124,219
4086,drmickhead,,5,6,9,15
4087,sonofagunn,,20,57,95,152
4088,ChrisToTheCenter,,13,32,3,35
4089,DrCrankenstein,,5,65,23,88
4090,bierhofff,,43,2,3,5
4091,rolex22,,19,11,18,29
4092,helly,,20,3,1,4
4093,plethorex,,1,109,143,252
4094,Carniv0re,,5,2,2,4
4095,wmacura,,20,12,6,18
4096,sunmaster13,,31,7,5,12
4097,themysteriousfuture,,32,14,19,33
4098,shitbird,,9,4,12,16
4099,chris1672,,6,2,1,3
4100,Carmilla5,,20,1,1,2
4101,theCore,,20,28,23,51
4102,Majupra,,18,1,3,4
4103,strolls,,17,334,441,775
4104,iansmith6,,20,1,1,2
4105,EamonR,,3,23,53,76
4106,purplegalaxy,,22,3,1,4
4107,ueberbobo,,20,2,8,10
4108,danc86,,20,3,5,8
4109,burntsac,,18,49,28,77
4110,freep2,,19,1,2,3
4111,Morikal,,9,1,1,2
4112,tuppertrenine,,31,3,1,4
4113,dubyas_my_hero,,19,71,120,191
4114,usurper2009,,1,93,20,113
4115,igad,,19,4,3,7
4116,zwrtwtr,,20,1,2,3
4117,NyteStarNyne,,18,11,17,28
4118,kynth,,20,1,4,5
4119,CuntPuntingIsAHOBBY,,20,1,2,3
4120,hectorwc,,31,211,320,531
4121,RedRaya,,13,131,53,184
4122,fortranran,,20,5,3,8
4123,justhadto,,43,58,104,162
4124,MetroSpy,,34,3,5,8
4125,climbon321,,18,205,64,269
4126,bdash,,20,98,92,190
4127,irishcocacola,,18,132,66,198
4128,thegooddoctor,,22,1,1,2
4129,AnotherTia,,13,1,1,2
4130,BravoLima,,19,1322,403,1725
4131,boxofjack,,1,1,4,5
4132,SLiPSTR34M,,18,2,2,4
4133,Mints,,18,20,14,34
4134,TruthMonger,,13,13,1,14
4135,SamSoBuff1215,,18,11,17,28
4136,Kaemack,,19,1,7,8
4137,Ravenkettle,,2,3,6,9
4138,chaosdude78,,1,1,6,7
4139,ahjones,,43,14,1,15
4140,dvogel,,20,86,94,180
4141,Wagnerius,,20,84,78,162
4142,giulianob,,20,17,38,55
4143,kulakovich,,34,1,1,2
4144,jdhawk,,20,6,4,10
4145,kmr62,,6,2,2,4
4146,GayEd,,13,53,57,110
4147,Cloud7659,,18,5,7,12
4148,aspinex,,40,38,6,44
4149,fellowette,,17,3,3,6
4150,boredatheist,,18,3,4,7
4151,Cait_Monster,,13,82,117,199
4152,adarshiscool,,36,29,47,76
4153,switch495,,39,10,12,22
4154,pestilence4hr,,18,39,39,78
4155,juan_mccain,,4,1,1,2
4156,nventit2,,22,34,1,35
4157,stims,,20,13,9,22
4158,redbean1,,32,2,1,3
4159,sgoadhouse,,43,6,2,8
4160,The_Cougar,,37,2,5,7
4161,modnar,,18,309,390,699
4162,Catana,,32,4,7,11
4163,otatop,,23,490,633,1123
4164,sirris,,34,2,1,3
4165,Slawekk,,20,1,1,2
4166,slate,,20,5,6,11
4167,heatmaster,,19,1,1,2
4168,lamerx,,0,20,49,69
4169,wackyvorlon,,32,235,191,426
4170,piggysmacks,,19,2,4,6
4171,godders,,33,19,27,46
4172,derio42,,40,1,1,2
4173,farlow,,1,20,35,55
4174,gossipmonkey,,13,85,5,90
4175,mindhacker,,20,21,19,40
4176,MicahFitch,,19,193,35,228
4177,jameslaw,,20,80,141,221
4178,pakacuda,,13,31,38,69
4179,shwaldo,,14,1,1,2
4180,musicisum,,18,79,127,206
4181,NowakFilms,,19,10,12,22
4182,brandf,,20,3,9,12
4183,arielh85,,34,228,2,230
4184,soulreaver,,18,20,4,24
4185,notaloop,,1,131,225,356
4186,ePurch,,36,2,4,6
4187,bluepepper,,17,20,34,54
4188,rrcjab,,0,1,1,2
4189,Oriard,,1,8,7,15
4190,senti2048,,18,21,18,39
4191,NewPeonSameAsOldPeon,,33,22,13,35
4192,luisbrudna,,18,67,11,78
4193,jixitar,,20,17,5,22
4194,metal_falsetto,,36,113,99,212
4195,cusiter67,,22,1,5,6
4196,casted,,20,87,11,98
4197,collinsc,,18,4,8,12
4198,Anonymoose2,,20,3,3,6
4199,chahn,,43,19,16,35
4200,rt702,,20,5,5,10
4201,glassie,,31,1,1,2
4202,KatfromCanada,,18,19,47,66
4203,fact,,20,19,21,40
4204,daniels220,,3,302,520,822
4205,antonivs,,20,132,211,343
4206,maxonemaxtwo,,13,7,7,14
4207,trav,,19,38,5,43
4208,sjwillis,,1,86,62,148
4209,glackk,,0,16,26,42
4210,chomputer,,18,6,16,22
4211,jbzd,,6,118,91,209
4212,IcanReddit,,30,3,3,6
4213,joshnunn,,18,3,3,6
4214,OnzeVader,,22,1,1,2
4215,tousdan,,3,2,1,3
4216,SkyMarshal,,0,273,420,693
4217,fprintf,,13,14,15,29
4218,tritchey,,20,2,1,3
4219,pornholio21,,19,29,11,40
4220,igwan,,20,3,3,6
4221,theosloexperience,,40,82,70,152
4222,the3secondrule,,13,8,9,17
4223,otisfresh,,19,10,12,22
4224,adamwhiles,,43,3,6,9
4225,SizzlingStapleCider,,1,53,35,88
4226,gorn2,,13,2,2,4
4227,wrightc,,14,1,1,2
4228,synapticon,,31,1,1,2
4229,JonhCarnol,,33,1,1,2
4230,zordac,,43,2,1,3
4231,MaxBro,,32,6,9,15
4232,nicholaides,,20,17,4,21
4233,wolfe1978nm,,13,13,21,34
4234,the-blimp,,43,1,1,2
4235,bfkelsey,,1,3,3,6
4236,mothslice,,19,2,1,3
4237,bfioca,,34,2,1,3
4238,scjohnson,,0,15,13,28
4239,deadfrank,,18,23,45,68
4240,mshade,,1,273,266,539
4241,tdieckman,,13,40,42,82
4242,Tyrus8,,1,1,2,3
4243,StevenLevithan,,20,29,18,47
4244,mattgifford,,19,1,1,2
4245,shabby47,,11,156,85,241
4246,brianchester666,,19,52,68,120
4247,tigerledoux13,,39,1,4,5
4248,simplydunn,,18,120,1,121
4249,issawiah,,19,2,2,4
4250,joaocosta,,13,3,1,4
4251,wingless,,19,2,3,5
4252,loonidood,,1,5,1,6
4253,timetraveller83,,13,4,5,9
4254,caroll245912,,8,1,1,2
4255,cfcamerica,,13,182,18,200
4256,shrednwail,,19,1,1,2
4257,monkeyman114,,13,550,1210,1760
4258,Troll-in-the-corner,,42,20,4,24
4259,radix42,,20,1,6,7
4260,Daveed,,5,11,25,36
4261,billin,,31,27,56,83
4262,feauxreal,,32,5,2,7
4263,Consensus,,4,6,8,14
4264,chelle84,,13,3,1,4
4265,wtfever,,0,8,9,17
4266,greengunner,,35,1,1,2
4267,badfish,,1,121,266,387
4268,Hoobam,,32,69,105,174
4269,imnotbillgates,,43,1,1,2
4270,adammcbomb,,42,2,15,17
4271,daamsie,,34,35,5,40
4272,laziz,,22,3,2,5
4273,tazmanian,,13,55,92,147
4274,katykat29,,31,10,13,23
4275,Blumbo,,13,44,64,108
4276,redthirtytwo,,18,17,29,46
4277,Chibi,,19,4,3,7
4278,yrqaay,,31,12,10,22
4279,sunshinerundown,,19,13,31,44
4280,Tatsu23456,,20,4,7,11
4281,nostupidquestions,,6,5,1,6
4282,amishius,,1,8,23,31
4283,crazybehind,,13,16,31,47
4284,musicalpeach,,43,9,11,20
4285,tszyn,,17,1,3,4
4286,Melvillian,,34,36,18,54
4287,riffito,,20,16,38,54
4288,mazing,,42,54,68,122
4289,sarahfrancesca,,43,456,335,791
4290,nof,,13,2,9,11
4291,achillesminor,,20,11,6,17
4292,patrickc,,22,1,1,2
4293,jardeon,,20,18,22,40
4294,missoulian,,18,5,6,11
4295,dru171,,0,6,15,21
4296,jerryjamesstone,,34,78,22,100
4297,dustin9797,,13,2,3,5
4298,alarumba,,18,66,106,172
4299,barnesnoble,,19,2,7,9
4300,khoury,,6,1077,1929,3006
4301,mocheeze,,23,2,5,7
4302,BMErdin,,42,94,166,260
4303,tonythewilson,,42,6,4,10
4304,strangedoctrines,,22,1,1,2
4305,myname3,,12,4,1,5
4306,skyo,,18,92,86,178
4307,vsundber,,14,1,2,3
4308,blackkettle,,20,66,85,151
4309,unptitdej,,19,8,8,16
4310,TheOneDM,,1,5,3,8
4311,Entintado,,19,4,7,11
4312,wizdum,,1,36,89,125
4313,BristolPalin,,18,76,118,194
4314,DrivebyGroper,,20,4,2,6
4315,lunamoon_girl,,31,14,21,35
4316,TerraFF,,1,9,20,29
4317,Irradiance,,15,97,31,128
4318,chefshaolin,,19,55,89,144
4319,Achara,,32,3,6,9
4320,live_free_or_die,,12,1,2,3
4321,monkeyx,,34,44,12,56
4322,vera123,,0,739,73,812
4323,911zionotroll,,19,2,2,4
4324,bluegene,,30,7,5,12
4325,Burkey,,31,19,25,44
4326,gbrudy16,,1,2,14,16
4327,doodahdei,,13,361,688,1049
4328,jstack,,18,11,27,38
4329,CygnusFTK,,19,147,165,312
4330,RetroRock,,43,671,104,775
4331,Tomboys2,,5,44,6,50
4332,Kafir,,18,40,56,96
4333,motang,,20,1267,37,1304
4334,users,,12,2,1,3
4335,concertmaps,,43,3,4,7
4336,xabi,,20,19,7,26
4337,jamarcus,,32,7,26,33
4338,cskaterun,,19,3,6,9
4339,augustallen,,12,3,7,10
4340,bluehorse00,,19,3,1,4
4341,jimdorey,,18,13,32,45
4342,xqtfmd,,0,27,39,66
4343,newbay,,13,3,4,7
4344,dsg123456789,,20,47,64,111
4345,annihilus813,,13,60,60,120
4346,ColdMountain,,20,3,5,8
4347,astorite,,18,6,13,19
4348,walterxraleigh,,19,2,3,5
4349,gpayet,,34,1,2,3
4350,aredash,,18,1,1,2
4351,ozmonster,,0,55,15,70
4352,psyker,,20,1,3,4
4353,gregmoskun,,19,50,139,189
4354,cellison,,1,5,2,7
4355,BigMax,,27,20,14,34
4356,Tbone139,,1,11,37,48
4357,ellaella,,13,573,365,938
4358,flawedai,,13,13,1,14
4359,CD7,,18,35,112,147
4360,bridgetroll,,17,2,2,4
4361,bugsland,,43,1,1,2
4362,lantech2,,13,24,50,74
4363,jbus,,19,15,19,34
4364,Dross,,22,2,6,8
4365,Twiin,,18,2,1,3
4366,sonar_un,,34,189,242,431
4367,flyspagmon,,12,67,40,107
4368,ilikeboobs,,21,1,2,3
4369,headius,,20,3,6,9
4370,greentriangle,,6,344,75,419
4371,highside,,41,5,8,13
4372,beeblez,,30,54,42,96
4373,mistersir,,19,3,7,10
4374,montypython1087,,20,1,8,9
4375,rednukleus,,32,331,583,914
4376,sinfulsamaritan,,43,97,10,107
4377,Yelly,,34,24,8,32
4378,philig,,18,3,7,10
4379,mbwahl,,29,2,2,4
4380,pietro,,20,15,34,49
4381,XoYo,,22,111,159,270
4382,vestus,,19,15,14,29
4383,spyder9,,20,2,1,3
4384,edelwater,,13,4,1,5
4385,omnic0n,,18,3,1,4
4386,robbyism,,13,2,5,7
4387,billabong,,18,5,14,19
4388,not-leet,,10,2,1,3
4389,rudylishious,,17,8,3,11
4390,RDS,,1,7,5,12
4391,Aloy,,32,16,22,38
4392,fisheggs,,4,18,23,41
4393,cpt_headshot,,29,2,3,5
4394,venir,,13,19,12,31
4395,thedangler,,20,10,6,16
4396,MrHat,,43,7,1,8
4397,tjperkins,,34,1,1,2
4398,BennyGreenberg,,18,1,1,2
4399,lutefisky,,18,25,55,80
4400,chrisrocks,,18,4,2,6
4401,1729,,4,75,104,179
4402,cam2009,,18,88,5,93
4403,markleno,,0,4,12,16
4404,beowulf,,20,79,83,162
4405,Humbert,,13,3,6,9
4406,svemirac,,20,4,3,7
4407,justinweiss,,20,14,7,21
4408,jcurtis34,,32,56,36,92
4409,ampsc2,,0,4,10,14
4410,itsme92,,19,58,67,125
4411,kiriel,,29,427,801,1228
4412,billrobertson42,,20,21,49,70
4413,OriginalSyn,,22,1176,1702,2878
4414,potterzot,,19,4,6,10
4415,butpolandsays,,39,1,1,2
4416,kmdudich,,1,13,40,53
4417,NO_NO_NO,,8,83,135,218
4418,JeremyFlint,,19,4,8,12
4419,ndawson89,,13,24,51,75
4420,werb001,,5,1,1,2
4421,Bleda,,13,1,2,3
4422,ArisOfAlaska,,29,94,38,132
4423,nudgedafudge,,40,6,2,8
4424,layjudge,,13,6,13,19
4425,KarmaReddits,,40,9,18,27
4426,DannyP72,,4,75,115,190
4427,mrim,,20,1,3,4
4428,Clemsanza,,1,4,17,21
4429,toseikai,,13,2,2,4
4430,aithnea,,17,23,7,30
4431,olbermannisadick,,19,1,1,2
4432,blackeyes,,32,382,480,862
4433,i_hate_turtles,,12,5,8,13
4434,thrandur,,5,3,5,8
4435,jberryman,,20,237,343,580
4436,Chev,,31,17,28,45
4437,slackwaresupport,,20,10,10,20
4438,nobahdi,,18,50,66,116
4439,markovich,,39,6,2,8
4440,thrills,,34,108,16,124
4441,dakana,,6,1,1,2
4442,demechman,,23,7,14,21
4443,gregorgede,,18,1,3,4
4444,UnincorporatedSnoCo,,13,66,85,151
4445,Sonarman,,20,117,47,164
4446,wronghead,,7,12,14,26
4447,fatinthemiddle,,43,1,1,2
4448,aero142,,42,9,5,14
4449,i_am_present,,2,1,2,3
4450,justinklin,,31,1,1,2
4451,dangerfingers,,22,4,6,10
4452,gmcbay,,20,29,34,63
4453,27182818284,,32,127,129,256
4454,danfan20,,19,36,23,59
4455,rammeh,,18,1,4,5
4456,sosixteen,,20,5,5,10
4457,gobacktodigg,,0,21,13,34
4458,ButtToucher,,23,1,1,2
4459,londonzoo,,19,726,406,1132
4460,rastafa,,20,1,4,5
4461,defenestrator,,20,132,156,288
4462,jsled,,20,14,13,27
4463,peteyH,,19,303,216,519
4464,unixsuperuser,,8,1,1,2
4465,Semantix,,18,4,5,9
4466,kandimar,,19,1,2,3
4467,MonkeyMachine,,20,8,13,21
4468,Petergibbons,,13,3,1,4
4469,markblei,,0,208,45,253
4470,lkirkw,,13,1,2,3
4471,markstoneman,,13,16,9,25
4472,darkreign,,18,178,196,374
4473,twowordz,,14,48,102,150
4474,yellowmix,,39,45,16,61
4475,cheesingballs,,14,2,2,4
4476,skotski,,31,12,20,32
4477,gaurax,,20,1,2,3
4478,soleus333,,6,7,2,9
4479,googlemaps,,20,2,3,5
4480,zenmasher,,43,32,36,68
4481,Lu-Tze,,19,51,69,120
4482,gidonyto,,0,1,1,2
4483,mulletmang,,42,42,34,76
4484,TwinSigma,,19,25,14,39
4485,elviscc0,,27,4,4,8
4486,Kojach,,18,10,10,20
4487,metacynic,,0,4,5,9
4488,fiddlosopher,,20,1,3,4
4489,johnnywantshismeme,,19,14,63,77
4490,hazridi,,20,1,2,3
4491,VinC,,20,43,51,94
4492,gonzogustav,,13,5,6,11
4493,ialsohaveadobro,,18,10,15,25
4494,netzwerkerin,,20,26,54,80
4495,Keawe12,,18,4,6,10
4496,Jomskylark,,13,28,24,52
4497,mindfvck,,14,46,6,52
4498,ralphc,,20,5,14,19
4499,keenacid,,17,2,1,3
4500,rdanays,,18,6,2,8
4501,pythagoruz,,18,9,20,29
4502,blong,,20,19,9,28
4503,Subdiver,,13,35,23,58
4504,kevlarbaboon,,1,280,220,500
4505,KillerAngel7,,43,228,322,550
4506,jacj,,20,121,175,296
4507,golov,,20,11,18,29
4508,ben_13,,18,1,1,2
4509,Len_Zefflin,,18,3,10,13
4510,liaohaohui,,20,6,7,13
4511,totallyawesome,,22,2,5,7
4512,OscarAlcala,,22,1,1,2
4513,OperativeSix,,42,5,4,9
4514,cartlidge,,20,2,6,8
4515,simplicity,,8,1,3,4
4516,wil2200,,13,770,784,1554
4517,theboone,,42,1,1,2
4518,Oshuma,,10,4,3,7
4519,Deinumite,,22,10,11,21
4520,stopping,,30,8,13,21
4521,mrpickles,,43,9,20,29
4522,anonymousy,,23,2,1,3
4523,bwoodall,,18,13,8,21
4524,DaDibbel,,13,371,903,1274
4525,joannavankovic,,14,1,1,2
4526,botnet,,18,12,23,35
4527,snarkyturtle,,18,125,92,217
4528,ars_moriendi,,0,60,48,108
4529,Holly_Golightly,,13,3,3,6
4530,ap0rnnstar,,0,4,4,8
4531,salpara,,18,147,167,314
4532,coroney,,42,2,2,4
4533,jblangworthy,,20,1,4,5
4534,Menagerie,,1,15,7,22
4535,joesb,,20,158,227,385
4536,sahaskatta,,0,1,1,2
4537,dart_throw,,6,2,1,3
4538,chillmandan,,18,142,166,308
4539,ArtStrom,,32,4,6,10
4540,weasel3d,,13,10,2,12
4541,KingofDerby,,1,37,59,96
4542,dannomac,,30,212,433,645
4543,cannedleech,,1,4,4,8
4544,tronbrain,,32,7,3,10
4545,fzfzfz,,1,67,119,186
4546,Bucketshred,,19,1,11,12
4547,ArabburnvictiM,,28,2,1,3
4548,SorryThereisnoGod,,19,2,2,4
4549,CoffeeandTV,,43,2,3,5
4550,Buddha24,,13,15,24,39
4551,die_asteroid_die,,31,1,1,2
4552,baddog76,,26,1,2,3
4553,ULJarad,,12,286,495,781
4554,mcscandalous,,34,26,1,27
4555,iosef,,30,5,3,8
4556,bonton_sean,,10,4,2,6
4557,troyjmorris,,19,1,4,5
4558,m_733,,39,84,111,195
4559,dawtcalm,,18,6,10,16
4560,rockhandsome,,18,1,12,13
4561,rottingflamingo,,13,2,2,4
4562,lostwolf,,30,11,45,56
4563,ntr0p3,,0,463,773,1236
4564,mmihevc,,34,2,2,4
4565,staxofmax,,9,15,21,36
4566,daemin,,32,91,64,155
4567,groutexpectations,,22,82,122,204
4568,felyduw,,22,8,3,11
4569,dougly,,18,56,92,148
4570,ModernDemagogue,,28,32,29,61
4571,SoPoOneO,,36,114,134,248
4572,Longabow,,20,2,1,3
4573,bit_wise,,9,3,1,4
4574,jimbelk,,29,6,4,10
4575,srilankan,,6,1,3,4
4576,lolhatz,,32,14,21,35
4577,moritsch,,8,1,2,3
4578,voldern,,31,1,2,3
4579,cantitoe,,18,29,41,70
4580,Mantraa,,29,2,2,4
4581,dikanst,,32,1,1,2
4582,pimo74,,20,22,35,57
4583,Harfatum,,12,2,4,6
4584,herorev,,20,17,26,43
4585,Mueritzer,,13,1,2,3
4586,Spazbot,,19,4,2,6
4587,locriology,,32,234,306,540
4588,formerfatguy,,14,3,9,12
4589,SylvanusUrban,,33,4,1,5
4590,boyan100,,19,6,5,11
4591,kathynic,,13,24,2,26
4592,Grapes,,19,33,9,42
4593,swimerman,,13,51,36,87
4594,interknot,,20,10,7,17
4595,ponchoboy,,18,133,159,292
4596,delta4zero,,18,105,195,300
4597,pusherforward,,42,1,5,6
4598,gonzone,,19,15,30,45
4599,cornerbodega,,18,3,4,7
4600,Pluth,,26,41,56,97
4601,croco,,4,3,6,9
4602,waterhammer,,42,1,2,3
4603,Synoptix,,19,175,229,404
4604,thor52879,,18,1,3,4
4605,mattsilv,,18,91,14,105
4606,chockZ,,18,7,8,15
4607,Flys007,,18,2,5,7
4608,salmangz,,11,2,2,4
4609,xwrxwrxwr,,1,3,1,4
4610,thepeopleschoice,,1,1,1,2
4611,gauthier,,18,2,8,10
4612,HumorousRebel,,1,21,32,53
4613,mhud,,32,5,2,7
4614,tsteele93,,14,2903,2195,5098
4615,jabjoe,,20,27,26,53
4616,bnardone,,20,15,16,31
4617,kommandarskye,,5,1,2,3
4618,glymor,,20,1,2,3
4619,sedaak,,43,47,80,127
4620,Wirehed,,18,67,88,155
4621,tomparker1,,12,2,1,3
4622,bananapeel,,1,100,180,280
4623,hongnanhai,,31,815,810,1625
4624,Count_Duccula,,19,2,7,9
4625,BinaryNinja,,32,15,23,38
4626,alsiu86,,14,1,1,2
4627,soporifery,,0,2,3,5
4628,Jarrod,,34,8,14,22
4629,MasterBob,,32,19,28,47
4630,snoaj,,18,8,24,32
4631,TheRiff,,1,398,785,1183
4632,spartanlonewolf,,18,6,9,15
4633,newsoracle,,19,1,1,2
4634,bd01177922,,18,4,10,14
4635,OddQuestionGirl,,1,86,59,145
4636,mharkness7,,33,1,2,3
4637,jfire6,,20,36,6,42
4638,Hupfinsgack,,5,6,6,12
4639,kreygD,,19,3,5,8
4640,sableenees,,18,25,35,60
4641,Parvan,,18,4,5,9
4642,wowthatscool,,31,1,1,2
4643,vsl,,20,160,247,407
4644,Jottor,,12,10,28,38
4645,astrange,,20,128,105,233
4646,graham_king,,43,40,3,43
4647,bobsmithhome,,19,9,37,46
4648,SenecaDoane,,13,73,98,171
4649,Mgapany,,18,43,30,73
4650,Kamekoozie,,18,31,123,154
4651,wu-wei,,13,6,9,15
4652,Godwin_wins,,19,16,13,29
4653,AliLaPointeTexasii,,18,2,3,5
4654,uberjohn,,32,1,1,2
4655,sandking,,20,22,21,43
4656,ncr100,,20,9,19,28
4657,nollem,,13,3,5,8
4658,dwarry,,20,3,3,6
4659,Isvara,,20,284,219,503
4660,rgarf,,9,91,12,103
4661,bijoy,,13,4,1,5
4662,schlag,,13,48,147,195
4663,unjust,,13,54,94,148
4664,michaelscott2,,19,1,1,2
4665,wolface,,0,9,7,16
4666,joshmaker,,31,1,4,5
4667,EnderMB,,20,28,18,46
4668,aspenbaloo,,13,24,63,87
4669,oduska,,18,110,93,203
4670,dmel4483,,31,9,6,15
4671,crankheckler,,20,5,6,11
4672,gIowingsheep,,19,436,53,489
4673,daveos,,13,3,3,6
4674,Cpunks,,32,4,8,12
4675,daguruvjt,,0,1,1,2
4676,fffish,,13,5,23,28
4677,biomedtechnology,,20,10,8,18
4678,suicidaldonut,,43,9,5,14
4679,toolee,,1,5,4,9
4680,covertcracker,,27,10,8,18
4681,Anti-Hippy,,18,23,3,26
4682,Yage2006,,36,7,27,34
4683,technomadic,,1,6,10,16
4684,misinterpreter,,43,2,5,7
4685,pmn8441,,34,152,158,310
4686,andrewry,,22,11,14,25
4687,v8engine,,18,2,1,3
4688,airlung,,16,2,3,5
4689,skipunk,,13,3,3,6
4690,setec_astronomy,,42,15,14,29
4691,mrgrieves,,42,2,2,4
4692,shining_fountain,,18,2,14,16
4693,cdimino,,18,3,6,9
4694,miamibfly,,34,1,1,2
4695,Call_For_Peace,,13,7,5,12
4696,Andrekosumn,,13,2,1,3
4697,JxE,,13,2,6,8
4698,GraphPaper,,19,2,1,3
4699,monkeu,,19,12,25,37
4700,cybernytrix,,20,8,11,19
4701,bobbymcgill,,13,10,1,11
4702,rzm61,,1,61,99,160
4703,nigy,,18,209,298,507
4704,nemof,,29,66,86,152
4705,sisternovena,,41,31,38,69
4706,Digger123,,22,66,97,163
4707,firefly5683,,1,202,137,339
4708,bschroed,,30,1,3,4
4709,asianavenger,,1,6,1,7
4710,boo27,,19,16,24,40
4711,cfvgcfvg,,19,136,150,286
4712,ynyny,,13,1,1,2
4713,bubba_mudd,,43,49,9,58
4714,Joyfuldemise,,22,8,14,22
4715,agentsully,,5,1,3,4
4716,AngelDustnBones,,16,3,6,9
4717,wiuara,,1,1,1,2
4718,GeeYouEye,,19,35,26,61
4719,cashto,,20,53,58,111
4720,fatcatholic,,1,66,91,157
4721,elendur,,18,1,1,2
4722,knexfreak111,,8,2,1,3
4723,pomerpants,,0,6,2,8
4724,BradDoenges,,18,1,1,2
4725,atheken,,20,14,28,42
4726,moredown,,18,21,4,25
4727,bonniejeanne,,1,9,4,13
4728,codeforkjeff,,20,2,1,3
4729,RedditAllMaker,,18,9,2,11
4730,Kiro,,42,7,14,21
4731,pediculus,,18,13,38,51
4732,ghyspran,,35,2,3,5
4733,spook327,,31,3,1,4
4734,jwk147,,22,1,3,4
4735,total_bruce,,8,8,2,10
4736,teamhot,,20,4,10,14
4737,rexo,,18,2,1,3
4738,MattL920,,7,53,81,134
4739,Metalwarrior,,18,29,8,37
4740,HappyEngineer,,14,17,36,53
4741,weemeglet,,5,10,15,25
4742,tthomps,,19,3,4,7
4743,he11odave,,40,5,8,13
4744,in_vitro,,18,13,33,46
4745,CaptainG0705,,18,19,75,94
4746,Masteyan,,20,8,5,13
4747,plinkplonk,,20,27,11,38
4748,test-explorer,,20,1,3,4
4749,dweej1,,1,11,28,39
4750,elusion54,,32,1,1,2
4751,xsidekick409,,18,94,130,224
4752,jstevoh,,28,3,1,4
4753,Rhoomba,,20,305,369,674
4754,airmas,,34,69,2,71
4755,insert_name,,20,7,13,20
4756,guither,,39,1,1,2
4757,Rude_Asshole,,1,14,9,23
4758,glasspenguin,,34,3,10,13
4759,heinrich66,,18,3,5,8
4760,cschaab,,12,5,10,15
4761,babblingdweeb,,19,14,33,47
4762,darkened,,0,242,153,395
4763,flibbertigibbit,,41,21,11,32
4764,seizureboy,,41,8,18,26
4765,Knots,,19,7,2,9
4766,scobro,,42,2,2,4
4767,random_comment,,20,1,1,2
4768,jayrot,,43,14,14,28
4769,ungood,,28,384,542,926
4770,rebelrogue995,,1,84,154,238
4771,pinkpackrat,,5,1,6,7
4772,nothingcool,,13,6,21,27
4773,stw,,32,21,20,41
4774,servertyp,,9,3,3,6
4775,davega7,,1,261,366,627
4776,chihsuanmen,,18,55,54,109
4777,SurrealEstate,,15,55,46,101
4778,dr_deep_sheet,,43,5,4,9
4779,cheenius,,11,3,1,4
4780,timestryder,,0,1,1,2
4781,MrFrankly,,20,102,90,192
4782,pretz,,1,62,114,176
4783,veganroofer,,36,1,1,2
4784,mokiligon,,8,1,1,2
4785,ux11,,5,1,2,3
4786,ThinkBeforeYouDie,,1,53,74,127
4787,xoomac,,42,3,1,4
4788,JoeFuckingSixPack,,0,1,3,4
4789,WhirlingVortex,,29,1081,59,1140
4790,evrae,,31,372,548,920
4791,codahale,,20,17,29,46
4792,MachoManRandySavage,,19,1,1,2
4793,creamyBasil,,18,37,4,41
4794,fivex,,30,2,2,4
4795,neogoblin,,31,21,20,41
4796,brodel2,,30,2,3,5
4797,Psy-Kosh,,29,475,883,1358
4798,jinsing,,34,4,9,13
4799,NewAmericanInsurgent,,1,4,5,9
4800,crimemastergogo,,5,2,4,6
4801,j3ffy,,1,13,3,16
4802,dkinmn,,13,252,376,628
4803,tardmrr,,1,17,14,31
4804,MaximumBob,,22,492,794,1286
4805,wicked82,,13,2,2,4
4806,leadera,,18,6,6,12
4807,erik_goldman,,1,3,3,6
4808,oxryly,,1,23,40,63
4809,yearone,,34,1,1,2
4810,cryforfiji,,32,37,31,68
4811,EDubs83,,5,45,32,77
4812,lucasrfl,,22,13,20,33
4813,boxofrain,,13,429,206,635
4814,wizalt,,18,1,1,2
4815,acey,,42,13,23,36
4816,thebamoor,,31,77,89,166
4817,oohay_email2004,,18,14,3,17
4818,stevepark,,19,2,1,3
4819,Buzz-Killington,,14,1,4,5
4820,quack,,13,503,805,1308
4821,LSDemon,,18,96,58,154
4822,Ibelieveitsbutter,,1,4,3,7
4823,jb3,,20,1,3,4
4824,Kaeinlya,,1,4,10,14
4825,grable,,20,18,35,53
4826,jzamor,,6,1,1,2
4827,bradspangler,,13,1,1,2
4828,qwertython,,18,10,18,28
4829,sigismundo,,43,5,8,13
4830,lazerdave,,4,42,46,88
4831,jeremy_spoken,,13,1,1,2
4832,phr,,20,2,5,7
4833,mikesmithie98,,19,3,4,7
4834,realityone,,19,4,4,8
4835,shamba,,5,11,6,17
4836,franck_B,,8,1,1,2
4837,vandelay,,30,2,3,5
4838,PirateMike,,15,5,9,14
4839,Dax420,,34,780,878,1658
4840,trencher,,20,4,4,8
4841,TheDizzleFoShizzle,,34,275,378,653
4842,jnicklas,,20,3,8,11
4843,Acrimonious,,43,1,6,7
4844,ommadon,,34,702,122,824
4845,bassvandijk,,20,1,2,3
4846,pedo,,18,5,4,9
4847,Canadianchris,,0,4,1,5
4848,katherineC,,5,1,3,4
4849,sanity,,20,108,56,164
4850,bryher1,,34,2,4,6
4851,bartwe,,20,95,113,208
4852,Cameroni,,13,1,4,5
4853,ffejnamhcab,,13,4,6,10
4854,pdecell,,34,1,3,4
4855,hypersonikk,,13,3,6,9
4856,ballagarba,,43,1,2,3
4857,letcha,,19,2,2,4
4858,KingOfFlan,,22,241,329,570
4859,pummer,,0,4,2,6
4860,ThirteenYearsOld,,5,1,1,2
4861,udha,,18,1,6,7
4862,rbackowski,,4,1,2,3
4863,banshee9s,,4,5,4,9
4864,CedricDaniels,,3,1,1,2
4865,lozierj,,22,80,92,172
4866,rossdub,,1,34,31,65
4867,mrz,,20,3,13,16
4868,yakyak,,32,144,53,197
4869,mekanicallyseperated,,18,111,202,313
4870,yutzish,,13,3,7,10
4871,greenwave87,,13,3,4,7
4872,eredhuin,,1,9,22,31
4873,pip3000,,19,49,39,88
4874,dikallman,,29,2,2,4
4875,mizer,,12,2,4,6
4876,gob,,0,37,80,117
4877,K1DUK,,32,15,23,38
4878,soooz,,15,1,1,2
4879,headfire,,14,165,259,424
4880,cdills,,31,55,91,146
4881,ShorttSirket,,42,39,29,68
4882,Shlufi,,31,19,16,35
4883,TWee,,18,5,2,7
4884,UglieJosh,,19,58,77,135
4885,GOJIMAN2012,,1,1,2,3
4886,jelos98,,34,1,1,2
4887,EtherGnat,,4,8,9,17
4888,kaoru77,,19,237,129,366
4889,cov,,29,574,891,1465
4890,Tranced0nline,,42,2,3,5
4891,henriq,,20,15,15,30
4892,ihatetotellyouthis,,22,1,1,2
4893,ff1959,,19,21,70,91
4894,uglypuppy,,1,1,1,2
4895,chemman,,19,8,2,10
4896,chipshot,,0,3,5,8
4897,antimatter3009,,4,26,38,64
4898,ellanana,,19,70,6,76
4899,nullgraph,,36,2,10,12
4900,FiReaNG3L,,42,93,9,102
4901,malibar,,43,3,3,6
4902,juicejuice,,9,1,1,2
4903,nasilyani,,32,1,2,3
4904,bertie_wooster,,0,33,39,72
4905,ehosca,,20,46,33,79
4906,bW9zc2Fk,,17,1,2,3
4907,Jason_Lee,,6,3,8,11
4908,wispygalaxy,,34,1,3,4
4909,wildjimbo,,43,102,16,118
4910,ayu_tsukimiya,,0,6,6,12
4911,delatiz,,13,158,11,169
4912,halcali,,15,1,2,3
4913,robu,,20,2,2,4
4914,zhezhijian,,30,6,5,11
4915,clark_kent,,22,4,6,10
4916,neandertal,,5,108,89,197
4917,anime_wars,,22,16,26,42
4918,protarchus,,1,14,13,27
4919,ThriftRomantic,,18,36,3,39
4920,highonzovirax,,31,16,34,50
4921,willjohnston,,13,693,48,741
4922,texascrow,,7,7,7,14
4923,pizi,,23,2,4,6
4924,pdileepa,,20,11,8,19
4925,Schooley02,,5,4,2,6
4926,sgtslut,,13,1,1,2
4927,nickieblue,,25,1,4,5
4928,w4y,,20,6,6,12
4929,monday,,18,19,50,69
4930,reveller,,0,63,98,161
4931,uselessdegree,,4,7,14,21
4932,ferrel,,17,2,2,4
4933,peteberg,,26,127,19,146
4934,gordigor,,13,5,11,16
4935,parker,,0,17,30,47
4936,hen,,19,153,61,214
4937,phillyLA,,5,97,22,119
4938,barake,,20,16,16,32
4939,ttfkam,,20,9,1,10
4940,HankWilliamsJr,,20,2,4,6
4941,diggensack,,4,1,3,4
4942,therunningcrow,,20,2,5,7
4943,anupakkihal,,19,485,78,563
4944,wow0088,,18,1,1,2
4945,Hume77,,20,2,1,3
4946,Bustachai,,19,3,2,5
4947,PacketScan,,0,61,145,206
4948,jdani,,13,5,11,16
4949,Schmallon,,20,4,6,10
4950,ogrechow,,18,14,9,23
4951,scubasteve377,,31,279,342,621
4952,tyrionlannister,,43,35,74,109
4953,PlatonicPimp,,4,303,496,799
4954,revealeddeception,,4,4,2,6
4955,blank89,,32,34,82,116
4956,aniya,,6,240,192,432
4957,soforth,,12,21,21,42
4958,wright3279,,9,2,1,3
4959,dacount,,13,10,21,31
4960,lordofsealand,,1,7,10,17
4961,idontwanttortfm,,20,15,34,49
4962,tyoungjr2005,,20,2,6,8
4963,ggypsy,,13,17,12,29
4964,SRB,,12,20,21,41
4965,darknyte,,1,10,11,21
4966,Yablan,,10,1,1,2
4967,gray_hat,,43,12,16,28
4968,iamprivate,,1,3,9,12
4969,dabradfo,,3,2,2,4
4970,insipid,,20,47,34,81
4971,mjferring,,10,9,4,13
4972,t1o0m,,6,7,6,13
4973,slickricks,,18,3,2,5
4974,rebolek,,42,30,58,88
4975,RPMiSO,,18,1,2,3
4976,ribsaregood,,18,24,2,26
4977,hamtastico,,0,1,1,2
4978,foolforlove,,21,6,4,10
4979,gawright,,35,5,3,8
4980,FaggyLiberalAss,,20,1,1,2
4981,shadowkeeper,,43,15,4,19
4982,AndTheHeroFai1s,,13,2,7,9
4983,Chryson,,6,20,21,41
4984,Alaric,,20,3,9,12
4985,ghostrunner,,19,4,3,7
4986,eloco,,2,26,29,55
4987,neptuno3,,0,11,15,26
4988,rucumu,,13,2,4,6
4989,eleete,,6,2,4,6
4990,JesusChrist,,32,9,10,19
4991,kablamo,,13,9,11,20
4992,uvaodu,,32,104,38,142
4993,NotPhil,,34,802,91,893
4994,csinser,,32,18,1,19
4995,techmoney,,18,31,41,72
4996,areyouforserious,,22,1,2,3
4997,jonesburg,,19,59,72,131
4998,orioleberd,,27,9,9,18
4999,degustisockpuppet,,20,136,137,273
5000,jimmydean,,18,3,6,9
5001,jerzguy,,32,3,4,7
5002,timewaves,,39,9,10,19
5003,sammysunset,,26,5,11,16
5004,NintendoNut,,19,3,2,5
5005,redditcredit,,1,1,1,2
5006,joejoe33,,6,7,7,14
5007,russelldb,,20,1,1,2
5008,blastradii,,0,66,34,100
5009,ezekiel,,20,73,147,220
5010,motdidr,,39,2,2,4
5011,mfaassen,,20,6,6,12
5012,RandomSuffix,,34,19,20,39
5013,beduinix,,18,9,17,26
5014,Creative_Username,,39,2,1,3
5015,thehigherlife,,1,23,48,71
5016,stevegebsta,,13,2,1,3
5017,name_withheld,,12,5,37,42
5018,toastah,,32,1,4,5
5019,cosmok,,43,2,4,6
5020,terkot,,13,1,3,4
5021,theont7,,34,3,1,4
5022,xyzabcd,,38,1,1,2
5023,kayabek,,20,1,1,2
5024,jcm267,,13,1,1,2
5025,cliffotn,,31,95,102,197
5026,AlSweigart,,20,96,66,162
5027,zombie_jesus,,12,1,3,4
5028,spi131313,,29,24,44,68
5029,mandaya,,5,10,17,27
5030,Mannex,,32,105,185,290
5031,Etropal,,18,29,21,50
5032,ketchuponmyketchup,,0,25,122,147
5033,ike6116,,34,100,106,206
5034,Wrathwilde,,18,82,44,126
5035,ferdinand,,13,374,623,997
5036,gwillyn,,18,15,17,32
5037,oblongski,,1,39,60,99
5038,kasser,,19,8,2,10
5039,dmalouf,,36,1,1,2
5040,psayre23,,0,8,6,14
5041,nkrasney,,13,3,2,5
5042,Eschew_Obfuscation,,20,11,18,29
5043,MacMan25,,13,1,1,2
5044,SAWOOL,,13,19,19,38
5045,JackDupp,,17,28,24,52
5046,corndog4,,19,10,18,28
5047,Nanite,,13,225,349,574
5048,somethinginteresting,,22,43,68,111
5049,RooflerOnTheFid,,19,10,33,43
5050,someguyorother,,42,1,1,2
5051,211_was_my_old_apt,,22,8,17,25
5052,lagerbhoy,,31,3,4,7
5053,Thatbul,,13,65,155,220
5054,stalin,,19,5,9,14
5055,Theantiloquax,,13,1,3,4
5056,br0ck,,14,2,6,8
5057,the_arpanet,,19,5,16,21
5058,henno,,12,6,6,12
5059,wikum,,18,33,21,54
5060,perverted_monk,,13,87,97,184
5061,ucslug,,18,5,12,17
5062,bubbagrub,,1,151,29,180
5063,afbase,,6,28,37,65
5064,archmichael,,34,14,27,41
5065,thegroom09,,18,1,4,5
5066,the_prey,,22,16,34,50
5067,shlinton,,1,26,28,54
5068,Skittilz,,18,21,38,59
5069,giga,,30,88,93,181
5070,Celtic_Toad,,13,5,16,21
5071,PossibleMat,,20,46,19,65
5072,howmuchmore,,30,87,145,232
5073,PongGod,,13,3,5,8
5074,Ateenager,,18,2,1,3
5075,father_of_svantuss,,21,2,1,3
5076,L320Y,,18,72,107,179
5077,eko23,,18,3,6,9
5078,TomOwens,,20,11,13,24
5079,ScrubbingBubbles,,29,1,1,2
5080,jinx81,,20,5,1,6
5081,bodo3000,,32,3,13,16
5082,sonorandragon,,20,3,3,6
5083,codyrioux,,42,6,6,12
5084,Merumeru,,18,3,7,10
5085,Sinusoid,,27,2,6,8
5086,Konradprojects,,13,1,3,4
5087,giunta13,,18,61,106,167
5088,johlstei,,20,9,11,20
5089,nebby,,20,9,12,21
5090,stevan_little,,20,30,26,56
5091,bastard_filling,,31,152,208,360
5092,younkint,,13,89,119,208
5093,vicoesco,,4,4,9,13
5094,megablast,,32,125,199,324
5095,ShardPhoenix,,18,5,5,10
5096,murdervillain,,13,51,2,53
5097,sdbillin,,20,7,8,15
5098,panuta,,43,1,13,14
5099,russellh,,22,188,324,512
5100,edwardkelly,,15,162,178,340
5101,neonnoodle,,8,98,166,264
5102,bobcats_mom,,36,1,1,2
5103,kibitzor,,18,69,105,174
5104,pxlpshr,,43,1,1,2
5105,tamarind,,13,1,7,8
5106,movi,,32,5,11,16
5107,acydlord,,13,8,12,20
5108,andyukguy,,1,32,42,74
5109,cos,,13,952,367,1319
5110,Routerbox,,32,12,21,33
5111,lusophiliac,,34,101,116,217
5112,xCooLMaN,,15,2,4,6
5113,professor_mc,,13,58,88,146
5114,Albuyeh,,1,108,33,141
5115,trevftw,,18,25,3,28
5116,Mobat555,,5,7,23,30
5117,cnildo,,19,1,7,8
5118,finallytalking,,42,2,1,3
5119,jrb,,42,109,186,295
5120,ImAGoddess,,18,1,3,4
5121,SwellJoe,,20,322,504,826
5122,dwchapin,,20,3,3,6
5123,cark,,20,11,9,20
5124,mjaviss,,19,5,6,11
5125,piplaw,,22,6,2,8
5126,bufsabre666,,18,61,136,197
5127,pepegg,,20,5,1,6
5128,dacat,,36,26,19,45
5129,Monkeyget,,20,230,99,329
5130,krartan,,18,7,9,16
5131,depleater,,20,224,357,581
5132,BenHicks,,43,1,1,2
5133,PaiTrakt,,1,60,23,83
5134,mosburger,,10,179,180,359
5135,mattmac1955,,10,3,6,9
5136,niobevulpes,,32,26,48,74
5137,vlcod,,10,126,8,134
5138,lerker,,20,4,2,6
5139,bobfunk,,20,2,4,6
5140,mabd,,19,61,113,174
5141,cafefort,,20,9,7,16
5142,PandemicSoul,,36,26,27,53
5143,workpost,,10,10,30,40
5144,Libcon,,13,14,1,15
5145,degalloman,,20,2,1,3
5146,wave_or_particle,,13,7,8,15
5147,joehoover,,29,1,1,2
5148,tims1979,,1,2,2,4
5149,20cc0,,1,1,7,8
5150,f4nt,,34,13,8,21
5151,ijkl,,20,33,23,56
5152,freddymusic,,0,1,1,2
5153,nimbo,,18,4,4,8
5154,TestForSarcoidosis,,6,1,4,5
5155,faassen,,20,25,39,64
5156,failsaurusrex,,18,8,16,24
5157,AstroZombieDC,,3,29,25,54
5158,Bill_OLiely,,18,5,4,9
5159,ADIDAS247,,1,59,50,109
5160,grubnasty,,0,2,5,7
5161,greenspikefrog,,19,10,38,48
5162,reverselookup,,13,100,183,283
5163,whineypdfuser,,20,4,2,6
5164,Chewbacca69,,18,9,17,26
5165,etty,,19,11,6,17
5166,mgorsuch,,20,20,6,26
5167,bmtri,,13,72,16,88
5168,interrobang,,2,2,2,4
5169,nothingtoseehere,,13,6,6,12
5170,tcgunner90,,13,8,6,14
5171,LazarusDubois,,19,98,143,241
5172,pwnerator,,14,1,2,3
5173,jeolmeun,,32,7,4,11
5174,MercyPolitics,,13,34,2,36
5175,slaizer,,18,60,57,117
5176,visualise,,19,4,5,9
5177,sutts,,20,2,2,4
5178,jonasb,,20,52,24,76
5179,massive_hair,,32,6,7,13
5180,Winkyboy,,0,2,6,8
5181,nemotux,,20,1,3,4
5182,BarrackObama,,22,1,1,2
5183,refreshthis,,22,79,86,165
5184,cloudwolf,,22,1,1,2
5185,niltermini,,13,57,60,117
5186,AAnastasio,,32,1,1,2
5187,tpaine,,13,3,3,6
5188,vanandrew,,19,15,18,33
5189,sbrown123,,20,342,438,780
5190,tozarslan,,34,4,4,8
5191,hotkurva,,20,11,12,23
5192,Kohonen,,18,18,12,30
5193,ialexi,,8,1,1,2
5194,kib,,32,22,16,38
5195,1000Steps,,13,232,346,578
5196,bigbadbrad,,30,7,9,16
5197,nathanaustralia,,32,27,6,33
5198,DrTom,,17,44,52,96
5199,MajorUnrelated,,43,1,3,4
5200,marknunney,,5,1,2,3
5201,OtherPointOfView,,31,23,15,38
5202,klhigg04,,20,1,1,2
5203,naturalethic,,13,24,62,86
5204,Mr_Confused,,42,6,9,15
5205,pbarmasher0,,18,63,23,86
5206,DpThought0,,22,11,14,25
5207,diggin01,,13,5,2,7
5208,amoebius,,31,11,24,35
5209,mummyhazelnut,,43,1,1,2
5210,reedsparks,,0,6,2,8
5211,ut2k4king,,36,10,14,24
5212,TheEnglishLanguage,,43,1,2,3
5213,_Pato,,20,1,3,4
5214,jimosa,,8,4,2,6
5215,clango,,32,101,21,122
5216,RichAromas,,18,13,26,39
5217,Boanerge,,19,6,8,14
5218,bosephus,,3,1,1,2
5219,S2S2S2S2S2,,1,634,265,899
5220,solarsavior,,32,96,137,233
5221,bstadil,,19,202,339,541
5222,W1GG1NS,,1,1,3,4
5223,aelfric,,18,3,9,12
5224,gmick,,10,742,1124,1866
5225,ubiformby,,6,1,1,2
5226,TheRandomGuy,,19,95,12,107
5227,parkerdaniel50,,0,1,1,2
5228,tigerinhouston,,34,2,5,7
5229,qrush,,20,285,5,290
5230,flange,,32,4,5,9
5231,thec,,6,7,10,17
5232,trains11tjc,,18,1,7,8
5233,datura22,,34,51,52,103
5234,busytigger,,19,489,742,1231
5235,david5678,,1,2,2,4
5236,slinky317,,17,438,536,974
5237,ch1ll1ng,,1,12,6,18
5238,gragland,,22,13,10,23
5239,hiimerik,,18,60,49,109
5240,skribe,,19,35,54,89
5241,pencilbox889,,32,4,4,8
5242,tokenbearcub,,11,33,40,73
5243,treets,,13,3,4,7
5244,silentOpen,,29,73,109,182
5245,mgilley,,34,4,9,13
5246,CLorinsky,,34,220,3,223
5247,cmdweb,,0,7,4,11
5248,Jees,,39,6,1,7
5249,aplusbi,,20,37,66,103
5250,djprince,,43,65,2,67
5251,baysiqq,,18,8,12,20
5252,up2nogud247,,19,1,1,2
5253,ramit,,14,10,8,18
5254,Disconnekted,,19,114,231,345
5255,kormgar,,13,5,7,12
5256,sohail_s,,20,5,6,11
5257,wergerver,,13,11,13,24
5258,DAS_DAS,,30,16,1,17
5259,goodbyejim,,20,72,77,149
5260,timbonicus,,18,11,10,21
5261,user5000,,13,8,4,12
5262,eldri,,42,19,17,36
5263,jaybol,,5,1022,127,1149
5264,jlroettger,,3,1,1,2
5265,one_shot_one_liberal,,13,2,1,3
5266,Tobyisspecial,,18,5,3,8
5267,BitterOldMan,,13,1,1,2
5268,scribe9999,,19,32,11,43
5269,RayWest,,1,463,694,1157
5270,magnus911,,32,8,4,12
5271,barichards,,32,29,43,72
5272,hellmarsh,,22,2,2,4
5273,dnp42,,32,21,28,49
5274,redditeering,,13,99,41,140
5275,liberal_one,,13,394,403,797
5276,chiwawamom,,13,42,49,91
5277,ishwarchand,,43,1,2,3
5278,erisdiscordia,,13,31,48,79
5279,craigalms,,1,3,7,10
5280,shd67,,20,22,17,39
5281,pal32,,20,6,6,12
5282,zappo,,19,78,10,88
5283,tarnin,,18,2,5,7
5284,captain_republican,,1,268,296,564
5285,Snappy386,,22,1,3,4
5286,godsgod,,1,1,2,3
5287,geneusutwerk,,31,23,25,48
5288,phoxybetsy,,18,24,4,28
5289,noconfidence,,18,3,3,6
5290,im_bozack,,12,4,6,10
5291,Stopher,,19,206,376,582
5292,christianwaton,,19,1,1,2
5293,maclure,,34,14,1,15
5294,shub,,20,474,687,1161
5295,bbbeans,,18,4,9,13
5296,gstuartj,,18,11,1,12
5297,USA_USuckAss,,32,2,2,4
5298,SinisterS2k,,18,1,1,2
5299,brhunter86,,14,2,1,3
5300,dlsmd,,34,4,5,9
5301,dustyfog,,13,61,11,72
5302,karl_max_is_my_hero,,10,2,2,4
5303,carpediem420,,13,47,26,73
5304,jankoM,,20,1,4,5
5305,alkasettheory,,11,1,1,2
5306,slippery,,20,9,6,15
5307,zombiekraken,,18,14,11,25
5308,harrydude,,19,28,35,63
5309,DestructiveDreaming,,42,86,42,128
5310,gc4life,,18,18,39,57
5311,suroburo,,18,2,3,5
5312,criminy,,1,97,181,278
5313,gth757e,,18,1,5,6
5314,inseptiv,,26,18,20,38
5315,lampiaio,,18,50,40,90
5316,Dirtstar,,4,15,24,39
5317,marilinda,,26,4,1,5
5318,gdmedia,,19,3,1,4
5319,instantdm,,14,52,41,93
5320,mrgordon,,20,3,4,7
5321,rimberry,,19,20,8,28
5322,kwismexer,,18,36,69,105
5323,fortybillion,,20,9,2,11
5324,jpzanetti,,43,202,71,273
5325,typical_american,,43,6,7,13
5326,bad_code,,20,12,12,24
5327,al_islaaaaaaaaaaaaam,,6,4,9,13
5328,gusza,,18,2,1,3
5329,sennii,,43,32,26,58
5330,spreri,,43,43,56,99
5331,Raidion,,32,42,49,91
5332,LostAbbott,,20,5,5,10
5333,davidlwdn,,18,1,8,9
5334,sniggins,,19,2,3,5
5335,syadasti,,29,28,25,53
5336,Sarcasticus,,18,11,6,17
5337,NoDude,,20,2,3,5
5338,xplrr,,32,3,11,14
5339,jackystan,,20,4,3,7
5340,lasvegasgamer,,4,1,2,3
5341,bitslayer,,4,21,25,46
5342,Bobsickle,,43,25,42,67
5343,seuhipocrita,,18,16,1,17
5344,iidestined,,13,4,16,20
5345,Gradius,,42,31,2,33
5346,ZEYTIN22,,18,1,1,2
5347,jasonmacs,,30,82,74,156
5348,zeteo,,19,48,22,70
5349,ztphn,,1,18,22,40
5350,chinger,,38,1,3,4
5351,ashibby86,,1,1,2,3
5352,Deoz,,20,1,1,2
5353,IhaveAIDS,,32,1,1,2
5354,Arawyn,,43,1,2,3
5355,iraq_vet,,4,2,1,3
5356,eclipsedev,,20,10,12,22
5357,p4c,,29,1,3,4
5358,threedian,,39,3,3,6
5359,qwe1234_,,20,1,1,2
5360,qulic68,,18,1,1,2
5361,mordred,,22,13,9,22
5362,academician,,20,105,139,244
5363,killick,,31,61,97,158
5364,spamdefender,,42,554,434,988
5365,graveler,,32,2,5,7
5366,j_johnso,,20,15,21,36
5367,ThirstyEar2,,1,7,6,13
5368,grow4road,,43,13,36,49
5369,jkeele9a,,34,1,1,2
5370,awice,,6,7,4,11
5371,BohmaJenkins,,13,13,10,23
5372,rigga,,40,2,2,4
5373,llm2010,,6,1,2,3
5374,Bigsby,,6,4,6,10
5375,johnw11,,20,1,2,3
5376,AlbinoOrangutan,,13,2,2,4
5377,slyf,,18,69,122,191
5378,Mariani,,20,15,16,31
5379,azzdafff,,1,1,4,5
5380,Stiltskins,,1,4,13,17
5381,C9H13NO3,,43,72,9,81
5382,magus,,2,1,2,3
5383,98493484,,20,1,2,3
5384,sep11insidejob,,1,55,75,130
5385,jvburnes,,20,1,5,6
5386,petdog,,20,3,3,6
5387,shilabula,,31,79,75,154
5388,forumdragon,,31,2,4,6
5389,astrab,,3,1,1,2
5390,FirthOfFifth,,22,1,1,2
5391,encinarus,,22,285,377,662
5392,cti97,,30,3,1,4
5393,maleman,,30,25,23,48
5394,avip,,20,44,47,91
5395,annaswims,,1,18,4,22
5396,puggydug,,18,140,95,235
5397,jamesgreddit,,0,96,122,218
5398,dinky51525,,32,1,2,3
5399,prostoalex,,5,1,2,3
5400,mahill55,,13,27,32,59
5401,paltal,,14,1,1,2
5402,dualboy24,,30,12,6,18
5403,devpopol,,31,1,2,3
5404,letoatreides,,31,36,41,77
5405,Decumanus,,19,26,92,118
5406,jsilvrs,,1,19,6,25
5407,Andareed,,20,99,109,208
5408,todalimitbaby,,32,31,13,44
5409,teambob,,20,46,102,148
5410,badwithnames,,32,5,5,10
5411,kimbokasteniv,,10,10,9,19
5412,tolley,,12,21,4,25
5413,nhuong,,13,3,8,11
5414,twb010,,17,3,8,11
5415,izend,,0,110,78,188
5416,bglodde,,13,207,87,294
5417,__init__,,6,1,1,2
5418,brain3000,,32,1,1,2
5419,RebuildHim,,13,97,40,137
5420,NoSex,,1,226,136,362
5421,jekpopulous,,19,93,2,95
5422,fulmar,,31,58,98,156
5423,madmaxpt,,1,4,17,21
5424,aelron,,18,13,4,17
5425,cyclo,,0,105,15,120
5426,reddit_hates_women,,19,3,11,14
5427,localhorst,,20,277,137,414
5428,ElJabbo,,43,1,1,2
5429,amorangi,,22,20,30,50
5430,bobbincygna,,18,168,199,367
5431,shadowvox,,18,30,24,54
5432,eidetic3d,,32,5,13,18
5433,skyhaseyes,,1,33,1,34
5434,Cousin_Dupree,,1,6,8,14
5435,jc_mizzle,,18,7,9,16
5436,tjic,,19,25,10,35
5437,dystopian,,19,46,49,95
5438,munroe,,30,24,5,29
5439,pathogenix,,20,8,9,17
5440,moxierain,,0,5,13,18
5441,SpencerH99,,42,1,1,2
5442,ctrl_alt_del,,18,1,5,6
5443,kungfoomaster,,14,17,12,29
5444,sunra,,20,3,8,11
5445,sanitz,,20,1,2,3
5446,tiffany43,,18,3,12,15
5447,TigerDelta,,4,3,2,5
5448,nas5755,,19,19,52,71
5449,tenmuses,,18,9,14,23
5450,femol,,20,2,5,7
5451,4rashi,,18,55,59,114
5452,wyoming_1,,18,7,5,12
5453,Apfelkuchen,,30,4,6,10
5454,pyrrhus,,34,9,14,23
5455,hypnopixel,,43,8,35,43
5456,somimi,,31,1,3,4
5457,What_In_Hell,,22,3,2,5
5458,pinkLady80,,30,2,7,9
5459,hethug,,8,2,4,6
5460,PumpkinSeed,,8,4,4,8
5461,m64,,43,2,3,5
5462,Axle,,20,11,10,21
5463,kerbz,,14,2,2,4
5464,BuddyHOL,,1,80,52,132
5465,amttaylor,,19,5,7,12
5466,arabelladragon,,19,4,6,10
5467,scottandrewstevens,,20,3,3,6
5468,myhazeispurple,,32,2,1,3
5469,moogah,,13,71,111,182
5470,jesperht,,20,15,5,20
5471,hopelessromanticwuss,,4,1,1,2
5472,thatrez,,5,21,57,78
5473,rgrasell,,32,3,3,6
5474,username-explainer,,22,1,1,2
5475,bluehatrider,,34,7,9,16
5476,ChicagoMemoria,,10,238,234,472
5477,towlies,,8,10,4,14
5478,tressapos,,26,39,22,61
5479,Langhorne,,1,1,1,2
5480,Sammzor,,1,36,75,111
5481,HelveticaScenario,,20,41,68,109
5482,diziaka,,1,2,1,3
5483,frozenmelon,,30,1,1,2
5484,willbently,,19,5,4,9
5485,sjmooreviking,,18,2,8,10
5486,kiznik,,18,173,234,407
5487,china_rider,,12,1,2,3
5488,avizoa,,31,1,1,2
5489,Ma-aKheru,,18,191,464,655
5490,KennyFulgencio,,4,168,286,454
5491,jezuzgirl,,18,5,1,6
5492,unheeding,,31,157,128,285
5493,Nobodyatall,,32,11,19,30
5494,CIAguy,,19,1,2,3
5495,teebes,,43,2,2,4
5496,tekronis,,20,76,161,237
5497,Wykyd,,3,1,1,2
5498,rrwhite,,11,3,1,4
5499,zcmack,,22,12,20,32
5500,mfp,,20,138,134,272
5501,ercd,,20,7,6,13
5502,spiderbite7,,22,10,12,22
5503,rzn,,1,2,1,3
5504,forceinstall,,1,1,1,2
5505,pinkbean,,19,1,4,5
5506,dezmd,,31,152,224,376
5507,lmfrey,,34,1,3,4
5508,jjjjjjjjjjjjk,,10,1,2,3
5509,BobCFC,,16,6,11,17
5510,freedomgeek,,32,1,2,3
5511,superm0nkey,,6,28,1,29
5512,SecretCommentator,,11,1,1,2
5513,rainbird997,,19,2,1,3
5514,somefool,,18,2,5,7
5515,walruteer,,20,78,71,149
5516,tuckerjohn,,12,3,2,5
5517,vailripper,,31,16,24,40
5518,jophillips,,5,63,2,65
5519,lang_war,,20,6,5,11
5520,nontoxyc,,13,5,5,10
5521,OtisDElevator,,18,2,9,11
5522,shemper,,0,1,1,2
5523,lipservisceral,,19,1,1,2
5524,Luc,,43,57,70,127
5525,dollars-and-skulls,,5,2,3,5
5526,Chlorophil,,20,9,26,35
5527,stoptrackingme,,20,1,2,3
5528,rc79wa,,18,4,9,13
5529,robstercraw,,18,2,4,6
5530,TehMCP,,18,16,32,48
5531,mjs,,20,3,6,9
5532,jack47,,20,103,69,172
5533,poozoodle,,18,12,25,37
5534,wolever,,20,6,6,12
5535,forps,,20,1,1,2
5536,cptnjack,,1,26,18,44
5537,slutbanger,,19,45,5,50
5538,motley2,,20,1,1,2
5539,BHazell,,18,874,29,903
5540,Avrumales,,0,12,7,19
5541,jaxcs,,4,90,152,242
5542,cattleprod,,22,1,2,3
5543,FancyClancy,,13,3,3,6
5544,robert2cane,,18,278,1,279
5545,sigint_bn,,18,28,65,93
5546,anothernut,,8,5,6,11
5547,zboyet,,5,1,3,4
5548,chanster,,1,82,16,98
5549,mitchwright,,18,10,47,57
5550,cc138,,18,2,7,9
5551,swrlyhrly,,19,48,90,138
5552,ChennehCis,,1,1,2,3
5553,nosound,,1,29,13,42
5554,blpatt,,20,1,2,3
5555,likeafox,,1,55,72,127
5556,rugs,,34,18,34,52
5557,nitropumpkin,,32,8,11,19
5558,jpezzznuts,,18,23,16,39
5559,cracki,,20,194,327,521
5560,JoeSick,,10,21,42,63
5561,xwigginx,,31,33,42,75
5562,JeffBuzz,,5,28,7,35
5563,sanampetri,,12,329,8,337
5564,assfloss,,0,1,3,4
5565,TR4CKS,,13,22,6,28
5566,moetwa,,18,507,26,533
5567,ladoladi,,19,1,2,3
5568,gershom45,,34,2,3,5
5569,ParadoxRoom,,13,2,3,5
5570,johnnydough,,18,29,31,60
5571,nccwarp9,,20,10,21,31
5572,Davec_15,,25,1,1,2
5573,MoreKindUS,,13,103,79,182
5574,sjbach,,20,43,14,57
5575,street-knowledge,,30,63,120,183
5576,PlutoISaPlanet,,34,94,130,224
5577,bob_gnarley,,16,2,1,3
5578,TuttiFrutti,,22,92,173,265
5579,pjbarnoy,,18,14,19,33
5580,severedbrain,,32,2,2,4
5581,Jillish,,18,12,13,25
5582,daft_monk,,4,76,129,205
5583,rogersm,,31,10,14,24
5584,shanker,,22,1,2,3
5585,undecidedname,,13,2,1,3
5586,texasbuddha,,1,4,2,6
5587,redpill911,,13,2,1,3
5588,professorOak,,19,21,8,29
5589,vints1,,13,65,74,139
5590,leddit666,,19,3,15,18
5591,crepia400,,18,1,1,2
5592,letoti,,32,194,66,260
5593,Cid_X,,0,2,1,3
5594,pref,,15,141,71,212
5595,wakeupsheeeple,,34,2,1,3
5596,areyoukiddingme,,19,1,1,2
5597,pufuwozu,,20,1,1,2
5598,pahina1,,18,13,22,35
5599,betrayedamericanvet,,19,21,63,84
5600,haywire9000,,13,176,182,358
5601,Kijamon,,18,172,182,354
5602,thelimabeanking,,19,90,90,180
5603,VerticalWindows,,7,5,7,12
5604,crazedover1111,,22,56,50,106
5605,edstace,,13,6,1,7
5606,matthiasl,,12,3,2,5
5607,stekkit,,34,1,3,4
5608,svat,,20,1,1,2
5609,hellobot,,43,11,14,25
5610,paulrbrown,,20,12,22,34
5611,scaz7,,13,2,15,17
5612,AlfHimself,,12,13,19,32
5613,MrTulip,,1,108,150,258
5614,Brachinus,,18,63,20,83
5615,SoWhatYoureSayingIs,,19,32,46,78
5616,erudition,,13,19,44,63
5617,elustran,,29,130,211,341
5618,ntrifunovic,,20,8,13,21
5619,tripcomputer,,19,6,5,11
5620,gassit,,1,86,56,142
5621,council,,4,1,4,5
5622,dfreir1,,13,22,7,29
5623,obytorno,,5,1,2,3
5624,PSUBreno,,18,38,49,87
5625,janeair,,19,26,5,31
5626,supremesonic,,42,81,20,101
5627,kalphegor,,22,17,27,44
5628,sentienceISi,,13,28,21,49
5629,jello_b,,22,128,104,232
5630,philosophize,,32,53,1,54
5631,Tigrael,,18,57,94,151
5632,jpfed,,20,88,120,208
5633,phutro,,18,5,16,21
5634,kerwinste,,42,197,20,217
5635,Scarker,,1,1498,1073,2571
5636,samtregar,,20,10,13,23
5637,inthewater,,13,124,110,234
5638,DeviousOne,,10,45,44,89
5639,volcano420,,18,6,7,13
5640,Brincuckoo,,0,1,1,2
5641,CheeseBurgerInACan,,32,5,7,12
5642,sjain,,21,11,23,34
5643,bigday,,43,1,1,2
5644,danecookfan,,18,11,11,22
5645,glokoe,,43,2,2,4
5646,praestovito,,13,191,345,536
5647,jippiejee,,41,1,11,12
5648,annevk,,20,4,3,7
5649,bwanab,,20,19,34,53
5650,maing,,13,246,9,255
5651,tinhat,,43,311,691,1002
5652,reddit_clone,,20,34,50,84
5653,feedmec00kies,,1,86,111,197
5654,spanishjonny,,19,10,14,24
5655,wwcory,,18,14,37,51
5656,abelsson,,32,23,11,34
5657,killermathilda,,19,2,6,8
5658,vanislander,,19,33,80,113
5659,greyamal,,19,1,2,3
5660,Foozie,,31,1,1,2
5661,Ummagumma,,0,45,64,109
5662,skullheadbonyhands,,1,1,1,2
5663,pamlyn,,34,1,1,2
5664,dlgtho,,20,4,6,10
5665,indylarry,,20,1,2,3
5666,Buzz_Light,,6,4,9,13
5667,mchoward,,42,23,9,32
5668,ultrafusion,,13,6,16,22
5669,beatles910,,42,6,5,11
5670,philmoskowitz,,19,227,418,645
5671,shervster,,14,2,5,7
5672,mackpayson,,12,23,94,117
5673,bboarder12_,,22,23,34,57
5674,CaspianX2,,13,378,472,850
5675,brucehoult,,20,39,57,96
5676,coda,,20,6,1,7
5677,judofyr,,20,77,70,147
5678,RSNV,,20,6,1,7
5679,snth,,40,1,1,2
5680,rattenmaus,,31,94,162,256
5681,houstonray,,13,1,1,2
5682,babblingpoet,,19,752,158,910
5683,familyguy,,13,4,1,5
5684,trengbu,,43,20,28,48
5685,aoper,,1,56,103,159
5686,ANSICL,,0,218,201,419
5687,crazy_chris,,20,6,8,14
5688,Soesoe,,29,40,27,67
5689,I-earned-that-money,,6,1,1,2
5690,maky29,,18,14,3,17
5691,lionheart,,19,41,9,50
5692,melanarchy,,13,5,3,8
5693,jason007,,29,1,1,2
5694,yoyank34,,43,1,2,3
5695,ohemgee,,39,8,5,13
5696,pronto185,,18,33,21,54
5697,Gary_Burke,,10,1,1,2
5698,Swan_Writes,,32,150,313,463
5699,owlmanatt,,4,214,253,467
5700,hectorguerra,,18,11,13,24
5701,mawdsquad,,19,2,2,4
5702,0maha,,12,9,10,19
5703,bdogm,,34,7,19,26
5704,JQT,,13,66,52,118
5705,playdead,,14,1,2,3
5706,evilpego,,20,2,4,6
5707,phlosys,,13,1,1,2
5708,blindscouse,,13,1,2,3
5709,ClintPhelps,,18,7,18,25
5710,BustaCsuk,,31,2,2,4
5711,tiffanychloe,,18,1,6,7
5712,rodditor,,7,1,2,3
5713,dudenell,,18,38,71,109
5714,Matr1xAgent,,13,2,3,5
5715,PinkEye,,38,1,3,4
5716,jennicamorel,,1,554,511,1065
5717,machim,,13,5,3,8
5718,JollyGreens,,32,3,11,14
5719,matthias_georgi,,20,24,33,57
5720,jicima71,,13,1,2,3
5721,joefritz,,1,3,10,13
5722,shazzmak,,5,6,15,21
5723,justicewalks,,32,2,2,4
5724,IlyaM,,20,2,1,3
5725,ndiin,,20,93,200,293
5726,markayler,,19,8,5,13
5727,pandadude,,13,4,1,5
5728,cursor,,43,33,1,34
5729,hazri,,8,12,6,18
5730,rhutchison,,5,5,3,8
5731,ChristianAAJ,,18,2,3,5
5732,johnptg,,13,9,14,23
5733,DaiTengu,,0,2,2,4
5734,avacadojessica,,5,1,2,3
5735,Joshsmac,,32,1,1,2
5736,jumbox,,19,54,79,133
5737,ccx,,18,1,1,2
5738,HotHead,,31,7,3,10
5739,LeviTheSmith,,22,2,1,3
5740,sakipooh,,13,7,22,29
5741,praptak,,20,27,40,67
5742,teadrinker,,31,287,392,679
5743,apogeerstarr,,10,1,4,5
5744,millerlogic,,20,4,8,12
5745,gravaton,,31,14,6,20
5746,mikelgan,,6,18,2,20
5747,freakie,,32,6,7,13
5748,deblock306,,13,1,2,3
5749,zecg,,20,251,276,527
5750,dhl,,16,1,2,3
5751,kegie,,20,5,7,12
5752,ABA477,,19,1,2,3
5753,didnthaveachoice,,10,5,4,9
5754,dchestnykh,,20,69,51,120
5755,needsmorecoffee,,43,114,22,136
5756,hyperbolic,,38,401,535,936
5757,Nakken,,18,19,78,97
5758,stevovee,,42,3,1,4
5759,NickVenture,,13,41,53,94
5760,LordHumongous,,20,19,25,44
5761,Abovethelaw,,32,2,2,4
5762,powerfulninja,,18,13,5,18
5763,Reddit_Admin,,13,2,1,3
5764,petrichor,,1,18,8,26
5765,GUBBED_AGAIN,,18,17,13,30
5766,NorthernLights,,18,1317,1,1318
5767,Erator,,36,7,15,22
5768,OneArmJack,,1,67,26,93
5769,jjj_nnn_jjj,,8,1,1,2
5770,fifitrixiebelle,,13,1,2,3
5771,mconrace,,0,9,22,31
5772,chocosebuenos,,19,15,22,37
5773,jsample2012,,1,3,17,20
5774,papalmonkey,,13,20,16,36
5775,VisVirtusque,,5,223,179,402
5776,dothebackstab,,10,1,1,2
5777,desqjockey,,0,64,133,197
5778,wellhellothere,,31,5,5,10
5779,ajturner,,20,2,1,3
5780,rokusan,,39,69,94,163
5781,mantasradzas,,19,7,5,12
5782,pseudonymous,,18,35,23,58
5783,scrimsims,,43,5,9,14
5784,petahi,,20,69,22,91
5785,poutine,,4,24,32,56
5786,khslinky,,20,1,1,2
5787,_MrBabyMan_,,22,1,1,2
5788,hyperizer,,5,3,2,5
5789,paulite,,19,1,2,3
5790,babesh,,19,4,8,12
5791,emarus,,43,69,122,191
5792,chalengr,,20,7,5,12
5793,foxxyb069,,33,1,2,3
5794,tpearl,,13,12,7,19
5795,pySSK,,30,14,11,25
5796,NoMerican,,31,6,6,12
5797,toconnell,,20,2,2,4
5798,Araneidae,,20,2,10,12
5799,vilkacis,,13,3,2,5
5800,Browzer,,9,257,155,412
5801,Jantar,,0,310,131,441
5802,EvilPigeon,,12,376,660,1036
5803,paul57,,34,2,2,4
5804,zspecs,,13,26,6,32
5805,mikicg,,42,185,11,196
5806,rotty81,,20,5,7,12
5807,sundiverdb,,13,4,3,7
5808,jcsickz,,0,6,3,9
5809,emilyq,,32,3,5,8
5810,jrembold,,32,1,2,3
5811,reenigne,,6,45,63,108
5812,steilpass,,20,1,1,2
5813,runamok,,31,129,180,309
5814,hueyplong,,14,7,19,26
5815,ubuwaits,,14,1,3,4
5816,spinchange,,31,285,253,538
5817,somebritishdude,,8,1,2,3
5818,dwastchak,,1,1,3,4
5819,Glominator,,13,4,1,5
5820,bokumo,,0,11,3,14
5821,zemlyanin,,20,10,6,16
5822,rush378,,14,1,4,5
5823,LiberalHippies3,,19,19,37,56
5824,EtherDais,,13,40,99,139
5825,tecopa03,,21,19,44,63
5826,thisisntmyrealacount,,1,8,1,9
5827,yoodle,,34,23,52,75
5828,blindbug,,43,83,89,172
5829,joebloggs2k8,,11,3,1,4
5830,fserb,,1,4,2,6
5831,patcito,,20,211,230,441
5832,israelite,,4,4,1,5
5833,Busybyeski,,22,271,490,761
5834,neoarch,,13,1,1,2
5835,sazj,,20,1,1,2
5836,neocarty,,22,6,10,16
5837,shatteredmindofc,,11,2,1,3
5838,jbrein1,,18,6,7,13
5839,Dr_Cane_Toad,,34,41,21,62
5840,Lancer383,,1,49,55,104
5841,mik3,,13,21,28,49
5842,aparrotchick,,13,2,3,5
5843,AtomicFireball,,8,1,3,4
5844,nabiki87,,1,58,52,110
5845,bradjward,,39,1,1,2
5846,peridyn,,13,312,226,538
5847,semirami,,29,1,3,4
5848,ReverendJWright,,31,2,10,12
5849,notacake,,1,2,1,3
5850,Christopher_Robin,,19,1,1,2
5851,abbynormal1,,18,84,1,85
5852,mashei,,18,16,20,36
5853,thecasbah45,,13,119,18,137
5854,Nexnecis,,31,5,9,14
5855,whatevrmn,,30,19,20,39
5856,howlingman,,1,12,7,19
5857,jtan,,29,11,13,24
5858,redditeon,,19,42,114,156
5859,NDND,,18,14,7,21
5860,Rodrush62,,1,1,1,2
5861,Alexstrandberg,,13,3,1,4
5862,Wideroe89,,18,11,20,31
5863,YesMugatu,,18,2,2,4
5864,JRR_TOLKEIN,,5,1,2,3
5865,mongrelized,,13,8,8,16
5866,chicofaraby,,13,597,629,1226
5867,Jerph,,32,9,23,32
5868,jimmywanger,,34,4,8,12
5869,ichiban,,31,2,3,5
5870,kryptonik,,29,2,2,4
5871,MyBigRed,,18,52,69,121
5872,Paperclip1,,34,130,177,307
5873,greebus,,29,1,1,2
5874,tlf,,4,3,4,7
5875,metasonix,,29,3,3,6
5876,mengland,,18,7,6,13
5877,grrranpdaaa,,31,61,78,139
5878,jerms4649,,32,2,2,4
5879,nitrousconsumed,,19,29,27,56
5880,reddit_sucks,,19,17,12,29
5881,sysmgr,,20,1,1,2
5882,iqtrm,,18,13,22,35
5883,kevbruner,,20,2,2,4
5884,FlyingUndeadSheep,,1,147,168,315
5885,kwirky,,34,250,181,431
5886,mub,,20,4,9,13
5887,Octal040,,13,7,17,24
5888,sapphire,,20,4,5,9
5889,repairman99,,19,30,1,31
5890,MonkeyAsMan,,13,63,27,90
5891,realstevejobs,,20,7,8,15
5892,yurigoul,,12,1,5,6
5893,tmalsburg2,,4,15,2,17
5894,dirtymatt,,31,10,16,26
5895,Illmitch,,18,21,20,41
5896,Geebe392,,13,250,402,652
5897,cracksmoker,,18,10,7,17
5898,ryanissuper,,19,405,577,982
5899,snowmakerme,,19,1,2,3
5900,star_boy,,15,188,276,464
5901,wwasabi,,35,33,63,96
5902,zenosrevenge,,12,78,152,230
5903,tychobrailleur,,43,2,1,3
5904,wash77,,29,3,5,8
5905,fourty_two,,22,1,2,3
5906,ggduarte,,6,5,8,13
5907,karmathestrange,,0,11,27,38
5908,Aiurtime,,19,74,97,171
5909,ouzin,,1,62,60,122
5910,codepoet42,,29,93,125,218
5911,katoninetales,,1,741,1300,2041
5912,philh,,20,76,101,177
5913,totallynate,,19,39,49,88
5914,dwadwad,,18,8,7,15
5915,gONZObLISS,,13,1,2,3
5916,szano,,18,2,3,5
5917,pastagod,,19,8,4,12
5918,Whambulance,,4,2,1,3
5919,jl98,,8,3,4,7
5920,doliner,,1,12,4,16
5921,oracleofmist,,31,5,9,14
5922,johncapello,,13,56,15,71
5923,E3K,,27,299,371,670
5924,THIS_BE_PAUL_REVERE,,20,14,6,20
5925,damnhippy,,42,4,6,10
5926,karmais4retards08012,,19,3,15,18
5927,AlanCrowe,,20,184,292,476
5928,mokshjuneja,,13,1,1,2
5929,fightingirish,,22,12,14,26
5930,bdrydyk,,22,15,4,19
5931,KBestOliver,,1,26,1,27
5932,Sarm,,0,513,550,1063
5933,blax,,19,84,67,151
5934,ultimatt42,,42,436,621,1057
5935,HarnessItAll,,43,3,3,6
5936,2ndrateidiot,,43,5,9,14
5937,wigglywonk,,8,4,6,10
5938,rubentuben,,19,57,73,130
5939,yellowfellow,,43,1,1,2
5940,eyeofthestorm,,30,144,2,146
5941,nephesh,,20,18,19,37
5942,globe,,5,4,1,5
5943,808140,,20,258,296,554
5944,jeeebus,,4,75,82,157
5945,theplanetsaturn,,4,35,63,98
5946,jakewertz,,19,4,1,5
5947,ZachsMind,,18,5,19,24
5948,PaulLev,,13,42,5,47
5949,KittyAntonik,,19,2,1,3
5950,ZainA,,31,43,8,51
5951,GoodDogLefty,,22,3,2,5
5952,thetodd007,,13,4,5,9
5953,ghost_grl,,1,18,13,31
5954,thomaspajamas,,22,1,4,5
5955,felton,,19,4,1,5
5956,directtulip,,5,53,5,58
5957,sadie8686,,13,8,13,21
5958,arcycola,,6,5,6,11
5959,xitshsif,,20,62,86,148
5960,Denihilist,,18,18,39,57
5961,joeyconrad,,20,8,8,16
5962,nosocialism,,8,1,1,2
5963,esparza74,,19,1409,651,2060
5964,lhjmq,,34,27,22,49
5965,Robdontplay,,31,1,1,2
5966,thereticent,,19,55,7,62
5967,kokberg,,13,38,84,122
5968,saltedwyfe,,13,35,1,36
5969,Supposably,,18,47,65,112
5970,blastano,,17,1,1,2
5971,Ford-Prefect,,21,2,1,3
5972,fatllama,,13,1,1,2
5973,schroefoe,,43,90,50,140
5974,Captain_Cynical,,29,1,2,3
5975,roddy1369,,26,1,1,2
5976,JuniorKane,,19,2,3,5
5977,airbeck,,6,6,8,14
5978,cubeeggs,,20,40,38,78
5979,Miss_Cleo,,32,15,17,32
5980,Dav-id,,4,4,2,6
5981,iloled,,42,30,82,112
5982,frankness,,20,6,7,13
5983,babytomato,,18,4,1,5
5984,paul4pres,,34,3,8,11
5985,thomie,,32,1,2,3
5986,BaudiIROCZ,,32,51,10,61
5987,typography_nazi,,43,1,1,2
5988,spdyvkng,,19,2,1,3
5989,Jewjr,,19,69,56,125
5990,mysterx,,0,77,14,91
5991,smarthustlersdotcom,,19,1,3,4
5992,Callero,,33,1,3,4
5993,randarchy,,5,24,61,85
5994,SoCo_cpp,,32,6,2,8
5995,klemoyne,,1,23,14,37
5996,2il,,22,1,1,2
5997,imwithmaroon,,20,1,1,2
5998,yogisfunhouse,,20,1,1,2
5999,kuruvilj,,4,1,1,2
6000,snorp,,31,7,4,11
6001,bitspace,,19,118,144,262
6002,ithika,,20,238,362,600
6003,roerd,,20,83,107,190
6004,problemwiththemoon,,6,24,29,53
6005,falmeshon,,19,9,18,27
6006,shallit,,43,37,5,42
6007,SerialCrusher,,19,3,2,5
6008,Bizdorph,,4,9,13,22
6009,JWill628,,32,25,1,26
6010,rporter,,19,3,6,9
6011,SwampYankee,,5,2,1,3
6012,WinstonsMyth,,19,2,2,4
6013,sfnick,,12,2,2,4
6014,LukeZet,,18,1,1,2
6015,theone777,,18,1,1,2
6016,nerevar,,19,32,31,63
6017,technodawg,,19,58,51,109
6018,sk33t,,1,19,15,34
6019,missbossy,,9,1,2,3
6020,nimblerabit,,15,1,4,5
6021,paperbag01,,3,21,1,22
6022,lemination,,42,5,2,7
6023,antidense,,32,235,412,647
6024,SwiftyLeZar,,8,9,7,16
6025,sajb,,0,3,15,18
6026,SavageJeph,,32,11,28,39
6027,PurifyYourMind,,8,5,3,8
6028,lorg,,20,13,5,18
6029,shortarmed,,43,72,113,185
6030,sircrowbar,,1,19,35,54
6031,Magee_MC,,18,3,2,5
6032,Flickabus,,43,10,7,17
6033,giodude,,19,338,98,436
6034,kavabean,,31,7,3,10
6035,shiftyness,,31,80,73,153
6036,THN,,1,6,5,11
6037,lloydreddit,,13,3,5,8
6038,patrickjpatten,,31,26,12,38
6039,scotty2012,,6,4,3,7
6040,somnambulant,,4,6,2,8
6041,Popeyecon,,5,1,1,2
6042,WB41590,,13,1,2,3
6043,anonibird,,30,4,1,5
6044,bdelgado,,18,142,265,407
6045,felixkunze,,15,2,1,3
6046,soupslop,,18,10,15,25
6047,zzatz,,31,31,51,82
6048,Florb,,13,1,1,2
6049,shuaz,,30,366,607,973
6050,ardent,,12,12,5,17
6051,ugmold,,16,2,3,5
6052,natezomby,,22,3,10,13
6053,ryegye24,,18,2,4,6
6054,popqva,,34,1,1,2
6055,anon1999,,20,3,2,5
6056,NaviBlueShoes,,32,6,7,13
6057,thecompletegeek,,22,235,269,504
6058,BlueRose03,,3,11,17,28
6059,Irwick,,6,2,1,3
6060,ReKast,,19,2,13,15
6061,vegard,,14,1,3,4
6062,ShadowCaster,,20,1,1,2
6063,marvinisgay,,19,19,44,63
6064,mattw,,20,2,4,6
6065,bdude,,19,91,51,142
6066,tsm11,,43,2,2,4
6067,spocksbrain,,1,15,11,26
6068,BaconPump,,31,2,3,5
6069,Damn_Straight,,22,1,4,5
6070,Stellato21,,19,91,302,393
6071,aestus,,18,11,19,30
6072,quietsushishh,,18,1,4,5
6073,Transmetropolitan,,32,44,98,142
6074,Kenji_waterloo,,43,2,5,7
6075,delirium1086,,31,22,41,63
6076,ibking,,1,46,43,89
6077,frankrizzo83,,19,4,2,6
6078,legatoz,,20,14,1,15
6079,liquidhot,,18,4,5,9
6080,thakadu,,19,6,3,9
6081,flaubert,,22,64,68,132
6082,astrodust,,34,2,2,4
6083,Fazookus,,13,427,1125,1552
6084,TaserLite,,19,16,12,28
6085,billers311,,1,17,6,23
6086,drewhenson,,1,93,143,236
6087,chrispoole,,20,42,41,83
6088,ignare,,1,3,7,10
6089,300zedex,,42,349,242,591
6090,mallotrope,,31,17,15,32
6091,shazmak,,5,3,7,10
6092,fakelogin,,31,10,24,34
6093,uncia,,19,121,160,281
6094,Double-Z,,18,10,19,29
6095,rabeidoh,,5,72,26,98
6096,nouns,,32,83,203,286
6097,bruiser,,15,7,6,13
6098,HeIsMcSAME,,13,139,92,231
6099,rofld,,1,27,36,63
6100,uberdude197,,26,3,8,11
6101,remccain,,14,166,288,454
6102,Rudolpho_Guliano,,20,1,1,2
6103,spike,,19,155,86,241
6104,slbsoftware,,20,13,7,20
6105,redditloggy,,30,1,2,3
6106,vikhound,,18,85,49,134
6107,slaney,,34,1,3,4
6108,umrgregg,,1,273,415,688
6109,Tinman67,,14,5,3,8
6110,gwenpen62,,19,1,3,4
6111,tehsuq,,13,42,88,130
6112,emindaer,,43,11,17,28
6113,fuoobar,,14,1,1,2
6114,ganders,,0,8,12,20
6115,blue-boy,,21,5,7,12
6116,toft,,20,4,3,7
6117,DrFrost501,,8,24,8,32
6118,belm0,,19,42,7,49
6119,kalishinko,,13,141,37,178
6120,kmichaelwriter,,34,1,2,3
6121,thrthr,,20,40,6,46
6122,ADAP2K,,13,533,133,666
6123,khrushchev,,18,7,9,16
6124,thinkcomp,,12,3,1,4
6125,misternovember,,23,18,24,42
6126,SenatorTedStevens,,13,9,18,27
6127,Queue29,,20,52,48,100
6128,ghettoimp,,20,1,2,3
6129,w00tw00t,,13,1,6,7
6130,knappster99,,32,1,2,3
6131,MikeAwkenbauls,,27,1,1,2
6132,FcukingCracker,,19,8,26,34
6133,SergeantPepper,,20,1,2,3
6134,mkull,,19,13,14,27
6135,ancientweird,,1,3,23,26
6136,Griselda_Blanco,,13,20,37,57
6137,nomp,,43,28,4,32
6138,Jered,,10,1,1,2
6139,jmar777,,20,4,6,10
6140,flano1,,3,1,2,3
6141,Psalm,,31,33,44,77
6142,TheMightyDane,,18,6,13,19
6143,stop08,,13,1,1,2
6144,origamete,,17,3,3,6
6145,carlosmiller,,13,94,7,101
6146,Ihategeeks,,13,213,431,644
6147,SophieFatale,,22,4,4,8
6148,Toadus,,39,7,1,8
6149,Jonathan_Swift,,43,1,2,3
6150,OdinYggdrasil,,42,3,7,10
6151,srussian,,5,29,3,32
6152,bgoody,,13,11,4,15
6153,wheat,,31,6,11,17
6154,lahayshababyblue,,25,3,1,4
6155,gcampeau,,18,1,5,6
6156,mariosavio,,19,1,1,2
6157,tooneartoofar,,18,25,19,44
6158,dgreensp,,20,85,95,180
6159,justreddit00,,19,2,2,4
6160,jklabo,,20,386,86,472
6161,Rodelero2,,13,9,32,41
6162,africaninformer,,19,38,1,39
6163,cozmonut,,29,13,47,60
6164,nclester,,13,3,4,7
6165,SirBob1701,,20,3,8,11
6166,vishenml,,19,90,1,91
6167,SkipHead,,43,2,3,5
6168,Bery_Logo,,19,7,1,8
6169,oscar202000,,1,1,4,5
6170,strokerlinx,,0,1,3,4
6171,keepinithamsta,,4,9,17,26
6172,proshorts,,13,11,6,17
6173,ChemoThatIsCuring,,43,6,5,11
6174,lurkerr,,20,17,20,37
6175,Javbw,,22,234,407,641
6176,a_9th_circuit_judge,,13,3,6,9
6177,SimplyRy,,5,4,4,8
6178,w0lfh0und,,5,87,14,101
6179,deltree,,11,4,3,7
6180,MindOps,,14,3,1,4
6181,hanjeer,,18,4,5,9
6182,syrq,,4,19,13,32
6183,matblack,,43,1,1,2
6184,mr-oblivious,,18,129,69,198
6185,xgkx,,13,9,36,45
6186,Blindweb,,3,10,9,19
6187,OniTan,,0,5,3,8
6188,veritas23,,19,24,31,55
6189,ranthony24,,12,97,34,131
6190,TheCheezCake,,18,47,71,118
6191,joseph,,20,12,19,31
6192,grumpygorilla,,23,2,3,5
6193,Kamiwill,,43,2,2,4
6194,NFGman,,32,1,3,4
6195,jaffarabdul,,20,1,5,6
6196,FreeTibet,,31,9,15,24
6197,fuzzykitten,,19,14,14,28
6198,DrStrabismus,,22,95,69,164
6199,Rippin_Kitten,,18,49,1,50
6200,Jakomako,,1,21,21,42
6201,SoggySock,,19,14,22,36
6202,ianb,,20,1,4,5
6203,Sporknight,,41,1,2,3
6204,jozxyqk,,43,4,5,9
6205,ChineseFucktard,,15,1,1,2
6206,ForcedToAnonymity,,22,3,1,4
6207,watsoninc,,5,29,6,35
6208,orduz,,32,1,3,4
6209,jone,,20,3,4,7
6210,stackcats,,6,1,1,2
6211,OGstackadolla,,18,163,240,403
6212,Savant7,,22,2,1,3
6213,keymaker1954,,13,4,9,13
6214,jmchez,,0,1080,12,1092
6215,JdoubleE5000,,18,1,4,5
6216,mattgrommes,,20,4,1,5
6217,ChefQuix,,13,17,7,24
6218,cjnkns,,32,58,104,162
6219,kalashnikov,,19,6,9,15
6220,gravis27,,19,4,2,6
6221,Poltras,,31,4,7,11
6222,tingham,,42,2,2,4
6223,edunewz,,5,1,3,4
6224,secretchimp,,18,118,256,374
6225,JohnBender,,42,8,2,10
6226,kinglouis,,29,1,1,2
6227,randomrandomwoo,,18,2,9,11
6228,scotishstriker,,18,2,7,9
6229,zenweight,,29,1,2,3
6230,overacid,,34,1,3,4
6231,wh0r4cl3,,19,33,53,86
6232,isellchickens,,22,11,3,14
6233,Vernacularry,,13,139,66,205
6234,PikaKyri,,1,30,59,89
6235,911wasa_airplane_job,,41,2,4,6
6236,cthru,,8,2,7,9
6237,DirtySouth,,19,26,47,73
6238,spaknasaurus,,14,2,1,3
6239,hpartymarty,,19,3,2,5
6240,kogk,,18,1,1,2
6241,GorillaSushi,,18,4,2,6
6242,runnig,,20,3,1,4
6243,fugu_v,,0,4,1,5
6244,Gouranga,,1,79,129,208
6245,brandonmeek,,0,1,4,5
6246,a-zwei,,6,1,2,3
6247,FasTandFuriouS37,,34,6,4,10
6248,kaemaril,,18,18,25,43
6249,brainnovate,,5,15,14,29
6250,ifnotme,,5,540,76,616
6251,socalsamba,,2,647,15,662
6252,burnnnt,,22,5,1,6
6253,mildavw,,20,4,3,7
6254,RickAstIey,,20,5,2,7
6255,Sottilde,,1,26,30,56
6256,scoot87,,1,8,8,16
6257,recoletta01,,19,11,12,23
6258,Kutchi,,5,78,9,87
6259,stikeymo,,6,34,42,76
6260,lectrik,,13,9,18,27
6261,jfedor,,20,253,207,460
6262,jayoinoz,,21,1,2,3
6263,mu22le,,6,2,1,3
6264,IanBrandt,,19,3,1,4
6265,kareem,,0,1,3,4
6266,Markademus,,30,7,6,13
6267,NewsCat,,13,69,3,72
6268,rr1899,,10,3,3,6
6269,gtapro91,,19,16,56,72
6270,lazybychoice,,18,14,3,17
6271,genpeckem,,43,1,1,2
6272,lenolium,,20,6,10,16
6273,tlrobinson,,20,118,190,308
6274,Indeme,,39,43,20,63
6275,hotdogburrito,,18,2,7,9
6276,zen_tm,,32,12,9,21
6277,GAPit,,13,1,1,2
6278,gazzigger,,8,1,1,2
6279,Tobu,,6,6,22,28
6280,Rurouni,,20,3,6,9
6281,Grammar,,11,6,3,9
6282,WhatTheGentlyCaress,,34,205,129,334
6283,McCainIzNutz,,19,3,3,6
6284,shabayek,,19,8,13,21
6285,leakfinder,,30,1,5,6
6286,VenomFangX,,11,5,4,9
6287,thebeefytaco,,18,216,283,499
6288,krat,,20,10,4,14
6289,spellcheck,,11,11,11,22
6290,username223,,20,437,758,1195
6291,opineapple,,18,110,158,268
6292,EmmEff,,20,43,74,117
6293,patach,,19,5,1,6
6294,nihilisticmonk,,42,113,87,200
6295,sirberus,,32,95,38,133
6296,jailbate,,31,2,1,3
6297,konspence,,1,49,54,103
6298,characterzer0,,8,2,1,3
6299,Tortragon,,0,69,72,141
6300,aquilisdicio,,13,1,1,2
6301,ediamond,,22,2,2,4
6302,on3,,43,1,2,3
6303,Gizzmo0411,,20,4,3,7
6304,CCMSTF,,18,48,73,121
6305,FuzzyOne,,13,1,2,3
6306,danielsevelt007,,6,3,11,14
6307,foxhunter,,1,107,125,232
6308,mikeweezer,,10,1,2,3
6309,rec800,,13,2,1,3
6310,zickx009,,13,91,20,111
6311,larsorion,,13,5,1,6
6312,grimster,,18,71,115,186
6313,Shink,,19,3,1,4
6314,hammerofhope,,5,2,1,3
6315,robertunix,,13,1,4,5
6316,murrchen,,35,11,13,24
6317,evandec,,20,16,3,19
6318,collistaeed,,5,11,1,12
6319,fro0ty,,31,87,99,186
6320,muzaki,,43,21,20,41
6321,Hypnot,,18,4,1,5
6322,rrl,,22,2,11,13
6323,keithjr,,42,462,617,1079
6324,v_ger,,22,1,1,2
6325,buttermouth,,19,2,3,5
6326,mpuv6y,,18,1,3,4
6327,haiku_summary,,1,1,1,2
6328,suppressingfire,,20,46,70,116
6329,villageatheist,,13,14,23,37
6330,Tundrasama,,14,29,47,76
6331,bostontparty,,17,1,1,2
6332,alphex,,43,11,3,14
6333,ronin5,,0,32,19,51
6334,FuckingXtianPretards,,19,12,11,23
6335,Chacarron,,0,21,34,55
6336,kimwim42,,34,421,510,931
6337,Ceebs415,,3,47,77,124
6338,darkmoonsinger,,1,5,2,7
6339,timthebrit,,14,2,2,4
6340,mok000,,13,38,79,117
6341,_Mark_,,20,2,8,10
6342,drakshadow,,20,114,253,367
6343,vich,,5,4,8,12
6344,Omnica,,13,2,5,7
6345,Todash19,,13,2,2,4
6346,puffball,,18,35,29,64
6347,thehalfwit,,13,7,1,8
6348,radiowaves,,13,2,1,3
6349,pskomoroch,,20,27,17,44
6350,benburkert,,20,1,1,2
6351,jerschneid,,18,167,65,232
6352,towsonu2003,,0,114,158,272
6353,NeighborhoodWatchCom,,17,1,2,3
6354,we3bus,,1,11,18,29
6355,moocow89,,0,1,1,2
6356,sladner,,32,1,3,4
6357,baphomet256,,0,11,2,13
6358,ferm,,31,1,1,2
6359,newschool,,43,1,4,5
6360,snark,,13,168,246,414
6361,TestFlyJets,,14,5,1,6
6362,Aleksland,,18,82,4,86
6363,banipole,,17,3,6,9
6364,noroom,,43,226,213,439
6365,TwinEagle,,18,4,5,9
6366,shelearns,,8,3,2,5
6367,blknight18,,34,7,2,9
6368,ca_geologist,,43,12,4,16
6369,robins,,38,5,3,8
6370,gotta-take-a-rove,,42,11,7,18
6371,soyonsici,,31,2,1,3
6372,sp1keNARF,,34,30,41,71
6373,SimplyZee,,43,13,27,40
6374,joekarma,,20,27,42,69
6375,graysanborn,,1,1,3,4
6376,kentonerator,,31,39,54,93
6377,CJDehnel,,1,107,130,237
6378,AbortRetryFail,,22,7,5,12
6379,icamebuckets,,18,6,5,11
6380,siong1987,,20,1,1,2
6381,funbag26,,43,49,58,107
6382,ex0cet,,8,1,1,2
6383,atralyx,,0,3,4,7
6384,sikligar,,5,1,1,2
6385,episcope,,19,369,963,1332
6386,bradsh,,42,8,22,30
6387,scotttebeau,,22,1,1,2
6388,kaetzchen,,4,2,1,3
6389,ductions,,18,28,31,59
6390,merkabish,,18,2,3,5
6391,gamma_ray_burst,,21,29,52,81
6392,meesterlars,,1,43,2,45
6393,insickness,,43,14,10,24
6394,RonObvious,,19,879,888,1767
6395,NeilEBryant,,20,1,3,4
6396,vinieux,,5,5,15,20
6397,Unknownz,,31,32,34,66
6398,glitterlok,,13,290,516,806
6399,shuntjr,,6,5,9,14
6400,runiteking1,,1,10,6,16
6401,artificeren,,1,2,4,6
6402,duz,,20,1,1,2
6403,luaptifer,,13,1,1,2
6404,Fuzzyface,,0,1,3,4
6405,isdereks,,18,2,3,5
6406,b33j0r,,20,3,7,10
6407,tsiro,,42,10,5,15
6408,piusvelte,,13,2,5,7
6409,freepenguins,,11,1,7,8
6410,redstatepride,,7,5,5,10
6411,gopalan,,34,1,1,2
6412,reddit_voter,,19,4,3,7
6413,jlraz,,0,247,14,261
6414,tacooo,,0,1,2,3
6415,wplaurence,,13,20,34,54
6416,kxxb,,34,10,24,34
6417,buythatfromus,,13,10,12,22
6418,garoboldy,,17,3,7,10
6419,eleven_thirty,,34,12,33,45
6420,burzuj,,13,1,1,2
6421,lothair,,20,41,34,75
6422,kevcos,,42,1,3,4
6423,kronich,,5,18,6,24
6424,stevo301103,,13,9,5,14
6425,xtrmntr,,43,21,33,54
6426,weakly,,0,119,234,353
6427,xxxxsHERBxxxx,,19,1,3,4
6428,dfgsdfghiourg,,32,1,1,2
6429,fldash,,19,24,19,43
6430,a_c_munson,,32,55,30,85
6431,zero2460,,34,6,15,21
6432,catfive,,3,57,44,101
6433,swanzola,,18,19,18,37
6434,dfreezy,,18,11,25,36
6435,Unl1m1t3d,,13,1,1,2
6436,oinkbeast,,6,7,4,11
6437,sdawsey,,19,17,29,46
6438,TunaMan,,13,124,108,232
6439,bpg,,14,1,2,3
6440,WilliamWallace,,31,40,50,90
6441,pwolfe,,8,4,2,6
6442,pugs909,,8,3,3,6
6443,retguy64,,13,7,5,12
6444,dirtysnachez,,13,199,272,471
6445,0xdeadbabe,,9,4,4,8
6446,Cornwell,,30,12,10,22
6447,crysys,,1,10,14,24
6448,thinman,,26,1,1,2
6449,youngviking,,36,2,5,7
6450,t_w,,20,138,125,263
6451,BFG1x,,43,18,9,27
6452,nmcc847,,19,34,1,35
6453,IamtheFBI,,1,1,1,2
6454,sonictooth,,20,3,2,5
6455,csace,,18,13,21,34
6456,diffuse,,20,4,4,8
6457,zielgruppe,,7,3,3,6
6458,70ph3r,,18,1,4,5
6459,SculptusPoe,,41,42,68,110
6460,CalipsoII,,6,31,20,51
6461,bassx,,42,1,1,2
6462,macov2,,13,76,33,109
6463,anotherusername3,,6,17,29,46
6464,angrycoffee,,6,2,2,4
6465,busterbrown,,5,3,2,5
6466,safarijoe,,31,9,20,29
6467,lejeune,,18,9,32,41
6468,insanelygreat,,42,1,2,3
6469,rytmis,,20,7,13,20
6470,FemurL,,34,2,2,4
6471,flanband,,20,32,39,71
6472,Rihatsu,,34,1,1,2
6473,garim,,43,1,1,2
6474,Vighi,,18,3,2,5
6475,holden1792,,13,11,3,14
6476,happybob007,,13,31,65,96
6477,star_scream,,20,2,3,5
6478,LoriLight,,13,16,14,30
6479,originzz,,26,1,4,5
6480,LocoMoco420,,13,2,3,5
6481,chellebelly,,19,13,4,17
6482,danpaquin,,13,5,2,7
6483,jtizzle,,12,12,2,14
6484,danchan22,,19,4,2,6
6485,washoe22,,5,1,1,2
6486,soupy,,1,6,3,9
6487,aspersieman,,32,3,6,9
6488,wootincharmander,,34,1,2,3
6489,henryaj,,19,1,1,2
6490,bigwophh,,30,3,2,5
6491,hahahah,,13,1,2,3
6492,harrokitty,,22,6,9,15
6493,glamosphere,,18,26,1,27
6494,cnu,,20,42,18,60
6495,acurrie,,18,58,23,81
6496,joss82,,20,1,2,3
6497,jonveck,,32,20,35,55
6498,burdened,,10,1,3,4
6499,zair,,20,11,16,27
6500,nobody2008,,21,1,1,2
6501,operablogger,,22,1,7,8
6502,d20,,20,2,2,4
6503,laurenbosse,,18,7,17,24
6504,4realz,,0,4,2,6
6505,jrm,,20,1,4,5
6506,alsace,,19,2,2,4
6507,drifitz,,43,88,29,117
6508,atmccr,,18,48,67,115
6509,linuxhansl,,29,29,31,60
6510,mofino,,19,2,12,14
6511,nyfresh,,41,2,1,3
6512,Hochler,,20,20,13,33
6513,shifter,,19,83,14,97
6514,Randolpho,,1,5,5,10
6515,sillypeople,,18,1,1,2
6516,Fulltangviper,,29,50,51,101
6517,dustinjones,,18,11,24,35
6518,somehugenerd,,32,159,233,392
6519,froggie007,,1,3,5,8
6520,vox_neocon,,1,1,1,2
6521,gulfie,,13,21,62,83
6522,Klemens,,1,1,1,2
6523,Skoobe,,5,7,3,10
6524,aradil,,3,1084,1742,2826
6525,ectogon,,20,40,82,122
6526,cdm9002,,13,10,14,24
6527,varunb007,,1,11,31,42
6528,redditobandito,,43,4,1,5
6529,remove,,13,12,1,13
6530,polymorph505,,22,25,34,59
6531,zerodark,,19,55,81,136
6532,biiaru,,22,7,8,15
6533,begbudii,,19,338,71,409
6534,bhorwitz,,29,42,37,79
6535,ponder22875,,19,82,186,268
6536,SaratogaCx,,19,35,20,55
6537,observer,,14,26,22,48
6538,originaluid,,20,11,8,19
6539,numbelvsi,,18,44,143,187
6540,L3xicaL,,1,10,20,30
6541,logansnick,,22,16,5,21
6542,kolya3,,18,50,14,64
6543,jnm27,,13,34,1,35
6544,tehuasuh,,22,1,2,3
6545,QaSpel,,13,11,8,19
6546,jumpyg1258,,0,330,384,714
6547,Rowaan,,13,5,18,23
6548,funpolice,,18,7,3,10
6549,partypartyparty,,22,21,29,50
6550,zeeter,,19,1,5,6
6551,Wriston,,43,3,12,15
6552,tjcronan,,11,1,2,3
6553,vodkee,,34,16,36,52
6554,furiouslol,,20,1,1,2
6555,radox,,31,3,2,5
6556,ScienceMouk,,20,59,7,66
6557,phoenixankit,,22,80,162,242
6558,TimmyC,,19,30,14,44
6559,Diktator,,6,2,3,5
6560,KyrieEleison,,33,4,4,8
6561,android08,,13,155,63,218
6562,jck97,,42,1,1,2
6563,newgoldtooth,,5,2,2,4
6564,boneillhawk,,19,5,4,9
6565,doodly123,,20,9,3,12
6566,RichardSharp,,13,9,2,11
6567,freedryk,,30,4,3,7
6568,dthomasdigital,,19,4,1,5
6569,beltingorion,,30,10,7,17
6570,smorrell,,20,9,9,18
6571,michaelmacmanus,,42,167,257,424
6572,chomper,,7,2,7,9
6573,freethinker,,19,3,2,5
6574,Boppy,,34,1,2,3
6575,Cromanomaly,,22,1,2,3
6576,beerorkid,,18,4,2,6
6577,sirenace,,17,2,1,3
6578,Tulenian,,12,9,8,17
6579,stillsad,,1,9,2,11
6580,StreetLamp,,13,30,55,85
6581,jaybirdkdx,,18,1,1,2
6582,shauniv,,1,1,1,2
6583,notquitehere188,,18,4,2,6
6584,esdi,,20,8,9,17
6585,figdish,,32,18,12,30
6586,flyhighplato,,18,2,5,7
6587,NEWARKitecture,,26,2,2,4
6588,Dante2005,,18,255,235,490
6589,shellerik,,1,25,36,61
6590,freebeetree,,14,18,29,47
6591,PIF7Pb2n,,0,3,2,5
6592,nathansu,,20,22,51,73
6593,jason4188,,31,235,181,416
6594,ghaj56,,0,9,8,17
6595,Lord_Hadda,,19,2,7,9
6596,EggshellWhyte,,19,3,4,7
6597,triumphantbike,,20,4,4,8
6598,ringlen837,,33,1,2,3
6599,craiden,,32,1,1,2
6600,tarasic,,32,1,1,2
6601,slaman,,5,3,7,10
6602,WhiteAdmiral,,19,147,18,165
6603,manatwo,,19,3,2,5
6604,liquidcloud9,,22,4,2,6
6605,nickstreet36,,34,237,47,284
6606,fleanine,,34,31,17,48
6607,vdm,,20,27,52,79
6608,arvid,,20,17,15,32
6609,azebasse,,43,3,16,19
6610,jetspeed,,20,4,1,5
6611,altmod,,18,3,1,4
6612,beatard,,43,2,4,6
6613,sgnmarcus,,13,23,45,68
6614,pharoah724,,32,1,1,2
6615,stalf,,20,2,1,3
6616,jahusain,,20,4,2,6
6617,eddie964,,13,987,822,1809
6618,frutiger,,20,513,611,1124
6619,NoxiousStimuli,,18,108,175,283
6620,abccop,,20,3,2,5
6621,nichcarlson,,19,2,1,3
6622,akim,,0,3,1,4
6623,Devz0r,,20,165,93,258
6624,rhm,,8,4,4,8
6625,Daimoneze,,13,15,31,46
6626,RickBL99,,32,1,1,2
6627,thebcb,,34,5,9,14
6628,jermanis,,43,2,6,8
6629,Unununium272,,1,149,199,348
6630,billib,,26,10,8,18
6631,aidenvdh,,20,31,31,62
6632,GT4NE1,,20,1,1,2
6633,Rafe,,43,241,323,564
6634,utterlyboring,,0,1,1,2
6635,threading,,20,30,2,32
6636,h3h,,20,3,4,7
6637,jrdoran,,18,29,1,30
6638,jacobb11,,14,1,1,2
6639,komoloko,,1,32,60,92
6640,uncleozzy,,20,1,1,2
6641,elemenop,,18,21,47,68
6642,ignorance0,,12,9,9,18
6643,SmashingTool,,19,7,22,29
6644,RawbKahn,,42,1,3,4
6645,mfrace1,,13,2,4,6
6646,giftculture,,18,1,1,2
6647,yellowwit,,0,9,4,13
6648,pwnd3r,,34,9,12,21
6649,arbitrarium,,32,13,11,24
6650,Liberty_Vendetta,,13,1,1,2
6651,SgtPepperMD,,36,1,1,2
6652,dustmop,,20,24,54,78
6653,eris404,,29,6,2,8
6654,androgy,,32,10,2,12
6655,smackanicka,,19,2,4,6
6656,V4L0R,,36,89,158,247
6657,wafflez,,43,36,53,89
6658,wwestbrook,,18,1,1,2
6659,traveler_,,19,27,48,75
6660,stelmate,,19,16,19,35
6661,pavel9,,31,28,52,80
6662,JesusLovesasamorris,,18,1,1,2
6663,ffgabq,,31,1,2,3
6664,df07,,29,1,1,2
6665,jkasten,,36,15,29,44
6666,kiarias,,27,1,2,3
6667,thelsdj,,22,48,22,70
6668,sfreak,,8,2,2,4
6669,thisisthedave,,5,1,1,2
6670,bulletboy,,19,1,1,2
6671,d00bois,,32,3,13,16
6672,smog,,1,2,1,3
6673,ragica,,30,10,21,31
6674,sum1,,43,1,2,3
6675,vetler,,20,108,63,171
6676,MountainX,,0,138,75,213
6677,ssladam,,20,18,24,42
6678,The_NSA,,1,5,8,13
6679,dobbs_end_horror,,13,5,2,7
6680,aloysiusthird,,32,36,15,51
6681,seldon452,,42,194,147,341
6682,acct_rdt,,20,15,11,26
6683,phillyharper,,19,771,160,931
6684,ballons,,35,1,4,5
6685,donq321,,19,2,3,5
6686,dmwhipp,,13,69,14,83
6687,Teamster,,18,14,20,34
6688,rkaryn6,,1,4,12,16
6689,Bosley,,1,3,5,8
6690,bamdastard,,20,52,103,155
6691,lifvgblisdufv,,18,110,48,158
6692,mrbroom,,35,801,955,1756
6693,MarlonBrawndo,,19,2,2,4
6694,EnricoFermi,,19,9,2,11
6695,samography,,18,5,8,13
6696,grandwazzoo,,34,20,17,37
6697,shacamin,,1,348,458,806
6698,jlick,,0,1,2,3
6699,socalbeachgal,,13,22,27,49
6700,Pro777,,22,1,1,2
6701,maukdaddy,,34,168,207,375
6702,wwqlcw,,4,74,83,157
6703,GreenITGuru,,20,3,1,4
6704,shmegegi,,5,2,1,3
6705,benry,,29,1,3,4
6706,AmericaFuckNo,,19,1,1,2
6707,Moldavite,,13,1198,172,1370
6708,dutchboyelm,,42,31,1,32
6709,salgat,,23,538,909,1447
6710,rickrosstheboss,,1,65,83,148
6711,enki_enlil,,31,21,24,45
6712,jseigh,,20,19,39,58
6713,periclesmage,,34,70,13,83
6714,svazan,,18,16,11,27
6715,enjahova,,31,36,44,80
6716,wonknose,,42,11,10,21
6717,rafajafar,,20,111,91,202
6718,B-Con,,20,78,100,178
6719,sala,,0,142,19,161
6720,biochembabe,,31,5,2,7
6721,dolle,,20,27,32,59
6722,freekzindel,,20,3,3,6
6723,BenE,,20,1,1,2
6724,neonpowerbomb,,18,34,46,80
6725,ovi256,,20,174,203,377
6726,this_barb,,32,111,225,336
6727,f-ranke,,1,1,2,3
6728,hhuntington2,,13,15,15,30
6729,FerricOxide,,18,36,65,101
6730,mer91,,43,6,3,9
6731,wozer,,20,294,105,399
6732,thebaroque,,1,14,3,17
6733,mesquita,,19,15,23,38
6734,armistad,,20,2,2,4
6735,forrman,,31,2,1,3
6736,davvblack,,18,213,364,577
6737,HotBBQ,,3,105,86,191
6738,merpes,,13,1,1,2
6739,SnacksOnAPlane,,20,85,102,187
6740,isaa,,22,1,2,3
6741,ukdkbr,,19,176,320,496
6742,Qiran,,31,9,17,26
6743,Scurvy_D,,0,6,9,15
6744,khoker,,29,2,3,5
6745,HappyRacist,,31,7,9,16
6746,chaos_butterfly,,18,1,1,2
6747,alllie,,0,6388,2589,8977
6748,williamwhite,,43,7,4,11
6749,inthenameofmine,,31,152,3,155
6750,stopmakingsense,,34,6,2,8
6751,namja,,22,1,1,2
6752,potentialPast,,13,16,12,28
6753,wduff2,,19,8,11,19
6754,SubGothius,,1,221,397,618
6755,CLer_in_VA,,18,7,15,22
6756,zszafran,,17,1,1,2
6757,whatsupdocs,,40,3,1,4
6758,taejo,,20,244,392,636
6759,lwfleetham,,19,11,5,16
6760,bfpp,,20,1,1,2
6761,vvn102,,1,3,2,5
6762,qwzybug,,20,3,2,5
6763,arkabc,,5,30,10,40
6764,JohnDeere,,1,8,15,23
6765,baddog992,,19,8,11,19
6766,guruthegreat,,42,19,39,58
6767,aonic,,20,1,3,4
6768,paulkeitel,,13,33,1,34
6769,ChaoPope,,14,2,2,4
6770,olsner,,20,6,16,22
6771,iamthearm,,19,126,225,351
6772,tyrannoctonus,,42,5,14,19
6773,mjd,,20,155,154,309
6774,cunninglinguist,,22,15,25,40
6775,capnpyro,,13,1,1,2
6776,Evilhenchman,,13,2,12,14
6777,Mesmorize,,31,9,6,15
6778,michaelpinto,,18,114,26,140
6779,spillreviews,,13,47,7,54
6780,nonomore,,13,1,2,3
6781,cannibalbob,,26,3,5,8
6782,sencer,,30,4,7,11
6783,halligan00,,31,144,207,351
6784,menomena,,43,16,25,41
6785,SHv2,,20,3,2,5
6786,healeydawg,,8,4,3,7
6787,syph,,4,10,3,13
6788,agag,,19,5,9,14
6789,redokapi,,18,9,11,20
6790,petervandijck,,20,4,4,8
6791,bonnyray08,,0,5,1,6
6792,GregorMendel,,32,11,14,25
6793,frikk,,20,158,255,413
6794,Nablec00,,19,19,20,39
6795,the_antichrist,,19,1,1,2
6796,twolf1,,13,4101,134,4235
6797,ryepup,,20,67,17,84
6798,darcet,,32,1,1,2
6799,korkybuchek,,29,2,1,3
6800,syboor,,18,1,3,4
6801,daedpid1,,4,46,76,122
6802,amikael,,20,2,9,11
6803,elche,,21,2,1,3
6804,Colonel_Angus,,4,6,5,11
6805,what_the_rain_knows,,20,9,8,17
6806,Vandelay797,,43,2,1,3
6807,scottharden,,22,37,55,92
6808,Awesom-O,,42,1,2,3
6809,Vancelot,,18,7,11,18
6810,smokinsteve,,0,42,4,46
6811,rgarrison,,35,2,5,7
6812,6kdaysleft,,20,2,1,3
6813,beagle,,43,20,1,21
6814,Testsubject28,,18,180,333,513
6815,thegreenfury,,13,6,5,11
6816,FTR,,13,443,431,874
6817,rybl,,32,84,18,102
6818,geekgawd,,6,2,3,5
6819,help_me,,22,2,1,3
6820,GuyWhoScreamsAlways,,23,3,2,5
6821,mixscarlet,,29,2,3,5
6822,brimstone,,0,46,5,51
6823,FORTRAN,,30,1,1,2
6824,riseUP,,40,1,2,3
6825,4609287645,,20,91,188,279
6826,boobytrapped,,20,4,4,8
6827,Charice,,18,2,4,6
6828,buddaslovehandles,,43,343,364,707
6829,groggy,,43,1,1,2
6830,zebula234,,42,23,29,52
6831,capital,,19,1,2,3
6832,ntoshev,,20,4,3,7
6833,doutta,,1,1,1,2
6834,reddit1138,,1,4,4,8
6835,popeix,,20,249,113,362
6836,superdeluxesam,,20,3,1,4
6837,mystery_guest,,18,411,557,968
6838,fugat,,34,138,50,188
6839,iamblonde,,13,1,1,2
6840,scoopz,,18,1,1,2
6841,thisismyfakeaccount,,1,2,3,5
6842,bulletballMarc,,9,3,2,5
6843,jollins,,34,1,1,2
6844,nick8325,,20,25,37,62
6845,rudster,,13,5,9,14
6846,puskunk,,32,14,23,37
6847,tedwick,,19,4,2,6
6848,tj9991,,1,96,79,175
6849,nerox3,,19,156,162,318
6850,iliketowatch,,0,74,135,209
6851,goglserw,,42,1,1,2
6852,Prosopagnosia,,32,2,4,6
6853,TheGreenMiles,,34,48,3,51
6854,ChiliGuy,,37,1,1,2
6855,lmno,,42,1,1,2
6856,CrashCodes,,20,50,33,83
6857,spartan2100,,42,69,104,173
6858,ccoveney,,35,2,1,3
6859,dmk2008,,0,120,124,244
6860,GoldenFalcon,,19,3,3,6
6861,bct,,20,12,12,24
6862,ArminVanBuuren,,8,1,2,3
6863,powrslave,,19,1,3,4
6864,jayokay,,30,128,68,196
6865,cromulentadvice,,13,1,2,3
6866,raisedinhell,,20,130,194,324
6867,Trotskyist,,12,2,3,5
6868,PeteZaHutt,,13,94,16,110
6869,neutralforce,,43,162,64,226
6870,liberalcommiefag,,13,69,72,141
6871,juniorjj,,43,2,2,4
6872,StretchinAZ,,34,4,6,10
6873,triad1996,,32,80,4,84
6874,metamutator,,6,13,23,36
6875,bkforyou,,18,2,1,3
6876,atomicthumbs,,22,870,1100,1970
6877,gamewithabrain,,19,59,3,62
6878,lazyfisherman,,13,7,24,31
6879,emilis,,20,8,3,11
6880,frumious,,18,71,202,273
6881,AbolishtheFed,,0,2,2,4
6882,Robotmanforever,,6,8,3,11
6883,livejamie,,1,15,39,54
6884,trisgeminus,,14,3,2,5
6885,kokpilau,,13,7,5,12
6886,nkurz,,20,23,23,46
6887,byteCoder,,20,1,1,2
6888,democratizor,,31,2,2,4
6889,Jibberwalk,,31,292,292,584
6890,javert,,20,17,5,22
6891,buymorechuck,,20,33,4,37
6892,wjdennen,,31,4,3,7
6893,salavari,,13,2,7,9
6894,sleepsex,,18,1,1,2
6895,khubiliaJahn,,18,11,25,36
6896,loudambiance,,4,4,4,8
6897,ikovachi,,13,2,1,3
6898,Blaidd_Dwrg,,20,89,69,158
6899,richardnday,,5,12,5,17
6900,proham,,42,3,1,4
6901,haacked,,20,5,2,7
6902,mcl768,,1,6,5,11
6903,eric966077,,18,13,10,23
6904,Codys_Down,,43,14,24,38
6905,seethru,,18,1,4,5
6906,bodq,,20,28,6,34
6907,chrisandsmith,,18,108,42,150
6908,FloobLord,,1,24,36,60
6909,exeter,,20,451,460,911
6910,rene_s,,31,53,33,86
6911,automatedATTK,,19,71,154,225
6912,rabidcow,,20,302,532,834
6913,TTFAIL,,18,33,39,72
6914,progrockusa,,19,25,36,61
6915,buravirgil,,4,1,2,3
6916,thatspants,,18,31,9,40
6917,licoriceandshreddies,,18,11,28,39
6918,h00k,,34,8,13,21
6919,datatable,,12,11,6,17
6920,mithunc,,18,93,148,241
6921,dchu,,19,6,11,17
6922,nfnaaron,,31,6,6,12
6923,VAMPIRE__BITER,,32,2,1,3
6924,MM73,,13,6,7,13
6925,LoRez,,32,2,4,6
6926,mtnbarbours,,4,3,4,7
6927,lynch03,,35,39,38,77
6928,destructo_spin,,20,3,9,12
6929,markrages,,20,30,17,47
6930,arijit57,,18,141,6,147
6931,finglonger,,3,16,12,28
6932,ExplodingHead,,22,8,17,25
6933,timmy,,20,14,17,31
6934,evilbeaver333,,35,1,2,3
6935,padsip1,,5,36,1,37
6936,huffdaddy,,18,7,4,11
6937,vikky999,,32,2,1,3
6938,riq,,20,1,1,2
6939,xumiiz,,20,5,2,7
6940,zeddblue,,0,9,43,52
6941,mocisme,,13,8,9,17
6942,ryksych,,5,2,11,13
6943,WhiteJesus,,32,3,5,8
6944,jamesyboy,,13,40,66,106
6945,werkshop1313,,13,60,128,188
6946,jensv,,20,21,7,28
6947,DeviousMrBlonde,,29,1,1,2
6948,noamsml,,31,684,953,1637
6949,danvasquez29,,12,163,205,368
6950,kazuya,,41,9,14,23
6951,veritascitor,,22,18,12,30
6952,yliaba,,19,1,2,3
6953,mrpinto,,31,1,1,2
6954,vagijn,,32,100,191,291
6955,spaten,,8,1,3,4
6956,savoya,,20,2,1,3
6957,180andback,,32,1,2,3
6958,CorkyinSiam,,5,2,8,10
6959,ogretrix,,43,1,1,2
6960,rando_man,,43,51,43,94
6961,misterwilliam,,20,1,2,3
6962,jeromejohnson,,13,8,4,12
6963,madssj,,20,53,22,75
6964,acrophobia,,19,28,32,60
6965,Kimos,,22,345,374,719
6966,dockside,,34,1,1,2
6967,aevolve,,38,1,2,3
6968,Mofme,,22,48,111,159
6969,SuperSumoYakuza,,18,83,156,239
6970,pangeakiller,,36,1,1,2
6971,gongong,,18,7,1,8
6972,bleys,,1,4,1,5
6973,nobodylikeme,,34,1,2,3
6974,nanr93,,31,19,23,42
6975,Sui64,,4,1,1,2
6976,Kesseki,,42,1,1,2
6977,Superaverageman,,1,3,6,9
6978,bschmok1,,6,23,17,40
6979,Xocyll,,1,1,1,2
6980,beachbluewave,,31,1,1,2
6981,weel,,19,4,10,14
6982,GundamX,,42,48,60,108
6983,ray_scogitans,,13,485,298,783
6984,sk1p,,0,1,1,2
6985,Noche,,18,1671,510,2181
6986,matthewlarn,,13,10,4,14
6987,quasiperiodic,,6,1156,826,1982
6988,ChefOfSin,,1,3,4,7
6989,ionosphereB,,15,3,1,4
6990,Toallpointswest,,31,132,261,393
6991,slyvulpecula,,13,87,232,319
6992,bfbartolocolon,,22,1,2,3
6993,effortman,,18,1,1,2
6994,friendsshare,,18,196,532,728
6995,escapekey,,13,9,20,29
6996,koen_,,22,1,2,3
6997,markh1967,,18,220,30,250
6998,baldersplash,,20,15,12,27
6999,ceesaxp,,20,78,117,195
7000,ts334,,18,19,15,34
7001,glguy,,20,14,9,23
7002,grjemo,,1,128,32,160
7003,RonaldFuckingPaul,,32,259,645,904
7004,copenja,,20,1,1,2
7005,uglysister,,32,7,3,10
7006,Rido777,,18,12,2,14
7007,rantillo,,42,31,40,71
7008,crappyjoe,,13,3,1,4
7009,ne999,,18,19,4,23
7010,fakeproject,,20,4,8,12
7011,Annix,,13,8,7,15
7012,edme,,13,2,1,3
7013,LivingComfortEagle,,22,4,11,15
7014,ak_avenger,,20,135,270,405
7015,autarch,,20,21,25,46
7016,SolInvictus,,42,542,238,780
7017,conjuror1972,,43,8,6,14
7018,FearlessFreep,,13,12,25,37
7019,jagerbomb,,19,24,43,67
7020,rossbren,,5,1,1,2
7021,WRXSTi,,16,1,3,4
7022,contraco,,39,356,13,369
7023,dcumbo,,34,3,12,15
7024,diarrheaUHUH,,22,1,1,2
7025,LaGnoo,,42,3,2,5
7026,SAugsburger,,36,553,919,1472
7027,Evil_Morg,,32,34,52,86
7028,guns-11,,18,3,2,5
7029,rocktherobot,,1,37,18,55
7030,conspiracyken,,4,1,1,2
7031,katedoll02,,18,1,2,3
7032,electromagnetic,,43,34,46,80
7033,Grumblestiltskin,,22,4,9,13
7034,chesterriley,,8,3,2,5
7035,KanonDrita,,43,2,1,3
7036,scott1369,,41,47,51,98
7037,IKbot,,19,69,27,96
7038,Farginan,,34,1,2,3
7039,pascal21,,12,148,182,330
7040,indiamails,,30,2,1,3
7041,FerrisYJ,,0,12,4,16
7042,philzilla,,0,14,12,26
7043,cybermage,,13,16,13,29
7044,bhal123,,19,910,792,1702
7045,Pyrogenesis,,31,18,16,34
7046,Mondoterrifico,,20,5,2,7
7047,Doji,,1,6,5,11
7048,EJFudd,,6,1,2,3
7049,ZMeson,,20,38,40,78
7050,justcreatedthis,,16,1,1,2
7051,cq1,,18,1,4,5
7052,gedsnh,,4,2,3,5
7053,keybsnbits,,21,5,1,6
7054,modernTelemachus,,18,47,72,119
7055,creator11,,22,129,170,299
7056,nino2007,,20,3,2,5
7057,ispshadow,,4,108,145,253
7058,seeeb,,30,18,24,42
7059,reddits_conscience,,31,4,1,5
7060,kitten_kicker,,11,1,1,2
7061,scoobypants,,18,2,6,8
7062,drpants,,13,295,223,518
7063,findit,,18,112,25,137
7064,chrisnyc,,19,2,9,11
7065,realityhigh,,31,3,5,8
7066,kortox,,1,1,1,2
7067,jurnei,,19,1,7,8
7068,eagleeye1,,34,45,50,95
7069,waskliewbt,,1,25,13,38
7070,tkmckenzie,,18,7,10,17
7071,Tejas_Tornado,,13,24,76,100
7072,jack_championship,,10,61,93,154
7073,counterpoint,,19,4,8,12
7074,kyohapooka,,18,14,16,30
7075,bananaa,,13,7,41,48
7076,Imalittleteapalt,,29,17,3,20
7077,douchehead,,0,4,1,5
7078,davidhbolton,,31,1,1,2
7079,acerogue26,,1,29,61,90
7080,stevana,,20,6,2,8
7081,e404,,20,9,10,19
7082,CattBoy,,43,10,17,27
7083,Criggle,,18,19,49,68
7084,notSUREwhereTOyell,,13,4,6,10
7085,zombywuf,,20,3,5,8
7086,traverse,,19,88,84,172
7087,lucraft,,20,13,16,29
7088,EverythingsHilarious,,18,5,5,10
7089,weblaunches,,5,489,106,595
7090,UrbanLegend,,43,1,2,3
7091,spitfire111,,35,21,21,42
7092,tylerfulltilt,,13,1,1,2
7093,yowtrip,,18,1,1,2
7094,jayfehr,,18,1,1,2
7095,hasaang,,42,1,2,3
7096,killtina,,12,120,118,238
7097,jeblis,,39,2,4,6
7098,RoseEncollims,,42,13,5,18
7099,bullsbarry,,20,41,57,98
7100,analbumcover,,18,54,110,164
7101,unmutual,,26,3,6,9
7102,breakwater,,18,1,2,3
7103,wldkrd1,,1,2,2,4
7104,jellicle,,31,255,228,483
7105,christoir,,13,929,34,963
7106,mikedmoon,,31,8,10,18
7107,ShannonY75,,18,47,5,52
7108,ssanders82,,18,57,47,104
7109,tzeeth,,20,45,2,47
7110,shystar06,,0,71,114,185
7111,JoshuaSmyth,,30,1,4,5
7112,guyiniraq,,31,7,7,14
7113,DrunkenWizard,,30,13,19,32
7114,ENFour,,5,1,6,7
7115,egolatra,,18,7,9,16
7116,DaveNiks,,42,65,33,98
7117,eljeffe_teh_joo,,20,1,4,5
7118,peppaz,,18,1,6,7
7119,lilfuckshit,,18,29,1,30
7120,CaseyLW,,18,2,2,4
7121,dranek,,4,3,3,6
7122,Setekh,,31,1,2,3
7123,HanFuzzy,,30,2,6,8
7124,johnan,,21,4,1,5
7125,yena,,20,2,3,5
7126,angrykeyboarder,,13,13,18,31
7127,frickindeal,,43,584,890,1474
7128,dark_im4g3,,18,2,3,5
7129,igorsk,,18,3,1,4
7130,rolanatmi,,18,138,254,392
7131,negro_machine,,42,92,178,270
7132,Soxsider,,1,5,4,9
7133,curtiscu,,31,32,33,65
7134,razmanz,,19,8,16,24
7135,brennanmusic,,15,13,9,22
7136,harfga,,20,1,2,3
7137,nowa,,30,87,66,153
7138,krisokot,,20,20,1,21
7139,CreekDK,,18,3,6,9
7140,obamaniac,,31,1,1,2
7141,VitalyO,,31,10,10,20
7142,prof_hobart,,4,175,255,430
7143,ct4ul4u,,20,57,101,158
7144,fiddleroo,,20,1,3,4
7145,JadeFrogs,,22,7,8,15
7146,olivier101,,21,74,7,81
7147,sailfishhero,,34,11,11,22
7148,duncancarroll,,1,44,81,125
7149,yetanotherotherguy,,22,2,2,4
7150,Hermel,,20,78,63,141
7151,thegunn,,32,36,69,105
7152,c2_0,,13,1,5,6
7153,flashter,,19,6,4,10
7154,xenmate,,43,858,402,1260
7155,OhHappyDaze,,19,6,11,17
7156,DJ2,,19,1,1,2
7157,journobitch,,34,2,1,3
7158,shaydog,,20,3,2,5
7159,148937948,,19,1,1,2
7160,jairadballerina,,43,31,42,73
7161,clesch,,18,6,9,15
7162,skyhancock,,18,1,1,2
7163,wgsl,,0,65,1,66
7164,mattf,,22,17,13,30
7165,Daemonax,,32,31,44,75
7166,Luminator,,0,2,2,4
7167,stoyan,,32,14,34,48
7168,cr3,,20,74,75,149
7169,GerardMcGarry,,5,28,48,76
7170,pdonadeo,,20,5,1,6
7171,elelias,,32,22,42,64
7172,dumbboys,,29,4,4,8
7173,900fool,,4,11,6,17
7174,AllenHo,,22,17,23,40
7175,Dekken_,,32,76,153,229
7176,meatpuppet,,20,1,1,2
7177,Supratik,,1,28,72,100
7178,joybusey,,5,28,2,30
7179,ilubporn,,12,10,3,13
7180,aethidd,,6,1,2,3
7181,bluemonkey,,32,2,4,6
7182,e1516,,5,1,1,2
7183,apullin,,34,2,6,8
7184,Evdawg,,0,63,11,74
7185,yuhngnegeh,,19,8,3,11
7186,inferno714,,10,15,9,24
7187,w00dstock,,19,1,1,2
7188,macadocious,,30,1,1,2
7189,FUCK_the_FCC,,1,7,2,9
7190,WillHutch5,,18,8,11,19
7191,floydiannyc,,14,1122,381,1503
7192,cmndradama,,13,6,18,24
7193,staticit,,35,1,1,2
7194,scilfish,,13,1,1,2
7195,fatsk8r,,8,1,3,4
7196,mtalbot,,13,10,1,11
7197,jsydik,,20,1,5,6
7198,phrankle,,13,95,66,161
7199,Grrrinch,,18,1,4,5
7200,Eduren,,1,2,8,10
7201,vegiimite,,19,3,1,4
7202,yks,,18,1,1,2
7203,chieffy,,20,1,2,3
7204,BenKirsch,,19,1,1,2
7205,RaDeus,,32,7,8,15
7206,gedehs,,32,4,4,8
7207,underdog138,,18,177,318,495
7208,theaceofclubz,,1,20,14,34
7209,mazenharake,,18,11,8,19
7210,neken,,20,2,3,5
7211,youenjoymyself,,18,48,64,112
7212,shammalammadingdong,,32,50,41,91
7213,weidel,,20,4,2,6
7214,smoothdzion,,20,4,6,10
7215,BobCollins,,6,13,23,36
7216,agl,,20,24,17,41
7217,kbedell,,16,183,82,265
7218,hack4good,,31,155,119,274
7219,i_am_outraged,,19,1,4,5
7220,potatop,,19,2,2,4
7221,manierisme,,13,5,6,11
7222,samuelhalle,,30,17,4,21
7223,bluh123,,20,31,3,34
7224,DataGeneral,,28,55,86,141
7225,shootdashit,,19,114,276,390
7226,Bosworth,,32,1,1,2
7227,CoolDragon,,43,83,86,169
7228,Hogulus,,19,1,1,2
7229,mrhawkinson,,18,6,8,14
7230,daubuch,,4,3,1,4
7231,handsome_b_wonderful,,11,13,19,32
7232,louis_xiv42,,19,652,374,1026
7233,Benny_Lava,,34,386,863,1249
7234,fbristow,,20,4,6,10
7235,hidden_enterprise,,43,1,1,2
7236,Hadz,,40,19,2,21
7237,Farik,,13,1,3,4
7238,blazin_chalice,,43,99,105,204
7239,gpurrenhage,,43,6,8,14
7240,rainman_104,,30,1751,1808,3559
7241,TyTN,,0,247,54,301
7242,drfrog666,,20,10,5,15
7243,studyoflife,,20,1,1,2
7244,OKKO,,13,56,21,77
7245,blooXgiuliaXcyan,,25,5,3,8
7246,photozel,,18,2,7,9
7247,Anth741,,13,21,17,38
7248,notarealaccount,,18,1,1,2
7249,Buckleydog,,13,5,3,8
7250,ScatCamel,,8,3,3,6
7251,Shad0wSP,,22,91,101,192
7252,teej,,20,153,178,331
7253,Quickswitch79,,19,6,7,13
7254,epvcu,,20,1,3,4
7255,frootloops,,22,6,4,10
7256,JackRawlinson,,0,161,463,624
7257,Mantle,,26,1,1,2
7258,goink,,13,56,64,120
7259,BunkmonKey,,13,16,4,20
7260,menstrualpoetry,,34,41,2,43
7261,okvol,,19,83,153,236
7262,sabai_sabai,,27,4,1,5
7263,noseyb,,43,24,65,89
7264,steffyboots,,16,1,1,2
7265,Ortus,,32,11,12,23
7266,svideo,,1,91,115,206
7267,bwb,,5,23,18,41
7268,corvettecraz92,,19,15,5,20
7269,NeonNinja,,43,12,5,17
7270,arexx,,20,4,5,9
7271,switchmotiv,,27,19,16,35
7272,arrozconevan,,18,30,3,33
7273,Zeerph,,36,127,220,347
7274,gry_own,,32,6,5,11
7275,curtis119,,19,119,189,308
7276,Resident_asshole,,42,27,38,65
7277,rogerniner,,0,2,2,4
7278,badenglish,,13,9,3,12
7279,glimberg,,20,7,6,13
7280,jweather,,42,3,6,9
7281,tester_person,,14,1,1,2
7282,blueletter,,20,1,6,7
7283,sirnot,,16,1,3,4
7284,BigFeets,,19,653,526,1179
7285,CrazyJoeDavola,,18,5,6,11
7286,GillyRoze,,13,20,18,38
7287,PeterDB,,22,18,6,24
7288,smedleybutler,,39,7,7,14
7289,lilleswing,,20,2,1,3
7290,Unk0,,32,3,11,14
7291,uuiU,,18,1,1,2
7292,fordnut,,18,94,4,98
7293,freewheeling,,34,7,6,13
7294,midnightmonster,,20,9,4,13
7295,sgguitar88,,36,3,4,7
7296,zamnfan,,41,1,3,4
7297,ShkaBank,,18,8,19,27
7298,Hattusa,,43,12,28,40
7299,BigRetard,,0,1,2,3
7300,machia,,20,3,5,8
7301,wotanzeit,,13,3,7,10
7302,SirDyluck,,31,108,120,228
7303,primary0,,43,57,109,166
7304,MaximumD,,20,1,1,2
7305,rhwhtrash,,3,1,3,4
7306,bangfoo,,13,2,5,7
7307,_reddit,,3,1,1,2
7308,tupiniquim,,34,23,37,60
7309,r00tus3r,,31,33,39,72
7310,utAlice,,18,1,1,2
7311,otcpdx,,5,7,7,14
7312,melissappa,,30,25,32,57
7313,oh_whoopsss,,13,36,29,65
7314,coriolis,,43,1,1,2
7315,mhongser,,30,3,3,6
7316,x864life,,39,2,2,4
7317,elmiko,,5,5,5,10
7318,DenverRocks,,32,8,12,20
7319,DragonDawg,,32,4,5,9
7320,lhxx,,43,1,1,2
7321,cyphr555,,13,23,6,29
7322,juliob,,20,13,16,29
7323,DrStabbingworth,,42,17,26,43
7324,CognitiveLens,,18,10,13,23
7325,RonpaulFTW,,19,9,4,13
7326,atlantics,,32,8,19,27
7327,qabsteak,,13,6,4,10
7328,BlackestNight21,,1,128,313,441
7329,Magsec,,0,37,66,103
7330,allergic,,5,28,54,82
7331,espn,,19,3,5,8
7332,designtofly,,19,49,3,52
7333,chunksloth,,13,1,1,2
7334,jgollad,,15,3,1,4
7335,aim2future,,20,15,25,40
7336,zzzSleepyCoder,,20,27,3,30
7337,only_one_question,,0,1,1,2
7338,musofire,,31,85,55,140
7339,adammck,,20,45,30,75
7340,sharmaamitabh,,31,3,6,9
7341,valiant19,,14,2,3,5
7342,justjeff1,,20,1,1,2
7343,DDyce,,19,1,10,11
7344,endhits,,1,17,31,48
7345,Bixie,,22,183,198,381
7346,STFXGX,,18,18,10,28
7347,el_jeffe,,0,7,22,29
7348,DoneCorpNumbers,,6,1,1,2
7349,Circuit23,,32,2,2,4
7350,efuest,,18,1,2,3
7351,Danks4theLove,,1,3,4,7
7352,crackbaby,,12,1,1,2
7353,mh94,,31,1,1,2
7354,000078754,,32,177,30,207
7355,xhb,,20,3,3,6
7356,eoyola,,20,7,10,17
7357,satx,,4,1126,1648,2774
7358,aranasyn,,13,14,22,36
7359,pimpanzo,,34,36,26,62
7360,Tralobyte,,31,177,125,302
7361,JadedTLC,,13,5,1,6
7362,mattfarr,,29,1,4,5
7363,makavely,,5,4,2,6
7364,AEIYM,,22,1,2,3
7365,JimJohnson19,,18,79,54,133
7366,Candyshanks,,19,1,2,3
7367,newguy4,,36,5,2,7
7368,cjharrod,,19,69,119,188
7369,glowleaf,,22,1,1,2
7370,specialbus,,18,8,1,9
7371,gobbles,,12,6,12,18
7372,bblfish,,20,5,7,12
7373,seaphd,,34,1,1,2
7374,schala09,,20,98,41,139
7375,bruderjakob,,8,11,2,13
7376,tcd004,,0,187,9,196
7377,Fx71,,18,4,4,8
7378,sonus,,5,2,6,8
7379,Vock,,1,3,1,4
7380,Flaaron,,1,1,2,3
7381,HaxSir,,43,32,33,65
7382,Inri137,,13,699,139,838
7383,kevinlacker,,20,1,1,2
7384,MisterTureaud,,31,4,1,5
7385,bvoid,,4,7,1,8
7386,JRRZ,,32,3,8,11
7387,sneakyfrenchspy,,0,140,57,197
7388,sungsam2,,31,11,10,21
7389,StoveBottomStuffin,,18,3,9,12
7390,lcafiero,,20,2,1,3
7391,livinginexile,,29,1,1,2
7392,spaceyraygun,,20,6,2,8
7393,devolve,,18,141,135,276
7394,junkeee999,,6,390,566,956
7395,jeremy1701,,8,3,4,7
7396,Dailylife,,14,11,28,39
7397,hoffmabc,,5,7,2,9
7398,norfty,,4,4,11,15
7399,soumokil,,19,76,167,243
7400,shade75,,5,1,1,2
7401,HunkOfLove,,31,29,18,47
7402,raresilk,,41,1,1,2
7403,goodthingnet,,19,60,1,61
7404,Mirielle,,18,15,17,32
7405,ThrasherC,,22,111,159,270
7406,zroach,,13,3,2,5
7407,Tchocky,,19,192,230,422
7408,ucratbo,,20,5,3,8
7409,bobgem,,13,35,29,64
7410,pupeno,,20,245,207,452
7411,redstarburst,,13,6,6,12
7412,quirm,,22,137,134,271
7413,oelsen,,13,1,7,8
7414,solyanik,,31,37,70,107
7415,Mordisquitos,,4,25,29,54
7416,dougie173,,20,7,6,13
7417,jackieduvall,,29,28,8,36
7418,div,,20,93,83,176
7419,delrond,,5,167,21,188
7420,isseki_nicho,,13,3,3,6
7421,ireadyou,,13,1,1,2
7422,raphtze,,39,2,1,3
7423,ahusni,,32,19,25,44
7424,taxman32,,13,6,5,11
7425,cresquin,,19,110,100,210
7426,eggsofamerica86,,19,27,55,82
7427,syscrash,,20,4,2,6
7428,betternickname,,42,50,94,144
7429,nbsp,,34,35,1,36
7430,evergay,,29,6,10,16
7431,shadowcast,,19,24,26,50
7432,ImWithStupid,,0,147,106,253
7433,blakestah,,32,37,33,70
7434,MrWhite,,6,233,368,601
7435,maxdavid,,34,26,5,31
7436,DrPoodle,,32,117,18,135
7437,Wakefield,,0,16,40,56
7438,lenden_guy,,17,1,3,4
7439,ironknee,,13,8,3,11
7440,reedlaw,,40,2,1,3
7441,chiller2002,,14,24,33,57
7442,zackman,,20,1,1,2
7443,mnevis,,20,2,2,4
7444,All23,,13,319,261,580
7445,creeront,,1,5,4,9
7446,RevoS117,,4,82,145,227
7447,jrblast,,1,5,9,14
7448,drappier,,13,1,1,2
7449,arstechnica,,42,1,3,4
7450,Korbindallas,,13,5,6,11
7451,jputnam,,20,29,36,65
7452,florinandrei,,0,66,110,176
7453,l12,,19,403,71,474
7454,deathtokarmawhores,,19,4,4,8
7455,jwang,,31,1,2,3
7456,jacobian,,20,17,22,39
7457,theShatteredOne,,18,28,71,99
7458,joemawlma,,31,12,8,20
7459,leolapinos,,1,1,1,2
7460,scott2368,,0,16,6,22
7461,sonofpookie,,19,72,88,160
7462,vmalarcon,,19,3,2,5
7463,balinx,,14,151,124,275
7464,kanak,,20,761,417,1178
7465,robert_plants_bulge,,13,5,3,8
7466,shrimp,,19,60,3,63
7467,chipmunc56,,20,1,1,2
7468,shyvyr,,19,7,7,14
7469,consultant_barbie,,20,64,168,232
7470,radarsat1,,20,57,82,139
7471,airguitarhero,,18,1,10,11
7472,fani,,34,108,158,266
7473,shaver,,20,3,6,9
7474,jwesleyclark,,36,9,3,12
7475,Gerald_Broflovski,,30,3,1,4
7476,skizmo,,32,57,110,167
7477,WrongSubreddit,,18,27,18,45
7478,asheu,,20,23,22,45
7479,I_Also_Like_Pie,,8,3,2,5
7480,UagenZlepe,,20,6,15,21
7481,sweetjayjay,,31,3,9,12
7482,Erik_Naggum,,20,2,1,3
7483,frogger1995,,18,7,17,24
7484,CoagulatedMilk,,32,12,18,30
7485,crazy4,,21,2,8,10
7486,thanatos001,,1,1,1,2
7487,kevin143,,19,226,52,278
7488,concernedcitizen2,,18,2,2,4
7489,haljordan,,16,4,5,9
7490,touche,,32,7,7,14
7491,fugue88,,20,4,10,14
7492,zambuka42,,43,3,7,10
7493,LIEberal,,18,19,33,52
7494,DrSin,,31,4,6,10
7495,LADalt,,4,1,2,3
7496,bosk,,20,1,3,4
7497,phobosdiemosx,,13,3,8,11
7498,kyrandian,,18,112,151,263
7499,EEPS,,31,5,1,6
7500,domchi,,22,12,4,16
7501,ericrolph,,32,19,25,44
7502,speakafreaka,,18,4,8,12
7503,Gremlin87,,34,6,3,9
7504,Emrecall,,13,25,17,42
7505,cpuetz,,43,74,132,206
7506,stransky,,20,38,39,77
7507,wow_reddit,,43,1,3,4
7508,andyduncan,,14,1,1,2
7509,phughes,,4,127,207,334
7510,theswingingdoor,,2,1,1,2
7511,80085,,19,1,3,4
7512,djepik,,1,208,231,439
7513,madfrogurt,,31,20,15,35
7514,ja30278,,19,19,24,43
7515,panphobia,,18,77,19,96
7516,Bridge_Dweller,,5,5,6,11
7517,tmatte,,1,22,23,45
7518,agnas,,20,2,2,4
7519,dimsdalehedgehog,,5,1,1,2
7520,ibrb,,19,1,2,3
7521,brsmits,,1,10,16,26
7522,raoulduke,,43,146,134,280
7523,fractal74,,29,1,5,6
7524,joemo,,18,1,1,2
7525,CorpusCallosum,,29,3,1,4
7526,Zenthor,,18,33,31,64
7527,scratchpunk7,,1,41,43,84
7528,nater99,,42,5,9,14
7529,jamsiepaine,,7,2,2,4
7530,Blackberry826,,6,1,3,4
7531,thodgson,,12,1,1,2
7532,andreasmk2,,20,6,12,18
7533,alurie,,12,1,3,4
7534,paisleyrob,,20,5,9,14
7535,PissinChicken,,13,4,11,15
7536,stronimo,,31,104,141,245
7537,simoncpu,,32,1,1,2
7538,Captain_Sarcastic,,14,1,3,4
7539,slabgorb,,20,155,203,358
7540,legolust,,18,7,6,13
7541,PissedNumlock,,22,3,4,7
7542,scared1,,12,210,255,465
7543,dar7yl,,9,2,1,3
7544,10acious,,43,14,50,64
7545,jpeel,,19,3,2,5
7546,RedHerringHack,,13,9,14,23
7547,walrod,,43,22,48,70
7548,typicaljoe,,20,53,7,60
7549,dnorton,,14,1,4,5
7550,krymise,,20,4,3,7
7551,Brianchef,,0,1,1,2
7552,allnewupdate,,13,4,2,6
7553,ZeroEffort,,43,37,64,101
7554,curlz,,19,11,5,16
7555,todddominey,,16,7,5,12
7556,roggor,,20,9,13,22
7557,larrypastore,,43,134,178,312
7558,emja,,18,14,24,38
7559,Abandon,,19,14,12,26
7560,xorxor,,6,98,147,245
7561,sjh3585,,12,59,118,177
7562,Sekenre,,20,6,3,9
7563,cyyip,,1,5,3,8
7564,pyroman8813,,1,2,1,3
7565,FireWorm,,43,120,29,149
7566,SEE_YOU_IN_HELL,,32,1,1,2
7567,contour,,20,43,17,60
7568,asnydercdw,,13,3,1,4
7569,erichansa,,5,8,3,11
7570,wolot,,18,1,1,2
7571,l0rddiabl0,,19,13,6,19
7572,kipmartin,,18,25,41,66
7573,JFrizzle,,20,6,6,12
7574,unclean1,,32,4,5,9
7575,lukehyper,,19,4,6,10
7576,mrcoder,,0,163,337,500
7577,syrinx,,19,1,6,7
7578,wetjack,,18,53,143,196
7579,asphodelian,,32,11,43,54
7580,hollywoodphony,,22,29,6,35
7581,jrxq,,32,36,66,102
7582,ushitomo,,22,13,25,38
7583,doctor_yukio_hattori,,20,98,170,268
7584,FritzMuffknuckle,,19,5,9,14
7585,woknroll,,41,6,4,10
7586,jfenserty,,1,1,1,2
7587,Operation_dooms,,43,6,7,13
7588,JohnFive,,19,40,15,55
7589,mecharedneck,,1,63,125,188
7590,hecubus,,30,65,91,156
7591,yellownumberfive,,32,331,337,668
7592,bluntbord,,23,2,4,6
7593,snz3,,21,1,5,6
7594,longboarder543,,42,34,22,56
7595,easymovieref,,19,6,3,9
7596,CCCCCCOMBOBREAKER,,18,6,11,17
7597,hexmode,,19,63,14,77
7598,socialmedia,,5,1,1,2
7599,mig21,,20,49,7,56
7600,MikaelMN,,19,457,19,476
7601,evoLverR,,18,7,12,19
7602,Joff1979,,31,18,15,33
7603,Locke87,,43,61,71,132
7604,redwall_hp,,22,163,301,464
7605,danleykubrick,,13,26,20,46
7606,dedac,,1,23,45,68
7607,joetehplumr,,6,1,1,2
7608,kilimanjaro,,20,9,12,21
7609,Jonathan_the_Nerd,,29,292,359,651
7610,ivey,,20,56,31,87
7611,chimere,,18,5,10,15
7612,MrKlaatu,,34,908,2515,3423
7613,paxit,,0,81,24,105
7614,MrHector,,19,102,28,130
7615,personanongrata,,1,29,9,38
7616,Frostyausty,,18,23,22,45
7617,pdoken,,13,3,9,12
7618,strikethephone,,12,1,1,2
7619,ittybiggy,,13,3,3,6
7620,tjdziuba-h8r,,20,1,1,2
7621,kalsyrinth,,22,17,26,43
7622,iuserailsdurrrrr,,19,4,2,6
7623,julaun,,19,20,40,60
7624,djl,,20,3,4,7
7625,NeuroSys,,20,4,6,10
7626,charbo187,,34,951,1062,2013
7627,nolij420,,18,6,12,18
7628,arcterex,,1,1,1,2
7629,66666,,19,6,13,19
7630,curomo,,18,17,31,48
7631,aktornado,,19,130,91,221
7632,jasonok,,18,18,4,22
7633,kallell,,18,180,16,196
7634,itzar,,9,2,2,4
7635,nraustinii,,35,4,5,9
7636,jlmayo,,31,1,2,3
7637,sanders8,,43,13,33,46
7638,vengeance64,,19,3,2,5
7639,nick_l,,8,1,1,2
7640,Sobek,,0,11,10,21
7641,peacedove,,13,5,6,11
7642,rapsey,,20,24,14,38
7643,shishou,,18,15,36,51
7644,freedomist,,13,2,4,6
7645,pixelbeat_,,20,74,63,137
7646,allhere,,34,9,26,35
7647,TheNightCat,,18,10,16,26
7648,w0wzers,,2,4,13,17
7649,doliorules,,20,36,62,98
7650,GamingTrend,,1,8,6,14
7651,RevantRed,,11,9,18,27
7652,elazutkin,,20,4,10,14
7653,grantmidwinter,,1,227,255,482
7654,redification,,18,107,296,403
7655,metrofeed,,18,133,42,175
7656,Inzamam,,19,14,13,27
7657,TheDancingSalad,,1,10,1,11
7658,Ephemeral_Node,,43,8,5,13
7659,myaj2000,,31,2,3,5
7660,maritzay,,18,1,3,4
7661,robitor,,29,7,24,31
7662,rodjam,,19,2,1,3
7663,rikardlinde,,1,5,2,7
7664,interpreter,,36,1,1,2
7665,Ic0n0clast,,29,94,53,147
7666,SanMikeva,,13,3,2,5
7667,auxxin,,27,6,9,15
7668,Woeful,,13,153,236,389
7669,Tychotesla,,34,3,9,12
7670,intypicalredditfashi,,20,4,4,8
7671,crapulent666,,1,1,2,3
7672,jinko1,,31,5,3,8
7673,danielrm26,,13,577,100,677
7674,Excremento,,42,94,16,110
7675,cynicist,,19,7,12,19
7676,permafrost91,,13,8,4,12
7677,helmut1,,18,1,1,2
7678,heythisisgandhi,,18,131,258,389
7679,burobudar,,36,2,1,3
7680,ringthorp,,32,1,3,4
7681,mitchbones,,1,205,91,296
7682,mapeni,,13,7,15,22
7683,thegalli,,18,203,129,332
7684,xingo,,22,46,122,168
7685,Shadow120,,31,10,10,20
7686,olt,,20,6,3,9
7687,Construct,,13,3,3,6
7688,mulligan,,19,36,34,70
7689,Praesil,,34,64,61,125
7690,rumpusroom,,6,110,139,249
7691,WooParadog,,31,2,1,3
7692,squirt_aka,,8,1,1,2
7693,mikkachops,,43,7,22,29
7694,ADNyce,,13,2,3,5
7695,primbet,,19,27,4,31
7696,d3r1v3d,,42,3,1,4
7697,kdraper,,22,163,304,467
7698,mrtomservo,,19,93,87,180
7699,tigeratty,,1,1,1,2
7700,Nikakoda,,29,1,1,2
7701,chadm,,20,12,23,35
7702,cardinalcajetan,,4,2,1,3
7703,thebacon,,10,8,3,11
7704,christopheles,,18,949,390,1339
7705,kc1man,,12,36,44,80
7706,sanchokeep33,,18,7,4,11
7707,sixstrings,,19,16,4,20
7708,indyjones16,,13,14,9,23
7709,counterspammer,,22,1,2,3
7710,wildster,,20,7,6,13
7711,kinkydarkbird,,19,208,306,514
7712,thebean,,5,1,2,3
7713,Ickypoopy,,32,82,131,213
7714,karapuz1,,31,42,47,89
7715,testleft,,20,7,9,16
7716,DURIDS_has_CAT_FROM,,22,9,24,33
7717,dresden1,,13,1,1,2
7718,mando5ths,,43,2,1,3
7719,savagestranger,,19,18,48,66
7720,df-sean,,1,1,1,2
7721,robmyers,,20,8,10,18
7722,groihbfg,,20,6,3,9
7723,irit1885,,18,3,5,8
7724,doingtimeonearth,,18,11,8,19
7725,lexabear,,1,60,81,141
7726,KneeGrowMAD,,42,1,2,3
7727,Pounce_ca,,13,49,16,65
7728,compu73rg33k,,31,1,8,9
7729,simplify,,43,125,102,227
7730,hatefulhater,,22,1,1,2
7731,qartis,,20,15,28,43
7732,ennead,,34,7,6,13
7733,purplebottle,,18,1,3,4
7734,eMaster101,,5,106,10,116
7735,cokekiller,,20,1,1,2
7736,onelasttime,,19,67,66,133
7737,RPftWO8,,31,4,6,10
7738,jtauber,,20,6,8,14
7739,Filmore,,12,650,890,1540
7740,dratman,,13,2,4,6
7741,eterps,,20,52,23,75
7742,someonesdaughter,,19,2,11,13
7743,w0waddict,,23,3,1,4
7744,CodenameEvan,,34,62,107,169
7745,MoeDrippins,,20,88,66,154
7746,fasdfasdfardas,,16,2,1,3
7747,qazsxx,,41,9,3,12
7748,c0sm1c8,,18,2,3,5
7749,Steffers,,29,2,1,3
7750,kylelap,,5,6,1,7
7751,danuvian,,30,4,4,8
7752,guswatkins,,19,1,2,3
7753,pdq,,20,54,42,96
7754,sugar_man,,34,7,11,18
7755,Tbola,,36,2,1,3
7756,mizike,,31,20,26,46
7757,roaplyn,,3,1,2,3
7758,playbass,,23,6,12,18
7759,jkatlanta,,18,8,2,10
7760,thecity,,43,9,13,22
7761,elberto,,2,5,4,9
7762,FesteringZodiacFairy,,13,1,4,5
7763,jjonphl,,19,1,5,6
7764,flynnfx,,5,42,45,87
7765,jslav201,,35,4,1,5
7766,NickZee,,32,10,9,19
7767,chipt4,,43,27,38,65
7768,petevalle,,4,155,188,343
7769,aerojad,,6,204,55,259
7770,redhenteam,,20,3,3,6
7771,imwalrus,,5,3,4,7
7772,zestor,,22,5,10,15
7773,blackicepro,,18,86,3,89
7774,r00kie,,17,278,494,772
7775,bingoczar,,17,111,61,172
7776,ForeverTangent,,12,9,1,10
7777,poi0987,,20,6,3,9
7778,General_Hilarity,,15,62,61,123
7779,TyroneSloth,,19,1,10,11
7780,sdfgkluj,,20,58,59,117
7781,2x4,,30,1,2,3
7782,the_vanguardian,,19,34,4,38
7783,liberte49,,13,12,22,34
7784,Taikoto,,13,1,4,5
7785,kemibe,,31,12,9,21
7786,someshta,,19,9,2,11
7787,aestheticreddit,,18,14,13,27
7788,tazmanic,,18,4,6,10
7789,JohnFromChicago,,40,7,1,8
7790,epiclogin,,34,102,48,150
7791,masterdirk,,20,66,78,144
7792,gozmeranian,,32,594,174,768
7793,topherclay,,43,315,610,925
7794,ioiioiloi,,43,1,6,7
7795,daoine_sidhe,,13,2,2,4
7796,aacase,,0,48,26,74
7797,HalcyonSskyler,,13,24,30,54
7798,swiftbuttsfortruth,,22,6,8,14
7799,axul,,20,1,2,3
7800,magz0r,,18,6,7,13
7801,Birdy58033,,34,9,8,17
7802,SnackConcepts,,39,20,24,44
7803,Squarsh,,12,126,76,202
7804,Sierra81,,13,25,2,27
7805,Virjyl,,42,2,1,3
7806,andrewjstone,,20,3,8,11
7807,mozahid,,19,6,6,12
7808,gigaset,,19,3,5,8
7809,gregturn,,20,2,6,8
7810,molls22,,31,3,1,4
7811,earthtograndma,,20,1,1,2
7812,tftb,,18,1,3,4
7813,5seconds,,18,5,1,6
7814,smylie,,20,5,3,8
7815,rule,,20,61,67,128
7816,skazhy,,20,35,13,48
7817,traxstarz,,13,6,14,20
7818,masont,,20,13,16,29
7819,Jumile,,32,20,41,61
7820,fcukbear,,39,213,86,299
7821,teeks,,41,10,7,17
7822,bagley,,3,3,2,5
7823,lotkrotan,,18,2,16,18
7824,lmanc,,12,1,1,2
7825,Flying_Teapot,,34,9,22,31
7826,bagofcats,,18,1,3,4
7827,sgtdiarrhea,,20,2,4,6
7828,north,,18,21,30,51
7829,LinesOpen,,30,45,37,82
7830,aajenkin,,13,1,1,2
7831,mblakele,,20,1,3,4
7832,newbie27,,0,5,10,15
7833,rockhoward,,20,2,18,20
7834,brockelyn,,0,15,30,45
7835,red_cloud,,1,6,21,27
7836,justaname,,32,6,16,22
7837,ngrudin,,0,1,1,2
7838,randomusername2,,18,2,1,3
7839,anon_smoker,,34,2,3,5
7840,dotist,,18,5,3,8
7841,codergirl,,30,1,1,2
7842,etiole,,13,3,1,4
7843,jdvolz,,20,8,6,14
7844,zephos,,16,7,4,11
7845,alina_popescu,,5,18,8,26
7846,foobster,,18,1,4,5
7847,narcalexi,,13,2,2,4
7848,mattrepl,,20,22,16,38
7849,Frankbert,,18,3,4,7
7850,happyhappy,,20,51,79,130
7851,balgarath,,20,3,5,8
7852,magicducksauce,,0,39,50,89
7853,tblarson,,19,407,31,438
7854,Mentor,,19,5,9,14
7855,AlucardZero,,12,20,22,42
7856,CabSyrah,,1,1,1,2
7857,InfoWarrior905,,19,36,51,87
7858,case-o-nuts,,20,171,236,407
7859,pjesi,,20,1,10,11
7860,binro,,13,4,3,7
7861,User202,,1,4,10,14
7862,meatpopsikle,,4,11,14,25
7863,-omg-optimized,,20,43,75,118
7864,iTroll,,1,95,40,135
7865,redawn,,18,97,172,269
7866,sherkaner,,29,96,142,238
7867,tookus,,19,1,3,4
7868,pRedditor11,,6,19,22,41
7869,blindcyde,,36,6,6,12
7870,Zoocchini,,43,4,16,20
7871,sockmarionette,,32,27,1,28
7872,manateesareneat,,11,93,106,199
7873,rodgling,,1,4,4,8
7874,funkyfurry,,32,1,1,2
7875,datamichaelxxx,,19,7,6,13
7876,Berry_Logo,,14,38,24,62
7877,spraynard,,18,4,13,17
7878,Monopolies,,18,8,19,27
7879,justjim73,,13,801,180,981
7880,xgerrit,,20,1,1,2
7881,insaneflame24,,4,18,12,30
7882,beosnitch,,32,6,18,24
7883,Coffee_Apocalypse,,18,13,4,17
7884,idoubleplusedyourmom,,22,1,1,2
7885,gnat23,,0,62,1,63
7886,Wallstreet,,14,2,2,4
7887,jokesterss,,42,1,2,3
7888,zerok,,20,4,1,5
7889,mirra,,18,10,13,23
7890,epic,,16,17,30,47
7891,noyfbfoad,,1,1,2,3
7892,Cardin,,31,1,1,2
7893,gwright,,19,15,18,33
7894,pr0methium,,35,8,3,11
7895,seattlebartender,,8,2,4,6
7896,kylcrow,,10,1,1,2
7897,100EducWay,,13,1,1,2
7898,Emolee,,7,9,7,16
7899,dirkmcdirt,,0,33,13,46
7900,hsdkfhusfhuio,,6,1,2,3
7901,jones77,,42,948,1172,2120
7902,Clevedog,,1,38,44,82
7903,the_engineer_says,,29,2,1,3
7904,chibioz,,13,16,28,44
7905,chaitujm,,18,30,13,43
7906,HilldogBigTitsYayuh,,19,1,2,3
7907,cesarwal,,18,6,22,28
7908,bridgietherease,,19,24,31,55
7909,stewdick,,20,17,12,29
7910,yardwaste,,13,11,10,21
7911,branston,,20,112,146,258
7912,notes,,34,6,16,22
7913,PastorX,,18,3,4,7
7914,El_Fajitas,,43,6,11,17
7915,prometeus,,20,2,2,4
7916,hoooked,,13,8,25,33
7917,pjf,,20,2,1,3
7918,ki11a11hippies,,12,498,234,732
7919,MrSarcasm,,43,2,4,6
7920,astraycat,,4,1,4,5
7921,prophet001,,0,70,129,199
7922,mumumum,,19,2,2,4
7923,fasterx,,19,1,6,7
7924,othermatt,,1,3,4,7
7925,maddpaky,,22,3,1,4
7926,Enginerd,,13,224,412,636
7927,hemmicw9,,19,103,45,148
7928,chuz0,,18,2,7,9
7929,Tabooyah,,4,9,7,16
7930,saysthegiraffe,,0,3,1,4
7931,davidlvann,,0,17,13,30
7932,milesaday,,23,2,2,4
7933,2skinny,,13,8,17,25
7934,MagicOtter,,18,1,1,2
7935,onar,,31,1,1,2
7936,mattbarclay,,22,6,10,16
7937,Anzi,,14,16,33,49
7938,remmosi,,36,1,2,3
7939,Deadpixel1221,,18,309,89,398
7940,surreal1,,19,5,9,14
7941,greenman7,,18,4,16,20
7942,Intrepid1,,10,1,1,2
7943,philipjfry,,22,10,8,18
7944,ulric,,20,1,3,4
7945,debeli,,31,2,2,4
7946,QueBarbara,,13,18,10,28
7947,kgsokl,,19,36,44,80
7948,jefehurst,,43,1,1,2
7949,Internal_Affairs_Dpt,,22,1,1,2
7950,llanor,,3,644,775,1419
7951,justastatistic,,18,20,16,36
7952,slb,,29,75,47,122
7953,travois,,31,1,2,3
7954,Lee_Nukes,,1,18,35,53
7955,ak01,,1,1,1,2
7956,fakeaccount1,,1,7,1,8
7957,btanaka,,1,3,1,4
7958,catnamedmax,,29,99,70,169
7959,cwd67,,18,4,10,14
7960,titusbrown,,20,2,4,6
7961,pragma,,20,98,12,110
7962,Meltacular,,1,1,1,2
7963,chneukirchen,,20,126,139,265
7964,panamaspace,,1,225,379,604
7965,benlund,,19,16,17,33
7966,dkeinge,,13,1,2,3
7967,paf0,,19,289,156,445
7968,Bwardrop,,18,9,2,11
7969,TheRealSwoop,,22,18,5,23
7970,bokchoy20,,11,5,2,7
7971,Audity,,13,1,1,2
7972,msaint,,18,12,12,24
7973,kevingessner,,20,4,1,5
7974,splorky,,43,1,1,2
7975,oddly,,18,1,1,2
7976,destijl13,,41,8,11,19
7977,br0wn0ut,,0,5,3,8
7978,demoniusrex,,1,9,4,13
7979,wrongwindow,,43,6,14,20
7980,Lunitide,,19,13,23,36
7981,baxyjr,,0,47,70,117
7982,hesika,,12,1,1,2
7983,ballpressure,,18,202,211,413
7984,pongo,,32,61,73,134
7985,lude,,20,13,7,20
7986,jkldfkjldfakjladsf,,13,1,1,2
7987,flavor8,,20,63,82,145
7988,saft,,18,4,8,12
7989,Shannonigans,,18,34,77,111
7990,dimitrij,,0,2,1,3
7991,lordvirus,,29,1,1,2
7992,nekosej,,20,2,1,3
7993,kickthatbass,,7,3,2,5
7994,personsaddress,,18,2,6,8
7995,homestyle,,19,2,2,4
7996,olivia_2,,29,2,1,3
7997,amandalea,,43,1,4,5
7998,usernameII,,0,1,1,2
7999,dobaman,,19,131,185,316
8000,dienaid,,18,2,2,4
8001,ltjpunk387,,18,29,29,58
8002,matelotgeek,,18,25,96,121
8003,triplewide,,31,1,2,3
8004,twotimepostaccount,,13,3,1,4
8005,captain_gordino,,43,156,274,430
8006,Anderson82,,29,5,8,13
8007,mds,,10,2,6,8
8008,Quicksilver_Johny,,14,1,2,3
8009,goobegudde,,1,1,2,3
8010,FlashRage,,4,2,2,4
8011,papelboner,,32,16,3,19
8012,drebeck,,33,56,11,67
8013,NaziGrammar,,13,18,39,57
8014,postur3,,10,3,1,4
8015,dozo,,19,1,1,2
8016,pat_o,,0,65,16,81
8017,reasonattlm,,13,30,3,33
8018,chunkyslink,,3,14,9,23
8019,brunetteonabudget,,34,3,2,5
8020,yanni,,20,30,23,53
8021,rogerssucks,,1,1257,1575,2832
8022,iocchelli,,32,52,78,130
8023,JerkfaceMcGee,,6,5,2,7
8024,loopla,,5,4,2,6
8025,jonah-,,31,2,5,7
8026,hunli,,18,5,6,11
8027,TallStu,,32,1,1,2
8028,andrewd,,19,923,1111,2034
8029,singingfish42,,20,35,33,68
8030,EsotericFox,,20,15,14,29
8031,asshole123,,31,1,1,2
8032,wendelgee2,,19,67,112,179
8033,lisp-hacker,,20,19,30,49
8034,hansolo,,0,17,26,43
8035,AutomatedTrollBot,,22,9,9,18
8036,marijn,,20,65,76,141
8037,techtoy,,18,16,17,33
8038,deaddjembe,,1,3,1,4
8039,Luinitari,,29,2,1,3
8040,mhatt,,13,49,51,100
8041,tenken,,12,402,80,482
8042,garrgh,,20,28,27,55
8043,ender6,,30,35,42,77
8044,shakestheclown,,43,14,31,45
8045,jinkop38,,22,1,2,3
8046,antmandan,,22,6,4,10
8047,gotjuice,,18,819,2,821
8048,arne,,1,3,7,10
8049,photogtony,,42,2,1,3
8050,vishnuvardhanraop,,18,7,1,8
8051,eserorg,,20,1,1,2
8052,enri,,13,7,17,24
8053,birdlives,,13,2,3,5
8054,fuelvolts,,32,12,9,21
8055,Sovereign,,19,1,1,2
8056,Sylense,,13,11,12,23
8057,Sukoshi,,20,17,33,50
8058,alucididea,,31,1,1,2
8059,fastfinge,,30,1,2,3
8060,tdrizzle,,19,149,152,301
8061,njm,,20,5,5,10
8062,dahburbb,,15,1,2,3
8063,gpowell88,,19,4,1,5
8064,bbrian1,,20,3,6,9
8065,Turno,,19,17,11,28
8066,oniall,,19,1,6,7
8067,DartStudent,,4,1,1,2
8068,Logoll,,32,54,62,116
8069,kawauchi,,41,15,1,16
8070,fino963,,30,1,2,3
8071,niggles,,32,18,17,35
8072,pushpin,,0,99,271,370
8073,picrad,,4,1,3,4
8074,bumrushtheshow,,31,2,5,7
8075,kevinalright,,6,2,4,6
8076,ThirstyFerret,,18,2,1,3
8077,skiaec04,,20,24,22,46
8078,leonstagg428,,31,1,1,2
8079,thoroughly,,18,5,6,11
8080,dharh,,5,28,56,84
8081,jeramey,,20,2,9,11
8082,e_to_the_m,,18,37,4,41
8083,lar,,18,83,9,92
8084,hurfery,,32,17,24,41
8085,kubrickrules,,31,3,7,10
8086,denimdragon,,13,1,2,3
8087,mimic,,12,57,152,209
8088,bowie36,,11,2,1,3
8089,nycjohndoe,,42,21,25,46
8090,Non_Sequitur_,,22,21,26,47
8091,andnow,,31,11,16,27
8092,unshifted,,32,127,140,267
8093,Weirdsmobile,,13,2,2,4
8094,mkk,,1,3,5,8
8095,seven10design,,27,1,1,2
8096,borud,,20,25,39,64
8097,reddit-QA,,41,4,5,9
8098,gracin,,20,7,5,12
8099,Manny82,,18,27,20,47
8100,flecknoe,,13,6,4,10
8101,blunster,,29,1,2,3
8102,Blue_Eskimo,,18,67,47,114
8103,alcanada,,0,89,50,139
8104,cendant,,19,71,39,110
8105,Pappenheimer,,18,327,511,838
8106,ssander,,0,83,33,116
8107,cemerick,,20,10,6,16
8108,timothyfitz,,20,3,6,9
8109,jnzfin,,18,6,8,14
8110,paspektibu,,32,18,19,37
8111,kdizzle13,,31,24,24,48
8112,BoardColorado,,43,32,36,68
8113,criswell,,18,79,142,221
8114,beermann,,20,3,2,5
8115,J0hnDvorak,,18,11,10,21
8116,michelle1959,,13,1,1,2
8117,gnomemage7,,22,7,10,17
8118,smaster87,,19,15,20,35
8119,NeverReadsTheArticle,,34,12,39,51
8120,qoumran,,8,1,2,3
8121,daemmon,,19,33,43,76
8122,GWaleed,,13,89,164,253
8123,Frobenius,,22,145,116,261
8124,bensone1,,1,10,17,27
8125,eluusive,,4,3,2,5
8126,spolsky,,31,10,4,14
8127,stevesan,,20,61,105,166
8128,duncanbojangles,,20,32,44,76
8129,bob4apples,,30,43,108,151
8130,alkfjasldf,,43,1,1,2
8131,meglet,,22,323,379,702
8132,Xiol,,20,411,530,941
8133,shivoham,,34,5,3,8
8134,coutourier,,14,1,4,5
8135,sabrina17331979,,13,10,18,28
8136,sesh,,19,50,16,66
8137,ast3r3x,,13,1,2,3
8138,royalawesome,,1,3,7,10
8139,TeejPDX,,30,1,1,2
8140,MonsieurX,,1,1,1,2
8141,jackolantern75,,13,15,1,16
8142,pkunk,,19,26,27,53
8143,IceCreamYou,,13,15,1,16
8144,ralphthewonderlama,,14,1,1,2
8145,raouldagain,,20,24,27,51
8146,malenky,,32,14,7,21
8147,ogeidnas,,20,7,12,19
8148,ithkuil,,20,145,154,299
8149,z0id,,20,28,14,42
8150,edelweisspirate,,13,14,21,35
8151,doubleD,,1,6,6,12
8152,louismg,,8,32,5,37
8153,SlightlyEmbarassed12,,22,1,1,2
8154,Chancy,,32,120,41,161
8155,Kayeak7,,34,1,2,3
8156,mossman,,8,41,56,97
8157,spelunker,,32,184,211,395
8158,TheHolyBible,,42,1,2,3
8159,jay71,,19,2,2,4
8160,BHGDigital,,41,2,1,3
8161,pussnboots,,31,2,2,4
8162,37prime,,18,1,4,5
8163,jdickinson,,20,5,6,11
8164,purplecow,,18,14,16,30
8165,cqxray,,32,3,4,7
8166,ObamaCampaign,,18,15,19,34
8167,tanka,,20,8,12,20
8168,poco,,30,313,497,810
8169,Dorphat,,0,7,9,16
8170,mgeisler,,20,1,2,3
8171,toastbot,,18,3,11,14
8172,formated4tv,,42,31,39,70
8173,Abegale,,3,1,1,2
8174,beamrider9,,32,118,4,122
8175,cf80,,36,14,12,26
8176,shadoi,,19,1,1,2
8177,opennorse,,1,7,1,8
8178,alicetiara,,18,1,1,2
8179,MarginOfError,,13,36,59,95
8180,Snowflake23,,17,1,1,2
8181,pedokip,,28,4,7,11
8182,jaysonbank,,19,517,581,1098
8183,Insignificant,,43,262,493,755
8184,jeepxj206,,13,16,7,23
8185,golgi42,,29,2,1,3
8186,ar8699,,31,13,14,27
8187,powersoffour,,20,2,1,3
8188,Arkonnan,,30,53,86,139
8189,bojancho,,32,227,111,338
8190,wackoquackosacko,,11,1,1,2
8191,fanboyssuck,,19,1,1,2
8192,ahminus,,13,44,74,118
8193,techshaman,,19,11,1,12
8194,morfin,,11,4,4,8
8195,ShannonO,,1,16,21,37
8196,cuzzy,,18,48,13,61
8197,PickledJesus,,42,9,9,18
8198,rtfmplease,,20,1,1,2
8199,cdellin,,18,1,1,2
8200,skippy17,,10,548,610,1158
8201,roorksw,,34,9,16,25
8202,erinsikora,,30,1,1,2
8203,brymax,,31,73,51,124
8204,J-Bone,,15,114,46,160
8205,o0dano0o,,22,52,80,132
8206,milkymanchester,,20,3,4,7
8207,hetmankp,,20,10,9,19
8208,potifer,,32,40,61,101
8209,splynch,,36,1,1,2
8210,BREAKING_OMG,,0,246,251,497
8211,codingjester,,1,3,8,11
8212,cstod83,,1,15,36,51
8213,syn-abounds,,43,464,252,716
8214,macnomad84,,34,33,41,74
8215,takebackcongress,,32,1,1,2
8216,hayzeus,,20,39,91,130
8217,SeanC,,43,2,1,3
8218,pkhuong,,20,53,81,134
8219,devolute,,22,229,362,591
8220,jojopotato,,20,6,15,21
8221,Rythin,,13,11,4,15
8222,nibinathion,,22,7,3,10
8223,tontovila,,13,23,20,43
8224,nolife,,14,1,4,5
8225,widestancedude,,19,13,12,25
8226,masg11,,32,1,1,2
8227,fyl899,,42,2,1,3
8228,uberto,,18,45,86,131
8229,arantius,,20,43,63,106
8230,taclbo,,27,2,2,4
8231,truthersaredumb,,13,1,1,2
8232,Cronof,,31,10,6,16
8233,Alexd007,,30,11,11,22
8234,sanchopanza,,43,2,7,9
8235,profblix,,19,21,29,50
8236,cofun,,20,1,1,2
8237,LostOne,,18,4,5,9
8238,Cbird54,,42,21,33,54
8239,machocheese,,11,1,2,3
8240,starkwhite,,19,188,164,352
8241,Skip_Town,,1,31,47,78
8242,IngsocFTW,,18,17,27,44
8243,carvdouttawood,,32,9,4,13
8244,roguebagel,,3,35,29,64
8245,Consumer-Warning,,31,3,7,10
8246,irjav,,19,2,3,5
8247,yesimalex,,32,2,1,3
8248,Lukadium,,18,705,10,715
8249,celebrity208,,20,1,1,2
8250,raman00,,19,10,7,17
8251,brettbum,,5,1,1,2
8252,saromanenko,,20,1,1,2
8253,carlospc,,18,6,19,25
8254,trbo20,,18,74,65,139
8255,syngen,,38,11,11,22
8256,mtanski,,19,5,4,9
8257,wnbe,,13,22,20,42
8258,RonPaulUsesLisp,,20,4,4,8
8259,cemason9009,,20,3,1,4
8260,lameuser,,18,3,2,5
8261,moussif,,31,13,14,27
8262,SamsLembas,,14,194,217,411
8263,karapuz,,31,12,12,24
8264,MoreCowbellPlease,,13,33,67,100
8265,trezor2,,20,402,513,915
8266,politicon,,29,3,3,6
8267,nomecks,,11,8,2,10
8268,Mrs_Sinner,,19,2,1,3
8269,ruffyamaharyder,,26,1,1,2
8270,Escher0,,15,3,5,8
8271,apsampson,,13,6,17,23
8272,Quizbiz,,31,36,83,119
8273,brainspan,,18,1,3,4
8274,Texel,,32,20,37,57
8275,lordgilman,,20,7,10,17
8276,malekov,,10,136,147,283
8277,diggeasytiger,,19,1,1,2
8278,assman13,,29,2,2,4
8279,zeindaman,,15,3,2,5
8280,tagx,,20,3,3,6
8281,Thats_What_She_Said,,0,2,1,3
8282,ACArticulate,,11,1,1,2
8283,UNTmeangreen,,13,5,8,13
8284,funksta,,20,36,37,73
8285,gamerates,,42,11,1,12
8286,MonumentMan,,18,31,31,62
8287,russianbandit,,18,423,82,505
8288,k79,,29,1,6,7
8289,jacksofscience,,34,5,3,8
8290,stratonike,,30,2,1,3
8291,mlawless1138,,34,322,105,427
8292,barney52,,15,8,6,14
8293,powerfuless,,6,35,47,82
8294,hannityisgod,,23,4,1,5
8295,dwils27,,33,51,82,133
8296,rnichols,,34,29,35,64
8297,mstubz,,13,1,1,2
8298,2phatgeeks,,0,24,1,25
8299,os851,,42,2,13,15
8300,hippely,,0,2,2,4
8301,spinemangler,,18,47,57,104
8302,montreal01,,19,532,92,624
8303,rugby8man,,18,94,37,131
8304,SpiritBreakr,,13,130,10,140
8305,lelthompson,,13,3,1,4
8306,monopoleroy,,13,175,49,224
8307,kyew,,3,1,3,4
8308,aquanutz,,20,26,51,77
8309,farang,,13,12,27,39
8310,mrboj,,22,9,2,11
8311,RasberryTurtle,,43,1,1,2
8312,thewriteguy,,12,150,148,298
8313,jnag,,1,156,201,357
8314,lorena,,0,125,24,149
8315,earlsofsandwich,,19,58,37,95
8316,skinnyuser,,18,1,1,2
8317,posiduck,,32,15,11,26
8318,CodeRedEd,,0,1,4,5
8319,oOllOo,,5,2,2,4
8320,brokencow,,34,1,3,4
8321,parismay34,,15,3,1,4
8322,mechastyle,,32,2,4,6
8323,buzzbeepbeep,,18,39,5,44
8324,arpunk,,20,1,1,2
8325,wankerbot,,13,292,461,753
8326,jkatz,,13,10,5,15
8327,jimmybob34,,34,5,11,16
8328,hunter9000,,5,75,149,224
8329,tunacow,,43,3,2,5
8330,jwb1504,,6,1,1,2
8331,robbyking,,18,23,50,73
8332,vidmark156,,28,2,2,4
8333,SnakeWaisted,,22,1,1,2
8334,lowerlogic,,29,3,6,9
8335,pwim,,20,13,5,18
8336,texmex,,31,36,83,119
8337,HansHotter,,31,13,13,26
8338,global360,,13,56,12,68
8339,NoYouAreTheFucktard,,15,1,1,2
8340,notpeter,,20,5,11,16
8341,nakor28,,32,2,2,4
8342,smashcrab,,15,2,1,3
8343,freshmas,,5,1,4,5
8344,sblinn,,29,1173,1551,2724
8345,bluefish101,,1,2,1,3
8346,gordohimself,,19,2,1,3
8347,judgsjobs,,21,2,1,3
8348,BentonMiller,,1,4,3,7
8349,spiretop,,32,2,1,3
8350,DocTomoe,,18,105,143,248
8351,dmi123,,40,3,4,7
8352,SyncMaster,,19,29,66,95
8353,Jjess311,,30,1,3,4
8354,kstauss,,0,1,1,2
8355,MUGATU66,,43,1,1,2
8356,dHoser,,17,314,510,824
8357,qda,,18,51,133,184
8358,br1776,,19,109,44,153
8359,brotherfirefly,,13,32,40,72
8360,maxxpower5000,,32,1,1,2
8361,semmi,,20,58,77,135
8362,DoorM,,13,11,14,25
8363,bpgb,,14,3,4,7
8364,dgilby,,30,2,2,4
8365,bekkle,,31,66,79,145
8366,mcohenATbulbsDOTcom,,31,18,3,21
8367,colindean,,13,2,2,4
8368,RaceAgainstAtrophy,,13,2,1,3
8369,KramitTheFrog44,,13,5,10,15
8370,mgainor,,1,1,1,2
8371,dwinnk,,13,1,1,2
8372,Haddaway,,32,21,25,46
8373,thesantini,,18,2,4,6
8374,justincase1021,,18,42,109,151
8375,grav,,20,2,9,11
8376,Sealab2021,,22,15,7,22
8377,Brenden105,,18,33,27,60
8378,Comic_Sans_MS,,1,4,5,9
8379,GodDamnedX,,43,1,6,7
8380,tywolff,,43,13,16,29
8381,sauce2,,13,7,9,16
8382,variableenigma,,18,2,3,5
8383,mooseclamps,,18,11,21,32
8384,carac,,20,213,293,506
8385,wustudybreak,,20,22,22,44
8386,conmulligan,,0,17,11,28
8387,MrData,,20,7,7,14
8388,Captain_Midnight,,31,282,332,614
8389,austin_k,,20,127,181,308
8390,sassmo,,18,7,3,10
8391,TheHobo,,30,6,5,11
8392,Boxorz,,4,1,1,2
8393,jwimberly,,15,1,2,3
8394,0124816,,20,8,21,29
8395,NoodlyAppendage,,1,111,214,325
8396,pudica,,32,10,9,19
8397,EFall26,,19,8,11,19
8398,zaphod_42,,22,132,116,248
8399,maxwellimus,,0,13,6,19
8400,kerbuffel,,1,359,349,708
8401,deephouse24,,18,24,25,49
8402,crox,,13,25,7,32
8403,TaterRecon,,6,12,27,39
8404,incomingfire,,18,17,26,43
8405,spikey1000,,1,37,48,85
8406,kalimistuk,,19,1,1,2
8407,Internet_Meme,,22,100,90,190
8408,el_bandito,,18,4,1,5
8409,supersauce,,32,515,1074,1589
8410,grimmuss,,31,8,24,32
8411,star-d,,19,335,115,450
8412,Technica,,19,2,1,3
8413,eugene_victor_tooms,,20,79,19,98
8414,LeNoir,,0,90,113,203
8415,madelinecn,,1,209,162,371
8416,clivefx,,18,8,20,28
8417,transeunte,,18,32,51,83
8418,sartak,,20,31,54,85
8419,vootiebox,,31,334,272,606
8420,Timequake,,13,4,5,9
8421,heresybob,,32,205,349,554
8422,miborovsky,,34,113,191,304
8423,mrjuandrful,,42,94,13,107
8424,mmmscallops,,16,2,2,4
8425,tulsakev,,8,2,3,5
8426,oxygen2,,18,20,2,22
8427,jstrebel,,20,2,1,3
8428,mikusjay,,19,4,10,14
8429,gene9,,20,5,2,7
8430,96mileshome,,19,13,17,30
8431,heyjon,,19,22,23,45
8432,ralphwiggum,,1,218,332,550
8433,littlefinger,,13,61,15,76
8434,badseedjr,,20,17,16,33
8435,zyzzx0,,22,8,10,18
8436,shisno,,43,2,3,5
8437,asr,,31,168,204,372
8438,rail16,,18,3,10,13
8439,RedGarland,,42,1,1,2
8440,Klama,,43,1,1,2
8441,vladk,,19,3,2,5
8442,inabsolutes,,20,1,1,2
8443,gottareadit,,18,185,366,551
8444,TheGunner,,37,3,8,11
8445,TheMachine,,26,62,21,83
8446,forrestparkay,,6,50,76,126
8447,epsilona01,,19,533,951,1484
8448,root,,20,10,10,20
8449,z0m_a,,13,38,49,87
8450,blinz,,23,2,2,4
8451,porkcharsui,,14,16,9,25
8452,davidreiss666,,36,1784,1247,3031
8453,mizunoz,,29,3,3,6
8454,pingwin,,42,3,3,6
8455,heh_yeh,,13,221,205,426
8456,danielg7,,0,46,74,120
8457,enkafan,,5,228,200,428
8458,fr0z3nph03n1x,,3,9,11,20
8459,neura,,42,52,46,98
8460,Artmageddon,,3,110,178,288
8461,ronpaulist,,20,3,2,5
8462,mateo3,,43,1,1,2
8463,CozyGundam,,13,6,5,11
8464,don_draper,,34,1,2,3
8465,Rockmaninoff,,1,13,6,19
8466,brave_new_world,,32,1,2,3
8467,tji,,8,1,2,3
8468,benackerman,,13,2,2,4
8469,NightcrawlerX,,5,104,13,117
8470,hishuu,,1,15,29,44
8471,Dubfire,,13,15,4,19
8472,fredhersher,,34,28,1,29
8473,tpahornet,,13,1,11,12
8474,actionscripted,,32,38,73,111
8475,generic-identity,,32,1,2,3
8476,ei2g,,13,8,1,9
8477,tlynnsimon,,18,2,1,3
8478,winnipegtommy,,34,134,169,303
8479,losferwords,,13,57,50,107
8480,GoTeamAmerica,,42,1,1,2
8481,karmachu,,17,3,2,5
8482,mijamala1,,31,17,14,31
8483,deese64,,16,1,2,3
8484,goobersmooch,,19,4,2,6
8485,brianwisti,,20,1,5,6
8486,alterEgon,,43,1,1,2
8487,jonnythin,,18,1,3,4
8488,adamfbs,,31,6,8,14
8489,ciontaba,,13,25,31,56
8490,redditspirit,,5,13,4,17
8491,somedeveloper,,29,8,2,10
8492,Keeri3,,18,10,32,42
8493,Individualista,,43,6,4,10
8494,pny,,22,2,1,3
8495,ronideutch,,19,7,7,14
8496,ajayrockrock,,32,7,13,20
8497,99percentchimp,,32,4,2,6
8498,firefruze,,18,120,296,416
8499,BandraK,,30,2,3,5
8500,kanchan_1304,,22,1,1,2
8501,keithnoir,,19,4,3,7
8502,herrmann,,20,26,11,37
8503,nexus2112,,20,15,19,34
8504,cyrusmancub,,19,2,1,3
8505,caswyn,,1,5,4,9
8506,michaeljones7,,8,2,2,4
8507,BlackJelly,,19,31,22,53
8508,happymcclinch,,13,7,5,12
8509,SJurgenson,,20,10,6,16
8510,tranquil,,8,1,1,2
8511,dcg,,42,2,2,4
8512,martincmartin,,20,135,77,212
8513,chanandler_bong,,32,4,1,5
8514,cavorite,,20,11,7,18
8515,marktron,,19,54,63,117
8516,goober8008,,31,69,135,204
8517,stroop,,16,1,2,3
8518,fvincentis,,34,21,29,50
8519,samehereyo,,13,11,12,23
8520,Prod,,0,13,15,28
8521,zwood,,15,3,8,11
8522,helloworldbea,,18,266,87,353
8523,jshirley,,20,2,3,5
8524,orsa,,4,16,18,34
8525,--------------------,,20,4,4,8
8526,Barack_Obama,,19,2,1,3
8527,Raisins,,18,233,10,243
8528,thrillho,,6,1,1,2
8529,super_duper,,43,46,67,113
8530,dassouki,,20,48,51,99
8531,raopm,,20,9,1,10
8532,willlin87,,0,25,55,80
8533,jp007,,1,46,97,143
8534,strained_brain,,12,6,4,10
8535,normal,,26,4,8,12
8536,mikeylikesit,,18,1,1,2
8537,oakleez,,0,115,7,122
8538,moldworld2008,,12,5,1,6
8539,skandel,,31,7,3,10
8540,SysAdmin412,,31,15,1,16
8541,dr_spork,,32,61,91,152
8542,JOEINDIAK,,13,10,20,30
8543,baalduriel,,30,1,3,4
8544,sgfsdfgsdfg,,18,160,165,325
8545,NEWSUNSEO,,18,2,1,3
8546,corporate_america,,19,4,8,12
8547,bryanveloso,,1,1,1,2
8548,hseldon_99,,19,2,7,9
8549,asfsadf,,19,4,2,6
8550,gtbth,,33,1,9,10
8551,eve6andahalf,,43,13,9,22
8552,mogmog,,20,349,423,772
8553,techsticle,,18,25,29,54
8554,Dadelus,,13,103,95,198
8555,kaptainlange,,31,213,330,543
8556,bustamove259,,28,1,1,2
8557,jspeights,,0,32,47,79
8558,vivaladisney,,18,10,14,24
8559,fandyboy,,0,6,10,16
8560,slim_nick,,19,1,3,4
8561,cycle2,,18,49,49,98
8562,modality,,18,8,12,20
8563,SrGrieves,,20,8,8,16
8564,sonicreducer333,,19,316,193,509
8565,arockthebebop,,12,1,2,3
8566,crzytech1,,22,16,16,32
8567,shaymoss,,4,1,2,3
8568,jodonoghue,,20,1,5,6
8569,danteferno,,20,1,1,2
8570,totalnet,,13,1,1,2
8571,notgibb,,13,179,154,333
8572,Curvature,,4,1,3,4
8573,mayuge_born,,41,9,12,21
8574,z144man,,31,4,16,20
8575,Errol,,21,5,1,6
8576,canonymousoward,,31,1,1,2
8577,spezdispenser,,19,7,5,12
8578,jals,,1,78,30,108
8579,greenmoon,,13,13,23,36
8580,freewine,,19,32,2,34
8581,jetcopter,,5,3,4,7
8582,skullphuct,,40,2,1,3
8583,arwb,,29,4,6,10
8584,Unsmith,,13,7,11,18
8585,Gregste,,43,2,1,3
8586,SSChicken,,18,7,2,9
8587,karatechops,,18,262,249,511
8588,pmazer,,20,1,1,2
8589,oneblue,,1,2,2,4
8590,andrewli4,,29,3,2,5
8591,gracenotes,,20,25,36,61
8592,88dan88,,5,218,372,590
8593,balibones,,5,25,18,43
8594,zenif,,43,45,83,128
8595,laluser,,12,32,24,56
8596,qwertys,,19,94,177,271
8597,thesupermario,,20,3,2,5
8598,mattmattmatt,,0,8,4,12
8599,robewald,,20,6,13,19
8600,hilldog,,18,82,153,235
8601,egbert,,18,214,54,268
8602,Futurepower,,1,1,2,3
8603,maytard,,0,1,1,2
8604,EternalVigilance,,13,1365,656,2021
8605,Readmore,,20,8,3,11
8606,thephilip,,18,46,19,65
8607,outofline,,22,1,1,2
8608,Pillowtalk,,32,104,166,270
8609,Hypn0s,,19,5,3,8
8610,capecode,,31,36,18,54
8611,markon,,20,6,4,10
8612,digginahole,,6,169,167,336
8613,sfluke20,,19,4,3,7
8614,johndisko,,18,1,4,5
8615,Ripzerskins,,18,12,25,37
8616,speeddaemon,,13,19,12,31
8617,jawdirk,,13,10,15,25
8618,urnyfy,,14,1,1,2
8619,mikelanzaro,,13,1,11,12
8620,Old_Timer,,0,18,17,35
8621,SteveD88,,18,181,197,378
8622,Rollouts,,1,5,4,9
8623,select,,18,12,8,20
8624,simonw,,20,80,87,167
8625,mbuf,,19,44,6,50
8626,pdrummond,,20,35,11,46
8627,disbelief,,4,6,5,11
8628,djblade1501,,1,2,1,3
8629,arkestra,,15,1,1,2
8630,giiik,,43,10,11,21
8631,christinextine,,6,2,1,3
8632,AKStuart,,13,3,5,8
8633,DL_Adidas,,1,1,1,2
8634,theredgiant,,18,353,31,384
8635,infinityvortex,,22,376,595,971
8636,herchen,,34,2,7,9
8637,anal_avenger,,12,3,5,8
8638,yome,,20,34,8,42
8639,jamwil,,31,5,8,13
8640,goj1ra,,31,48,85,133
8641,dailydishabille,,18,69,123,192
8642,TylerDurdenJunior,,19,184,77,261
8643,sizeight,,18,1,1,2
8644,ugnaught,,18,18,1,19
8645,beepsy,,42,8,6,14
8646,epicrdr,,34,102,175,277
8647,cholouno,,8,6,2,8
8648,dankimberly,,18,63,6,69
8649,tarwreck,,18,23,11,34
8650,method3,,42,25,27,52
8651,logicalnoise,,12,159,236,395
8652,orang,,18,89,67,156
8653,buhao,,13,4,1,5
8654,TheWildRover,,13,80,121,201
8655,rallyscag,,18,46,74,120
8656,Jeuk,,20,14,15,29
8657,genericerik,,22,22,11,33
8658,wumpushunter,,18,27,34,61
8659,engled68,,32,3,6,9
8660,Retinality,,19,6,2,8
8661,felinonymous,,0,1,1,2
8662,jagoff,,20,1,1,2
8663,twildz,,22,2,3,5
8664,factive,,5,2,5,7
8665,MissCellania,,18,7,9,16
8666,Formosus,,19,120,33,153
8667,nurseyourself,,28,6,3,9
8668,epsys,,31,127,99,226
8669,chucklarge,,20,1,1,2
8670,alpheccar,,20,33,11,44
8671,amichail,,20,118,49,167
8672,Elephantnews,,19,35,6,41
8673,lpettinati,,20,1,3,4
8674,avidyan,,18,1,2,3
8675,thegroom97,,20,4,3,7
8676,msblows,,34,1,1,2
8677,sugargirl,,5,18,18,36
8678,Daugaard,,20,81,136,217
8679,squeazy,,30,2,15,17
8680,stiflin,,20,11,12,23
8681,Jedai,,20,39,75,114
8682,pierski,,42,2,1,3
8683,ScratchMyJunk,,31,1,1,2
8684,booze,,19,2,1,3
8685,cliche-buster,,43,7,7,14
8686,dsdsds1,,13,19,44,63
8687,gunnerclark,,19,35,69,104
8688,mitchelwb,,6,1,4,5
8689,cthulhufhtagn,,1,556,424,980
8690,medspapa,,19,68,17,85
8691,harold_the_rebel,,20,23,25,48
8692,natterca,,18,4,4,8
8693,doopwoop,,43,1,1,2
8694,hillary2008,,19,5,2,7
8695,unkyduck,,13,115,325,440
8696,dingo_paschal,,19,18,58,76
8697,dirtnyureye,,18,1,2,3
8698,Tucci,,18,497,625,1122
8699,MooseCack,,19,20,35,55
8700,kavabula,,13,15,1,16
8701,ramen2666,,32,26,53,79
8702,sfx,,42,137,176,313
8703,jane73,,19,1,2,3
8704,KaptTorbjorn,,42,3,1,4
8705,paulc,,29,18,10,28
8706,notfancy,,20,296,436,732
8707,xrahull,,13,4,2,6
8708,eredicatorx,,18,6,16,22
8709,eyephotoguy,,0,1,1,2
8710,PPSF,,13,15,22,37
8711,writejdp,,19,58,27,85
8712,PicsOrItDidntHappen,,0,2,5,7
8713,upatrail,,13,2,1,3
8714,MorlokMan,,1,1,8,9
8715,jowdyboy,,18,1,3,4
8716,laforge,,42,13,17,30
8717,harlanji,,20,3,2,5
8718,r3dd173r,,19,718,140,858
8719,packmath,,19,6,2,8
8720,Huge_Penis,,43,5,7,12
8721,jook,,19,12,17,29
8722,silviusperry,,10,1,2,3
8723,sho19132,,13,41,19,60
8724,jleedev,,20,40,58,98
8725,Mendokusai,,5,2000,97,2097
8726,yqhardiel,,32,445,234,679
8727,mrlanemeyer,,6,1,1,2
8728,phogster,,42,3,1,4
8729,dantesfurnose,,14,1,1,2
8730,BeerSteak,,22,20,20,40
8731,CrackIsGoodForYou,,18,674,800,1474
8732,emorgant,,19,3,8,11
8733,omgmypony,,9,2,6,8
8734,mistergosh,,18,15,20,35
8735,marlowmarlowmarlow,,42,2,2,4
8736,equivoque,,30,10,2,12
8737,terryb088,,17,17,23,40
8738,gotmike,,11,4,1,5
8739,crayon78,,34,6,1,7
8740,JohnnyT9,,13,1,1,2
8741,bartczernicki,,22,1,1,2
8742,inventedscrap,,20,2,2,4
8743,roybatty,,20,5,7,12
8744,shazzzang,,34,1,1,2
8745,jmt1234,,32,4,8,12
8746,philasurfer,,13,986,139,1125
8747,piptastic,,20,19,26,45
8748,stevehnsn,,5,19,6,25
8749,tacoblah,,0,1,2,3
8750,nhelm83,,29,172,59,231
8751,MediaMoguls,,34,568,265,833
8752,all2hell,,18,13,24,37
8753,UlisesBrambila,,43,22,34,56
8754,tastytacos,,12,3,4,7
8755,aynrandfan,,32,252,97,349
8756,warget,,43,6,5,11
8757,akila9182,,18,1,1,2
8758,Parallax_Corp,,19,3,1,4
8759,ursnafu,,9,3,2,5
8760,foolman89,,18,12,20,32
8761,individual1,,16,1,1,2
8762,NickM,,34,27,21,48
8763,Timmy83,,29,89,143,232
8764,xaplexus,,19,129,234,363
8765,soupcan,,20,2,4,6
8766,yoniroit,,31,16,13,29
8767,minutillo,,20,12,13,25
8768,boojit,,18,12,13,25
8769,dawnfinder,,10,12,11,23
8770,flybirdiefly,,41,2,8,10
8771,Sherwooder,,0,51,8,59
8772,I_LIKE_PI,,8,1,1,2
8773,dirtmcgurk,,22,40,55,95
8774,justinhj,,20,190,230,420
8775,sylvikhan,,31,2,2,4
8776,Sam8131,,18,2,5,7
8777,hasNextInt,,32,53,1,54
8778,Chasmosaur,,18,21,1,22
8779,elettroreddit,,20,332,8,340
8780,kewlboontjies,,34,49,16,65
8781,begdorf,,5,3,8,11
8782,jerryred,,25,1,1,2
8783,igrigorik,,5,1,1,2
8784,satoshen,,1,3,2,5
8785,bondolo,,30,180,166,346
8786,colourAgga,,20,138,25,163
8787,MrJoeSmith,,32,1,2,3
8788,epalla,,31,36,34,70
8789,MrBean99999,,43,1,1,2
8790,wiifm69,,22,25,21,46
8791,gwynvir,,13,8,17,25
8792,merik_jb,,22,11,10,21
8793,microstuck,,31,5,2,7
8794,ashleyw,,1,8,16,24
8795,pbears,,18,1,2,3
8796,foilhead,,10,1,1,2
8797,yougoslaviayougo,,8,2,1,3
8798,johnfudrow,,43,1,1,2
8799,scottmaxim,,13,8,2,10
8800,troymcdavis,,4,328,480,808
8801,ramises,,19,250,41,291
8802,nostrich,,43,51,1,52
8803,qqqqqqqqq,,29,13,28,41
8804,ugubabba,,13,1,3,4
8805,torabisu,,6,9,10,19
8806,bigattack,,23,1,2,3
8807,tacklebox12,,10,1,2,3
8808,bostonusa2020,,0,2,8,10
8809,pcronin,,13,7,6,13
8810,GTanaka,,31,10,15,25
8811,Glendon,,22,4,2,6
8812,ryal,,13,5,8,13
8813,saradoc,,12,1,1,2
8814,wselman,,22,1,1,2
8815,Wiggles69,,0,46,84,130
8816,avzett,,19,54,44,98
8817,genuinepolitician,,31,236,445,681
8818,quazy,,0,1,2,3
8819,vonralls,,18,19,55,74
8820,listerinemouth,,5,2,2,4
8821,Franks2000inchTV,,32,130,62,192
8822,c3nder,,20,1,1,2
8823,hednej,,0,10,9,19
8824,pistonhonda1987,,36,1,3,4
8825,Tim56,,8,2,1,3
8826,clathrate,,20,18,32,50
8827,RX3715,,31,22,30,52
8828,lvwhtboyz,,4,2,1,3
8829,SovietRussia,,43,2,1,3
8830,DesCo83,,18,82,51,133
8831,BladeBV,,43,93,7,100
8832,yelaina,,12,1,4,5
8833,SteveAM1,,35,500,265,765
8834,npinguy,,34,106,113,219
8835,catfiesta,,20,1,6,7
8836,astitious,,19,80,80,160
8837,catsrgr8,,15,26,35,61
8838,bexamous,,34,8,12,20
8839,gazonvagon,,14,1,1,2
8840,norbertyappa,,28,1,2,3
8841,turfmuffin,,40,2,2,4
8842,zillode,,18,1,1,2
8843,DAVYWAVY,,13,3,7,10
8844,yourefiredpal,,22,79,119,198
8845,TheHapacalypse,,1,75,116,191
8846,Zac8241,,0,1,2,3
8847,manaleid,,20,3,3,6
8848,ChernobylBaby,,31,20,29,49
8849,aleph1,,19,7,15,22
8850,samlee,,20,399,426,825
8851,demoneyes,,1,34,21,55
8852,blackpage,,18,13,20,33
8853,neolefty,,43,98,131,229
8854,littleking,,13,4,7,11
8855,lanthus,,20,79,63,142
8856,anjamerret,,5,20,18,38
8857,stevejust,,42,1,2,3
8858,Kaoz,,31,2,1,3
8859,bearp,,41,5,4,9
8860,sling,,22,3,1,4
8861,SwordOfShannara,,13,7,2,9
8862,dreyruugr,,34,1,6,7
8863,radix89,,5,13,32,45
8864,txsteele,,43,4,9,13
8865,stugy,,20,46,50,96
8866,facebook1234,,13,4,5,9
8867,insert_name_here,,1,29,8,37
8868,meg1938,,19,13,2,15
8869,snoozzell,,42,3,3,6
8870,bongy,,5,13,14,27
8871,kirun,,22,589,1013,1602
8872,gavri,,32,12,11,23
8873,patrickomatic,,17,3,2,5
8874,icantthinkofone,,20,24,60,84
8875,eyereddit,,32,17,26,43
8876,bitflip,,43,14,16,30
8877,gravitypushes,,0,166,5,171
8878,lonelliott,,6,400,559,959
8879,creiss74,,13,86,122,208
8880,65165434518435,,31,1,1,2
8881,lazukars,,19,80,69,149
8882,rio517,,5,232,110,342
8883,TheActionCombo,,19,3,3,6
8884,jordiculous,,6,76,28,104
8885,FunnyMan3595,,20,267,375,642
8886,ymrhawk,,4,2,2,4
8887,Vaste,,20,100,161,261
8888,caesar79,,31,3,4,7
8889,gossipgirlz,,13,111,2,113
8890,matholio,,20,91,159,250
8891,apz,,20,2,3,5
8892,sandrejev,,20,1,2,3
8893,derefr,,20,494,648,1142
8894,reseph,,18,292,167,459
8895,SpiderJerusalem,,17,125,292,417
8896,tcdoey,,13,310,145,455
8897,monkeyback,,6,2,1,3
8898,Zaden,,8,2,2,4
8899,Sports_Maniac,,11,1,2,3
8900,pablogott,,8,47,62,109
8901,anamerican,,19,33,2,35
8902,ElricOfLisaBonet,,32,138,224,362
8903,Gotebe,,20,369,646,1015
8904,Mr_Sadist,,12,1652,319,1971
8905,eunos,,5,26,31,57
8906,ginger_balls,,0,72,103,175
8907,transienthobo,,13,14,28,42
8908,PoliticsSubredditCop,,13,125,324,449
8909,santabear25,,19,7,3,10
8910,__unsigned,,20,1,3,4
8911,toastyfries2,,1,250,443,693
8912,sabrewulf,,13,61,61,122
8913,GiannyL,,43,71,2,73
8914,j2d2,,0,161,232,393
8915,sariwat1,,13,2,6,8
8916,destinyland,,0,153,4,157
8917,raedix,,10,913,1271,2184
8918,Yifkong,,13,4,8,12
8919,LabThug,,12,39,68,107
8920,KosmoTheSynner,,32,101,189,290
8921,beemer330,,16,2,2,4
8922,dpzdpz,,1,329,385,714
8923,jonplim,,17,2,1,3
8924,faxxy,,31,8,17,25
8925,evandena,,43,61,68,129
8926,randommouse,,1,2,5,7
8927,drworm,,21,9,12,21
8928,drexil,,20,8,8,16
8929,itzkoolaid,,1,16,27,43
8930,cookingrobot,,22,12,15,27
8931,edbutler3,,34,29,58,87
8932,kijiki,,20,9,12,21
8933,obamaramama,,19,3,1,4
8934,EdwardCoffin,,0,3,4,7
8935,masklinn,,20,1343,2027,3370
8936,GreekStyle,,13,18,22,40
8937,grotnag,,19,7,6,13
8938,anthropology_nerd,,1,453,127,580
8939,drakarian,,6,14,25,39
8940,Lionhart,,10,3,4,7
8941,DopeyRopi,,19,2,2,4
8942,jjbbff,,14,1,2,3
8943,aaronwinningham,,13,42,6,48
8944,SapoLoco,,1,34,10,44
8945,artistry,,18,1,2,3
8946,nmcfarl,,31,2,6,8
8947,typwo,,0,6,9,15
8948,wildmXranat,,20,95,206,301
8949,antibios,,18,58,100,158
8950,Celauran,,33,2,4,6
8951,Bhaald,,13,6,4,10
8952,cyberfreak77,,18,1437,83,1520
8953,myristika,,18,88,185,273
8954,quazarjim,,1,25,52,77
8955,blazingti,,1,24,83,107
8956,lordymann,,17,1,1,2
8957,toadstool,,13,1,3,4
8958,farfinio,,11,1,1,2
8959,xinxy,,29,11,16,27
8960,rustdnails,,1,2,4,6
8961,Soulsbane,,20,7,2,9
8962,Velvette,,43,5,18,23
8963,peturoh,,18,25,13,38
8964,vitalyb,,31,39,35,74
8965,guest,,19,306,254,560
8966,Renniks,,19,48,54,102
8967,Borster,,19,2,3,5
8968,brainsik,,20,4,1,5
8969,specialdogg,,18,2,4,6
8970,villaged,,32,21,27,48
8971,nmessenger,,31,2,3,5
8972,net_junkie,,31,5,5,10
8973,sandout,,19,2,2,4
8974,ericsilver,,22,2,3,5
8975,phooey,,29,1,1,2
8976,DracheMitch,,32,5,8,13
8977,apodemos,,1,1,2,3
8978,x414353,,20,1,1,2
8979,AltTab,,1,16,40,56
8980,cuptocanada,,13,55,63,118
8981,Scutters,,18,1,5,6
8982,fishbones,,13,25,14,39
8983,lurkergirl,,19,5,4,9
8984,kiwipete,,20,58,64,122
8985,jeffbarnett513,,19,1,2,3
8986,Slickselixir,,34,47,67,114
8987,jungalero,,43,2,1,3
8988,lukejames,,19,2,2,4
8989,the_big_wedding,,19,647,713,1360
8990,Luminoth,,3,129,142,271
8991,ekimneems,,13,9,3,12
8992,sashapave,,18,1,3,4
8993,papercrane,,20,12,9,21
8994,gpn,,20,1,1,2
8995,mtaclof,,34,75,94,169
8996,that_guy,,8,2,4,6
8997,EventHorizon,,22,19,16,35
8998,harveyat,,4,7,5,12
8999,abc2014,,13,27,16,43
9000,dikaiosyne_the_wolf,,19,8,2,10
9001,rbu,,19,18,5,23
9002,pepgma,,30,5,4,9
9003,JustinHN1,,19,1,2,3
9004,chinoflav,,13,38,71,109
9005,drdballard,,34,6,8,14
9006,fizzy742,,4,3,5,8
9007,NeleH,,12,2,1,3
9008,nickydean,,1,26,40,66
9009,teabaggingmedia,,14,1,2,3
9010,timoleon,,8,239,468,707
9011,batok,,20,2,3,5
9012,freesid,,20,10,15,25
9013,Georgiacc,,22,4,7,11
9014,Simon280586,,19,7,7,14
9015,DaGoodBoy,,20,22,19,41
9016,jamesduvall,,30,3,6,9
9017,sleppnir,,32,165,378,543
9018,sensiblegirl,,18,18,43,61
9019,MoMan82,,29,2,13,15
9020,OceanSpray,,20,95,163,258
9021,Haitian_Mud_Eater,,19,8,10,18
9022,pochacco20,,22,2,4,6
9023,madmosche,,18,1,1,2
9024,Murdoc,,19,2,1,3
9025,compnski,,20,10,8,18
9026,wcalvert,,1,52,78,130
9027,Emardhi,,32,12,23,35
9028,antoniofabio,,20,5,13,18
9029,snuggleslut,,18,70,58,128
9030,broccolitroll,,4,2,1,3
9031,splatter_pattern,,18,5,8,13
9032,anonymous_howard,,7,1,1,2
9033,drgalaxy,,18,4,11,15
9034,spectre78,,1,1,1,2
9035,notheory,,20,10,7,17
9036,reverendpoon,,18,1,2,3
9037,GuavaFoo,,14,3,2,5
9038,johns-appendix,,6,31,62,93
9039,Ojai,,34,155,166,321
9040,fumar,,12,58,87,145
9041,ballm,,20,31,1,32
9042,xkero,,18,20,39,59
9043,ericpratum,,1,38,13,51
9044,mantra,,8,191,367,558
9045,citizen_snips,,18,16,23,39
9046,mattn,,41,1,1,2
9047,wearie,,1,1,1,2
9048,unled,,22,6,17,23
9049,orb,,20,94,167,261
9050,zencynic,,16,12,28,40
9051,nightshifter,,18,37,84,121
9052,gordonguthrie,,20,4,11,15
9053,rcj023000,,1,1,1,2
9054,sinnyin,,29,1,1,2
9055,fivewand,,7,2,1,3
9056,mapoftasmania,,13,245,264,509
9057,agrover,,20,4,8,12
9058,n_felon,,22,15,1,16
9059,getson,,36,17,4,21
9060,natlite,,26,3,6,9
9061,redditalienhasabig,,19,1,2,3
9062,bugmenot47,,22,31,46,77
9063,marstall,,20,15,12,27
9064,killhouse82,,39,1,6,7
9065,joe2100,,43,4,6,10
9066,RichardRoe,,13,10,13,23
9067,ladybonezzz,,13,1,1,2
9068,elie195,,5,1,2,3
9069,tibbe,,20,13,14,27
9070,smilli02,,19,28,34,62
9071,sniping4dummies,,19,30,33,63
9072,lisakay123,,5,1,3,4
9073,rudhdogg,,1,3,4,7
9074,dunsany,,19,1,1,2
9075,psychicsailboat,,32,2,2,4
9076,takker,,0,1,1,2
9077,ripbingers,,19,13,23,36
9078,Silhouette,,20,325,440,765
9079,RationalEgoist,,4,3,2,5
9080,Romantix,,18,4,5,9
9081,max3000,,2,2,2,4
9082,politics,,5,201,122,323
9083,redditnews,,19,91,6,97
9084,Archica,,31,2,2,4
9085,cmdrNacho,,32,10,19,29
9086,Bubblechaser,,13,1,3,4
9087,notjawn,,18,37,118,155
9088,TheKidd,,13,147,75,222
9089,pillage,,19,674,1089,1763
9090,whiprat,,13,10,5,15
9091,brandyn_w,,12,1,2,3
9092,andrewljohnson,,20,13,20,33
9093,huxtiblejones,,1,481,533,1014
9094,Detuned,,0,3,8,11
9095,Bevatron,,13,21,26,47
9096,pkaine,,13,29,13,42
9097,ragesoss,,10,91,119,210
9098,otheraccount,,18,1,2,3
9099,k2tse,,1,1,6,7
9100,jimmyr2021,,19,14,19,33
9101,bryan0514,,19,3,2,5
9102,lyso,,32,2,1,3
9103,Darkmeerkat,,4,383,404,787
9104,Jesus____Christ,,43,1,2,3
9105,moonchic,,13,3,4,7
9106,connerfitzgerald,,18,4,4,8
9107,jmagar,,12,1,2,3
9108,stop_it,,43,1,1,2
9109,memccoy,,21,1,1,2
9110,munney,,32,2,8,10
9111,nolman,,1,4,16,20
9112,FaithyPop,,18,78,5,83
9113,bmg50barrett,,18,4,12,16
9114,Blacky4McCain,,19,1,1,2
9115,druzix,,13,4,9,13
9116,gimpishi,,32,13,17,30
9117,vasken,,19,9,6,15
9118,Mnbvc,,8,4,4,8
9119,theonusta,,4,65,41,106
9120,thecitydesk,,29,6,4,10
9121,humdrum,,19,14,4,18
9122,mrtubby,,6,1,1,2
9123,kamillus,,18,1,1,2
9124,obamarama,,13,45,46,91
9125,johnresig,,5,6,14,20
9126,wildfire,,33,1,1,2
9127,pucko,,34,1,1,2
9128,sduff,,31,1,1,2
9129,IrrigatedPancake,,31,448,830,1278
9130,Dilettante,,4,3,3,6
9131,jamesnvc1,,20,2,3,5
9132,samongoose,,1,5,6,11
9133,Raptor7,,21,5,3,8
9134,facepalm,,19,4,5,9
9135,nagdude,,13,63,92,155
9136,chjb,,31,2,2,4
9137,rickhunter333,,28,2,2,4
9138,jparram,,19,130,81,211
9139,atlantic,,8,109,186,295
9140,silon,,20,28,61,89
9141,sandesh247,,20,6,1,7
9142,jansobieski,,19,5,5,10
9143,dmz,,20,127,16,143
9144,valloq,,18,11,9,20
9145,BradJ,,34,2,3,5
9146,SconnyRotten,,19,3,2,5
9147,Targeted,,20,3,1,4
9148,liron00,,43,46,75,121
9149,coax75ohm,,20,2,3,5
9150,CCRRJJ,,18,4,24,28
9151,HypoLuza,,22,1,2,3
9152,jstrong,,31,16,16,32
9153,xanderzeshredmeister,,18,25,40,65
9154,vintermann,,29,495,929,1424
9155,Domitri,,8,1,4,5
9156,elektro,,43,4,6,10
9157,enobrev,,20,22,10,32
9158,dude78_3,,6,68,76,144
9159,retrac,,32,32,4,36
9160,aselbst,,19,39,49,88
9161,daviday,,19,76,1,77
9162,AlasdairA,,20,1,1,2
9163,amackera,,18,12,25,37
9164,hadlongopposed,,19,2,2,4
9165,Ashex,,12,561,589,1150
9166,killerbiscuit,,34,30,8,38
9167,LowerHorn,,5,2,3,5
9168,witigonen,,1,14,2,16
9169,p1zawL,,13,2,2,4
9170,TheChris,,30,2,2,4
9171,gertjan,,4,2,1,3
9172,jewdass,,35,20,40,60
9173,Leila0373,,31,9,9,18
9174,cr125er,,1,4,8,12
9175,thefullcrimp,,32,3,3,6
9176,akakgo,,13,13,25,38
9177,yuseit,,41,1,1,2
9178,Microwave,,6,10,20,30
9179,hibryd,,6,281,259,540
9180,bulanga,,20,10,10,20
9181,brutus66,,19,110,197,307
9182,syphonn,,13,3,4,7
9183,billionareHuman,,41,1,2,3
9184,sschepis,,5,66,7,73
9185,one_word,,22,4,4,8
9186,Zabier,,0,17,51,68
9187,superegofox,,18,12,11,23
9188,cr0m,,19,3,7,10
9189,brexians,,1,3,1,4
9190,groupthinkjunkie,,18,105,150,255
9191,jonnnny,,13,4,3,7
9192,deki,,20,23,2,25
9193,deadA1ias,,1,63,73,136
9194,enfa,,18,1,3,4
9195,Solaris_,,19,17,24,41
9196,spik301,,1,2,2,4
9197,Culyt,,20,7,6,13
9198,gthsii,,1,14,31,45
9199,vthechef01,,19,1,4,5
9200,whenwe,,43,1,1,2
9201,raid517,,6,54,65,119
9202,rwbaskette,,6,17,22,39
9203,obscurity,,10,141,3,144
9204,lipjuicer,,19,333,307,640
9205,jpdoctor,,18,3,2,5
9206,cs80,,32,19,31,50
9207,alpinehigh,,43,8,8,16
9208,Articon,,19,2,3,5
9209,scienceisfun,,29,55,72,127
9210,NoFixedAbode,,19,43,46,89
9211,vlewis85,,43,3,6,9
9212,GuineaPig84,,19,129,316,445
9213,wizlb,,20,8,11,19
9214,yomammamia,,19,2,1,3
9215,bungle,,20,5,3,8
9216,his_jimboness,,18,1,3,4
9217,str8sin,,0,16,25,41
9218,MeetMyBackhand,,13,1,1,2
9219,jsaxton86,,43,2,1,3
9220,Octoman,,1,16,25,41
9221,phil-anderer,,0,10,1,11
9222,dvomedo,,20,1,5,6
9223,failfunnies,,1,1,1,2
9224,koolaidguy,,20,2,2,4
9225,ogrisel,,20,15,18,33
9226,zenox,,20,26,27,53
9227,ftrain,,20,8,1,9
9228,too_2th,,39,1,5,6
9229,quhaha,,20,335,344,679
9230,edovino,,18,2,5,7
9231,zekon,,33,4,1,5
9232,berean,,31,9,22,31
9233,blurrie,,12,28,84,112
9234,swivel,,18,28,21,49
9235,lobsters,,19,1804,251,2055
9236,pmdboi,,20,18,17,35
9237,Stooby,,42,122,144,266
9238,bonton,,13,12,4,16
9239,geiljd,,13,160,13,173
9240,oslash,,42,15,32,47
9241,lepht,,18,4,4,8
9242,granolajoe,,5,101,39,140
9243,drbonemonkey,,18,44,11,55
9244,stfudonny,,18,23,20,43
9245,TheMoo,,21,12,18,30
9246,rubink,,42,10,16,26
9247,oldmanstan,,20,2,3,5
9248,mqt,,20,52,6,58
9249,plbland,,12,4,4,8
9250,mvatlarge,,13,1,1,2
9251,shish,,18,2,2,4
9252,Pratyush,,43,1,2,3
9253,norimachebeer,,18,110,13,123
9254,heyruby,,31,22,36,58
9255,sabotank,,13,31,130,161
9256,uzmifue,,31,1,2,3
9257,landpirate,,17,2,4,6
9258,cinnix,,18,2,3,5
9259,Criminoboy,,31,344,249,593
9260,frosty1,,20,38,44,82
9261,HillaryRClinton,,16,1,2,3
9262,starfeeder,,42,276,122,398
9263,jtpesq,,30,2,3,5
9264,jdemery,,32,24,39,63
9265,mouse_user,,31,22,11,33
9266,bighemp,,18,7,6,13
9267,kemche,,18,1,4,5
9268,faerielfire,,18,313,284,597
9269,kirillt,,43,1,1,2
9270,cmucl-user,,31,1,1,2
9271,tubersalad,,42,1,2,3
9272,batrastard,,31,4,3,7
9273,eadmund,,20,1457,979,2436
9274,uberstuber,,22,118,161,279
9275,xcelsior,,13,19,13,32
9276,Shayateen,,13,56,22,78
9277,discopope,,19,3,6,9
9278,BearBearBaer,,12,1,3,4
9279,rav33n,,30,1,1,2
9280,angry_young_man,,34,2,2,4
9281,eruonna,,20,54,58,112
9282,ukygwdsa,,18,272,140,412
9283,leedalee23,,18,13,25,38
9284,kathmandu,,18,1,1,2
9285,Kioti,,3,3,1,4
9286,crusoe,,20,870,1518,2388
9287,catomaior,,10,1,1,2
9288,snarg,,18,5,14,19
9289,eurleif,,20,595,432,1027
9290,JJTizzle,,18,3,9,12
9291,relic2279,,17,1254,1427,2681
9292,bwchambers,,19,27,35,62
9293,jgarfink,,42,100,126,226
9294,nikosapi,,1,1,1,2
9295,alphadogg,,20,2,3,5
9296,thewhatifgirl,,13,2,1,3
9297,pridkett,,18,12,5,17
9298,jonpv,,20,9,19,28
9299,serhei,,20,58,65,123
9300,osp70,,14,59,90,149
9301,CunningRunt,,17,29,27,56
9302,lifofifo,,20,1,4,5
9303,sakodak,,10,47,41,88
9304,Slogby,,19,3,3,6
9305,blandry,,19,1,1,2
9306,Le_Prince,,5,4,9,13
9307,sebfisch,,20,6,3,9
9308,jehovaishere,,20,1,1,2
9309,EstebanVelour,,31,19,19,38
9310,midan22,,20,2,2,4
9311,danibx,,20,6,8,14
9312,mtkd,,5,163,54,217
9313,flyryan,,14,496,340,836
9314,buzzdiggity1,,5,327,32,359
9315,CJGibson,,18,2,8,10
9316,SFLawdog,,13,11,2,13
9317,2girls1me,,1,3,4,7
9318,krum,,20,132,164,296
9319,spatterlight,,22,24,23,47
9320,Sagan,,9,1,9,10
9321,draegtun,,20,4,2,6
9322,kennyman,,22,1,1,2
9323,mobyhead1,,13,85,128,213
9324,ProSauce,,34,1,1,2
9325,farkonian,,18,6,9,15
9326,losthalo,,14,1,2,3
9327,disco_kryptonite,,0,48,88,136
9328,nassrat,,13,2,10,12
9329,mizai,,20,59,92,151
9330,smallgovisbest,,19,22,53,75
9331,JimJones,,20,108,22,130
9332,sanitybit,,32,1,1,2
9333,oldguyfox,,19,25,4,29
9334,kewldude606,,1,25,30,55
9335,shakajumbo,,10,1,4,5
9336,eggsyntax,,13,2,3,5
9337,lekahe,,5,270,36,306
9338,candycorn,,19,3,8,11
9339,miraimatt,,18,7,2,9
9340,NeverGonna,,24,3,5,8
9341,rbcain,,13,2,2,4
9342,cecinepasunepipe,,19,32,63,95
9343,domstersch,,32,31,43,74
9344,RipRapRob,,18,32,44,76
9345,JeebusWept,,1,251,166,417
9346,ryanvm,,18,128,101,229
9347,Zoned,,32,27,56,83
9348,eitelj99,,5,8,2,10
9349,justin_henzie,,20,4,9,13
9350,cecilkorik,,30,518,827,1345
9351,urlnotfound,,8,1,1,2
9352,Flemlord,,19,2318,422,2740
9353,uhuh,,42,13,14,27
9354,bgog,,1,1,2,3
9355,45g,,20,14,11,25
9356,rhiltd,,15,1,5,6
9357,ijdk,,16,3,3,6
9358,loverollercoaster,,20,82,68,150
9359,Sirkkus,,29,9,7,16
9360,pycoder,,18,55,3,58
9361,JenniferG,,13,25,1,26
9362,eightfivezero,,1,4,4,8
9363,arthurdentlives,,41,1,2,3
9364,Merkilo,,18,2,4,6
9365,isaacand,,18,114,13,127
9366,salent241,,20,2,4,6
9367,i80and,,20,21,22,43
9368,bpowah,,8,6,9,15
9369,rtm1,,20,1,1,2
9370,Onemean98GT,,18,12,24,36
9371,leed25d,,5,59,122,181
9372,wthank,,34,2,5,7
9373,Saracudda,,13,5,4,9
9374,SolCheetah,,4,26,16,42
9375,geojaz,,19,66,85,151
9376,RepublicanMale,,12,2,1,3
9377,a47danger,,18,2,2,4
9378,dkraft,,18,42,42,84
9379,tubaTripper07,,39,1,3,4
9380,MercurialMadnessMan,,1,800,1558,2358
9381,Nils100,,32,3,1,4
9382,To0n1,,18,15,28,43
9383,opiates,,1,19,1,20
9384,LMRuane,,13,1,2,3
9385,craigg77,,13,5,9,14
9386,CaptainObIivious,,33,1,2,3
9387,karkaremtg,,20,6,2,8
9388,tonyb983,,18,4,4,8
9389,extrapolation,,5,1,1,2
9390,GoAwayStupidAI,,20,14,17,31
9391,mackh,,30,1,2,3
9392,rs8472,,31,4,5,9
9393,kurin,,20,116,152,268
9394,Big_McLargeHuge,,31,3,5,8
9395,taviso,,20,1,2,3
9396,lordbobo,,12,2,1,3
9397,jmhawk,,18,25,26,51
9398,BillyBraggFan333,,13,4,4,8
9399,iron_ball,,20,8,14,22
9400,kalayne8,,6,22,24,46
9401,jschaud,,4,1,2,3
9402,stardawg,,13,75,174,249
9403,beercheer,,0,2,2,4
9404,Xeiliex,,1,170,278,448
9405,fifth_element,,20,22,27,49
9406,SquirrelBoy,,19,24,1,25
9407,tollgate6,,4,1,1,2
9408,1point21_Jiggowatts,,0,8,8,16
9409,magnethy,,42,1,1,2
9410,dsummeriln,,36,3,4,7
9411,etank,,8,2,1,3
9412,nephros,,1,2,5,7
9413,dezro,,20,58,99,157
9414,bhb,,20,9,2,11
9415,netuserx,,5,115,24,139
9416,checolo,,31,3,12,15
9417,mangotree,,13,23,28,51
9418,unoladron,,18,87,23,110
9419,Leighther,,34,61,82,143
9420,proliberty,,13,52,3,55
9421,SiPCP,,22,11,15,26
9422,sporg,,43,1,1,2
9423,Zetavu,,1,7,4,11
9424,clem_acc,,0,1,2,3
9425,brennen,,20,386,490,876
9426,the_hmm,,1,4,4,8
9427,bumbledbee,,18,8,29,37
9428,Prorogue,,1,19,20,39
9429,plagiats,,1,2,2,4
9430,CaptainSmirko,,32,1,2,3
9431,pappy,,34,338,502,840
9432,zanelightning,,20,2,5,7
9433,tuoder,,32,1323,1447,2770
9434,chucklechops,,13,1,1,2
9435,kucinich-08,,8,2,1,3
9436,luemob,,11,1,3,4
9437,BobbyDelray,,1,2,1,3
9438,hilo,,7,4,5,9
9439,holdenk,,20,10,1,11
9440,People,,13,26,3,29
9441,biowar,,18,13,6,19
9442,hupp,,20,98,103,201
9443,steeled3,,8,97,57,154
9444,amitlu,,42,246,48,294
9445,AeroAggie,,1,38,22,60
9446,solarleaf07,,20,6,5,11
9447,vgtaluskie,,13,3,4,7
9448,notwhereyouthink,,19,2,1,3
9449,pedantic_man,,22,12,11,23
9450,trypsin200,,0,23,20,43
9451,lorderunion,,18,36,132,168
9452,nonades,,42,21,46,67
9453,czawadzki,,13,87,101,188
9454,RegretfulMorning,,0,7,16,23
9455,noahhealy,,2,1,1,2
9456,assholelikethat,,19,197,168,365
9457,livegreatnow,,13,1,1,2
9458,mrcsparker,,6,171,221,392
9459,mkoga,,20,15,13,28
9460,a2zme01,,19,2,4,6
9461,BennyG02,,1,157,258,415
9462,rudy__giuliani,,8,1,1,2
9463,notnowimbating,,19,16,21,37
9464,BogginEx,,14,1,1,2
9465,sgf,,20,1,1,2
9466,mckaym,,20,1,4,5
9467,jroos123,,29,3,1,4
9468,pandronic,,13,3,2,5
9469,clinintern,,5,47,78,125
9470,theocarina,,1,86,51,137
9471,tannedvampire,,32,15,1,16
9472,smalls760,,18,8,2,10
9473,bruce_lowery,,22,1,1,2
9474,dkeav,,30,2,7,9
9475,legatek,,22,84,110,194
9476,Greir,,1,51,66,117
9477,BostonCharlie,,29,7,7,14
9478,Frood,,30,114,159,273
9479,Pandemonium1x,,10,118,12,130
9480,weerobin,,13,1,1,2
9481,Mephiska,,1,50,69,119
9482,dpgaspard,,18,18,29,47
9483,solo1qwerty,,0,1,2,3
9484,serialmc,,1,1,6,7
9485,Schrodingers_cat,,43,5,10,15
9486,jonny324,,29,1,1,2
9487,jerivix,,30,7,7,14
9488,chirodiesel,,13,1,5,6
9489,Tigerbot,,18,20,7,27
9490,sergeyfeldman,,20,4,3,7
9491,morelearning,,43,26,64,90
9492,entwithanaxe,,13,1,2,3
9493,Propolis,,20,42,70,112
9494,kaboom_to_us_en,,19,2,1,3
9495,heliosxx,,29,22,35,57
9496,lwrun,,18,36,59,95
9497,bhoconnor,,19,5,1,6
9498,rekonquista,,0,39,32,71
9499,fbg111,,19,63,126,189
9500,jermisoot,,34,2,4,6
9501,ignorantn00b,,34,2,1,3
9502,kennethhass,,19,4,12,16
9503,sanhedrin,,31,15,27,42
9504,theinternetftw,,5,3,7,10
9505,yelkeew,,1,1,3,4
9506,hgoldsmith,,13,5,1,6
9507,sukael,,13,44,48,92
9508,cbright,,20,8,4,12
9509,thecal,,20,4,2,6
9510,the_real_captain,,5,15,33,48
9511,mikey865,,1,5,4,9
9512,downey_ryan,,0,29,6,35
9513,facemonkey,,12,3,5,8
9514,javaseeds,,20,3,5,8
9515,SarahPalinsXXXCostar,,42,2,1,3
9516,dave8927,,12,2,3,5
9517,joeber325,,22,6,1,7
9518,Nausved,,29,115,217,332
9519,nwootten,,35,17,20,37
9520,dlweinreb,,20,1,4,5
9521,Raticide,,20,62,67,129
9522,GrayOne,,12,526,554,1080
9523,counteraxe,,34,25,46,71
9524,Rorshach,,12,1,3,4
9525,DickBCheney,,19,2,1,3
9526,hacedor,,34,1,1,2
9527,twigs488,,17,3,1,4
9528,decieved545,,19,6,4,10
9529,darrenlobo,,13,22,1,23
9530,msjo,,5,1,1,2
9531,woogley,,18,1,3,4
9532,hortensius5,,31,1,1,2
9533,gerryscat,,30,49,35,84
9534,velosteve,,12,1,1,2
9535,ojnesdottir,,22,3,6,9
9536,nohit,,8,1,3,4
9537,arcsine,,34,10,2,12
9538,mg0314a,,32,188,483,671
9539,bhaller,,43,102,187,289
9540,ssdgoalie,,19,174,201,375
9541,lpiob,,20,6,7,13
9542,tugteen,,1,793,551,1344
9543,_bruno_,,20,26,15,41
9544,13ismitch,,18,3,2,5
9545,aawyee,,6,1,1,2
9546,jimmijim,,34,1,1,2
9547,Observer231007,,20,86,59,145
9548,paintmeblue719,,39,1,1,2
9549,lastshot,,19,67,220,287
9550,TedsGame,,5,63,35,98
9551,apollot4l,,12,33,55,88
9552,akatsukix,,19,156,211,367
9553,therealtombaker,,0,1,1,2
9554,invidious9000,,22,74,123,197
9555,bradleyhudson,,20,28,38,66
9556,shiryu13,,13,50,15,65
9557,bluefoot,,43,5,20,25
9558,Goodfella18,,12,10,10,20
9559,Epyo,,8,3,2,5
9560,biggest_douchbag,,33,2,2,4
9561,MinervaDreaming,,18,14,10,24
9562,bobthecow,,5,2,1,3
9563,apropos,,19,1,1,2
9564,yaye,,43,68,108,176
9565,ikimashokie,,5,67,124,191
9566,nesquik,,1,11,7,18
9567,curlicue,,43,36,37,73
9568,yellowtape,,5,4,1,5
9569,celebritywigs,,29,1,2,3
9570,Johny5,,13,77,130,207
9571,Curtisbeef,,18,50,118,168
9572,FTHamilton,,19,32,44,76
9573,rotll,,6,279,304,583
9574,dus7y,,22,116,216,332
9575,mextremist,,13,3,3,6
9576,simtek,,0,11,9,20
9577,someguyontheinternet,,20,1,1,2
9578,oodley_noodle,,20,7,18,25
9579,chrisirmo,,13,17,2,19
9580,felonious_punk,,43,1,3,4
9581,kerith,,9,4,1,5
9582,IvanBo,,5,17,2,19
9583,acer888,,18,8,1,9
9584,Samus_,,20,155,315,470
9585,ninethousand,,22,13,18,31
9586,cawel,,20,45,5,50
9587,Ihatedigg,,30,82,10,92
9588,eeltech,,20,10,9,19
9589,dlm85,,32,5,4,9
9590,firstking,,31,55,115,170
9591,ignathius,,18,24,29,53
9592,HumbleDialog,,4,49,49,98
9593,Duggers,,18,43,101,144
9594,jessicalbarry,,43,7,7,14
9595,boredomtakesover,,18,1,1,2
9596,imfinking,,20,18,10,28
9597,ivhassel,,20,3,5,8
9598,mintcoffee,,20,3,3,6
9599,jkenasiojenwff,,10,1,2,3
9600,DrJosh,,3,34,11,45
9601,solarmass,,13,5,25,30
9602,ZamboniPalin,,13,8,11,19
9603,bercikr,,13,27,1,28
9604,kpdvx,,13,1,2,3
9605,bloodmonkey,,43,2,1,3
9606,malarie,,0,20,42,62
9607,trae,,20,25,38,63
9608,ooorgh,,22,5,6,11
9609,onlythebritishfly,,13,4,6,10
9610,bigtom42,,18,16,18,34
9611,zazerr,,39,143,54,197
9612,Stereowire,,34,4,15,19
9613,dhusk,,12,856,323,1179
9614,Fromageball,,32,2,1,3
9615,jstump91,,13,2,4,6
9616,mickrussom,,0,1,2,3
9617,KAC,,43,9,3,12
9618,wubwub,,13,39,56,95
9619,8-Mighty-Arms,,22,133,162,295
9620,EX-TER-MI-NATE,,22,7,10,17
9621,tattva,,34,1,2,3
9622,zyghsdfa,,31,45,62,107
9623,dmercer,,20,34,35,69
9624,brokenteeth,,14,1,6,7
9625,bmach,,1,121,74,195
9626,DiscoRage,,5,12,28,40
9627,oce222,,26,4,4,8
9628,prohaska,,8,7,9,16
9629,T-888,,13,21,38,59
9630,bwhisenant,,13,4,6,10
9631,mdubrowski,,20,2,4,6
9632,thmanwithnoname,,18,2,3,5
9633,CyberShadow,,20,4,3,7
9634,fml,,13,2,20,22
9635,maokai,,13,11,3,14
9636,jsglick123,,13,1,1,2
9637,csalem,,19,2,2,4
9638,Vailhem,,31,6,4,10
9639,sunexplodes,,22,41,53,94
9640,foldor,,18,9,7,16
9641,jared592,,11,1,8,9
9642,osulumberjack,,29,24,4,28
9643,icjonu,,20,11,9,20
9644,Zentripetal,,18,444,458,902
9645,UnderTheMud,,18,54,109,163
9646,ExtraGravy,,32,34,28,62
9647,Phocas,,36,8,15,23
9648,adamaliqius,,6,14,57,71
9649,kirbence,,13,47,26,73
9650,pitrpatr,,18,15,12,27
9651,RomanMoroni,,41,4,3,7
9652,sriramgopalan,,19,642,494,1136
9653,blusKi,,1,1,1,2
9654,chachee,,19,2,5,7
9655,jjames456,,21,7,1,8
9656,haasted,,18,25,15,40
9657,drndown2008,,31,2,1,3
9658,CookieAcct,,8,9,10,19
9659,cfabbro,,1,573,676,1249
9660,jisakujiens,,34,2,1,3
9661,cnbc,,0,6,11,17
9662,skymajic,,0,3,1,4
9663,AmericanGoyBlog,,31,327,658,985
9664,KJW,,18,38,63,101
9665,marianass,,36,2,1,3
9666,dublinclontarf,,20,83,107,190
9667,Headache,,4,1,2,3
9668,Spiracle,,0,304,109,413
9669,brokoli,,30,45,62,107
9670,Graybeard,,19,3,2,5
9671,Jescro,,19,25,21,46
9672,themoose,,32,25,37,62
9673,trueform,,19,2,21,23
9674,ahfoo,,34,189,153,342
9675,mongrethod,,0,2,1,3
9676,TastyNewEngland,,5,1,1,2
9677,audpicc,,34,157,204,361
9678,blodulv,,13,4,8,12
9679,LincolnHat,,1,95,95,190
9680,yeswomenlikereddit2,,18,10,4,14
9681,mjar81,,20,12,18,30
9682,dzozef,,20,14,13,27
9683,Eriq,,19,15,32,47
9684,Overmind12812,,5,23,8,31
9685,SaltyBoatr,,17,404,234,638
9686,l3ri,,18,6,30,36
9687,muleherd,,20,11,12,23
9688,sonatine,,4,2,8,10
9689,gwillewyn,,18,19,32,51
9690,bobbbyy,,13,20,26,46
9691,whowhatwherenow,,43,146,117,263
9692,tornadoteddy,,34,11,16,27
9693,omg2k,,19,31,42,73
9694,conrad_hex,,3,260,341,601
9695,consoleguru,,20,1,1,2
9696,ShutUpYou,,30,2,2,4
9697,distipel,,36,3,2,5
9698,timmy242,,18,42,85,127
9699,crunchychips,,19,68,35,103
9700,mdreid,,20,81,90,171
9701,frambles,,18,36,39,75
9702,nelsoje3,,43,3,3,6
9703,KapitanObvious,,22,1,5,6
9704,s0rce7,,19,57,198,255
9705,shiroisuki,,19,8,7,15
9706,sedition,,42,56,83,139
9707,moneymatador,,19,38,2,40
9708,DSinclair,,34,307,247,554
9709,j1337,,0,394,236,630
9710,rockjohnson98,,13,51,8,59
9711,brentp,,20,3,3,6
9712,FangornWarden,,21,84,26,110
9713,grottobill,,1,109,100,209
9714,contraption,,28,30,23,53
9715,spiralz,,21,2,3,5
9716,rogerconnery,,29,1,1,2
9717,JerkFace_Asshole,,19,9,25,34
9718,hcarlgolden,,19,5,21,26
9719,jdhemsath,,0,38,8,46
9720,hank777,,20,1,2,3
9721,iwan_w,,20,25,40,65
9722,chno95,,4,2,4,6
9723,koriellis,,5,1,1,2
9724,carto,,31,1,1,2
9725,9defek-,,18,4,8,12
9726,davidreavis,,1,16,13,29
9727,geekuskhan,,1,26,43,69
9728,squarepants,,12,1,1,2
9729,ghettron,,10,49,22,71
9730,thatcrazylady,,29,3,4,7
9731,hungryfoolish,,20,35,22,57
9732,FwD,,36,13,20,33
9733,quadrupled,,9,1,1,2
9734,RiverStyx,,20,1,1,2
9735,3lilangels,,13,27,1,28
9736,Lycur,,13,64,108,172
9737,greatoz1972,,4,1,1,2
9738,Gliridae,,13,2,2,4
9739,dketterick,,18,4,2,6
9740,philo23,,42,1,1,2
9741,DevastatinDave,,18,1,1,2
9742,gdilla,,43,5,6,11
9743,OpenedEyes,,13,1,1,2
9744,s-heurist,,6,18,32,50
9745,br16,,1,47,47,94
9746,Chutch,,9,1,1,2
9747,propriable,,20,1,1,2
9748,lalaland4711,,20,165,276,441
9749,Tangerous,,18,2,4,6
9750,simmias,,15,47,31,78
9751,dkfn,,20,26,11,37
9752,mastersoda,,29,1,2,3
9753,kugai,,34,168,46,214
9754,lilzaphod,,13,25,59,84
9755,5hoe,,18,2,2,4
9756,TheMemo,,29,212,277,489
9757,valeriepieris,,15,618,258,876
9758,mattdurrant,,43,19,13,32
9759,xcalibre,,33,318,417,735
9760,ex_msft_employee,,20,2,2,4
9761,EliAndrewC,,20,19,36,55
9762,Mogreen,,18,54,1,55
9763,krucifyx,,20,2,2,4
9764,Skarrg,,13,11,5,16
9765,redthis,,0,7,8,15
9766,iminurinternet,,18,35,1,36
9767,Enkaybee,,1,188,258,446
9768,dyoo,,26,1,2,3
9769,arbitrarystring,,13,29,44,73
9770,sbma44,,12,1,1,2
9771,travis-,,12,71,75,146
9772,big_cheese,,22,228,528,756
9773,lauterhaus,,18,5,1,6
9774,turfyman,,22,7,19,26
9775,alienomega,,13,3,19,22
9776,nr0mx,,4,1,1,2
9777,tsunziven,,1,2,1,3
9778,stulove,,11,22,26,48
9779,paganel,,31,193,195,388
9780,myst112,,32,1,1,2
9781,Eilarais,,42,19,45,64
9782,cibbuano,,20,2,3,5
9783,texasflip,,43,6,6,12
9784,yanwg,,32,5,6,11
9785,desrt,,20,3,1,4
9786,lunkdjedi,,34,82,2,84
9787,beek,,19,3,3,6
9788,anon-22,,20,12,25,37
9789,gnyffel,,32,13,28,41
9790,freebasen,,31,5,14,19
9791,siliconoff,,18,7,1,8
9792,josemela1,,18,52,1,53
9793,indefinicy,,0,4,10,14
9794,wkessinger,,13,3,9,12
9795,evilgeologist,,18,69,103,172
9796,NolanT,,18,115,20,135
9797,smoooooov,,12,296,284,580
9798,enforcer51,,4,2,1,3
9799,angryjester,,19,29,28,57
9800,seul,,20,5,8,13
9801,aibzw,,18,2,12,14
9802,KatrineSegane,,0,205,19,224
9803,neilmcintyre,,31,1,1,2
9804,unonimus5,,1,68,57,125
9805,potency,,13,90,74,164
9806,kwan,,42,43,17,60
9807,appleman,,1,13,27,40
9808,monkadorganev,,43,4,1,5
9809,crazlunatic,,13,2,3,5
9810,sparkysko,,19,61,98,159
9811,DinoRider,,11,5,19,24
9812,goldenfire,,13,2,2,4
9813,alps,,7,9,16,25
9814,frank3000,,0,9,6,15
9815,look,,20,26,44,70
9816,jc8898,,43,1,2,3
9817,mrt,,18,9,7,16
9818,rironin,,18,30,43,73
9819,zsaleeba,,5,5,10,15
9820,whichdan,,1,53,87,140
9821,insertnounhere,,1,9,9,18
9822,fitqueenb,,5,100,93,193
9823,stealtheair99,,21,1,1,2
9824,au_courant,,19,7,10,17
9825,milwaukeegreenie,,34,4,6,10
9826,burnsey,,42,15,9,24
9827,levand,,20,39,12,51
9828,herosw,,10,1,1,2
9829,zgott300,,34,3,7,10
9830,algorythym,,18,26,20,46
9831,ShadowScythe13,,18,34,2,36
9832,goldenberg,,19,71,1,72
9833,colin_ebert,,13,27,2,29
9834,airwick,,19,32,8,40
9835,JohnnyS,,42,1,1,2
9836,DancesWithPenguins,,1,6,2,8
9837,OlDer,,20,1,3,4
9838,pooryorick77,,31,41,47,88
9839,sleazepleeze,,43,1,7,8
9840,ljkh,,43,24,21,45
9841,unsharp,,7,7,2,9
9842,antidentite,,39,1,1,2
9843,Oxxider,,18,6,8,14
9844,ifreew,,19,7,9,16
9845,blacklabelrum,,0,2,10,12
9846,omelman,,20,2,1,3
9847,Professr,,32,55,68,123
9848,HornyMelon,,42,54,11,65
9849,CovOps,,29,1,1,2
9850,PragmaticChris,,32,36,67,103
9851,YaBetchya,,19,12,10,22
9852,werwefsf,,18,16,10,26
9853,akurnids,,6,4,1,5
9854,imGonnaTellUhowGayUr,,18,2,2,4
9855,xyphus,,6,687,603,1290
9856,panjsher,,32,1,1,2
9857,gordol,,22,18,24,42
9858,my2ndaccount,,19,4,16,20
9859,Wakasaki_Rocky,,32,17,16,33
9860,joelanman,,42,143,76,219
9861,LainOfTheWired,,11,1,3,4
9862,petere,,19,41,1,42
9863,raddevon,,8,113,14,127
9864,zero_cool1990,,31,179,73,252
9865,roflcop,,30,1,1,2
9866,symbha,,31,1,2,3
9867,mozilla4,,34,1,1,2
9868,odinx,,13,33,1,34
9869,joevogel,,8,1,3,4
9870,pockelford,,34,141,101,242
9871,kakeeman,,18,3,5,8
9872,dick_in_a_box,,14,13,13,26
9873,lindini,,1,2,18,20
9874,JohnGalt2010,,42,15,14,29
9875,pricklypete,,19,10,16,26
9876,the_neubie,,8,353,516,869
9877,dmhouse,,20,13,18,31
9878,stcredzero,,20,295,513,808
9879,crazyvibes,,36,2,3,5
9880,WeeMary,,13,4,9,13
9881,DaPM,,34,9,7,16
9882,rb_busboom,,43,1,4,5
9883,diggthis,,4,3,5,8
9884,superiority,,31,180,195,375
9885,letsrun,,41,8,7,15
9886,JimmiP,,13,4,6,10
9887,jessb,,18,25,2,27
9888,cis4cookie,,20,1,1,2
9889,bobkingof12vs,,1,18,30,48
9890,smartkuz,,13,2,1,3
9891,bethhaught,,18,4,5,9
9892,kgsulliv,,0,2,7,9
9893,LAWSKEE,,19,55,100,155
9894,McMoop,,1,5,4,9
9895,JoeCollege,,35,26,23,49
9896,newztek,,21,1,1,2
9897,EmeraldCityElephant,,19,4,1,5
9898,focks,,1,67,66,133
9899,sonofthor,,14,1,1,2
9900,qayn,,19,3,1,4
9901,baihu,,31,6,11,17
9902,chourobin,,13,52,68,120
9903,iansocool,,18,20,31,51
9904,degustisnowshoes,,19,7,11,18
9905,mister_amazing,,18,6,21,27
9906,dr_poopeh,,38,2,2,4
9907,ichverstehe,,20,9,12,21
9908,koan,,13,80,62,142
9909,ewheat,,18,152,287,439
9910,Jan_book_lover,,14,28,30,58
9911,TomorrowCar,,0,1,1,2
9912,Ron__Paul,,19,3,7,10
9913,Lagstorm,,9,33,48,81
9914,noimallergic,,19,1,1,2
9915,powerrangers,,32,11,5,16
9916,mvo76,,13,5,11,16
9917,mctmct,,23,1,2,3
9918,itrends,,32,130,209,339
9919,mattgup,,5,257,67,324
9920,killuminati22,,12,3,4,7
9921,sternap,,19,25,20,45
9922,cstoner,,14,261,287,548
9923,_y_,,18,2,3,5
9924,formeorangeme,,13,1,3,4
9925,storko,,18,1,1,2
9926,du_playground,,13,1,3,4
9927,redditRoss,,19,191,12,203
9928,eyko,,2,18,28,46
9929,ChiXiStigma,,18,4,5,9
9930,erbowman,,42,4,7,11
9931,nhmike,,13,28,16,44
9932,notnice,,31,6,12,18
9933,doob,,19,15,24,39
9934,robcane,,19,5,4,9
9935,tanguyr,,20,70,99,169
9936,bozomind,,8,19,16,35
9937,Iggyiggy,,18,12,53,65
9938,leaknoil,,0,24,29,53
9939,lindabot,,32,2,6,8
9940,maxtheman45,,0,161,123,284
9941,kjk,,20,1,1,2
9942,awkward,,20,21,33,54
9943,Rubenb,,1,7,6,13
9944,Walhalla,,32,12,16,28
9945,lunarcanary,,19,17,18,35
9946,jmikola,,1,48,18,66
9947,Jabraltr,,36,3,2,5
9948,cinch123,,30,2,4,6
9949,mbland07,,13,8,1,9
9950,GrumpySimon,,29,892,777,1669
9951,mightyarmenian,,19,116,52,168
9952,mjk1093,,19,1639,177,1816
9953,daylily,,29,133,103,236
9954,redshoes,,1,29,46,75
9955,suleyman3,,19,16,33,49
9956,MiamiMan,,6,5,6,11
9957,fritts84,,0,1,1,2
9958,basscadet,,32,5,26,31
9959,Asbradley21,,13,21,26,47
9960,Rambis,,18,142,118,260
9961,booshmagazine,,18,13,17,30
9962,kvigor,,20,22,14,36
9963,omorashi,,6,1,1,2
9964,robliecruise,,14,1,1,2
9965,hotbaconsauce,,0,100,126,226
9966,asampson,,20,4,6,10
9967,superjuan,,10,83,106,189
9968,annekat,,21,119,182,301
9969,coel,,2,1,1,2
9970,yuxt,,34,13,31,44
9971,BossOfTheGame,,32,1,1,2
9972,bwrandall,,13,9,3,12
9973,Scientista,,12,19,28,47
9974,sonofbodil,,31,4,2,6
9975,reddit08,,19,91,107,198
9976,weeds,,32,1,1,2
9977,rub3s,,18,258,375,633
9978,niobium,,30,1,5,6
9979,TonzB,,1,13,14,27
9980,bertolotti,,18,147,60,207
9981,papatrpt89,,23,4,4,8
9982,payback1,,31,2,5,7
9983,blackstarinc,,4,1,1,2
9984,rdbb,,5,7,3,10
9985,Happinessisbetter,,18,11,5,16
9986,multani,,20,6,8,14
9987,j_b0mb,,42,3,1,4
9988,gogofromzozo,,13,27,10,37
9989,Timmah1978,,13,130,199,329
9990,whereverjustice,,30,274,341,615
9991,cantstanditanymore,,19,4,1,5
9992,greenmimmy,,18,9,1,10
9993,twrn,,13,52,64,116
9994,StarlessKnight,,13,115,220,335
9995,cerealghost,,13,5,3,8
9996,Micle,,5,10,2,12
9997,qhc23,,13,1,7,8
9998,asdfman,,19,31,14,45
9999,robe,,20,10,5,15
10000,gnudarve,,42,45,111,156
10001,nicwolff,,13,2,6,8
10002,mesmoria,,20,8,17,25
10003,calder100,,19,1,6,7
10004,creasybear,,32,1,2,3
10005,MoonPoint,,0,2,2,4
10006,joltek,,32,44,68,112
10007,miles_1963,,43,1,7,8
10008,scrunchcrunch,,1,25,25,50
10009,bigweeklynews,,1,3,4,7
10010,sheesh,,18,4,5,9
10011,sccuca,,13,1,2,3
10012,luvimarie,,6,1,1,2
10013,easterner7,,19,23,28,51
10014,wanakawoman2,,18,1,18,19
10015,djm210,,32,144,88,232
10016,solforge,,18,2,2,4
10017,NotAFanBoy,,7,2,2,4
10018,Marlowx2,,13,5,13,18
10019,lneves,,20,10,4,14
10020,comohammer,,14,3,1,4
10021,mpecsek,,0,69,84,153
10022,hudders,,18,199,321,520
10023,altie,,13,44,116,160
10024,bozarts5,,14,1,3,4
10025,Dark_Karma,,19,34,51,85
10026,flavigny,,30,1,1,2
10027,wowphreak,,19,2,2,4
10028,mlisiotti,,20,8,4,12
10029,peterington,,1,4,1,5
10030,mojomajojo,,31,4,1,5
10031,repnop,,20,13,11,24
10032,Tetragrammaton,,1,72,29,101
10033,silverionmox,,31,274,503,777
10034,CaptainIrony,,22,1,2,3
10035,fakkedap,,7,2,2,4
10036,truffle_shuffle,,18,48,54,102
10037,eatmycow,,6,21,16,37
10038,someguy456,,27,2,4,6
10039,NovusTiro,,0,103,145,248
10040,mrtactical,,1,1,1,2
10041,hepj,,42,29,25,54
10042,tridentgum,,0,592,813,1405
10043,adleym,,43,612,274,886
10044,pariahjane,,19,62,39,101
10045,fl00d,,43,15,31,46
10046,CasualReader,,0,105,149,254
10047,verblitas,,43,1,1,2
10048,zielaj,,20,1,5,6
10049,iPiranha,,5,1,1,2
10050,chubbybubba,,19,7,16,23
10051,tracknod,,13,23,22,45
10052,dictatortot,,18,1,2,3
10053,dafunk60,,13,16,25,41
10054,freshone,,19,187,300,487
10055,OreoPie,,18,8,8,16
10056,18_84_58_A6_D1_50_34,,13,1,2,3
10057,ihavenoidea,,43,1,2,3
10058,defconoi,,19,12,11,23
10059,Canadiac,,19,30,38,68
10060,pcdescha,,18,23,8,31
10061,The_Pot,,1,1,1,2
10062,musicmaverick,,18,1,3,4
10063,b17w153,,8,1,3,4
10064,teeteringwreck,,13,77,14,91
10065,roblob,,1,1,1,2
10066,andycullison,,1,6,3,9
10067,peblos,,18,16,29,45
10068,breakables,,18,10,6,16
10069,Flun,,18,2,10,12
10070,cholefischer,,18,111,28,139
10071,ChazR,,5,7,12,19
10072,tspike,,20,16,24,40
10073,robknight,,20,4,2,6
10074,tropoli,,18,126,11,137
10075,gabrielroth,,19,56,11,67
10076,JonisJon,,23,4,2,6
10077,rotbart,,31,1,1,2
10078,charliedontsurf,,19,10,10,20
10079,tripod3,,31,3,2,5
10080,druidmerlyn,,6,3,2,5
10081,scottperezfox,,13,24,27,51
10082,phoephus2,,13,53,56,109
10083,pokute,,0,10,19,29
10084,nas,,20,22,24,46
10085,cbr,,29,74,94,168
10086,randomasspseudonym,,12,1,1,2
10087,ohmdogz,,5,46,49,95
10088,drbatbawls,,43,4,5,9
10089,Chayoss,,11,15,15,30
10090,nynelyves,,43,1,1,2
10091,quitesonew,,1,89,122,211
10092,chipmunkninja,,0,4,2,6
10093,twl,,43,16,23,39
10094,he-nameth-the-twat,,8,1,16,17
10095,ermd2000,,19,162,158,320
10096,irony,,29,572,142,714
10097,sodj1,,18,45,94,139
10098,popesicle,,32,16,20,36
10099,mattbeach,,31,1,1,2
10100,icenine,,6,2,1,3
10101,HenryR,,20,121,11,132
10102,jugaru,,5,1,1,2
10103,YongWang,,20,1,1,2
10104,orkies,,18,1,7,8
10105,LaLa01,,13,4,3,7
10106,getabrain,,13,4,10,14
10107,kooby64,,18,362,65,427
10108,Musashi007,,13,1,7,8
10109,Professor_Dubya,,19,2,4,6
10110,Pesshau,,34,17,20,37
10111,nsputnik,,32,16,2,18
10112,rjglasse,,20,3,7,10
10113,Ioewe,,22,252,377,629
10114,extremeanger,,32,7,7,14
10115,diggernaught,,19,94,165,259
10116,pokrmessiah,,18,68,115,183
10117,stevepohlit,,13,3,1,4
10118,mattnyc99,,5,3,7,10
10119,Rekzai,,34,68,62,130
10120,treetree888,,20,17,19,36
10121,JRoxas,,12,11,2,13
10122,mark7,,19,20,31,51
10123,twelvestringed,,13,1,1,2
10124,ubikwitous,,13,362,223,585
10125,vbKing,,5,1,2,3
10126,justsai,,12,16,52,68
10127,ectornator,,19,15,6,21
10128,ColinDoody,,13,1,1,2
10129,yeahdude,,4,1,1,2
10130,DarthMalcontent,,1,86,161,247
10131,duncan345,,1,4,13,17
10132,mauszozo,,22,38,49,87
10133,libertyordeath1,,18,29,42,71
10134,tuirn,,13,53,128,181
10135,mcnab,,1,103,75,178
10136,joereger,,36,6,3,9
10137,brutal_one,,1,17,29,46
10138,minionx133,,19,6,13,19
10139,fishhead,,5,8,17,25
10140,uchecerulean,,25,2,2,4
10141,ionrock,,20,2,7,9
10142,ven,,19,2,3,5
10143,runway,,43,14,15,29
10144,TomonReddit,,13,22,4,26
10145,chuck74,,13,12,30,42
10146,agent_smith,,1,1,2,3
10147,safetyworm,,6,2,1,3
10148,tehpointbeing,,18,8,25,33
10149,konradj,,18,6,13,19
10150,Joeunionreview,,13,8,18,26
10151,wingofbentsteel,,22,4,4,8
10152,jjlava,,32,29,77,106
10153,benjphoto,,30,1,2,3
10154,lerdex,,33,3,11,14
10155,hahshaez,,20,7,7,14
10156,bobwrit,,20,1,3,4
10157,ramblin101010,,4,10,9,19
10158,deimos,,17,6,4,10
10159,econnerd,,0,20,36,56
10160,psbp,,19,1,2,3
10161,svadhisthana,,1,22,31,53
10162,slinger,,36,1,1,2
10163,mixsense,,13,12,3,15
10164,baldr83,,13,50,54,104
10165,dogpb,,29,4,2,6
10166,ramblnrose,,0,1,1,2
10167,Foodstamp,,5,1,2,3
10168,InternNick,,37,1,2,3
10169,matthewn,,5,1,3,4
10170,dudedominicano,,32,3,2,5
10171,illuminusluna,,18,84,97,181
10172,hoopjones,,19,2,2,4
10173,ixos,,43,3,2,5
10174,suprfsat,,20,19,37,56
10175,bhikshu,,43,1,1,2
10176,yokel,,20,1,3,4
10177,darkhelmet16,,12,22,6,28
10178,worq,,20,1,1,2
10179,venjax,,3,1,2,3
10180,clutterskull,,6,24,49,73
10181,JJCDAD,,18,25,38,63
10182,PixelMagic,,19,531,372,903
10183,insertmedia,,19,1,3,4
10184,jdfreeze,,27,1,3,4
10185,aerosquid,,0,69,120,189
10186,JoshSN,,31,5,2,7
10187,sepierce,,19,2,2,4
10188,mibchronicles,,1,4,1,5
10189,stewhar,,0,10,15,25
10190,bafta,,31,17,40,57
10191,Hendrik,,5,20,22,42
10192,H-Bar,,13,77,53,130
10193,Haiavaha,,1,472,642,1114
10194,toppur,,29,2,3,5
10195,amybean,,13,6,13,19
10196,d_goddard,,14,1,3,4
10197,wolfman116,,32,39,60,99
10198,androk,,13,11,19,30
10199,Splitter4,,4,7,9,16
10200,Booperelli,,18,9,10,19
10201,jeffg79,,17,1,1,2
10202,deepikaur,,18,7,2,9
10203,rixed,,20,5,1,6
10204,aultshark,,17,1,1,2
10205,-Swig-,,43,1,1,2
10206,addicted,,28,2,2,4
10207,saterdaies,,20,4,4,8
10208,sixbillionthsheep,,15,71,55,126
10209,Jeffnfun631,,11,1,4,5
10210,Deestan,,20,180,251,431
10211,zeddit,,18,10,12,22
10212,rknickme,,31,3,1,4
10213,valeyard,,8,17,1,18
10214,AlbyWee,,1,7,10,17
10215,Sub7,,0,25,24,49
10216,LightShadow,,1,64,73,137
10217,darmon,,18,41,33,74
10218,Pokaris,,19,5,10,15
10219,dhotson,,20,37,17,54
10220,gazmic,,32,106,159,265
10221,Happyburn,,0,77,6,83
10222,firstoutofline,,1,1,1,2
10223,aier,,5,27,44,71
10224,Hyperion1144,,13,324,329,653
10225,najnarp,,13,34,11,45
10226,mattl,,20,196,244,440
10227,shankrabbit,,13,3,4,7
10228,jsully,,0,320,425,745
10229,TechnoCrit,,22,136,154,290
10230,tuttut97,,13,2,2,4
10231,mattdoyle13,,16,10,18,28
10232,johnlert22,,18,11,6,17
10233,obamania,,32,8,2,10
10234,jimm,,20,44,31,75
10235,jellison,,13,58,43,101
10236,lazyplayboy,,22,275,460,735
10237,agyrtes,,19,1,1,2
10238,Burbulous,,13,13,23,36
10239,revdev,,5,3,3,6
10240,wonderboy2005,,1,32,44,76
10241,hyena,,43,2,1,3
10242,mcanon,,20,55,50,105
10243,carolinaswamp,,16,6,19,25
10244,nrfx,,18,6,9,15
10245,dagger_5005,,18,61,138,199
10246,texanianman,,34,2,3,5
10247,SuperThread,,19,13,16,29
10248,romwell,,18,124,167,291
10249,Finger-Nail,,20,65,56,121
10250,ayuda42,,18,2,6,8
10251,Ionse,,30,13,7,20
10252,requiem4boredom,,19,243,279,522
10253,behrangsa,,20,146,82,228
10254,Thomas_Jefferson,,40,1,4,5
10255,gregkitson,,43,9,21,30
10256,round2,,11,1,4,5
10257,neuromonkey,,18,866,2055,2921
10258,Magick93,,12,35,68,103
10259,austinwiltshire,,20,63,92,155
10260,JavaVoodoo,,13,23,3,26
10261,mockablekaty,,6,24,29,53
10262,TheSwashbuckler,,19,3,1,4
10263,ArmadilloBrillo,,5,1,1,2
10264,breakbread,,13,2,4,6
10265,anguisinherba,,42,1,2,3
10266,lamintak,,1,111,42,153
10267,madmanz123,,6,78,157,235
10268,kidnthebrook,,19,28,34,62
10269,acidargyle,,14,3,3,6
10270,hbbengal,,19,15,2,17
10271,rraaarr,,22,349,454,803
10272,TruthPicker,,32,5,16,21
10273,bowdog,,13,17,74,91
10274,AnhaengerVonMarx,,18,24,60,84
10275,mynameishere,,10,861,838,1699
10276,stopmotionsunrise,,34,291,669,960
10277,nooz,,1,1,4,5
10278,krypnos,,18,17,12,29
10279,darkshine,,18,27,6,33
10280,negcap,,22,3,1,4
10281,mfkap,,0,49,64,113
10282,attekojo,,20,51,61,112
10283,skraps,,20,73,94,167
10284,me_so_porny,,0,104,82,186
10285,flaxer,,42,1,1,2
10286,enkoopa,,12,7,7,14
10287,nexxai,,0,37,1,38
10288,Carmack,,17,8,5,13
10289,zxvf,,20,165,172,337
10290,moultano,,29,749,363,1112
10291,eigyan,,22,1,1,2
10292,death,,20,43,53,96
10293,DoeDoe,,13,53,53,106
10294,arbiterElegantiae,,4,1,2,3
10295,jorgeka,,22,47,145,192
10296,markitymark,,4,781,1336,2117
10297,biggus_dictus,,6,1,1,2
10298,prasanna_reddit,,20,11,12,23
10299,Cananopie,,43,53,14,67
10300,DMTurneR,,13,1,2,3
10301,croxmeister,,13,1,2,3
10302,captian2,,20,51,47,98
10303,webmaster8888,,34,8,3,11
10304,lpe,,31,27,32,59
10305,twodaylife,,34,36,49,85
10306,AluminiuM,,20,36,4,40
10307,sunlovey,,6,1,1,2
10308,jacobd,,3,1,2,3
10309,brad-walker,,19,673,919,1592
10310,Deezul,,0,22,27,49
10311,Spanish_Inquisition,,22,2,6,8
10312,aldarris,,31,6,5,11
10313,thinkbox,,40,3,1,4
10314,winnarps,,43,53,27,80
10315,rbrumble,,0,16,22,38
10316,cap11235,,20,59,80,139
10317,new_anus,,8,3,5,8
10318,brenelz,,20,16,1,17
10319,samsing,,17,25,43,68
10320,evilive,,18,8,2,10
10321,finix,,20,634,753,1387
10322,nublet,,23,8,4,12
10323,preferswhitesocks,,23,2,3,5
10324,rcavanaugh,,15,4,1,5
10325,greyjay,,18,105,130,235
10326,apocalypse_k,,43,18,48,66
10327,dangerpronedaphne,,18,12,24,36
10328,runn1rebels198,,6,1,1,2
10329,adn,,34,26,16,42
10330,rvirding,,20,9,14,23
10331,XBMC,,9,50,80,130
10332,drakesn,,20,3,3,6
10333,imm0rtal_aeris,,18,5,5,10
10334,Purp,,33,246,426,672
10335,rdd,,5,2,2,4
10336,DocmanCC,,42,18,20,38
10337,rywinter,,12,4,6,10
10338,Dexia,,16,2,6,8
10339,phylo,,20,3,5,8
10340,unregistered,,1,12,11,23
10341,returntofreedom,,19,155,160,315
10342,Uncle_Chachi,,22,62,92,154
10343,dwayne12,,13,1,2,3
10344,larryjohnson404,,42,3,1,4
10345,thorman,,1,4,12,16
10346,UncleTom23,,13,1,1,2
10347,afclark,,13,39,12,51
10348,wanker123,,43,1,1,2
10349,callmedanimal,,42,1,1,2
10350,alienman,,1,143,244,387
10351,dalmaer,,20,5,3,8
10352,kippy,,18,92,4,96
10353,cincimedes,,19,3,5,8
10354,detaer,,9,121,210,331
10355,secretGeek,,20,15,13,28
10356,jzief128,,17,1,1,2
10357,daramel,,1,4,9,13
10358,macbony,,18,7,6,13
10359,buckethead,,39,3,1,4
10360,mjern,,6,35,30,65
10361,nerotic,,5,1,1,2
10362,Soupstorm,,30,112,182,294
10363,specialk16,,2,3,3,6
10364,b12345en,,20,28,2,30
10365,retarded,,31,1,2,3
10366,sien,,15,22,23,45
10367,follys,,2,3,3,6
10368,j4b,,20,8,18,26
10369,jus10k,,18,22,81,103
10370,newreader,,19,10,14,24
10371,ewilliam,,19,17,15,32
10372,Mihan,,28,68,106,174
10373,russross,,20,2,5,7
10374,directq,,18,9,2,11
10375,yosterizer,,42,4,4,8
10376,astonm,,20,3,4,7
10377,lavoshe,,0,28,1,29
10378,mego,,43,33,56,89
10379,Khael,,5,13,19,32
10380,troglodytehomunculus,,13,14,30,44
10381,ron12345,,18,4,3,7
10382,rekishi,,18,7,14,21
10383,cwp,,11,3,4,7
10384,docmgmt,,19,5,10,15
10385,myopian,,10,4,4,8
10386,kaspar42,,22,111,132,243
10387,superfreak77,,34,294,496,790
10388,JonathonDD,,29,1,1,2
10389,bkharris45,,34,1,2,3
10390,mh1111q,,20,4,3,7
10391,robertpaulson0106,,18,1,2,3
10392,carbonfishbone,,1,2,1,3
10393,yorkshire99,,42,17,2,19
10394,MayanFire,,20,1,4,5
10395,laika84,,29,2,1,3
10396,nedTheInbredMule,,18,43,24,67
10397,scubastard,,20,14,20,34
10398,whatamac,,42,1,2,3
10399,lfnoise,,20,12,17,29
10400,phaneros,,19,5,11,16
10401,spidermite,,19,220,278,498
10402,a_caspis,,29,21,17,38
10403,nrieke,,13,3,6,9
10404,Batfastard,,30,9,13,22
10405,twopigs,,13,23,20,43
10406,euphoriacoffee,,13,16,1,17
10407,aurochs,,6,53,80,133
10408,nickripley,,18,29,27,56
10409,photoflyer,,1,30,23,53
10410,SteefHarsley666,,32,1,2,3
10411,mindshadow,,18,1,2,3
10412,pittmb,,19,7,7,14
10413,ltbs,,19,8,9,17
10414,Perfu,,5,1,1,2
10415,fxtrader,,31,1,5,6
10416,fsjenkins2000,,19,3,3,6
10417,johnbell,,14,1,1,2
10418,docmars,,18,5,1,6
10419,eoin2000,,29,77,158,235
10420,TRH,,31,2,2,4
10421,gregmackay,,6,1,1,2
10422,lastchance,,19,272,62,334
10423,deadfones,,5,16,26,42
10424,IIECONII,,18,15,20,35
10425,benihana,,10,560,623,1183
10426,bradbeveridge,,20,12,17,29
10427,SMN1,,30,6,5,11
10428,samrose,,31,1,3,4
10429,FUCKING_THING_SUCKS,,20,1,1,2
10430,facebones,,18,3,3,6
10431,SportsCarAdvis,,18,34,43,77
10432,noahsachs,,4,1,4,5
10433,DonCasablanca,,14,15,6,21
10434,stevenlss1,,18,1,1,2
10435,penterz,,18,22,27,49
10436,monkkbfr,,32,64,107,171
10437,msthursday,,20,2,6,8
10438,marcocanb,,31,3,1,4
10439,darrylhickson,,3,2,1,3
10440,Hittman,,31,23,22,45
10441,sidsavara,,13,25,1,26
10442,narmak,,43,10,7,17
10443,turbo-tom,,41,1,4,5
10444,werries,,1,37,52,89
10445,do-un-to,,19,275,501,776
10446,rawls,,19,19,31,50
10447,overtoncanada,,19,1,4,5
10448,newsens,,18,6,20,26
10449,MrTrolleePants,,31,21,32,53
10450,mcpagal,,2,5,1,6
10451,bcbarrett,,16,3,3,6
10452,AMysticalApproach,,3,2,1,3
10453,cheics_w,,12,1,3,4
10454,wrekxx,,22,8,16,24
10455,durkin65,,6,4,10,14
10456,MrTaco,,20,7,9,16
10457,DrScott,,43,48,89,137
10458,anonymousone,,19,2,2,4
10459,dghould,,19,56,40,96
10460,acs58,,32,2,1,3
10461,Jayschwa,,4,5,1,6
10462,nannuPAWLU,,34,3,5,8
10463,nonethelesses,,19,2,4,6
10464,STL_reddit,,18,1,1,2
10465,ecomaniac,,16,3,8,11
10466,apostoli,,30,1,1,2
10467,am533,,34,54,38,92
10468,typemast,,19,27,20,47
10469,LeMadChef,,20,35,51,86
10470,spaulo,,20,12,5,17
10471,disconcision,,30,3,3,6
10472,Bizzell,,22,1,2,3
10473,joedunn721,,1,3,5,8
10474,Draracle,,30,177,328,505
10475,cwolfe,,19,266,304,570
10476,Majination,,43,7,4,11
10477,earthacis,,18,1,2,3
10478,petenu,,20,83,95,178
10479,MikeonTV,,5,361,24,385
10480,xolusmojo,,13,7,25,32
10481,abassguitaryouare,,14,1,1,2
10482,seb101189,,5,11,18,29
10483,Harum,,1,1,2,3
10484,IkastI,,32,14,21,35
10485,neoform3,,30,1261,1428,2689
10486,chiu6411,,26,1,2,3
10487,blah23,,6,5,4,9
10488,Vraiment,,31,6,7,13
10489,nullibicity,,18,623,758,1381
10490,FormerDittoHead,,7,2,2,4
10491,endia314,,6,235,83,318
10492,Lunchy,,23,3,1,4
10493,dprevite,,20,5,13,18
10494,jayhawk691,,13,17,24,41
10495,Average-Joe,,1,46,9,55
10496,35dga,,34,1,1,2
10497,sainox,,18,33,3,36
10498,mhmdshkr,,18,4,8,12
10499,leoedin,,0,43,28,71
10500,pjism,,1,3,6,9
10501,MoltenBoron,,19,4,1,5
10502,michaelhoney,,18,5,12,17
10503,fashion_freak202,,1,2,1,3
10504,moveez,,39,2,1,3
10505,aeflash,,18,2,3,5
10506,baseball_god,,19,19,26,45
10507,whiteyonthemoon,,5,2,14,16
10508,mbana,,20,6,9,15
10509,angry_man,,31,79,63,142
10510,pwa01,,20,6,5,11
10511,riraito,,18,21,56,77
10512,Fireblend,,19,14,7,21
10513,mattc,,18,2,3,5
10514,crazyeight,,18,72,93,165
10515,newgenome,,32,15,3,18
10516,koolaidsipper,,30,1,2,3
10517,windvexer,,1,4,3,7
10518,jeffpostcn,,6,3,3,6
10519,pramodbiligiri,,41,2,5,7
10520,henrygeorge,,31,5,2,7
10521,swimmerchick,,19,3,2,5
10522,starphish,,19,94,162,256
10523,JustAnotherVagueAnon,,20,38,37,75
10524,dashteacup,,0,7,8,15
10525,nomorewar,,13,371,352,723
10526,phawnky,,43,2,8,10
10527,rezrovs,,20,3,4,7
10528,sidnelson13,,3,1,2,3
10529,xsxsxs,,43,34,14,48
10530,josef,,20,81,42,123
10531,feanor512,,36,316,458,774
10532,EndUserX,,1,3,2,5
10533,blaineT,,13,1,4,5
10534,tusharm,,5,75,1,76
10535,cde32wsxzaq1,,31,4,5,9
10536,shoesmell,,19,36,34,70
10537,Makin_You_Pay,,6,2,2,4
10538,kybernetikos,,31,31,36,67
10539,hji87,,22,1,1,2
10540,Varian,,1,6,7,13
10541,kovacs70,,18,26,29,55
10542,rampart,,20,1,5,6
10543,MrsChime,,12,2,1,3
10544,malconsidine,,18,83,32,115
10545,zamyaid,,1,1,1,2
10546,hi_lo,,42,2,1,3
10547,johngalt,,18,3,29,32
10548,amenszer,,18,3,5,8
10549,dangled,,32,2,5,7
10550,Pipstydoo,,31,6,7,13
10551,omphalaskepsis,,13,5,10,15
10552,DethKlokBlok,,42,4,1,5
10553,LukeDuke,,6,4,6,10
10554,FlamingHomoSexual,,15,5,3,8
10555,beenthereredthat,,18,3,9,12
10556,snoonoo,,18,2,2,4
10557,chrisamiller,,6,3,2,5
10558,willis77,,1,738,570,1308
10559,njfemdem,,13,16,30,46
10560,dudeabides909,,34,11,2,13
10561,portladelphia,,19,59,99,158
10562,keithwalsh1972,,2,5,4,9
10563,boomd02,,43,1,1,2
10564,william01,,19,30,52,82
10565,harvard_law_school,,43,10,8,18
10566,jon_k,,19,717,867,1584
10567,ioillusion,,13,2,3,5
10568,anglfe,,13,27,43,70
10569,fuckitwelldoitlive,,9,1,3,4
10570,Skippy_McDougal,,29,1,1,2
10571,shinaku,,18,1,7,8
10572,AHarrison,,0,18,14,32
10573,architimmy,,1,1,3,4
10574,mackatt,,34,14,1,15
10575,fubar9000,,0,5,4,9
10576,phyzhoe,,0,14,1,15
10577,gcapell,,20,7,10,17
10578,ddvlad,,20,17,18,35
10579,redditisnews,,34,14,19,33
10580,gcranston,,30,8,7,15
10581,SnakeDiver,,13,13,16,29
10582,mwilliherb,,19,82,19,101
10583,torrefaction,,19,1,2,3
10584,tooli,,31,4,7,11
10585,hulahulagirl,,19,91,168,259
10586,jpb,,12,1,1,2
10587,khl2k,,19,1,1,2
10588,fujbuj,,1,21,15,36
10589,911_truther,,13,1,1,2
10590,brad2008,,13,83,123,206
10591,meatbot,,3,2,3,5
10592,ladafum,,34,5,4,9
10593,apinecone,,20,13,13,26
10594,tyomax,,1,33,39,72
10595,bhartzer,,5,22,6,28
10596,whyshave,,1,5,8,13
10597,unknownmat,,29,25,34,59
10598,cheek_meister,,13,3,2,5
10599,wickey29,,42,3,1,4
10600,sackitup,,43,5,15,20
10601,redditwontlogmein,,18,2,1,3
10602,Derj,,18,4,2,6
10603,ilya_ost,,20,4,3,7
10604,Sueblimely,,29,1,1,2
10605,vargas,,20,19,12,31
10606,ymomo,,19,68,77,145
10607,schex86,,31,26,24,50
10608,djadamjay,,13,2,9,11
10609,keitarofujiwara,,18,81,181,262
10610,paulgraham,,20,53,26,79
10611,scazrelet,,32,7,12,19
10612,miraflox,,10,13,17,30
10613,pembo13,,20,9,11,20
10614,dbabbitt,,32,8,12,20
10615,Bane,,18,6,14,20
10616,LordSkippy,,13,56,74,130
10617,bobbyvoicu,,5,6,1,7
10618,athiejane,,32,2,9,11
10619,objectnull,,22,2,3,5
10620,pepperink,,18,4,9,13
10621,brightsunshining,,32,13,27,40
10622,olliragic,,39,1,1,2
10623,claude_1903,,31,1,2,3
10624,jledbet,,13,5,1,6
10625,clam,,18,9,3,12
10626,nodger,,4,3,3,6
10627,studio64nyc,,13,7,1,8
10628,dwarfcadaver,,30,1,1,2
10629,petteri,,20,199,29,228
10630,Corgan1351,,18,27,34,61
10631,jowjow,,32,3,1,4
10632,DavidTehGnome,,13,92,150,242
10633,infocorruption,,19,2,3,5
10634,abstractthought,,20,6,3,9
10635,CharlesIII,,38,2,4,6
10636,nice_dkjames,,19,58,83,141
10637,AviationWorld,,34,11,7,18
10638,Worldviewsblog,,19,4,3,7
10639,daragh,,10,8,7,15
10640,keruha,,6,22,33,55
10641,monkeyballs,,20,4,10,14
10642,gt384u,,20,26,33,59
10643,simen,,20,175,238,413
10644,AniMouse,,31,2,1,3
10645,jpurc,,16,2,2,4
10646,aComa,,20,14,14,28
10647,asdasdo,,11,5,5,10
10648,mkwiat,,19,27,36,63
10649,ricoza,,1,9,8,17
10650,alalex,,20,10,1,11
10651,Daarom,,39,1,1,2
10652,twism,,20,2,1,3
10653,Cameljock,,18,5,10,15
10654,mylescloutier,,12,55,76,131
10655,uberjosh,,34,1,2,3
10656,PAK-9,,29,3,2,5
10657,Proximity,,18,7,5,12
10658,AceTracer,,32,20,28,48
10659,Starcrusher,,12,303,178,481
10660,krautpastry,,0,18,28,46
10661,lever2000,,19,1,1,2
10662,adeev,,19,7,7,14
10663,how_gauche,,20,13,15,28
10664,Guiness,,37,1,1,2
10665,fxj,,20,20,42,62
10666,hulacat,,13,28,5,33
10667,vees,,19,1,4,5
10668,hifibug,,0,1,1,2
10669,trezorr,,19,154,219,373
10670,youhadmeatzugzug,,6,2,1,3
10671,Goronmon,,12,2,2,4
10672,One808,,1,3,6,9
10673,assfacejackson,,19,20,48,68
10674,yergi,,32,3,7,10
10675,WE_ARE_ALL_GONNA_DIE,,43,1,2,3
10676,gordonjay2,,18,314,333,647
10677,lucid270,,20,7,12,19
10678,Gupie,,20,35,9,44
10679,adamwulf,,43,1,2,3
10680,xesttub,,1,2,3,5
10681,Tyrone_Gomez,,12,29,17,46
10682,xott,,43,21,34,55
10683,bariswheel,,30,25,29,54
10684,ndestries,,34,9,2,11
10685,Noladishu,,18,16,15,31
10686,dneuman911,,21,431,32,463
10687,retsotrembla,,22,41,25,66
10688,masterfoo,,18,2,10,12
10689,brokendown,,34,182,206,388
10690,4fthawaiian,,12,3,5,8
10691,CrazyDave303,,12,1,2,3
10692,clexmond,,16,1,1,2
10693,zeoslap,,3,106,94,200
10694,tads73,,13,72,189,261
10695,12AngryMen,,6,3,2,5
10696,bonefry,,20,51,59,110
10697,ttaylor38655,,19,2,1,3
10698,FullOfSheeple,,0,48,82,130
10699,dumbasshit,,31,21,18,39
10700,greenlizzard,,13,24,1,25
10701,Iraq_Hussein_Osama,,9,5,11,16
10702,rlm1966,,6,1,1,2
10703,lostangel202,,13,6,2,8
10704,edf825,,22,8,13,21
10705,SVOboy,,5,643,48,691
10706,Canucklesandwitch,,13,3,2,5
10707,SierraAlpha,,35,1,1,2
10708,Bubblyboo,,13,10,3,13
10709,bort901,,32,82,19,101
10710,jeffkolez,,18,34,29,63
10711,goleez,,18,1,2,3
10712,DoesItHurt,,29,9,1,10
10713,eegan1220,,35,4,8,12
10714,TheSquirrel,,34,8,10,18
10715,foamweapons,,19,55,66,121
10716,umeshunni,,21,6,1,7
10717,kennon42,,20,49,46,95
10718,markander,,22,94,136,230
10719,bobbothegrayson,,1,239,74,313
10720,scavenger,,18,108,2,110
10721,meganmcpain,,31,15,29,44
10722,mutatron,,13,2176,3301,5477
10723,falseprophet,,19,400,224,624
10724,growne,,20,2,3,5
10725,blackocellaris,,18,3,3,6
10726,FuggyFresh,,1,1,6,7
10727,etiennep,,1,1,1,2
10728,Maitreya,,19,1,1,2
10729,baxil,,18,128,129,257
10730,lunaemt,,17,3,2,5
10731,Arrgh,,20,200,276,476
10732,Yndis,,30,1,1,2
10733,Isth-mus,,22,18,30,48
10734,MichDdot,,5,71,30,101
10735,drjekelmrhyde,,8,6,13,19
10736,pdwerryhouse,,15,16,4,20
10737,ashoka,,19,3,2,5
10738,ScientificBlogger,,5,7,11,18
10739,stapuff6,,13,2,4,6
10740,Dick_And_Bush,,43,11,5,16
10741,elus,,31,347,577,924
10742,safronloongie,,19,29,85,114
10743,WLiam2012,,18,2,1,3
10744,publicunimail,,20,1,1,2
10745,slogg,,20,3,3,6
10746,spinney,,18,10,17,27
10747,zap,,10,160,79,239
10748,felipe806,,43,65,98,163
10749,beyondration,,22,4,6,10
10750,bath0ry,,43,1,1,2
10751,petermaxwel73,,15,52,5,57
10752,krowziviche,,3,1,1,2
10753,thatguydr,,1,1133,1573,2706
10754,nayturboy,,13,1,3,4
10755,stupidinternet,,18,21,41,62
10756,xinaaj,,19,2,2,4
10757,mmiller,,20,43,83,126
10758,zosomos,,18,77,107,184
10759,reddit_is_stupid,,1,3,7,10
10760,nextedge,,19,129,173,302
10761,AlBundy,,14,1,1,2
10762,Colee,,0,21,45,66
10763,Logician,,5,5,3,8
10764,retho2,,1,69,18,87
10765,WileyG27,,13,1,2,3
10766,aroundtown,,34,18,49,67
10767,rbraeu,,19,5,25,30
10768,durkheim_306,,43,5,8,13
10769,recidivx,,32,6,8,14
10770,davidddavidson,,18,1,1,2
10771,Hitler_was_Liberal,,31,15,29,44
10772,johnrobe,,1,7,13,20
10773,trashlikeyou,,19,1,2,3
10774,Nico_,,18,16,16,32
10775,tygez,,0,4,12,16
10776,sfacets,,15,611,954,1565
10777,johnhummel,,19,131,88,219
10778,hypatia21,,18,3,2,5
10779,bjs3171,,18,3,1,4
10780,vassago,,43,1,4,5
10781,hardcorerednext,,13,7,21,28
10782,matgilbert,,1,5,18,23
10783,kevorama822,,19,1,2,3
10784,sickofgoldbrickers,,13,7,3,10
10785,bigt748,,18,45,10,55
10786,mmm69,,18,9,9,18
10787,Cleric85,,1,96,156,252
10788,kday,,31,15,26,41
10789,IThinkYouMean,,18,2,10,12
10790,MrScotchBoy,,5,4,3,7
10791,mlappy,,32,211,316,527
10792,chonnes,,18,178,160,338
10793,scatter,,13,4,2,6
10794,rbvmusic,,1,140,126,266
10795,squirrel,,20,2,2,4
10796,Kapnobatai,,29,2,4,6
10797,ratatosk,,29,7,12,19
10798,Gimble,,13,36,88,124
10799,the_devils_advocate,,8,1,1,2
10800,LoganPhyve,,18,4,23,27
10801,dufus_pufus,,20,1,1,2
10802,Soss,,18,2,4,6
10803,thesnowfox,,43,13,18,31
10804,saibatsu,,6,3,5,8
10805,bewarethetreebadger,,18,247,365,612
10806,owee,,31,16,28,44
10807,KillYourTV,,35,364,529,893
10808,jameyc,,20,1,2,3
10809,_wool,,0,3,1,4
10810,hoopshype,,18,19,1,20
10811,blue7,,1,1,1,2
10812,pablogrb,,20,6,2,8
10813,dmd,,20,326,299,625
10814,darkwulf,,20,36,69,105
10815,fit4u,,5,1,2,3
10816,itv,,8,17,27,44
10817,rubensinclair,,14,14,26,40
10818,pics1301,,5,1,1,2
10819,john87,,5,24,39,63
10820,mrhota,,6,54,102,156
10821,juanchopancho,,0,62,139,201
10822,Mr_Clownn,,18,49,31,80
10823,ShaneLives,,20,1,2,3
10824,orjan,,32,6,6,12
10825,chikkidee,,22,1,1,2
10826,easyfrag,,43,63,35,98
10827,hash150,,20,1,1,2
10828,tyler2k,,18,1,4,5
10829,jasonal,,20,14,11,25
10830,hashi_lebwohl,,20,2,8,10
10831,popat2000,,34,31,73,104
10832,2Eterneon,,18,1,1,2
10833,extraheavymarcellus,,18,2,7,9
10834,t3mp3st,,20,33,33,66
10835,Twisted,,20,140,190,330
10836,GWBWTC911,,13,3,7,10
10837,neverknow,,4,90,47,137
10838,bagpipegoatee,,32,7,15,22
10839,parisxv,,30,20,10,30
10840,ronaldst,,6,3,2,5
10841,mictlanian,,31,1,2,3
10842,Jules_motherfucker,,32,1,3,4
10843,G-Race,,19,1,4,5
10844,glosie,,20,2,5,7
10845,ticklecricket,,2,326,361,687
10846,canadiaman,,31,4,8,12
10847,jozilla,,20,1,1,2
10848,hj427,,5,2,3,5
10849,NZ420,,17,7,2,9
10850,jody_imus_rulz,,13,2,1,3
10851,rosejonescolour,,34,16,22,38
10852,Sparq,,4,10,27,37
10853,AndWat,,34,88,29,117
10854,zaru_soba,,32,19,22,41
10855,kewidogg,,27,2,1,3
10856,rafo,,20,1,4,5
10857,cshipley,,13,2,7,9
10858,Cavorticus,,32,97,209,306
10859,Bloody_Eye,,30,421,476,897
10860,stealth210,,10,41,36,77
10861,drch,,22,36,37,73
10862,Varthash,,20,3,10,13
10863,sofacough,,13,1,1,2
10864,kmack,,18,43,101,144
10865,jarpit,,20,2,4,6
10866,kevinthedude,,3,2,1,3
10867,nofunatall,,22,5,7,12
10868,circusbred,,13,32,42,74
10869,stirfry,,19,17,31,48
10870,make_cookies_permane,,13,29,35,64
10871,DeadPrez,,20,10,4,14
10872,jacobhsoboroff,,19,95,3,98
10873,Creative_Thinker,,43,1,1,2
10874,alfismoney,,19,8,7,15
10875,dirka,,13,41,29,70
10876,onehitwonder,,20,5,1,6
10877,FatAssHam,,0,2,1,3
10878,TomatoSlayer,,18,29,70,99
10879,Blkhrtd,,29,3,3,6
10880,BornAMuslimStay4Ever,,22,10,13,23
10881,godseyeview,,13,5,5,10
10882,Zootex,,15,128,177,305
10883,JohnathanD,,19,6,6,12
10884,dyneo,,0,1,1,2
10885,infernalmachine,,13,1,2,3
10886,afahmed,,32,1,2,3
10887,mandroid,,0,1,2,3
10888,UberNL,,31,2,1,3
10889,thynnus,,19,4,16,20
10890,bluishred,,31,29,31,60
10891,bwelford,,5,1,1,2
10892,hangoneveryword,,1,323,324,647
10893,rogerly,,13,5,3,8
10894,nixons,,19,6,22,28
10895,camwaite,,4,1,1,2
10896,taggesq,,31,2,4,6
10897,GTracer,,36,1,1,2
10898,rarebluemonkey,,18,236,303,539
10899,olifante,,18,7,12,19
10900,mikeyc252,,13,75,61,136
10901,Wurlitzer,,20,1,1,2
10902,DrStrngeluv,,14,1,3,4
10903,cfrey,,34,27,56,83
10904,pointy,,20,9,11,20
10905,WiseMasterRat,,18,7,7,14
10906,Trevkor,,32,5,1,6
10907,SamB,,20,1,3,4
10908,jdrogers923,,19,49,75,124
10909,soopisgoodfood,,0,145,26,171
10910,mattfasken,,18,110,177,287
10911,NoData,,18,15,22,37
10912,DrunkenTrom,,33,12,18,30
10913,snark42,,4,133,186,319
10914,nerd123,,19,3,2,5
10915,beaumct,,38,2,1,3
10916,ebee,,18,54,90,144
10917,CrazyLemurBoy,,18,23,12,35
10918,seskie,,15,2,4,6
10919,Fromez,,18,31,23,54
10920,batpanther,,22,1,3,4
10921,spacenut37,,18,46,100,146
10922,thesalus,,1,10,8,18
10923,vinigrette,,32,92,118,210
10924,Tholo,,13,13,12,25
10925,Arsecroft,,17,15,26,41
10926,Knick,,18,50,4,54
10927,rkts,,20,3,6,9
10928,sping,,6,433,695,1128
10929,muramasa,,43,121,104,225
10930,Marxshmarx,,13,14,13,27
10931,bigpeters,,9,4,5,9
10932,nuanceify,,29,1,2,3
10933,AnimZero,,19,6,4,10
10934,gruuby,,31,66,102,168
10935,jczeus,,20,9,17,26
10936,thatusernameistaken,,20,2,3,5
10937,artlung,,3,4,2,6
10938,CaptWacky,,32,159,54,213
10939,nepotism,,1,44,49,93
10940,americafuckyeah,,18,7,22,29
10941,squirreltapper,,20,1,1,2
10942,xfactorial,,0,28,27,55
10943,powerhead,,43,40,53,93
10944,modivate,,30,27,11,38
10945,youwish20,,13,3,3,6
10946,miketrash,,19,197,62,259
10947,LordFoom,,32,94,187,281
10948,I_go_out_in_my_PJs,,43,10,2,12
10949,CdnGuy,,18,4,6,10
10950,ender1980,,13,2,9,11
10951,Sutto,,20,6,11,17
10952,otherguy,,43,77,117,194
10953,modelchick8806,,18,11,16,27
10954,Gmclaurin,,29,1,1,2
10955,StarBeamAlpha,,22,21,21,42
10956,KenMixtape,,18,12,18,30
10957,Stax493,,18,1,7,8
10958,zetsurin,,20,32,43,75
10959,worldlybedouin,,19,42,58,100
10960,beohbe,,22,19,34,53
10961,magnusbe,,34,10,15,25
10962,bboy1977,,0,6,6,12
10963,shoesbuttback,,20,49,87,136
10964,bobmoretti,,43,1,2,3
10965,honkerburger,,43,126,67,193
10966,ivankirigin,,18,33,31,64
10967,Slycne,,1,1,1,2
10968,doodoohead,,39,1,1,2
10969,johso,,18,4,3,7
10970,9917,,8,13,24,37
10971,machx,,20,1,1,2
10972,MadMark,,19,10,11,21
10973,ericthefish,,32,3,3,6
10974,vishnoo,,18,24,23,47
10975,onemoretune,,43,4,9,13
10976,aphexairlines,,20,160,237,397
10977,gtmills,,32,1,1,2
10978,canipole,,19,8,9,17
10979,gagle,,32,1,3,4
10980,Gnosquito,,31,1,1,2
10981,NorthwestWolf,,11,1,3,4
10982,wiggitywhack,,29,7,18,25
10983,zoltar74,,3,19,12,31
10984,ChendlerBing,,0,1,1,2
10985,Kricket,,6,8,14,22
10986,heyblincoln,,13,11,1,12
10987,massivedooker,,32,4,5,9
10988,poleary,,4,50,34,84
10989,bg785,,10,52,19,71
10990,filberts,,13,114,144,258
10991,torontoist,,1,15,1,16
10992,apenguinatemyhamster,,20,26,23,49
10993,asnklv,,29,1,3,4
10994,funk_wumpkins,,43,19,13,32
10995,sythec,,19,14,55,69
10996,vague_blur,,34,95,246,341
10997,fancy-free,,22,87,148,235
10998,bleedpurpleguy,,22,73,131,204
10999,sweetfish,,19,1,1,2
11000,OH-YEAH,,19,4,7,11
11001,kingGBush,,1,10,21,31
11002,comedyishard,,13,16,39,55
11003,motherof2,,32,1,1,2
11004,Crazy_Cyrax,,22,9,5,14
11005,thebarbarian87,,19,106,226,332
11006,alphasignal5,,43,34,49,83
11007,pb1157,,4,5,6,11
11008,edward_r_burrow,,18,206,237,443
11009,credence,,42,108,155,263
11010,capbrune,,30,5,6,11
11011,bcorfman,,20,54,49,103
11012,sacherjj,,19,210,299,509
11013,godhammre,,13,328,423,751
11014,lynxlynx,,10,4,6,10
11015,ryuujinusa,,22,3,13,16
11016,alice_,,29,1,2,3
11017,tzan,,31,24,25,49
11018,Zyg,,13,32,19,51
11019,erictheinfonaut,,19,153,3,156
11020,ktvoelker,,20,3,4,7
11021,GirlGeorge,,19,66,17,83
11022,gmee2213,,5,1,9,10
11023,Ivashkin,,38,3,6,9
11024,mapryan,,32,138,145,283
11025,gratdbat,,19,21,31,52
11026,GFHrecluse,,27,1,7,8
11027,itsallfunfunfun,,19,2,9,11
11028,ASquaredWriter,,19,1,5,6
11029,stealthfox,,16,1,1,2
11030,drslammy,,19,84,7,91
11031,sbjf,,29,22,12,34
11032,Chexjc,,5,1,2,3
11033,jedbism,,19,5,4,9
11034,regreddit,,12,66,104,170
11035,metallicafan,,22,17,25,42
11036,creativename,,19,82,70,152
11037,flowerb0x,,13,3,2,5
11038,ussr,,0,16,3,19
11039,Admiral-Evident,,43,61,86,147
11040,spliznork,,20,93,94,187
11041,Wiseman1024,,20,476,512,988
11042,graymalkin,,18,4,4,8
11043,canhaskarma,,20,209,173,382
11044,NOT_AN_ALIEN,,20,16,17,33
11045,Redwan,,19,35,36,71
11046,edgarallenpoe,,13,112,229,341
11047,RLET,,12,22,22,44
11048,orangetide,,13,7,15,22
11049,chandler760,,0,1,1,2
11050,tacitus1,,19,407,8,415
11051,AnonymousChicken,,31,38,54,92
11052,LordQuorad,,18,9,24,33
11053,suplol,,22,1,1,2
11054,SeaLegs,,13,11,1,12
11055,rcut,,19,99,91,190
11056,chuck_c,,13,18,29,47
11057,tulku,,31,5,5,10
11058,dsb101,,12,28,20,48
11059,helloinsomnia,,30,1,1,2
11060,buddhistkitten,,43,66,86,152
11061,BangGoodOne,,18,25,68,93
11062,deafmacro,,20,6,14,20
11063,michaelll,,20,7,12,19
11064,pbinder,,30,24,15,39
11065,pfhor,,1,23,43,66
11066,kingdom,,43,5,5,10
11067,jholloway7,,20,7,7,14
11068,sirshannon,,30,3,2,5
11069,thepowerwithin,,29,1,1,2
11070,lencioni,,1,20,7,27
11071,crazedover,,18,72,73,145
11072,teaguesterling,,20,51,78,129
11073,elliotakshun,,43,4,12,16
11074,Zlatty,,43,263,341,604
11075,retnuh730,,15,20,3,23
11076,ChosenTongue,,13,1,1,2
11077,singletask,,13,1,19,20
11078,apefist,,43,4,2,6
11079,eatme0,,13,1,2,3
11080,stonecannon,,18,76,38,114
11081,rocksauce,,34,116,225,341
11082,MassesOfTheOpiate,,1,326,539,865
11083,apackofwankers,,13,9,9,18
11084,GI-20,,36,6,1,7
11085,TKN,,20,97,102,199
11086,fdgdfgdf,,20,1,1,2
11087,ohhiohhi,,13,1,1,2
11088,ctrl-freak,,43,1,1,2
11089,srpr,,19,27,1,28
11090,isepic,,42,3,2,5
11091,mitja23,,4,1,1,2
11092,mexmexmex_2000,,12,1,1,2
11093,huhwhat,,12,2,1,3
11094,The_Government,,2,9,15,24
11095,jjmac,,5,77,87,164
11096,mythogen,,32,111,158,269
11097,tkengland,,13,9,15,24
11098,djv,,20,1,1,2
11099,jedrury,,33,3,3,6
11100,meritw,,20,3,2,5
11101,rowanwolf,,3,1,1,2
11102,peepingtom,,17,1,1,2
11103,cwhite,,43,23,40,63
11104,cmak,,0,34,29,63
11105,Gglii,,32,1,3,4
11106,RalphBott,,13,7,7,14
11107,seemant,,32,60,89,149
11108,scoobeee,,1,92,225,317
11109,ShoutShout,,8,1,3,4
11110,Unfair,,28,311,502,813
11111,cuyler,,4,71,70,141
11112,babaloooo,,31,1,3,4
11113,ochen7,,19,94,47,141
11114,tededit,,31,1,6,7
11115,bishoplonnie,,34,12,5,17
11116,TaraAthenry,,32,1,1,2
11117,1cesc,,42,252,69,321
11118,SemiLOOSE,,19,33,9,42
11119,Rev_Jeremiah_Wright,,0,1,1,2
11120,drewyp,,42,12,13,25
11121,bohemus,,18,481,141,622
11122,jnoller,,20,6,12,18
11123,mrmonster,,14,21,35,56
11124,JHMcCormick,,36,3,4,7
11125,Poligan,,13,80,7,87
11126,soulicro,,31,26,14,40
11127,SarahPalin-,,18,8,12,20
11128,MockDeath,,13,1,7,8
11129,pixzor,,34,16,31,47
11130,Ohio,,43,2,3,5
11131,WWJeffersonDo,,19,5,11,16
11132,psychicbologna,,18,6,18,24
11133,qubous,,30,5,7,12
11134,JW_00000,,20,141,167,308
11135,sexymustard,,18,19,7,26
11136,no1name,,13,303,399,702
11137,silverbax,,29,2,2,4
11138,missilesilo,,20,47,67,114
11139,fmoor,,34,3,5,8
11140,sarcasticmuch,,20,9,7,16
11141,poopballs,,13,41,80,121
11142,limplipliberal,,3,2,5,7
11143,jackndacrackman,,10,3,1,4
11144,Snugglzworth,,1,3,7,10
11145,luciansolaris,,20,15,13,28
11146,thindude,,20,1,1,2
11147,raand,,0,10,16,26
11148,Syl,,20,20,46,66
11149,ahall,,5,7,9,16
11150,AwkwardSilenceMan,,18,1,3,4
11151,swovii,,29,1,1,2
11152,twiggyfoot1,,13,3,2,5
11153,JacKrac,,22,139,224,363
11154,breauxaj,,32,3,1,4
11155,jayho,,42,21,26,47
11156,Sleepman,,31,20,14,34
11157,deathonabudget,,20,1,3,4
11158,coderob,,30,3,2,5
11159,elikagan,,31,13,4,17
11160,zintzun,,42,11,10,21
11161,srika,,1,891,1336,2227
11162,warchild,,8,7,8,15
11163,xeno81,,43,1,3,4
11164,sleepyhead-,,31,4,2,6
11165,_Cactus_,,20,2,1,3
11166,ThomasEdilson,,43,71,12,83
11167,danclaw,,22,41,84,125
11168,5555,,31,66,58,124
11169,subcypher,,19,4,14,18
11170,futto,,15,53,73,126
11171,w5k3fTkZ,,18,12,4,16
11172,tracii1984,,19,36,55,91
11173,uberfr4gger,,19,17,21,38
11174,strikingviking,,14,1,1,2
11175,Ask_Reddit,,1,1,1,2
11176,slowdraw,,17,1,1,2
11177,sundogdayze,,18,97,183,280
11178,nolte3,,18,5,3,8
11179,quattro,,20,154,227,381
11180,aaronreddit,,18,192,145,337
11181,sean9812,,19,4,5,9
11182,mr_aks,,20,17,1,18
11183,spiraltri3e,,43,22,36,58
11184,terrorazzi,,43,2,1,3
11185,mcsalmon,,34,302,180,482
11186,dan537,,13,1,1,2
11187,tywebb,,18,6,6,12
11188,Derferman,,1,76,77,153
11189,BigEazy,,18,76,13,89
11190,jruderer,,18,1,3,4
11191,Rabizar,,31,3,2,5
11192,DrMic,,22,49,30,79
11193,skea1811,,19,1,1,2
11194,abyssomega,,20,73,97,170
11195,scipio_major,,20,1,4,5
11196,p337,,32,346,391,737
11197,anthonygonsalves,,0,78,166,244
11198,janpjens,,20,34,43,77
11199,xualzan,,19,2,2,4
11200,obi-nine,,30,8,3,11
11201,gama69g,,19,8,15,23
11202,Corbier,,20,22,10,32
11203,kreiger,,20,3,7,10
11204,pvande,,18,3,9,12
11205,deism666,,13,41,8,49
11206,janisdoof,,18,9,19,28
11207,redbukil,,34,6,1,7
11208,abend954,,22,35,30,65
11209,GrantCity,,5,1,2,3
11210,harisn,,18,1,4,5
11211,wormmox,,18,7,7,14
11212,saculus,,31,5,3,8
11213,elmariachi304,,12,114,111,225
11214,noideawhatisgoingon,,18,5,5,10
11215,Chompy,,31,23,29,52
11216,psnajder,,13,53,18,71
11217,JPsmooth42,,1,102,66,168
11218,marion33,,20,9,10,19
11219,ggrothau,,13,14,7,21
11220,suacy,,13,9,10,19
11221,kfm,,13,30,10,40
11222,alecco,,20,31,30,61
11223,paket,,6,1,3,4
11224,beached,,18,1,1,2
11225,Jesus_is_great,,40,6,3,9
11226,harpwn,,12,175,167,342
11227,playerbeat,,1,68,42,110
11228,opie211,,18,5,1,6
11229,Pedobear-,,13,1,1,2
11230,arnone,,18,24,28,52
11231,Zareh,,19,7,8,15
11232,thurston51,,20,1,2,3
11233,StabbyGator,,42,5,6,11
11234,timberspine,,18,425,314,739
11235,Soul_Rebel,,35,4,7,11
11236,sophistirat,,6,3,5,8
11237,Fu3go,,13,6,8,14
11238,mexicanbach,,43,16,40,56
11239,charlesmcallister,,42,1,2,3
11240,ExactlyMyThoughts,,20,5,5,10
11241,kodemage,,22,33,50,83
11242,Joe6pack,,13,26,30,56
11243,bbbobsaget,,19,66,78,144
11244,DavidMcLaughlin,,20,29,13,42
11245,rds260,,13,342,494,836
11246,smokealot,,1,38,91,129
11247,Ek0nomik,,19,53,59,112
11248,ste3ve,,22,4,3,7
11249,sfddsfsddd,,19,9,14,23
11250,i31ush,,42,2,5,7
11251,FakeFact,,19,9,12,21
11252,Redfel,,19,65,150,215
11253,Traftron,,31,1,1,2
11254,arodessa,,20,4,5,9
11255,cnichols82,,13,1,12,13
11256,pyro138,,32,73,84,157
11257,Unapox,,18,111,143,254
11258,dmun,,21,7,4,11
11259,mjpanzer,,18,54,52,106
11260,kra,,20,8,8,16
11261,petelyons,,20,15,4,19
11262,moddestmouse,,1,470,497,967
11263,cmbezln,,0,6,6,12
11264,uhhhclem,,31,43,68,111
11265,whitepaper,,18,7,20,27
11266,CaptainDevious,,18,558,648,1206
11267,ppolv,,20,1,1,2
11268,confuseum,,18,2,4,6
11269,bstard,,5,27,29,56
11270,spineless,,20,1,1,2
11271,ryanroth,,19,15,3,18
11272,redrobot5050,,36,635,1027,1662
11273,docbrolic,,34,203,178,381
11274,BunjiX,,43,6,12,18
11275,KudoKid,,19,6,11,17
11276,janzo,,18,2,1,3
11277,phooka,,13,1,3,4
11278,whatevermakesuhappy,,19,41,13,54
11279,bricklab,,13,12,21,33
11280,GuardManiaC,,18,2,4,6
11281,jorgamun,,32,11,24,35
11282,slovakov,,29,17,34,51
11283,mraseelak,,42,1,1,2
11284,yosefmartin,,31,2,2,4
11285,gangsta-gangsta,,13,45,12,57
11286,ronbot,,19,15,18,33
11287,jt32470,,19,214,440,654
11288,perrin,,13,1,3,4
11289,ryan44,,13,1,5,6
11290,mvaliente2001,,20,24,18,42
11291,vjxucu,,34,1,1,2
11292,rexhardwick,,18,15,6,21
11293,dbt08,,18,9,28,37
11294,sati,,0,15,7,22
11295,keturn,,20,11,18,29
11296,noyu,,20,8,15,23
11297,aylwin,,29,7,11,18
11298,politicallore,,19,358,22,380
11299,Chun,,22,386,270,656
11300,Astrophro,,31,3,2,5
11301,pandaba,,19,45,52,97
11302,daikiki,,18,82,18,100
11303,restore,,19,14,25,39
11304,buddhagirl,,40,1,4,5
11305,rccgd,,19,1,1,2
11306,micahi21,,42,11,25,36
11307,Vicinus,,29,15,16,31
11308,comics4u,,19,6,12,18
11309,sufraga,,20,5,12,17
11310,Chasingwaves,,1,56,59,115
11311,ricky_clarkson,,20,22,31,53
11312,Quibbling_Fucker,,3,9,3,12
11313,manipur,,27,7,1,8
11314,superanth,,13,5,3,8
11315,basninja,,19,3,2,5
11316,xhanjian,,20,22,6,28
11317,JeddHampton,,11,80,109,189
11318,Zaphrod,,11,15,15,30
11319,This_guys_sockpuppet,,5,2,5,7
11320,fingernibbler,,18,3,4,7
11321,Camarade_Tux,,20,2,3,5
11322,damageboy,,31,25,7,32
11323,pmarsh,,20,59,73,132
11324,JNTB,,32,1,3,4
11325,Pxl_Buzzard,,42,23,2,25
11326,Judas,,10,54,85,139
11327,nuclear_eclipse,,20,227,299,526
11328,electrobutter,,13,47,9,56
11329,jinendu,,13,79,100,179
11330,FooFighter828,,18,3,6,9
11331,BillyBlanks,,19,62,73,135
11332,mrgreen4242,,4,484,417,901
11333,benjamincanfly,,43,372,341,713
11334,twomeanings,,3,2,5,7
11335,makapuf,,20,1,2,3
11336,hypoglycemic,,15,6,9,15
11337,mahade,,32,94,120,214
11338,heresyforme,,32,17,14,31
11339,secmil,,1,35,33,68
11340,joecool,,3,50,38,88
11341,vastib,,32,272,193,465
11342,gterrill,,20,2,2,4
11343,mlietzen,,43,3,9,12
11344,kehaar,,19,13,21,34
11345,skytland,,29,1,3,4
11346,cgeorgan,,23,108,122,230
11347,BloodWar,,31,1,3,4
11348,macsbac,,31,1,3,4
11349,boooomsquad,,19,1,1,2
11350,mccoyn,,20,494,851,1345
11351,Wickerchair,,43,148,94,242
11352,madjalapeno,,18,11,14,25
11353,scienceevofreak,,12,4,1,5
11354,gillnana,,27,1,1,2
11355,flicea,,20,17,10,27
11356,gippo333,,30,3,3,6
11357,bethyboo,,6,2,1,3
11358,VCavallo,,20,49,75,124
11359,vprasad1,,13,12,23,35
11360,enjo42,,13,6,1,7
11361,bw1870,,16,539,1064,1603
11362,RichardPryor,,1,1472,404,1876
11363,mick92627,,32,1,1,2
11364,redwoodtree,,18,2,2,4
11365,Iconic,,19,10,22,32
11366,spiker611,,5,25,52,77
11367,hannahlin,,6,60,85,145
11368,TypicalAmerican,,16,6,15,21
11369,troubleshooter,,0,2,2,4
11370,crawfordretail,,13,3,1,4
11371,megagreg,,30,105,177,282
11372,Maxxist,,42,118,218,336
11373,norsurfit,,19,81,80,161
11374,cherryhoward,,27,1,1,2
11375,Kildurin,,19,13,14,27
11376,tibbs44,,32,1,1,2
11377,xoner2,,20,44,60,104
11378,zarubi,,13,41,15,56
11379,alkoret,,18,2,4,6
11380,mrwesticles,,18,12,23,35
11381,jwgerard,,13,1,3,4
11382,reply,,13,133,208,341
11383,bobbyb500,,4,1,2,3
11384,boobasan,,13,430,129,559
11385,bengrubb,,15,3,2,5
11386,profr,,13,4,8,12
11387,brien,,19,7,6,13
11388,johnmorris,,19,9,1,10
11389,ravemanX,,20,1,1,2
11390,pressed,,22,311,333,644
11391,flamehead243,,34,20,1,21
11392,RichardSimmons,,18,7,14,21
11393,dr3d,,20,9,30,39
11394,dheld,,20,4,3,7
11395,scabootssca,,31,5,7,12
11396,cheech_sp,,3,46,50,96
11397,ggruschow,,20,15,6,21
11398,cogtrj,,29,1,2,3
11399,zapfastnet,,18,1,3,4
11400,m_res,,17,112,202,314
11401,kojef,,18,13,5,18
11402,gongus,,13,8,10,18
11403,fetty,,20,1,1,2
11404,feilb,,19,23,8,31
11405,withclothes,,6,16,2,18
11406,dango7777,,43,1,1,2
11407,art80,,31,1,2,3
11408,jaymeekae,,18,162,130,292
11409,superherojuice,,13,1,1,2
11410,indigo-alien,,30,78,192,270
11411,nullbot,,20,1,2,3
11412,OhNoMaiFreeDumbs,,0,3,4,7
11413,SFonTHill,,19,18,9,27
11414,djeron,,1,1,2,3
11415,paradigmshaft,,20,10,13,23
11416,kanima,,16,3,5,8
11417,pingu,,31,83,155,238
11418,Nivekt13,,13,3,4,7
11419,jigulous,,32,1,1,2
11420,baltar,,43,1,1,2
11421,peerLAN,,20,4,1,5
11422,SILNTBOB,,42,1,1,2
11423,nashife,,18,20,40,60
11424,slayt00,,14,1,1,2
11425,murkos,,18,1,4,5
11426,pingish,,31,792,698,1490
11427,willpall,,2,8,19,27
11428,overand,,43,5,6,11
11429,SNerison,,1,5,2,7
11430,revilo23,,34,3,12,15
11431,JohnZoidberg,,1,17,1,18
11432,kitsy,,18,13,39,52
11433,glassjoe984,,33,2,3,5
11434,dude187,,19,6,2,8
11435,kiriyama,,43,102,2,104
11436,vor,,20,6,2,8
11437,rastawala,,18,297,5,302
11438,drewfer,,29,17,19,36
11439,code2code,,20,3,2,5
11440,eldurable,,12,1,1,2
11441,Ciceros_Assassin,,13,76,81,157
11442,LiberalDemocrat_ftw,,19,1,1,2
11443,boomi,,32,4,4,8
11444,dwahler,,20,22,39,61
11445,Freedom4You,,4,1,1,2
11446,amican,,19,297,615,912
11447,woop_,,43,17,10,27
11448,j_mcc99,,18,1,5,6
11449,Sheki,,6,1,1,2
11450,vamit11,,43,1,8,9
11451,roccobuttonlucky,,34,341,39,380
11452,lastobelus,,32,34,51,85
11453,Joss,,43,50,75,125
11454,cmv1607,,8,6,6,12
11455,iknoritesrsly,,34,9,15,24
11456,thirstyrobot,,1,1,1,2
11457,balackosama,,31,2,2,4
11458,ShadedTrow,,18,9,18,27
11459,masukomi,,20,161,234,395
11460,thechicken,,43,1,1,2
11461,ekspiulo,,35,3,5,8
11462,weddingcrasher,,19,10,4,14
11463,haija,,31,68,77,145
11464,xcyclist,,19,2,3,5
11465,Clampurloiner,,31,2,2,4
11466,seangw,,13,21,4,25
11467,scubastza,,18,25,6,31
11468,cheddarben,,13,613,330,943
11469,anonymousgoat,,42,4,3,7
11470,skibybadoowap,,22,188,99,287
11471,whadthfxup,,32,1,1,2
11472,frabbergasted,,34,1,2,3
11473,caenum,,0,1,10,11
11474,neema,,20,9,3,12
11475,libertyman,,27,4,3,7
11476,Bitey,,13,87,60,147
11477,Spiralhead,,20,11,15,26
11478,helixblue,,1,1,1,2
11479,hammermybones,,5,1,4,5
11480,weekapaugr00ve,,0,4,7,11
11481,alephnul,,13,453,1263,1716
11482,dragonstyle,,20,5,2,7
11483,rischi,,18,12,19,31
11484,Misses_DePoint,,43,11,19,30
11485,rtknox00,,34,549,46,595
11486,darianjd,,18,1,2,3
11487,fuzzo,,34,1411,912,2323
11488,extole,,26,1,4,5
11489,k3ithk,,43,66,113,179
11490,vampireface,,1,173,160,333
11491,FFFFFFFFffff,,20,30,23,53
11492,cff,,19,12,10,22
11493,asdfadsfadsf,,6,11,15,26
11494,uiopq,,13,1,1,2
11495,nancybryan,,43,2,1,3
11496,n3m6,,43,56,113,169
11497,quetzalcoatl1,,29,2,1,3
11498,RibbonsUndone,,36,1,1,2
11499,maxbaroi,,20,13,23,36
11500,heff,,19,2,1,3
11501,allanf,,29,2,2,4
11502,Ridgecliff,,18,3,5,8
11503,jonez450,,18,161,6,167
11504,JimmyMcNulty,,3,1,1,2
11505,tri6ky,,8,5,5,10
11506,JulianHyde,,22,18,32,50
11507,imdk,,19,11,19,30
11508,grubonrice,,42,5,9,14
11509,knusi1212,,18,1,1,2
11510,prestigearticle,,19,23,1,24
11511,boyyy,,32,1,2,3
11512,WhooHoo,,18,6,11,17
11513,imbiat,,19,16,3,19
11514,Ron_Jeremy,,43,1,1,2
11515,losvedir,,29,257,203,460
11516,triceratops,,19,4,1,5
11517,MrngNeom,,22,14,26,40
11518,weegeekus,,34,126,58,184
11519,dadzilla,,13,9,13,22
11520,keenerd,,20,58,20,78
11521,petercooper,,43,132,144,276
11522,redeyeco,,18,260,32,292
11523,Oatmeat,,20,3,7,10
11524,jimmyviscain,,18,16,22,38
11525,ertomo,,18,10,2,12
11526,fsck3r,,20,5,5,10
11527,jandrews442,,18,4,11,15
11528,NegativeZero,,41,4,5,9
11529,imagemax,,5,1,2,3
11530,andwi,,20,2,2,4
11531,donh,,31,81,152,233
11532,desmund,,1,47,48,95
11533,deadagain,,29,2,4,6
11534,peekapuma,,18,2,1,3
11535,Soosed,,30,84,98,182
11536,nexit,,19,31,23,54
11537,OingoBoingo,,13,8,6,14
11538,Anselmo,,0,15,47,62
11539,weeeeeeeeeeeeee,,20,19,33,52
11540,mylife64,,34,11,22,33
11541,iofthestorm,,20,285,497,782
11542,COINTELPRO,,19,37,40,77
11543,ididntknowthat,,23,25,32,57
11544,witandtears,,32,2,2,4
11545,thugesquire,,13,142,209,351
11546,uncasid,,1,2,1,3
11547,likeem,,19,4,12,16
11548,themastermold,,36,3,3,6
11549,rochskier,,13,4,6,10
11550,DrSatyr,,18,69,1,70
11551,freakin_goose,,10,4,2,6
11552,operatix,,15,2,2,4
11553,kicktown,,29,2,11,13
11554,VigRoco,,13,18,9,27
11555,commontater3,,20,1,1,2
11556,NewDemocrat,,13,72,64,136
11557,alon85,,18,6,7,13
11558,PaulT,,34,5,9,14
11559,Masiosare,,38,1,3,4
11560,moozilla,,1,180,192,372
11561,m0ve,,18,8,9,17
11562,betanerd,,8,1,3,4
11563,Suniikaa,,1,1,5,6
11564,otagoyellow,,5,40,1,41
11565,captainhaddock,,4,844,1118,1962
11566,Vex550,,42,1,3,4
11567,Olgaar,,32,19,15,34
11568,MrBismarck,,18,22,63,85
11569,ptwarhol,,13,11,35,46
11570,iamdek,,43,2,3,5
11571,garrettw,,29,2,5,7
11572,koushiro,,43,29,25,54
11573,sefus,,13,2,1,3
11574,SandyTheDJ,,19,1,1,2
11575,danfard,,32,9,14,23
11576,G-Brain,,20,127,188,315
11577,pr0spero,,43,1,1,2
11578,evilnight,,17,128,227,355
11579,zttca5,,5,2,7,9
11580,roti,,22,11,13,24
11581,FreeOrDieFl,,19,6,8,14
11582,CPops,,14,20,30,50
11583,tripping,,1,82,28,110
11584,maht0x0r,,19,160,284,444
11585,darthmile,,34,4,2,6
11586,dwarfenfart,,32,2,1,3
11587,phelonius,,43,13,11,24
11588,k4ml,,20,14,1,15
11589,dandlion,,13,33,110,143
11590,praetis,,19,4,2,6
11591,Walkertalker,,43,2,2,4
11592,GizmoC,,20,4,9,13
11593,juggle,,32,146,39,185
11594,mlh1979,,19,1,3,4
11595,maxyRO,,5,1041,98,1139
11596,Your_God,,19,1,3,4
11597,mandies37894,,31,13,2,15
11598,nicasucio,,0,15,27,42
11599,rkcr,,18,189,55,244
11600,Narfinity,,12,14,12,26
11601,spencewah,,42,107,161,268
11602,williumbillium,,8,8,10,18
11603,meganiac,,6,7,11,18
11604,zmmmzzz,,43,50,10,60
11605,triggerpuff,,42,5,3,8
11606,lovespoppies,,35,1,2,3
11607,OlyLiberal,,31,5,4,9
11608,brianwitt,,19,6,6,12
11609,dban,,19,1,1,2
11610,ScorseseFan74,,43,30,13,43
11611,rawfiji,,29,1,3,4
11612,uncreative_name,,18,310,507,817
11613,othermimic,,13,7,11,18
11614,nitrusoxyde,,13,11,34,45
11615,SHEEPLE_ALARM_CLOCK,,31,29,36,65
11616,johnwilson1969,,18,43,116,159
11617,Desparanso,,11,42,4,46
11618,shep66,,13,11,6,17
11619,benji592,,0,1,1,2
11620,canofunk,,20,3,3,6
11621,bonez1255,,30,1,1,2
11622,andominus21,,19,3,3,6
11623,afterclap,,43,1,1,2
11624,anoon,,4,1,3,4
11625,slockton,,13,111,72,183
11626,localoptima,,19,5,5,10
11627,shoehornhands,,18,16,28,44
11628,Ecorama,,18,10,8,18
11629,Papper,,20,263,433,696
11630,stacy75,,1,337,192,529
11631,elissa1959,,31,573,908,1481
11632,tiefling,,18,2,2,4
11633,thealmightygott,,32,26,81,107
11634,lunarover,,13,3,5,8
11635,sammythemc,,34,10,9,19
11636,aaltonen,,31,15,37,52
11637,paulkerzner,,18,17,6,23
11638,ahktljlqxeym,,20,7,6,13
11639,userlame,,22,7,11,18
11640,PunBreaker,,7,1,1,2
11641,Jolva,,1,32,12,44
11642,kadath,,20,38,38,76
11643,tdhoufek,,8,13,26,39
11644,conkertheking,,0,10,19,29
11645,Quicksilver,,34,41,63,104
11646,morandomdanu,,14,41,45,86
11647,visarya,,18,3,7,10
11648,QueryBean,,1,3,1,4
11649,crazydiode,,30,25,20,45
11650,cybernetic_web_user,,18,50,55,105
11651,novemestranged,,31,2,1,3
11652,nandemo,,20,7,13,20
11653,dlytle,,32,2,9,11
11654,Maxxover,,18,107,123,230
11655,stuff071,,20,1,2,3
11656,VicGirl29,,8,1,1,2
11657,modreef,,18,28,36,64
11658,Tor_Onsen,,13,187,50,237
11659,leitao,,19,3,1,4
11660,jonnyg1986,,39,4,2,6
11661,Guinness,,43,53,35,88
11662,darwinisdead,,13,6,11,17
11663,frolix8,,18,9,6,15
11664,ReginaldCousins,,19,2,2,4
11665,drbold,,6,393,642,1035
11666,keramos,,18,17,47,64
11667,DImuthu,,31,1,1,2
11668,newtonapple,,31,1,1,2
11669,sorcia1,,43,5,4,9
11670,vbouret,,20,4,5,9
11671,jonknet,,34,12,7,19
11672,etm117,,1,12,16,28
11673,aresaypay,,0,13,13,26
11674,AgingPunkRocker,,32,57,94,151
11675,Borachoke,,18,16,39,55
11676,splag,,1,1,1,2
11677,aluminumovercast,,32,94,56,150
11678,zbob,,22,9,11,20
11679,stripchamber,,0,45,94,139
11680,shoelessone,,18,2,9,11
11681,bcostlow,,19,7,17,24
11682,vampiregabe,,13,175,200,375
11683,saad85,,42,98,90,188
11684,WhiteEagle,,27,4,3,7
11685,dirtymoney,,1,1787,1932,3719
11686,dellea,,13,6,2,8
11687,vel0x,,9,5,1,6
11688,moonbeaver,,18,13,7,20
11689,CreepyLittlePuppet,,18,2,1,3
11690,bretris,,18,19,2,21
11691,seely,,5,8,1,9
11692,mook_ster,,18,4,9,13
11693,orangut,,20,1,1,2
11694,njosnari,,18,5,9,14
11695,baboose,,19,3,2,5
11696,ArtVandeley,,18,86,52,138
11697,bob_doles_hard-on,,19,5,1,6
11698,zbtgf,,19,20,9,29
11699,smurfmx,,35,1,1,2
11700,Tsien,,34,1,1,2
11701,bretthoerner,,20,30,35,65
11702,kaehyu,,1,165,38,203
11703,jxhn,,0,9,13,22
11704,gizmogwai,,20,8,14,22
11705,rbl,,18,3,2,5
11706,morish,,31,27,29,56
11707,cdb8er,,17,1,1,2
11708,stevedoredolly,,3,2,3,5
11709,hanzie,,20,24,45,69
11710,alors_je_dis,,13,7,9,16
11711,midas888,,13,9,12,21
11712,Geruna3,,1,4,1,5
11713,jdeisenberg,,13,1,2,3
11714,dokodemodoor,,17,4,9,13
11715,ecoffey,,20,10,12,22
11716,kennies,,43,1,2,3
11717,pistoriusp,,43,99,24,123
11718,fearcomplication,,19,63,41,104
11719,thebroxo,,31,6,6,12
11720,Ruckusnusts,,18,115,208,323
11721,TheBison,,8,2,3,5
11722,RepublicansSUCK6,,13,1,5,6
11723,y3110w5,,1,1,1,2
11724,zutme,,20,4,7,11
11725,chipdip,,36,2,2,4
11726,secretmethod70,,31,1,7,8
11727,l3fff,,19,4,1,5
11728,steamer123,,13,47,39,86
11729,sgricci,,0,11,6,17
11730,Filipino_Monkey,,19,4,6,10
11731,taryneast,,43,4,1,5
11732,coreyshum,,29,2,2,4
11733,polygrapher,,19,8,6,14
11734,davidvincent2,,20,39,66,105
11735,tomjenkinson,,0,35,4,39
11736,nerdmonkey,,5,1,2,3
11737,Shirlock,,18,1,1,2
11738,jwigum,,18,14,15,29
11739,donmak,,13,32,3,35
11740,denhamsdoesit,,13,103,139,242
11741,sphurthy,,13,2,3,5
11742,snarkfish,,42,34,74,108
11743,Jack9,,20,75,185,260
11744,BttShaping,,29,2,1,3
11745,karmakaze,,32,44,56,100
11746,heelspider,,19,623,913,1536
11747,causeitsme,,9,71,109,180
11748,do_thax1,,18,1,1,2
11749,gor,,16,1,1,2
11750,dripsreddy,,21,1,1,2
11751,aarkerio,,31,37,52,89
11752,wongwong,,1,1,3,4
11753,iceschade,,32,37,43,80
11754,riven08,,26,20,35,55
11755,nikhilgore,,34,1,1,2
11756,Themarduk900,,22,13,38,51
11757,losmaxos,,20,8,6,14
11758,billybobbain,,41,4,6,10
11759,macr,,43,2,1,3
11760,akincisor,,20,21,49,70
11761,ion18,,3,1,1,2
11762,toby,,20,8,4,12
11763,angoulemmy,,43,27,25,52
11764,sweetwood419,,32,1,1,2
11765,Shaleblade,,1,27,24,51
11766,bigshit,,13,17,5,22
11767,johnnyzap,,8,1,1,2
11768,implementor,,31,21,27,48
11769,zydeco,,1,16,44,60
11770,DerkaRagnarr,,42,1,3,4
11771,oibalf,,7,3,2,5
11772,seraph582,,39,9,28,37
11773,inkstom,,0,4,3,7
11774,pjthomps,,0,23,37,60
11775,Rudegato,,19,10,6,16
11776,epboyd,,30,1,5,6
11777,LoveandRockets,,31,70,106,176
11778,metageek,,20,53,79,132
11779,Kream1,,18,15,26,41
11780,o0Enygma0o,,13,29,48,77
11781,phantom_slayer,,0,120,130,250
11782,troytop,,6,40,41,81
11783,prettybunnys,,18,11,25,36
11784,shikadi,,30,45,16,61
11785,rickmb,,20,32,26,58
11786,stephenfox,,13,38,5,43
11787,kidcoma,,18,21,19,40
11788,Rubuler,,1,4,20,24
11789,upvote_capote,,43,7,19,26
11790,rubber2002,,18,165,1,166
11791,brotorious,,13,3,4,7
11792,dillona,,13,4,7,11
11793,wrongway,,20,3,2,5
11794,frodwith,,20,44,71,115
11795,Fuzzy_3D,,0,1,1,2
11796,b937,,19,1,2,3
11797,koin,,31,1,3,4
11798,CooneyCoonCoon,,36,1,7,8
11799,velogiares,,6,6,12,18
11800,briancavner,,32,86,26,112
11801,ThorHammer,,22,66,22,88
11802,ulrick,,13,46,31,77
11803,drakula,,19,1,11,12
11804,captainAwesomePants,,26,282,310,592
11805,cabrilo,,18,6,2,8
11806,Lucretius,,14,189,185,374
11807,spacedude89,,32,12,5,17
11808,P522,,36,12,23,35
11809,leondz,,43,223,230,453
11810,ankuryt,,40,25,10,35
11811,KentBrockman,,8,1,2,3
11812,dragonfly310,,32,1,6,7
11813,youcanrunperl6,,20,1,2,3
11814,gmhafiz,,3,1,2,3
11815,Comment-Revealer,,1,1,1,2
11816,andybroc,,26,1,1,2
11817,jzawodn,,20,11,1,12
11818,Hexogen,,19,55,94,149
11819,typesmith,,19,14,36,50
11820,rodders101,,19,2,2,4
11821,dafthuman,,23,133,159,292
11822,aL999,,34,3,6,9
11823,AllmanBros,,0,1,1,2
11824,sushi-zen,,13,8,3,11
11825,ppppatrick,,20,4,8,12
11826,Natas_Enasni,,13,187,332,519
11827,ajaloux,,18,16,9,25
11828,timjos,,20,6,8,14
11829,laphr0aig,,5,5,6,11
11830,klodolph,,13,1,5,6
11831,dahlberg123,,9,265,375,640
11832,davidb_,,0,34,25,59
11833,holyshittles,,1,1,10,11
11834,hadley,,20,2,8,10
11835,woockash,,20,52,17,69
11836,golemiot,,19,42,63,105
11837,soldoutactivist,,14,2,3,5
11838,notoriginal,,1,35,33,68
11839,virtualkingster,,20,6,4,10
11840,supertran,,13,2,4,6
11841,computerwhiz,,19,4,1,5
11842,mearscn,,13,1,4,5
11843,DONT-TASE-ME-BRO,,32,1,2,3
11844,cstaff,,42,64,2,66
11845,bigunit3000,,5,124,105,229
11846,NedRyerson,,42,1,1,2
11847,Caligula,,34,24,18,42
11848,seedofc,,35,6,4,10
11849,imbecile,,43,38,47,85
11850,TinheadNed,,12,15,30,45
11851,Tchakra,,32,14,19,33
11852,glutamate,,20,12,9,21
11853,ncorax,,17,6,5,11
11854,ursine,,20,4,3,7
11855,concentricpuddle,,1,24,8,32
11856,ffffffffffffffffffff,,18,19,10,29
11857,opeti,,12,2,1,3
11858,mrrsx2006,,18,8,1,9
11859,reddatic,,42,37,23,60
11860,psycloned,,13,6,3,9
11861,Aegeus,,31,54,93,147
11862,pureonyx,,41,8,27,35
11863,flippinkittin,,43,8,14,22
11864,dimitrisokolov,,13,428,450,878
11865,RipperM,,13,141,183,324
11866,alextheshortseller,,19,3,2,5
11867,Droffats,,20,33,72,105
11868,ponderstibbons,,17,2,3,5
11869,Spike973,,13,16,18,34
11870,MisterEThoughts,,18,17,68,85
11871,chiltonlib,,31,5,8,13
11872,gustogus,,13,8,7,15
11873,GKChess,,20,1,3,4
11874,DoctorHouse,,32,1,1,2
11875,Luthien77,,18,62,91,153
11876,truthrises,,32,87,104,191
11877,lameweather,,20,2,2,4
11878,altern,,22,1,2,3
11879,jvoorhis,,10,2,1,3
11880,k3v1nhu4n9,,19,1,2,3
11881,mega05,,13,10,25,35
11882,maceywj,,20,2,3,5
11883,duncanmc,,36,5,12,17
11884,Khaless,,20,2,3,5
11885,butterface,,18,36,69,105
11886,feadog,,8,3,1,4
11887,joshthejumperman,,18,1,2,3
11888,mr_babar,,14,9,10,19
11889,gtlogic,,0,3,14,17
11890,orkgpro,,22,1,1,2
11891,methodartist,,20,1,3,4
11892,squink,,13,10,10,20
11893,sqrt,,22,9,1,10
11894,micah8,,29,1,1,2
11895,turbana,,20,7,10,17
11896,hillary2012,,34,3,4,7
11897,seeker135,,13,833,1779,2612
11898,NewKidOnTheBloc,,13,13,4,17
11899,pipcwru08,,12,2,1,3
11900,bobb730,,27,1,1,2
11901,bigslick,,16,1,3,4
11902,pootytang,,20,5,10,15
11903,GregEh,,30,13,21,34
11904,globeskipper,,13,1,2,3
11905,wartexmaul,,12,350,578,928
11906,camdon,,19,2,1,3
11907,AmputateYourHead,,15,57,80,137
11908,old-dude,,13,2,1,3
11909,sameteam,,22,8,7,15
11910,STHayden,,20,1,1,2
11911,ziggyfolly,,18,5,14,19
11912,nucleophile,,13,167,4,171
11913,SpindleyQ,,20,1,4,5
11914,vsync,,0,83,49,132
11915,TwarkMain,,2,104,161,265
11916,animaniac,,10,17,9,26
11917,arrowheadaddict,,19,12,9,21
11918,EthicalReasoning,,18,512,203,715
11919,bendlund,,13,20,32,52
11920,dysmas,,20,87,141,228
11921,AtlasSlept,,1,12,22,34
11922,liklik,,8,6,2,8
11923,CrackIsWack,,0,2,8,10
11924,nebraskalaska,,18,1,2,3
11925,TigerUppercut,,22,23,38,61
11926,deterrence,,18,12,21,33
11927,kihadat,,18,120,216,336
11928,ZeeJollyRoger,,18,2,14,16
11929,zjep,,18,50,58,108
11930,Lucent,,32,22,8,30
11931,sluggysan,,5,15,5,20
11932,df1,,13,202,442,644
11933,Fireproofsoul25,,12,1,3,4
11934,mkbunday,,43,67,53,120
11935,jlistf,,41,8,5,13
11936,takethescrew,,18,16,21,37
11937,russelly,,32,23,64,87
11938,jal0pee1,,6,8,3,11
11939,mosaic2,,20,7,3,10
11940,shashinmishra,,43,6,4,10
11941,pssm,,18,15,25,40
11942,basketball,,18,1,6,7
11943,starbuck1,,11,2,1,3
11944,pinky17,,5,2,6,8
11945,michaelburns,,16,6,4,10
11946,franco81,,3,6,6,12
11947,miserylover,,34,3,2,5
11948,tacostacos,,18,277,44,321
11949,thegrott,,33,1,5,6
11950,goodhairs5,,1,1,1,2
11951,saalon,,20,9,23,32
11952,pault107,,43,5,8,13
11953,topredder,,20,14,1,15
11954,arcoare,,29,7,2,9
11955,TrikeKid,,32,8,3,11
11956,sciencegeniusgirl,,34,2,2,4
11957,joelthelion,,20,997,758,1755
11958,mysterywhiteboy8,,19,27,3,30
11959,johntb86,,20,81,128,209
11960,merstudio,,18,39,37,76
11961,miserlou,,43,175,27,202
11962,linkfoo,,20,29,52,81
11963,AsFarAsIKnow,,43,2,1,3
11964,patricka,,20,4,8,12
11965,Surkow,,12,2,2,4
11966,spetracco,,23,1,2,3
11967,dietbrisk,,38,4,3,7
11968,noKarmaNeeded,,6,3,1,4
11969,nullspace,,18,1,1,2
11970,arse,,34,7,18,25
11971,florence0rose,,43,61,115,176
11972,jmhnilbog,,17,3,2,5
11973,Dr_Simon_Shane_CM,,30,1,1,2
11974,sigint,,20,1,4,5
11975,BigGoomba,,19,3,14,17
11976,NSMike,,30,655,735,1390
11977,Grubbie,,43,3,7,10
11978,bfkennedy,,13,1,1,2
11979,maximilian,,20,2,5,7
11980,PuppyPuncher,,8,2,2,4
11981,starwarrior,,20,22,24,46
11982,storm72,,20,2,2,4
11983,pilif,,20,58,39,97
11984,knellotron,,1,29,58,87
11985,redlightdistrict,,19,3,2,5
11986,bguildner42,,13,121,209,330
11987,Double-Entendre-Man,,43,10,17,27
11988,MockinBird,,13,18,50,68
11989,coredump,,18,7,4,11
11990,Yaff,,18,12,2,14
11991,fecal_fury,,1,1,5,6
11992,TarHeelBears,,13,64,4,68
11993,8002reverse,,18,2,1,3
11994,mindbleach,,12,1437,2470,3907
11995,grouch43,,0,1,3,4
11996,12358,,32,64,61,125
11997,mooky1977,,0,2,3,5
11998,poorpredictablebart,,0,2,1,3
11999,flogic,,20,52,94,146
12000,deviation,,18,10,19,29
12001,alphonse55,,13,52,3,55
12002,torontoted,,19,13,30,43
12003,fai,,13,31,81,112
12004,bezzrb,,14,1,1,2
12005,kcolttam,,32,1,3,4
12006,TobiasV,,16,32,42,74
12007,formatt,,18,61,76,137
12008,baix,,20,17,20,37
12009,Jagula,,22,78,65,143
12010,ltcmdrobvious,,20,1,1,2
12011,reallythateasy,,30,20,39,59
12012,keepurpantson,,20,2,1,3
12013,kkireyev,,42,25,25,50
12014,treebright,,31,181,268,449
12015,yojspew,,43,3,17,20
12016,jasonkester,,20,151,23,174
12017,PrescribedGod,,0,55,3,58
12018,jato,,34,23,3,26
12019,kialari,,39,29,54,83
12020,drilldo,,18,76,21,97
12021,daemoncollector,,8,1,3,4
12022,topper123,,43,18,14,32
12023,all_ways_thinkin,,19,197,66,263
12024,Horpy,,13,10,12,22
12025,rasl,,0,39,31,70
12026,partisann,,22,1,1,2
12027,ky420,,0,94,10,104
12028,strangerx,,30,1,1,2
12029,surfgeko,,0,25,7,32
12030,PixelColada,,0,87,196,283
12031,KebertXela,,10,8,5,13
12032,zedzedtop,,18,7,15,22
12033,calcio1,,18,107,69,176
12034,j_a_p,,19,53,109,162
12035,jollyjack,,13,7,9,16
12036,s20millas,,19,29,22,51
12037,lesbianimpregnator,,43,10,1,11
12038,darkslurpee,,19,58,105,163
12039,NewSc2,,12,192,235,427
12040,kali3000,,43,16,17,33
12041,majormind329,,16,41,37,78
12042,raindogmx,,20,45,104,149
12043,jstacy,,31,1,1,2
12044,lolbacon,,18,838,517,1355
12045,chandaman,,43,18,26,44
12046,omegahedron,,22,4,9,13
12047,Slartibartfaster,,15,18,21,39
12048,bison__,,20,1,2,3
12049,zandoli,,31,1,2,3
12050,clever_name,,18,40,74,114
12051,astrox,,14,4,3,7
12052,cldnails,,34,101,111,212
12053,ucfstormmy,,42,2,2,4
12054,vph,,20,334,427,761
12055,CocoaButterThighs,,14,48,44,92
12056,daltonames,,31,3,3,6
12057,123412384908,,3,5,6,11
12058,Osmanthus,,20,117,87,204
12059,geomagman,,42,3,1,4
12060,mandiees,,12,24,12,36
12061,micmad,,13,4,11,15
12062,fattestangrywiccan,,13,15,30,45
12063,Jindraaa,,18,12,18,30
12064,tehrooni,,30,6,7,13
12065,trippingchilly,,1,151,268,419
12066,Ores,,20,1,1,2
12067,vw1972bug,,34,1,1,2
12068,InkyChan,,14,104,127,231
12069,steve_yo,,13,194,243,437
12070,FredV,,34,6,6,12
12071,mymarkx,,13,5,1,6
12072,clwnninja,,22,10,1,11
12073,boomboom16,,0,12,6,18
12074,imcguyver,,14,1,2,3
12075,TheGreaterGood,,18,1,1,2
12076,detro1tjok3r,,14,5,3,8
12077,keillor3,,13,21,18,39
12078,agrw,,20,6,4,10
12079,andreask,,1,2,2,4
12080,jmatthew,,13,45,47,92
12081,lw0x15,,1,2,2,4
12082,theantirobot,,6,518,515,1033
12083,oesj,,43,6,6,12
12084,armitageshanks,,1,4,4,8
12085,abhi119,,18,14,2,16
12086,shkoo,,20,26,16,42
12087,WigInABox,,1,103,51,154
12088,bobalobo,,25,3,2,5
12089,aevil,,6,2,1,3
12090,fooqwah,,42,12,3,15
12091,nadmaximus,,18,7,18,25
12092,HandsomeDevil,,18,5,6,11
12093,omarman,,13,3,3,6
12094,dlm,,29,170,95,265
12095,nogami,,10,46,61,107
12096,homayoon,,20,9,2,11
12097,SkiAliG,,1,9,7,16
12098,Slacher,,43,32,41,73
12099,fighttothefinish,,22,1,1,2
12100,mojuba,,20,11,3,14
12101,rajbot,,20,18,11,29
12102,citrus538,,34,2,1,3
12103,interociter,,13,34,58,92
12104,Huplescat22,,18,181,349,530
12105,lameorcoolguy,,20,3,4,7
12106,TheGreatNico,,1,35,48,83
12107,HolyShitAnExplosion,,43,5,1,6
12108,trueidentity,,21,1,3,4
12109,dlwh,,22,17,12,29
12110,mizhi,,31,18,38,56
12111,warmricepudding,,19,11,35,46
12112,NinjaDuck12,,1,102,44,146
12113,Zuph,,5,32,24,56
12114,choseph,,13,51,49,100
12115,Inkifymark,,11,3,9,12
12116,DavePhun,,20,6,17,23
12117,Another1BitesTheDust,,12,2,5,7
12118,lb2,,3,5,5,10
12119,Schnooz,,19,49,31,80
12120,clawtros,,34,4,5,9
12121,seagg,,20,2,2,4
12122,HomerWells,,1,76,137,213
12123,profs,,28,61,85,146
12124,tarvaina,,20,10,10,20
12125,kratediggah,,22,3,6,9
12126,icicle84,,11,1,2,3
12127,ro999ro,,31,26,3,29
12128,Jeremiah_Wright,,5,6,5,11
12129,john1984,,20,1,1,2
12130,dividedby0,,29,1,2,3
12131,parsifal,,18,67,85,152
12132,twoshedsmcginty,,33,11,1,12
12133,Gyanish,,15,1,1,2
12134,liver,,20,6,5,11
12135,neodorian,,22,14,65,79
12136,foundatio,,43,2,8,10
12137,daringescape,,5,90,188,278
12138,vanillazilla,,32,34,25,59
12139,d00bie,,18,6,13,19
12140,Capitol62,,6,182,236,418
12141,tsai,,13,3,2,5
12142,ginosesto,,19,3,3,6
12143,catlady,,13,3,5,8
12144,gmcmanus,,30,3,2,5
12145,VoiceofPower,,22,22,24,46
12146,radtker,,31,8,4,12
12147,RalphieWiggum,,42,1,1,2
12148,denharsh,,18,18,8,26
12149,amarcus78,,1,1,2,3
12150,kevb,,19,60,61,121
12151,phipsi180,,18,107,16,123
12152,thesmallprint13,,13,8,3,11
12153,kayden0000,,1,27,15,42
12154,twoism,,32,16,4,20
12155,dagbrown,,22,7,11,18
12156,databyss,,20,1,2,3
12157,nightguilt,,8,1,1,2
12158,Shadowstep,,30,1,2,3
12159,noddyxoi,,0,7,11,18
12160,teksimian,,18,17,22,39
12161,ddyson,,20,9,9,18
12162,katiekatums,,14,2,3,5
12163,brockers,,19,25,40,65
12164,tad_ghostal,,1,12,14,26
12165,brocker,,43,3,4,7
12166,lisvblidfk,,20,101,119,220
12167,buirish,,22,6,3,9
12168,Bruiser_Bradley,,0,48,48,96
12169,michaelk99,,32,54,54,108
12170,stacecom,,19,565,819,1384
12171,stignordas,,18,207,71,278
12172,MichaelMex,,20,1,2,3
12173,cheezymoogle,,28,34,58,92
12174,AzMoo,,31,29,37,66
12175,raynim,,1,30,23,53
12176,BarackObamaTheMUSLlM,,19,33,40,73
12177,ignore_this,,19,3,25,28
12178,enneff,,20,371,534,905
12179,degusticar,,19,2,3,5
12180,adenbley,,13,15,21,36
12181,andychamp,,20,1,1,2
12182,ppinette,,10,164,278,442
12183,g1rlb0t,,43,2,3,5
12184,54gy6dm,,22,60,117,177
12185,OneOfUs,,43,1,2,3
12186,chairface,,20,49,69,118
12187,bipartite,,20,1,1,2
12188,maggi2929,,19,172,1,173
12189,Broward,,4,1,1,2
12190,peckitt247,,19,3,3,6
12191,Elishaa,,3,4,2,6
12192,psychophil,,34,3,6,9
12193,smiling_jess,,5,5,5,10
12194,Crankingser,,13,3,3,6
12195,KaraSwims,,39,1,2,3
12196,raezr,,22,102,6,108
12197,MiniTru,,31,1,1,2
12198,Swedishdest,,0,2,3,5
12199,Faze,,1,6,7,13
12200,xoxox,,20,11,15,26
12201,cgilkey2,,30,32,5,37
12202,krebscout,,22,2,1,3
12203,SlaveToReason,,13,4,3,7
12204,vmlemon,,13,7,1,8
12205,Query3,,32,22,6,28
12206,dansinglobster,,32,4,6,10
12207,nonservitus,,13,308,90,398
12208,tthorley,,32,3,8,11
12209,hiopilit,,20,5,1,6
12210,read_it_and_weep,,42,1,2,3
12211,schenectandy,,34,1,22,23
12212,yoga56456,,18,15,5,20
12213,loryzz,,13,8,4,12
12214,umop_apisdn,,31,395,535,930
12215,scoobypoo,,1,3,9,12
12216,ananum,,13,18,19,37
12217,punctuate,,20,1,5,6
12218,D3ADBOLT,,13,204,402,606
12219,thebradmiskell,,13,111,22,133
12220,sitruss,,18,9,12,21
12221,limukala,,22,34,28,62
12222,General-Obvious,,19,8,12,20
12223,oneP,,20,65,69,134
12224,teaBagger,,18,330,451,781
12225,george443,,32,2,10,12
12226,bakunin,,20,3,5,8
12227,olddoc,,31,288,175,463
12228,ivy7496,,30,6,12,18
12229,toninio,,13,30,58,88
12230,doommonky,,17,3,8,11
12231,hsaleem,,5,1,2,3
12232,jockychan,,22,24,26,50
12233,peach3s,,13,2,5,7
12234,PsychePsyche,,1,9,11,20
12235,Steiner,,1,8,10,18
12236,Pipvault,,18,3,6,9
12237,Ocaml_Kaizen,,1,352,320,672
12238,LRonHubbard,,19,21,28,49
12239,IronChief,,13,1,1,2
12240,BUBBA_BOY,,1,28,68,96
12241,georgi0u,,18,45,18,63
12242,anderaaron,,18,10,24,34
12243,igiveyoumylife,,34,2,2,4
12244,qowieury,,2,3,4,7
12245,abering,,20,2,2,4
12246,exedore2,,19,26,26,52
12247,thirdeyeopen23,,13,11,9,20
12248,ds2oo8,,35,1,6,7
12249,Flyboy,,4,304,361,665
12250,mastej,,18,3,3,6
12251,roland19d,,43,490,851,1341
12252,cowhead,,32,59,95,154
12253,iamnowhere,,18,1,1,2
12254,pinkerdude,,43,27,43,70
12255,redheadsrage,,13,4,2,6
12256,leatherback,,19,36,24,60
12257,wookie2u,,20,2,3,5
12258,ViktorVaughn,,18,64,15,79
12259,troglodyte,,42,343,378,721
12260,bephys,,21,3,5,8
12261,JBridge,,1,140,211,351
12262,fforw,,20,154,258,412
12263,cnc,,34,1,1,2
12264,jarcoal,,20,3,4,7
12265,vectorlord,,32,12,12,24
12266,Lt-DavidW,,1,21,35,56
12267,DeadtoSin1,,34,5,3,8
12268,willtelloverdrive,,2,1,4,5
12269,zeek,,20,10,25,35
12270,pazza66,,3,2,1,3
12271,jensm,,19,73,26,99
12272,irspariah,,13,72,270,342
12273,warkro,,18,69,86,155
12274,smitisme,,0,257,311,568
12275,cr4a,,10,450,299,749
12276,sjl7678,,42,12,12,24
12277,relipuj,,43,1,3,4
12278,trwww,,20,9,22,31
12279,curtismayfield,,31,1,1,2
12280,svengalus,,11,543,685,1228
12281,KieronR,,18,15,37,52
12282,lawngnomes4pres,,1,24,4,28
12283,supercharged302,,5,1,2,3
12284,jojo624,,0,3,3,6
12285,mypasswordispassword,,20,5,5,10
12286,reepecheep,,19,2,4,6
12287,master_gopher,,15,333,654,987
12288,blindingspeed80,,15,47,108,155
12289,GeorgiaGuy,,13,1,1,2
12290,sandeeprgowda,,0,1,1,2
12291,tspiteri,,19,2,5,7
12292,minusthebux,,1,7,18,25
12293,Bill-O-Reilly,,13,1,1,2
12294,dewx0x,,22,1,2,3
12295,burningapathy,,18,10,3,13
12296,rinanina,,0,3,1,4
12297,red-dit,,32,152,350,502
12298,ACoolT5,,16,3,1,4
12299,echo057,,36,2,2,4
12300,flyhrtgigs,,0,1,3,4
12301,lennon860,,43,108,13,121
12302,Qazster,,20,4,7,11
12303,forgottend,,30,56,64,120
12304,nicofremaux,,19,1,2,3
12305,friendinweed,,43,4,10,14
12306,JackTLogan,,19,5,6,11
12307,tolas,,6,62,32,94
12308,a-lady,,18,20,44,64
12309,randallsquared,,20,287,362,649
12310,Adzoe,,19,1,3,4
12311,Junior19,,19,24,18,42
12312,amosharper,,13,17,39,56
12313,calantorntain,,43,712,459,1171
12314,karai,,18,1,1,2
12315,nymbot,,6,8,9,17
12316,swede,,19,278,294,572
12317,csharper,,20,10,13,23
12318,zeytin,,34,12,19,31
12319,Cuetzalcoatl,,12,25,24,49
12320,burningmonk,,22,124,195,319
12321,kongdong,,42,1,1,2
12322,mikefats,,18,2,1,3
12323,philosophocles,,13,42,110,152
12324,Ralgor,,19,6,11,17
12325,maroonnit,,23,12,16,28
12326,photonicks,,1,7,9,16
12327,terrordactyl,,2,5,11,16
12328,viciouspoultry,,41,2,2,4
12329,redzim,,1,1,1,2
12330,col381,,18,5,7,12
12331,snead,,1,67,48,115
12332,Qubed,,14,609,1081,1690
12333,disposableaccount876,,1,2,1,3
12334,gboston,,19,31,21,52
12335,TehSoM,,18,9,24,33
12336,Symphonic_Nightmare,,42,28,42,70
12337,miratemp,,19,6,22,28
12338,pozzoe,,20,15,34,49
12339,anon93752,,30,3,5,8
12340,mommygetspaid,,12,1,1,2
12341,mentallyvoid,,15,2,4,6
12342,Hencq,,41,6,5,11
12343,beepboopimarobot,,31,3,8,11
12344,LoneTrumpeteer,,32,1,2,3
12345,Brillig,,5,1,6,7
12346,NnyCW,,43,1,3,4
12347,ensign,,19,6,1,7
12348,tucsonalama,,1,26,31,57
12349,stroupnp,,7,189,269,458
12350,pixel,,10,32,67,99
12351,mchean,,0,2,7,9
12352,drog,,20,11,3,14
12353,msprout,,22,107,126,233
12354,ryancarnated,,12,112,128,240
12355,halo,,20,180,140,320
12356,sayaman,,1,1,1,2
12357,Gaabo,,0,14,11,25
12358,inghamb87,,5,445,104,549
12359,viroplex,,20,1,1,2
12360,seidaot,,31,2,1,3
12361,Uiaccsk,,18,38,31,69
12362,that_hz,,18,2,2,4
12363,TeddyRoSvelte,,22,2,6,8
12364,StupidGenerator,,3,1,1,2
12365,AcesUP,,22,3,7,10
12366,Tango6,,32,2,2,4
12367,nexes300,,20,120,151,271
12368,janniel,,13,22,47,69
12369,DeBurgo,,31,9,15,24
12370,psych0sys,,10,2,1,3
12371,WishIwasWitty,,23,1,2,3
12372,vili,,1,7,11,18
12373,dankelley,,20,20,30,50
12374,amack77,,18,56,7,63
12375,esila,,34,2,2,4
12376,PoliticsPlease,,18,9,2,11
12377,coffeepoet,,20,3,4,7
12378,rebeccakd83,,13,5,2,7
12379,fghjuhdj,,4,1,1,2
12380,aeroplane,,5,1,8,9
12381,ResidentRedneck,,26,25,39,64
12382,Curmudgeon,,8,9,44,53
12383,evilpoptart,,13,28,56,84
12384,knotme,,1,2,1,3
12385,IMaPlatypus,,22,2,1,3
12386,davidhua,,34,1,1,2
12387,retrowebdev,,13,11,5,16
12388,iamjack,,20,155,178,333
12389,jon314,,10,1,3,4
12390,grawson,,13,2,6,8
12391,sigurdur,,22,1,1,2
12392,rsc,,20,134,18,152
12393,bonzodogband,,13,59,44,103
12394,omegamale,,12,4,6,10
12395,MonkAndCanatella,,1,10,30,40
12396,middayc,,20,86,26,112
12397,gaop,,0,34,13,47
12398,TerryMarsh,,13,1,2,3
12399,dkeck14,,22,1,2,3
12400,etake2k,,31,10,11,21
12401,funknjunk,,19,31,31,62
12402,eloki,,22,2,9,11
12403,alpharaptor1,,18,53,120,173
12404,smithers99,,16,69,2,71
12405,vajrasky,,5,14,6,20
12406,abfalltonne,,12,2,2,4
12407,mikila9,,19,3,2,5
12408,norbot,,13,6,7,13
12409,Kcck,,19,104,123,227
12410,jrforreal,,30,47,68,115
12411,gosurob,,8,2,1,3
12412,Prine,,19,37,55,92
12413,mashedpotatoes,,0,2,2,4
12414,FireFusion,,8,1,4,5
12415,imforpbj,,19,9,2,11
12416,AnonLulz,,19,74,1,75
12417,johnnypei,,29,2,6,8
12418,BrockLee,,19,27,16,43
12419,FabFour4Ever,,43,5,1,6
12420,twolongdoxies,,13,1,2,3
12421,aaroneff,,21,1,1,2
12422,LakeSolon,,18,22,45,67
12423,flaheadle,,30,3,4,7
12424,mcgosd,,27,2,2,4
12425,funkyz,,8,153,69,222
12426,zach978,,19,2,2,4
12427,aloring,,40,37,9,46
12428,SpongeBobSquarePants,,26,1,5,6
12429,DaveChild,,32,392,358,750
12430,digimonlove,,1,274,213,487
12431,coyotej,,1,2,4,6
12432,milehighmg,,12,1,2,3
12433,rogerspears,,12,8,1,9
12434,grumpy2,,20,88,44,132
12435,baseballisnewyork,,1,128,38,166
12436,gimmesome,,31,33,5,38
12437,Daedulun,,35,5,5,10
12438,hirschmj,,18,3,7,10
12439,innocuousnameftw,,11,1,1,2
12440,bennymack,,20,85,68,153
12441,vineetk,,20,106,131,237
12442,Sephoragal,,9,1,1,2
12443,darvish,,0,6,5,11
12444,Ophois,,18,1,1,2
12445,Anonymous_Wanker,,1,1,1,2
12446,john1967,,20,3,1,4
12447,shan66,,18,4,7,11
12448,startfragment,,42,811,79,890
12449,dumpbase,,18,87,1,88
12450,Thistleknot,,13,350,273,623
12451,sashimi,,18,4,10,14
12452,rickievaso,,13,3,3,6
12453,crackcoveredcunt,,13,2,3,5
12454,hopeLB,,19,2,17,19
12455,xceph,,34,13,2,15
12456,vbeast,,19,14,19,33
12457,StoicRomance,,1,344,230,574
12458,bloqmon,,31,153,168,321
12459,ybbih,,18,195,315,510
12460,piffsmoke,,18,1,4,5
12461,righttoresist,,1,197,281,478
12462,urbanaut,,32,59,33,92
12463,mrmunkey,,20,5,13,18
12464,yawn,,20,5,2,7
12465,Fishbum,,13,101,16,117
12466,jenks517,,13,12,17,29
12467,Mummanto,,20,6,1,7
12468,danamill,,14,7,1,8
12469,sidewalkchalked,,13,166,70,236
12470,paulkafasis,,34,11,11,22
12471,anonymous_somewhat,,10,1,1,2
12472,Cosmic_Charlie,,13,118,101,219
12473,xccx,,13,32,32,64
12474,Reddit_Surveyor,,6,20,4,24
12475,camalittle,,18,611,1081,1692
12476,Andos,,12,14,17,31
12477,altheahouse,,19,142,177,319
12478,Ketamine,,13,162,136,298
12479,benologist,,20,150,186,336
12480,jaggs,,29,1,1,2
12481,sux,,18,697,36,733
12482,Eddie_Catflap,,5,7,1,8
12483,refriedi,,7,1,2,3
12484,ilisia,,18,3,2,5
12485,IrishSamurai,,1,13,6,19
12486,jqp364,,43,2,3,5
12487,mycl,,20,27,24,51
12488,nvidutis,,22,8,9,17
12489,02bluesuperroo,,13,2,5,7
12490,st23am,,6,2,1,3
12491,jaimelazaro,,0,17,20,37
12492,cturkosi,,18,153,115,268
12493,ddddbbbb,,13,184,70,254
12494,Live_Wire,,4,3,3,6
12495,nemes,,19,49,104,153
12496,wjw75,,1,72,102,174
12497,savethempire,,31,2,1,3
12498,mbup,,18,7,14,21
12499,toddsanderson,,1,3,4,7
12500,harrisontheskater,,1,1,3,4
12501,SpikeWolfwood,,43,251,423,674
12502,chucks86,,18,139,325,464
12503,rjcluvvt,,18,1,5,6
12504,stottville,,13,1,1,2
12505,quintison,,34,60,114,174
12506,lyntux,,22,1,1,2
12507,sajae80,,18,1,4,5
12508,marcmarc,,19,3,3,6
12509,qwertyy,,43,19,19,38
12510,hazmatzo,,32,1,1,2
12511,nursingrnbsn,,5,1,1,2
12512,tpodr,,19,353,165,518
12513,sagarp,,14,6,8,14
12514,abhim12,,5,3,5,8
12515,minime283,,30,15,4,19
12516,robomix,,42,8,3,11
12517,SmellyGeekBoy,,42,271,34,305
12518,collosalsquid,,13,6,3,9
12519,Golden-Shower,,31,5,6,11
12520,JezusGhoti,,23,2,1,3
12521,recorcholis,,1,9,12,21
12522,lacus,,29,33,30,63
12523,eelinow,,20,3,6,9
12524,Basye,,13,11,10,21
12525,Gra7on,,29,44,88,132
12526,gnaborretni,,19,1,1,2
12527,vtdweller,,19,63,47,110
12528,lemurlemur,,6,10,13,23
12529,imadigger,,43,8,5,13
12530,khaddy,,0,1,1,2
12531,dkny22,,15,2,2,4
12532,illicium,,20,5,5,10
12533,swaggums,,18,16,20,36
12534,springwalk,,36,1,2,3
12535,rperigo,,13,31,10,41
12536,dayoldglowsticks,,27,1,1,2
12537,lakemag,,32,2,5,7
12538,mrttbag,,17,4,6,10
12539,erohen,,18,4,10,14
12540,Slipgrid,,19,1071,690,1761
12541,ChrisatCrane,,5,1,2,3
12542,tricadex,,18,2,8,10
12543,roosterx,,1,19,24,43
12544,djy,,19,2,3,5
12545,meatloaf_man,,43,19,47,66
12546,saniee,,19,10,5,15
12547,tbarlow13,,18,1,7,8
12548,chimchimchim,,13,6,2,8
12549,jmmf,,1,12,15,27
12550,TheOtherLebowski,,18,2,7,9
12551,chromium24,,22,24,14,38
12552,mutairy,,18,8,23,31
12553,kmason5,,34,3,1,4
12554,Munkee_Boy,,43,79,185,264
12555,mamluk,,20,54,77,131
12556,weirdalchemy,,18,21,39,60
12557,jxxx,,18,6,11,17
12558,spinfish,,13,17,7,24
12559,juantastic,,1,14,5,19
12560,CitySustainable,,34,198,45,243
12561,barkingllama,,18,39,72,111
12562,AlejandroTheGreat,,20,55,63,118
12563,unl,,43,1,2,3
12564,jagermeistr,,32,1,1,2
12565,tzz,,20,3,7,10
12566,mdarcy543,,19,27,2,29
12567,White_Owl,,30,2,7,9
12568,TWIXMIX,,20,2,3,5
12569,AttackTribble,,6,1,1,2
12570,sandidge,,4,12,9,21
12571,sannwood,,36,1,1,2
12572,emit_flesti,,23,13,24,37
12573,ewatkins3,,43,1,2,3
12574,eskimodemus,,35,1,1,2
12575,TrevorJordan,,18,31,8,39
12576,x3n0s,,1,92,86,178
12577,JesusWasAnEfinHippie,,29,1,1,2
12578,culix,,20,5,3,8
12579,bgeorge82,,8,1,1,2
12580,jkosmo,,31,15,27,42
12581,reddit-turd,,13,3,1,4
12582,coul2t,,20,13,8,21
12583,dertimbo,,22,2,2,4
12584,kayj,,19,1,1,2
12585,chaoskitty,,18,2,5,7
12586,lifeseeddeath,,18,14,14,28
12587,Ken_Watts,,1,3,4,7
12588,shgorhgoahrio,,1,1,1,2
12589,justinpgardner,,13,1891,284,2175
12590,tiredmountain,,23,1,1,2
12591,SkipHash,,1,99,100,199
12592,iamyo,,38,7,8,15
12593,eob,,0,24,1,25
12594,Preston4tw,,4,2,3,5
12595,splatnasty,,32,9,3,12
12596,thebigbradwolf,,42,253,510,763
12597,polar,,41,710,173,883
12598,neggbird,,18,13,37,50
12599,secret1234,,19,215,244,459
12600,homerunhomer,,13,3,14,17
12601,SuminderJi,,18,45,63,108
12602,four56,,22,8,6,14
12603,pixel7000,,1,12,20,32
12604,maxineshaney,,0,2,3,5
12605,madwicked,,13,5,1,6
12606,roosterjack,,34,484,39,523
12607,downerisdead,,18,4,4,8
12608,shools23,,36,1,1,2
12609,doing_it_live,,9,36,25,61
12610,atrn,,20,3,4,7
12611,beansworth,,34,324,592,916
12612,heirloom,,1,2,1,3
12613,sam512,,43,458,688,1146
12614,Darkstar68,,13,137,158,295
12615,cyclone7676,,19,2,2,4
12616,brianfit,,23,3,2,5
12617,dreamisle,,1,11,5,16
12618,phykicks,,18,2,5,7
12619,kocha,,20,2,2,4
12620,kuliweb,,31,6,6,12
12621,doompuma,,20,9,19,28
12622,eadwacer,,13,3,9,12
12623,Artman009,,1,12,20,32
12624,gomerspile,,2,2,1,3
12625,abhagg,,1,2,1,3
12626,escorn,,26,10,18,28
12627,em3r1c,,17,1,2,3
12628,Miggity,,13,4,1,5
12629,JoeyRamone63,,19,720,94,814
12630,cot6mur3,,20,34,42,76
12631,Rathbone,,19,223,274,497
12632,nkabbara,,19,19,1,20
12633,harsman,,20,16,16,32
12634,yaginuma,,6,2,3,5
12635,Praeger,,32,6,4,10
12636,combuchan,,1,25,26,51
12637,Sdek,,18,41,11,52
12638,wrf2,,36,4,1,5
12639,ijelsner,,1,9,1,10
12640,227de616,,1,1,1,2
12641,smsc,,19,374,870,1244
12642,darkfarmer,,18,13,18,31
12643,bartleby,,18,53,94,147
12644,chocolategamer,,18,1,3,4
12645,banz23,,12,1,1,2
12646,byukate,,36,2,2,4
12647,ntufar,,31,112,175,287
12648,ssushant,,20,2,6,8
12649,Ravenjade,,30,5,12,17
12650,netcowboy,,32,7,16,23
12651,flying_read,,20,2,1,3
12652,jeffyhunter,,0,4,2,6
12653,toomasr,,20,27,18,45
12654,dazzled1,,20,20,14,34
12655,Evil_Bastard,,34,15,20,35
12656,marinopagan,,11,2,1,3
12657,legoman31245,,1,9,5,14
12658,hoodiemonster,,1,169,100,269
12659,Therrick,,22,8,2,10
12660,MattWilcox,,20,23,22,45
12661,jojopapa,,19,4,3,7
12662,MikeNardozzi,,13,109,152,261
12663,kmudrick,,12,1,1,2
12664,kgrgreer,,20,1,2,3
12665,asgarmabuk,,5,1,1,2
12666,wiseduckling,,13,83,60,143
12667,auruspex,,13,5,6,11
12668,aeitzen,,33,1,1,2
12669,beefofages,,20,3,2,5
12670,cult45,,18,3,7,10
12671,aphlipp,,34,20,13,33
12672,cuteseal,,43,12,17,29
12673,mypasswordissimple,,18,22,18,40
12674,ArcadeBumstead,,18,52,76,128
12675,rickdiculous,,19,33,46,79
12676,colton36,,13,15,11,26
12677,pail,,20,38,34,72
12678,mcella,,31,2,2,4
12679,lessthanx,,31,4,1,5
12680,jsschreck,,32,7,10,17
12681,haron91,,0,2,1,3
12682,wither88,,20,3,3,6
12683,firahs,,31,11,9,20
12684,globewire,,21,13,10,23
12685,rhamej,,18,4,5,9
12686,phatmonkey,,26,1,5,6
12687,heartrush,,4,29,49,78
12688,oldschoolredditor,,19,3,1,4
12689,dt529,,18,3,14,17
12690,hanshasuro,,14,13,15,28
12691,audiodude,,18,68,73,141
12692,lotusstp,,13,1,4,5
12693,gnarlin,,34,2,3,5
12694,redditbannedmeagain,,3,61,95,156
12695,ThatGuyNamedBob,,1,18,25,43
12696,enjo13,,6,8,3,11
12697,ammonsld,,18,32,48,80
12698,nirk,,6,9,4,13
12699,citemach,,43,1,3,4
12700,cloudsurfer,,22,38,30,68
12701,mikey987,,29,4,3,7
12702,Aquaman,,20,3,4,7
12703,rack88,,34,56,33,89
12704,kuato,,34,897,195,1092
12705,bensylvania,,22,1,1,2
12706,midsummernightstoker,,1,178,37,215
12707,Aero72,,31,14,15,29
12708,hirschhorn,,43,34,66,100
12709,Chumbodonk,,13,19,41,60
12710,mootchell,,6,29,49,78
12711,cybrbeast,,32,1,1,2
12712,SuperJack108,,5,7,22,29
12713,astrosmash,,20,413,319,732
12714,D_rock,,20,6,1,7
12715,mrhomer,,18,85,19,104
12716,originator,,36,1,2,3
12717,denn2009,,18,4,1,5
12718,Katychell,,32,9,7,16
12719,Smits77,,0,2,4,6
12720,conformnow,,23,1,1,2
12721,Dagon,,18,135,202,337
12722,twistedcain,,32,732,792,1524
12723,vaskark,,35,1,1,2
12724,H3g3m0n,,20,202,246,448
12725,thruxton,,20,2,5,7
12726,beefsundae,,31,1,1,2
12727,Briamah,,43,2,6,8
12728,soupskin,,1,11,7,18
12729,reverendlongcat,,18,1,1,2
12730,romancexkills,,3,1,2,3
12731,xenon,,20,24,29,53
12732,biscuitjack,,29,1,1,2
12733,DoeL,,20,41,54,95
12734,mishka123,,18,21,27,48
12735,somethingrandom,,19,10,16,26
12736,srsly,,22,5,6,11
12737,pu3ka,,32,2,7,9
12738,YOMOMMA,,19,8,23,31
12739,jello3d,,1,2,1,3
12740,heee,,19,10,9,19
12741,3ugene,,7,54,3,57
12742,JRBobDobbs,,4,1,2,3
12743,rarerumrunner,,42,5,6,11
12744,Nitroadict,,29,213,411,624
12745,Perl_pro,,4,7,10,17
12746,subhuman33,,29,1,1,2
12747,piglatin,,5,24,36,60
12748,rhenrikson,,29,3,1,4
12749,fattymcgee311,,13,5,4,9
12750,Drexxle,,1,3,6,9
12751,suetonius101,,29,1,1,2
12752,sterling2505,,31,18,25,43
12753,JackoKill,,23,2,3,5
12754,ArcadeVeteran_70,,12,1,3,4
12755,darad0,,18,13,9,22
12756,tangy,,10,9,7,16
12757,madmonk,,13,2,4,6
12758,hellosaysme,,5,10,16,26
12759,boiserm,,20,20,12,32
12760,watevruwant,,1,82,24,106
12761,kelar,,19,4,3,7
12762,tealeg,,20,24,16,40
12763,BornToBeWilder,,43,7,6,13
12764,Juless_pistol,,32,4,2,6
12765,Buttsexman,,2,2,4,6
12766,CharlotteL,,32,1,2,3
12767,sunshine-x,,1,754,1073,1827
12768,tlms77,,3,1,1,2
12769,pahool,,18,16,24,40
12770,thebungalow,,20,1,1,2
12771,ipissonjellyfish,,32,1,1,2
12772,lpottsy,,22,4,8,12
12773,TechnologyGuy,,16,48,3,51
12774,munchhausen,,0,13,26,39
12775,nothingcorporate,,5,1,2,3
12776,kousi,,18,464,600,1064
12777,khill,,43,8,13,21
12778,dlan1000,,43,1,1,2
12779,dhgaut,,6,5,4,9
12780,runnerr0,,18,1,3,4
12781,RottenPeaches,,9,9,16,25
12782,lordcutter,,13,1,1,2
12783,PerfectShape,,19,1,4,5
12784,bdover234,,33,1,7,8
12785,Captain_Birdseye,,0,1,1,2
12786,egportal2002,,19,5,2,7
12787,djumbrosia,,1,263,92,355
12788,basteln,,39,1,3,4
12789,boga,,32,1,1,2
12790,meltingwax,,20,8,18,26
12791,andymikey,,34,185,219,404
12792,chimeric,,20,10,15,25
12793,spot,,34,5,4,9
12794,sunbear47,,13,2,5,7
12795,lahdeedah,,1,3,7,10
12796,msaleem,,5,511,9,520
12797,chancesarent,,15,15,14,29
12798,floatzilla911,,0,1,3,4
12799,newtronbomb,,30,1,1,2
12800,liorn,,10,5,1,6
12801,Zybergod,,22,53,35,88
12802,fyc,,20,3,15,18
12803,qnaal,,43,188,295,483
12804,dbarefoot,,17,94,77,171
12805,Clockind,,30,17,28,45
12806,jinstevens,,20,13,24,37
12807,rob_j,,15,16,21,37
12808,dan7gg,,18,3,1,4
12809,yoda17,,29,558,937,1495
12810,mage2k,,20,37,78,115
12811,rish_789,,18,31,25,56
12812,MethylRed,,17,1,1,2
12813,xoswiss,,1,33,29,62
12814,wing-tip,,30,6,7,13
12815,obijohn,,20,11,3,14
12816,edd_b,,1,12,15,27
12817,arkicfbjj,,43,4,3,7
12818,javascript,,20,9,12,21
12819,notochord,,32,1,2,3
12820,gh0st3000,,42,67,101,168
12821,Jamon,,1,28,8,36
12822,z_kungfu,,6,1,1,2
12823,vanillagamer,,19,280,434,714
12824,jaseaco,,43,8,31,39
12825,BasharTeg,,20,1,1,2
12826,nessthehero,,43,75,65,140
12827,fpisfun,,20,1,8,9
12828,ahalam,,42,8,17,25
12829,philostrato,,5,264,38,302
12830,ferveo,,13,84,205,289
12831,RuffBrute,,21,15,30,45
12832,sruizmier,,26,1,1,2
12833,udptelecom,,34,1,1,2
12834,quuxman,,20,12,5,17
12835,netstream,,7,29,24,53
12836,bghlek,,20,2,2,4
12837,rolik,,43,2,1,3
12838,lightdarkness,,1,16,5,21
12839,americangoy,,19,292,313,605
12840,ep_,,20,2,5,7
12841,lgeorgiadis,,32,1,2,3
12842,LarryCraig,,19,7,15,22
12843,420greg,,19,14,30,44
12844,WayOfTheIronPaw,,15,28,64,92
12845,aquraishi,,32,4,1,5
12846,chocolategirl,,10,2,7,9
12847,thepublicrecord,,13,86,1,87
12848,nocoolnametom,,43,2,5,7
12849,echo419,,4,1,5,6
12850,myMirrorImage,,13,21,36,57
12851,PoisnBGood,,18,20,31,51
12852,sfsdfd,,18,3,4,7
12853,psayer,,19,1,4,5
12854,foobr,,1,40,57,97
12855,Thadster,,13,91,116,207
12856,exuro3k7,,18,2,4,6
12857,durin42,,20,4,5,9
12858,kutch430,,18,16,17,33
12859,fourcylthrill,,11,2,2,4
12860,Troosk,,18,50,1,51
12861,dmercier,,18,75,66,141
12862,KiddieFiddler,,19,302,409,711
12863,domodomo,,41,2,3,5
12864,tawhaki,,20,36,22,58
12865,mcarolan,,34,1,3,4
12866,chrisodd,,22,3,6,9
12867,t4z3r,,34,19,12,31
12868,qubit,,12,8,1,9
12869,nsfwftw,,18,1,3,4
12870,retzed,,14,1,1,2
12871,contantofaz,,20,49,36,85
12872,jon_gaudet,,18,11,9,20
12873,dredd,,15,251,484,735
12874,mondongo,,18,30,36,66
12875,sanka,,43,76,110,186
12876,metmerc,,19,290,396,686
12877,the-red-mistress,,18,1,1,2
12878,F_A_S_T,,8,1,1,2
12879,louise6380,,8,1,3,4
12880,laurenth,,19,76,94,170
12881,defenstrated,,20,1,1,2
12882,kbaum,,29,3,3,6
12883,angry_wombat,,18,9,9,18
12884,128d,,19,14,16,30
12885,cygnus42,,13,4,2,6
12886,Ockham,,20,14,7,21
12887,hankrearden,,20,5,9,14
12888,Dmitri_Mendeleev,,12,1,1,2
12889,2390480192384,,41,7,4,11
12890,Scottybones,,12,3,1,4
12891,ops7roger,,0,206,5,211
12892,kay3121999,,31,1,1,2
12893,risottoinc,,20,22,6,28
12894,d1ss0nant,,17,7,9,16
12895,kayowas,,18,53,1,54
12896,drivingrain87,,43,14,12,26
12897,somedev,,20,10,10,20
12898,porcelainkitty,,14,12,2,14
12899,fascismUSA,,13,2,6,8
12900,nco71,,18,1,4,5
12901,jettca1,,43,10,15,25
12902,bitterbug,,3,2,2,4
12903,herminator,,4,354,120,474
12904,MrBucket,,23,5,6,11
12905,gwniobombux,,20,5,10,15
12906,CorbinFox,,13,47,127,174
12907,kevinb11,,43,44,102,146
12908,hgathers,,22,1,1,2
12909,zorlan,,1,1,1,2
12910,pathogen,,1,110,111,221
12911,nekoniku,,22,301,380,681
12912,kohan69,,18,19,36,55
12913,JoeSniff,,20,2,2,4
12914,wogwogwogwogwog,,8,1,1,2
12915,70dot7,,18,2,4,6
12916,cwabunga,,13,19,11,30
12917,stigma,,22,29,61,90
12918,isaacbroyles,,1,1,1,2
12919,suntzusartofarse,,30,55,68,123
12920,rbr,,13,1,1,2
12921,ph1103,,18,39,7,46
12922,donoyako,,32,1,3,4
12923,biffabacon,,20,3,3,6
12924,kimbele,,29,2,1,3
12925,indtechy,,20,6,1,7
12926,uncreative,,34,1,1,2
12927,timdoug,,20,2,1,3
12928,ted3977,,18,19,27,46
12929,farghal,,0,8,11,19
12930,felicity5150,,30,16,16,32
12931,famous_potato,,36,1,1,2
12932,kman2k1,,43,7,18,25
12933,Hrearden,,13,218,88,306
12934,shoelzer,,20,264,13,277
12935,psalm405,,34,9,17,26
12936,dries,,10,1,1,2
12937,SolidBones,,32,37,37,74
12938,roblodocus,,4,1,1,2
12939,techboy500,,34,1,1,2
12940,iankino,,36,3,4,7
12941,MorningRooster,,1,86,56,142
12942,BentSlightly,,13,188,315,503
12943,bloodriver,,43,2,3,5
12944,fifteencat,,4,2,1,3
12945,shb100,,20,2,1,3
12946,DisposableLogin667,,1,2,2,4
12947,DougExeter,,22,6,10,16
12948,kirkt,,22,121,153,274
12949,adjustafresh,,0,17,27,44
12950,marxsydc,,22,111,128,239
12951,thefeint,,31,37,87,124
12952,edong,,13,60,58,118
12953,scrollop,,20,11,6,17
12954,zorglub421,,30,10,8,18
12955,w0073r,,22,56,65,121
12956,colkowalski,,18,32,55,87
12957,hups,,18,78,97,175
12958,fellow,,43,139,16,155
12959,listen_to_blogs,,19,3,5,8
12960,supersocialist,,18,324,557,881
12961,breezytrees,,18,130,154,284
12962,liquidos,,20,7,6,13
12963,swyitch,,20,3,2,5
12964,jwoodsutk,,13,84,58,142
12965,fatpads,,14,75,122,197
12966,albenali,,42,1,2,3
12967,dinosuzerarlitarism,,31,25,38,63
12968,AlboxII,,43,1,1,2
12969,comradhuff,,18,9,5,14
12970,Mr_Belding,,5,336,63,399
12971,epb205,,1,17,24,41
12972,weekendcoder,,32,1,9,10
12973,mcdvda,,18,34,58,92
12974,kidfromnyc,,13,396,93,489
12975,JarvisCocker,,22,404,722,1126
12976,Verde,,19,3,5,8
12977,dejb,,32,9,15,24
12978,klarth,,1,224,199,423
12979,lschofield,,19,55,47,102
12980,eratus,,13,46,87,133
12981,k4t0n4,,20,4,1,5
12982,errer,,18,38,39,77
12983,dracovixen,,13,4,7,11
12984,stegner,,19,56,99,155
12985,aussiejoe,,0,27,37,64
12986,y4kk,,41,4,4,8
12987,Europe,,4,3,7,10
12988,mandysteve,,32,66,70,136
12989,DudasMoreira,,32,6,12,18
12990,Tiny_Elvis,,6,193,190,383
12991,nondecisive,,20,29,47,76
12992,jbuberel,,35,3,3,6
12993,soreyes,,18,2,4,6
12994,lite2005,,31,2,2,4
12995,Petrarch1603,,2,427,486,913
12996,Billy_Mays,,1,3,4,7
12997,zopiclone,,32,22,40,62
12998,mcg1103,,13,7,9,16
12999,meiso,,19,6,19,25
13000,infraredline,,19,62,104,166
13001,stopchasingplants,,0,2,2,4
13002,hakomasong,,22,16,8,24
13003,sn0wcommie,,17,4,6,10
13004,joe0926,,8,1,1,2
13005,megablahblah,,19,976,633,1609
13006,yay_monkeys,,18,45,52,97
13007,ParadoX_,,43,284,213,497
13008,dfekt,,18,30,38,68
13009,sfgeek,,19,870,789,1659
13010,Glanton,,18,485,563,1048
13011,dimdog,,31,5,3,8
13012,campkev,,13,5,8,13
13013,jpease,,1,73,58,131
13014,itsjibba,,13,26,14,40
13015,serrakat,,18,2,2,4
13016,sweetbldnjesus,,18,26,41,67
13017,Deif,,1,4,5,9
13018,monkeyborg,,29,232,226,458
13019,radstopper5,,14,3,1,4
13020,grandmoffcory,,18,1,5,6
13021,rmmead,,0,2,3,5
13022,MooseLicker,,0,35,42,77
13023,doctordocs,,5,1,2,3
13024,delma1947,,12,1,2,3
13025,jcastle,,43,650,1046,1696
13026,FFM,,43,26,38,64
13027,F4il3d,,13,5,12,17
13028,hollylovesyourguts,,18,2,2,4
13029,crunchbag,,22,19,48,67
13030,apex32,,18,90,22,112
13031,ZebZ,,13,924,892,1816
13032,yosefk,,20,15,19,34
13033,willhasbro,,3,1,1,2
13034,we_are_good_people,,19,22,29,51
13035,djnightshade,,43,1,2,3
13036,Grymes,,29,2,3,5
13037,nalison,,29,5,2,7
13038,fibber,,0,4,10,14
13039,llkoolk,,18,1,2,3
13040,Discmasterstu,,30,29,32,61
13041,bthx11389,,18,5,1,6
13042,wtreilly,,13,1,2,3
13043,starji,,4,1,2,3
13044,dkl,,20,2,4,6
13045,airborne99,,19,1,2,3
13046,str0be117,,19,5,5,10
13047,aaallleeexxx,,19,181,94,275
13048,beefsupreme,,18,8,16,24
13049,keith_phillips,,18,72,120,192
13050,extrabellum,,10,212,309,521
13051,Dellitron,,6,1,1,2
13052,bubcis,,18,2,4,6
13053,hafetysazard,,26,126,174,300
13054,fingerband,,20,14,18,32
13055,magpi3,,20,70,59,129
13056,laurens10,,31,18,25,43
13057,greenerthanmoney,,34,33,10,43
13058,EuropeForDummies,,31,6,3,9
13059,netbuzz,,0,442,31,473
13060,stateofdenial,,18,8,9,17
13061,santa4nt,,18,215,405,620
13062,Tatsumi,,18,7,14,21
13063,r_j_c,,22,3,3,6
13064,tannerthedog,,13,9,14,23
13065,HBH,,18,2,3,5
13066,vyralinfection,,43,18,18,36
13067,barkbark,,19,11,11,22
13068,kucinichguy,,31,2,1,3
13069,dpjames,,0,34,88,122
13070,Czo,,34,244,348,592
13071,kinglear,,13,6,5,11
13072,jackyardbackoff,,18,4,7,11
13073,WarmMachine,,20,15,18,33
13074,SMACKONE,,31,1,5,6
13075,vagifiswrong,,20,2,2,4
13076,ntallen,,8,1,3,4
13077,realist777,,19,1,1,2
13078,sophiee,,18,4,20,24
13079,plumcreek2,,18,1,1,2
13080,taxinfo07,,19,7,6,13
13081,EricWard,,18,4,2,6
13082,ender1004,,20,7,7,14
13083,etherreal,,16,3,2,5
13084,morty,,20,69,62,131
13085,illusina,,32,9,28,37
13086,Poultry_In_Motion,,43,943,931,1874
13087,enver,,22,5,11,16
13088,bwReddit,,20,2,5,7
13089,nostradumass,,20,1,1,2
13090,BIllyHatesYou1,,19,8,17,25
13091,jirachiex,,18,18,48,66
13092,Zoomerdog,,13,41,73,114
13093,Jushooter,,18,1645,145,1790
13094,sdcDaOriginal,,20,6,13,19
13095,JonValjon,,31,41,34,75
13096,jimmy_john,,13,5,6,11
13097,mortalwind,,1,12,50,62
13098,lgoldman,,13,8,9,17
13099,Indestructible,,20,5,2,7
13100,assholeface,,18,198,225,423
13101,pakistani,,31,39,4,43
13102,laurak,,34,117,80,197
13103,defconner,,32,1,1,2
13104,kitanokikori,,20,3,5,8
13105,A1phab3t,,13,2,2,4
13106,rwparris2,,1,20,34,54
13107,black2back,,18,1,1,2
13108,jasmined,,18,12,6,18
13109,DeathandGravity,,19,1,1,2
13110,dloewenherz,,18,20,1,21
13111,RonnyPfannschmidt,,20,10,15,25
13112,black7mgk,,34,4,8,12
13113,pragmatick,,18,30,64,94
13114,samebrian,,1,15,11,26
13115,redboots,,39,1,1,2
13116,csmith7502,,13,17,1,18
13117,nobody554,,1,10,22,32
13118,tetleyex,,43,1,2,3
13119,zaphodfl,,13,1,3,4
13120,itguru,,42,6,5,11
13121,arias85,,13,1,1,2
13122,cookedegg,,20,3,1,4
13123,tokamoka,,20,17,30,47
13124,mikaelhg,,20,339,531,870
13125,bering,,43,28,11,39
13126,drzowie,,14,1,2,3
13127,birdmanjeremy,,18,10,9,19
13128,flipflopg,,19,1,1,2
13129,KirkWylie,,20,42,35,77
13130,kumaku,,18,14,32,46
13131,mejaredme,,5,121,24,145
13132,westlingken,,43,58,9,67
13133,sets14,,30,2,1,3
13134,pfemeter,,22,1,1,2
13135,mattgif,,13,45,50,95
13136,pagemag1,,5,2,1,3
13137,Thunar,,19,33,39,72
13138,racherdoodles,,27,5,4,9
13139,shaynesweeney,,19,1,1,2
13140,illini,,19,6,13,19
13141,sfjoe,,9,1,1,2
13142,redleg,,31,22,27,49
13143,dstone,,18,4,1,5
13144,cgdc,,32,7,6,13
13145,opusdei,,31,9,16,25
13146,eriksays,,13,2,6,8
13147,Neptuneblue,,19,34,50,84
13148,automation,,22,1,1,2
13149,brightboy,,13,5,15,20
13150,geniusninja,,6,2,5,7
13151,blabla999,,18,1,2,3
13152,snackmaster,,43,10,13,23
13153,hoekbrwr,,43,1,1,2
13154,kohlmannj,,13,5,8,13
13155,ididntdoit,,19,19,19,38
13156,cultured_banana_slug,,18,386,482,868
13157,lennysan,,20,30,3,33
13158,mydirtyshoe,,18,1,1,2
13159,draxil,,20,1,1,2
13160,e1ioan,,2,9,7,16
13161,fred1980,,19,1,1,2
13162,blah881664,,17,73,77,150
13163,sixbit,,18,41,3,44
13164,clos01,,18,61,66,127
13165,rprz,,31,16,21,37
13166,cannedthought,,30,117,180,297
13167,teye,,18,2,4,6
13168,Lactoes,,41,4,3,7
13169,pisanty,,8,1,1,2
13170,mmm_coffee,,19,112,80,192
13171,haroldlovesmaude,,31,3,2,5
13172,youidiota,,21,1,1,2
13173,MrAchievement,,5,1,7,8
13174,jimmyb207,,19,180,64,244
13175,igoro,,20,42,4,46
13176,Cputerace,,8,2,3,5
13177,GomuGomu,,8,3,2,5
13178,akdas,,20,831,1659,2490
13179,andrewcubbie,,1,2,4,6
13180,react,,19,26,34,60
13181,nmcyall,,0,1320,2124,3444
13182,peteman,,36,2,3,5
13183,atypic,,20,10,11,21
13184,XenoZohar,,22,76,149,225
13185,tleaman,,34,17,29,46
13186,BorisKafka,,18,133,167,300
13187,asundi,,43,9,6,15
13188,wrerzl,,13,2,3,5
13189,billtheprofessor,,13,10,11,21
13190,torpid,,18,1,1,2
13191,flyafly1,,20,1,1,2
13192,cafematt,,3,1,1,2
13193,jschuba,,22,6,9,15
13194,sparechange2,,27,4,8,12
13195,bluspiders,,43,2,4,6
13196,hoekstar,,8,1,2,3
13197,SteveZarc,,13,5,2,7
13198,monkiman96,,13,11,9,20
13199,cb122,,18,5,13,18
13200,Zenderquai,,18,8,8,16
13201,grsites2008,,19,1,2,3
13202,Chewyboognish,,18,26,38,64
13203,break99,,0,409,826,1235
13204,melinte,,18,215,75,290
13205,howardjena,,13,6,7,13
13206,Lomborg,,9,2,2,4
13207,pflarr,,18,5,1,6
13208,stickynips,,18,19,25,44
13209,paledo,,22,5,3,8
13210,katsi,,31,481,701,1182
13211,topsdot,,5,17,1,18
13212,nadim,,20,2,3,5
13213,miked4o7,,4,1,1,2
13214,makhno,,29,83,54,137
13215,dialectic,,13,2,5,7
13216,sh0rtwave,,13,84,139,223
13217,springtime,,0,19,23,42
13218,Greentype,,8,4,1,5
13219,NickBurd,,13,2,1,3
13220,cybe2,,1,34,53,87
13221,raytube,,13,2,4,6
13222,ikefruusto,,17,6,4,10
13223,mworthin,,22,2,2,4
13224,2views,,43,3,8,11
13225,flrff,,32,1,1,2
13226,martinpolley,,8,16,34,50
13227,superwazn,,18,1,2,3
13228,havengr,,42,79,1,80
13229,ahoyhere,,31,35,72,107
13230,whatwhy,,30,3,5,8
13231,The_DEA,,1,1,1,2
13232,timothj,,31,3,5,8
13233,cheeseysynapse,,19,3,2,5
13234,Avonalt,,42,6,13,19
13235,PrashantV,,20,20,31,51
13236,Escafane,,6,1449,449,1898
13237,hermitcrab,,20,98,5,103
13238,the_Internet,,18,37,60,97
13239,kaboom,,20,15,13,28
13240,safishb,,31,374,64,438
13241,cybersnoop,,20,21,32,53
13242,alstewart73,,18,5,5,10
13243,Clintondiditfirst,,19,1062,678,1740
13244,dreesemonkey,,5,69,120,189
13245,yellowbkpk,,1,443,411,854
13246,SilverSureShot,,13,12,2,14
13247,aequitasdei,,22,1,4,5
13248,centrocampista,,43,97,1,98
13249,dawn3000,,1,2,1,3
13250,washjones,,29,1,1,2
13251,zyorker,,43,6,3,9
13252,paxton,,13,1,2,3
13253,dkohler72,,18,25,32,57
13254,seijio,,39,1,2,3
13255,bendybendy,,1,4,4,8
13256,coolmos1,,8,53,108,161
13257,zrooster99,,0,6,4,10
13258,benoror,,20,3,6,9
13259,andrewburnett,,5,117,30,147
13260,ArcticCelt,,22,561,886,1447
13261,protomyth,,20,1,1,2
13262,collegecallgirl,,22,19,11,30
13263,dhjdhj,,20,263,326,589
13264,blin10,,34,32,1,33
13265,notgoodatcomputer,,18,44,24,68
13266,wilkes,,20,2,4,6
13267,Zounas,,18,75,78,153
13268,wbennett,,13,4,3,7
13269,sigloiv,,14,3,12,15
13270,Zude01,,14,2,1,3
13271,yurtali,,18,15,25,40
13272,IdleMind,,21,9,2,11
13273,WallaceStevens,,19,3,3,6
13274,doylecentral,,20,1,2,3
13275,tomwill2000,,34,31,23,54
13276,skurk,,43,25,30,55
13277,enzomedici,,19,417,498,915
13278,Cophet,,13,154,188,342
13279,BuckWFush,,19,1,4,5
13280,KathyWinchell,,19,1,1,2
13281,temp2345,,18,3,1,4
13282,segv,,20,17,16,33
13283,ramblemn,,0,76,119,195
13284,PreferentialAttacher,,19,2,1,3
13285,Reita,,4,4,18,22
13286,mbonar1001,,13,1,3,4
13287,Tarantio,,0,76,87,163
13288,sabjek777,,13,1,1,2
13289,sockpuppet5381,,41,6,1,7
13290,letired,,1,67,68,135
13291,ballantyne1984,,0,1,2,3
13292,oldfag,,42,1,1,2
13293,xigam,,32,33,58,91
13294,rumbygum,,1,5,6,11
13295,tonny4,,31,11,16,27
13296,mgedmin,,18,1,2,3
13297,astraykitten,,22,1,2,3
13298,Korendir,,20,1,3,4
13299,dariyam,,20,1,4,5
13300,blandlife,,13,3,3,6
13301,hengsu,,41,4,6,10
13302,evilpeter,,1,32,37,69
13303,chuncken,,29,15,10,25
13304,WhirlyGirly,,30,8,15,23
13305,amclennon,,20,1,3,4
13306,milbs066,,12,3,1,4
13307,parcydarks,,30,6,2,8
13308,pclouds,,20,51,18,69
13309,skillet-thief,,20,37,70,107
13310,alphaterminus,,30,8,8,16
13311,wkukinslayer,,34,59,72,131
13312,obama12345,,19,2,1,3
13313,uglymike,,18,6,13,19
13314,The_Terrorists,,19,1,4,5
13315,blatsnorf,,19,3,7,10
13316,mbh1985,,22,17,17,34
13317,keenintellect,,31,39,13,52
13318,zaulus,,9,42,75,117
13319,Kerrik,,12,2,1,3
13320,driver8,,14,50,83,133
13321,k82l,,19,1,3,4
13322,mikealao,,40,109,44,153
13323,zootsuit,,20,11,9,20
13324,winkler,,18,3,3,6
13325,clearingtheagenda,,31,343,82,425
13326,green21821,,13,46,73,119
13327,sparkle8,,0,1,7,8
13328,_martind,,20,62,63,125
13329,abergou,,19,5,6,11
13330,Infogleaner,,8,7,6,13
13331,edwardkmett,,20,120,90,210
13332,jnorlie,,39,4,2,6
13333,Pooch_Badger,,22,34,68,102
13334,siegfail,,18,83,180,263
13335,luweewu,,3,9,6,15
13336,lanes,,18,1,1,2
13337,scipe,,19,621,211,832
13338,q5_,,11,4,3,7
13339,cmj1981,,13,259,4,263
13340,Mitch_Hedberg,,8,2,1,3
13341,cold_in_nome,,0,1,1,2
13342,abc2012,,13,24,7,31
13343,psyne,,22,382,542,924
13344,johnfn,,1,323,470,793
13345,Jimmy-D,,19,1,1,2
13346,calebbrown,,20,18,2,20
13347,dendrite,,43,36,4,40
13348,Msyjsm,,18,71,130,201
13349,ryhall,,11,2,7,9
13350,apottedficus,,19,40,39,79
13351,DLincoln,,18,27,19,46
13352,Ralith,,22,14,21,35
13353,ubermorph,,31,5,5,10
13354,somared,,0,4,14,18
13355,penguin673,,20,7,5,12
13356,itsame_mario,,13,20,3,23
13357,Linus-2,,8,1,1,2
13358,IamNotGivingMyName,,19,15,17,32
13359,RavenOfNod,,12,132,117,249
13360,FalconNL,,20,9,16,25
13361,nibbi,,32,2,1,3
13362,thepicto,,18,89,118,207
13363,d16n,,34,36,32,68
13364,littlemindy,,18,1,1,2
13365,BlakeRHB,,30,2,2,4
13366,peskypescado,,19,21,12,33
13367,rejser,,42,1,1,2
13368,mme_zonbu,,0,2,3,5
13369,safrax,,13,5,5,10
13370,carl915,,3,10,1,11
13371,livingdangerously,,1,4,5,9
13372,davidak,,13,16,22,38
13373,lorill,,20,9,4,13
13374,r2pro,,3,61,87,148
13375,elisabethjw,,18,1,1,2
13376,dangson,,18,15,20,35
13377,Pplus,,22,3,7,10
13378,binzbok,,13,41,6,47
13379,gravelrhodes,,0,1,1,2
13380,mfenniak,,20,58,63,121
13381,supajax,,30,35,35,70
13382,baadshahfarhan,,19,72,47,119
13383,GET_OFF_MY_LAWN,,31,2,1,3
13384,alantrick,,20,164,254,418
13385,antico,,42,248,177,425
13386,mdw,,43,81,42,123
13387,toolow,,0,26,35,61
13388,batcdav,,18,70,75,145
13389,woodenteeth,,6,1,1,2
13390,mckirkus,,19,215,220,435
13391,slithy_tove,,34,2,6,8
13392,911_was_an_inside_jo,,19,4,1,5
13393,blayde,,1,1,1,2
13394,kaskoosek,,13,113,220,333
13395,everlong,,39,3,2,5
13396,elmanchosdiablos,,32,1,1,2
13397,Antipop,,18,26,45,71
13398,liftaren,,42,1,1,2
13399,Bmelt,,43,4,4,8
13400,karenkleen,,28,13,1,14
13401,lgv,,43,5,13,18
13402,MANYplaces84,,1,73,91,164
13403,cgrd,,18,2,5,7
13404,godsvagina,,13,1,1,2
13405,jeffbell,,12,30,54,84
13406,gardosattila,,29,77,6,83
13407,Spelling_Nazi,,11,2,2,4
13408,niconiconico,,32,9,18,27
13409,gamingfox,,43,1,4,5
13410,gattis,,7,3,2,5
13411,braz1l,,20,4,3,7
13412,DazedenConfewzd,,13,1,1,2
13413,FrankGmoNEY,,22,1,2,3
13414,moker,,31,37,22,59
13415,aznegglover,,13,4,3,7
13416,sacado,,20,10,17,27
13417,BenderRodriquez,,31,14,18,32
13418,tuckerkevin,,13,2,4,6
13419,cbranden,,22,1,7,8
13420,diggflap,,13,1,3,4
13421,FoePaw,,23,51,70,121
13422,slap_shot_12,,18,24,29,53
13423,sandossu,,18,1313,37,1350
13424,bebnet,,8,527,768,1295
13425,logophobia,,20,35,40,75
13426,kurotome,,13,6,6,12
13427,bulletbh,,18,14,3,17
13428,Shapichka,,1,65,74,139
13429,tomjen,,0,870,1318,2188
13430,peterhogg,,19,2,3,5
13431,mnlg,,12,81,55,136
13432,TweakTastic,,1,15,34,49
13433,tandersen,,20,1,1,2
13434,halcy,,20,211,235,446
13435,ComradeBill,,1,3,4,7
13436,skeets99,,13,7,3,10
13437,stryker5252,,13,118,199,317
13438,MrSandman321,,26,14,15,29
13439,logic11,,18,3,1,4
13440,appleface77,,31,4,7,11
13441,LongTimeLurker,,1,2,1,3
13442,espot1,,19,6,18,24
13443,Flubb,,19,23,31,54
13444,joechin,,13,2,4,6
13445,vijayc05,,0,1,2,3
13446,LRonPaultard,,19,38,77,115
13447,karmus,,19,10,10,20
13448,catbertz,,0,3,7,10
13449,IncredibleSulk,,18,4,3,7
13450,maartenm,,20,1,2,3
13451,adamshades,,18,2,5,7
13452,ogg208,,11,1,2,3
13453,Tjalve,,20,38,9,47
13454,ARC72,,19,65,37,102
13455,aelbric,,18,1,1,2
13456,anarchocap,,16,4,6,10
13457,YAOMTC,,18,57,67,124
13458,SenatorSecretMoslem,,14,29,24,53
13459,rasmuss,,20,2,1,3
13460,callmejeremy,,19,10,3,13
13461,Nutritional,,31,4,6,10
13462,happychihuahua,,31,2,1,3
13463,p3p3,,20,5,3,8
13464,flybywire2a,,20,29,3,32
13465,hipilarius,,0,4,2,6
13466,lulula,,43,1,2,3
13467,gnazzah,,8,7,10,17
13468,ctrager2,,20,60,13,73
13469,prvtswtee,,13,2,1,3
13470,jebudas,,32,48,79,127
13471,dqualls,,43,5,8,13
13472,wolverian,,20,20,34,54
13473,johnigles,,16,6,4,10
13474,michaeltron,,19,17,27,44
13475,joshdick,,6,290,477,767
13476,Pendulum,,1,34,56,90
13477,heederspead,,13,15,17,32
13478,sourlout,,12,13,15,28
13479,nm8,,10,5,2,7
13480,arundelo,,20,49,32,81
13481,jefeweiss,,1,1,5,6
13482,scuffia,,20,2,1,3
13483,ninjaspy,,18,4,1,5
13484,KBPrinceO,,18,3,17,20
13485,opally,,29,2,2,4
13486,blakero,,42,1,1,2
13487,flower_sermon,,36,1,1,2
13488,ormebk,,17,4,2,6
13489,kirkleton,,13,364,550,914
13490,jt18,,13,14,23,37
13491,guchdog,,20,1,1,2
13492,kieronbm,,32,12,4,16
13493,the_golden_eel,,20,57,58,115
13494,sdoorex,,19,17,30,47
13495,madwetsquirrel,,27,3,1,4
13496,mdanas,,18,10,4,14
13497,InvidFlower,,20,44,94,138
13498,gc3,,13,10,12,22
13499,drumr,,18,27,43,70
13500,siliconman,,21,250,13,263
13501,theville1974,,20,1,1,2
13502,moab9,,34,33,53,86
13503,monotux,,1,4,6,10
13504,skelo,,29,4,7,11
13505,airhead75,,30,142,151,293
13506,mr_pickles,,43,98,35,133
13507,joelmbenge,,13,5,12,17
13508,yakk,,12,5,3,8
13509,vingt,,43,1,3,4
13510,helloandre,,13,1,1,2
13511,kidawesome,,18,27,39,66
13512,roamzero,,20,60,63,123
13513,mcneany,,11,5,1,6
13514,luke314pi,,18,8,14,22
13515,dfx,,18,7,13,20
13516,sime,,13,12,15,27
13517,tharkban,,31,50,88,138
13518,bulinutza,,13,6,3,9
13519,amide,,34,2,2,4
13520,dwmg,,22,1,1,2
13521,Tomoki,,1,18,10,28
13522,seanc04,,19,31,6,37
13523,thatperson12,,31,4,1,5
13524,NitsujTPU,,22,319,529,848
13525,Lazified,,22,1,1,2
13526,spudge,,43,10,20,30
13527,srmatto,,29,196,457,653
13528,leastrandom,,1,65,60,125
13529,Glyndm,,18,14,13,27
13530,NotChrisMatthews,,32,22,36,58
13531,hello_dfa,,32,5,9,14
13532,gnuix2008,,30,1,1,2
13533,MikeCerm,,10,6,3,9
13534,dowlls,,19,1,6,7
13535,Neticule,,32,188,105,293
13536,torgo,,34,6,8,14
13537,Redebo,,31,97,84,181
13538,Jinno,,6,216,243,459
13539,CobaltBlue,,18,1,5,6
13540,Xyleene,,18,40,44,84
13541,guitarromantic,,1,23,15,38
13542,Bjartr,,20,109,248,357
13543,r1ch,,20,15,22,37
13544,fortes,,4,3,4,7
13545,pointmetotheinternet,,22,7,8,15
13546,mant,,22,63,48,111
13547,Omoikane,,1,3,4,7
13548,JaneTsai,,34,1,1,2
13549,rman666,,20,93,90,183
13550,Schwallex,,12,386,352,738
13551,vinyl_x,,31,37,4,41
13552,zaph0d,,20,64,13,77
13553,MichaelDotNet,,20,1,1,2
13554,on2them,,13,20,17,37
13555,haroldp,,29,155,190,345
13556,neilo_au,,20,1,2,3
13557,retired_paratrooper,,34,12,7,19
13558,dominicds,,20,3,2,5
13559,shimon,,1,3,4,7
13560,me9atron,,6,9,4,13
13561,Leviathrix,,43,2,2,4
13562,lachlanhunt,,20,5,3,8
13563,katebroome1,,19,4,7,11
13564,Zlik,,31,1,2,3
13565,eraserh,,31,145,194,339
13566,jericho6,,18,52,4,56
13567,ladybluered,,13,34,23,57
13568,ma1content,,31,1,1,2
13569,interbutt,,22,1,13,14
13570,ashanbtb,,15,2,11,13
13571,mantic,,0,1,1,2
13572,jamesob,,20,19,21,40
13573,jim258kelly,,4,139,199,338
13574,passive,,19,48,76,124
13575,alneo5527,,21,7,3,10
13576,TriumphInsComicDog,,4,3,5,8
13577,Rhode,,1,391,567,958
13578,TeriyakiDelight,,28,1,1,2
13579,tinto2,,19,1,1,2
13580,loki614,,39,4,4,8
13581,esbern,,18,71,3,74
13582,theoriginalalex,,43,9,14,23
13583,EatSleepJeep,,13,278,523,801
13584,Iredditaoften,,5,136,31,167
13585,jayrolandsb,,34,14,9,23
13586,wof8,,18,39,68,107
13587,kyr,,22,3,3,6
13588,jasonbrennan,,20,243,194,437
13589,silversnowe,,4,9,5,14
13590,jozarich,,31,1,1,2
13591,rocketbike,,39,13,3,16
13592,commodore84,,23,9,18,27
13593,truthseeker37,,43,8,2,10
13594,mst3kcrow,,31,2,1,3
13595,Bogtha,,20,48,50,98
13596,Cookie,,32,219,174,393
13597,abbydigital,,13,1,1,2
13598,joeypt,,19,15,11,26
13599,Wendel,,19,78,89,167
13600,jjdonald,,20,6,4,10
13601,atorger1,,11,9,19,28
13602,0b4m4FTW,,19,12,5,17
13603,cowardlydragon,,20,154,165,319
13604,fbp,,30,30,41,71
13605,willdabeast,,1,84,102,186
13606,sb404,,6,145,240,385
13607,Arox,,29,1,2,3
13608,KomodoAce,,42,8,6,14
13609,nasadataboy,,20,4,5,9
13610,alex135,,29,2,10,12
13611,naturek,,18,129,4,133
13612,imonsei,,32,5,11,16
13613,protix,,18,1,6,7
13614,wintintin,,20,4,1,5
13615,creativeaccountname,,18,2,1,3
13616,nohope,,20,4,3,7
13617,somebody7,,23,2,3,5
13618,halter73,,20,27,39,66
13619,foodnerd,,1,2,1,3
13620,infinityplus1,,12,2,3,5
13621,eyesee,,20,3,3,6
13622,pilaf,,20,42,74,116
13623,hurleyNY,,13,2,1,3
13624,shutupnorthamerica,,13,1,1,2
13625,peachi,,13,3,2,5
13626,Moridin,,20,29,2,31
13627,jimsterbell,,43,6,11,17
13628,johncsadler,,5,2,1,3
13629,bitchincamaro,,40,8,4,12
13630,mian2zi3,,20,6,10,16
13631,unpercent,,34,1,2,3
13632,tripmcneely30,,4,1,3,4
13633,Crib_D,,19,77,90,167
13634,jd230,,20,1,1,2
13635,blueberryspecial,,34,3,2,5
13636,jay_vee,,4,299,519,818
13637,Sadepurple,,25,3,2,5
13638,shifty3,,20,12,4,16
13639,true911,,6,1,3,4
13640,EarthEmperor,,1,3,2,5
13641,SEMW,,31,26,34,60
13642,futino,,18,4,4,8
13643,craterass,,20,1,8,9
13644,mckooiker,,20,25,9,34
13645,emostar,,32,6,8,14
13646,yourfavweapn,,31,3,10,13
13647,RobertZimmerman,,31,8,11,19
13648,regnare,,18,6,8,14
13649,truename,,43,47,73,120
13650,ballardr,,13,50,136,186
13651,HasOvaries,,1,2,10,12
13652,merulus,,42,2,2,4
13653,pensivewombat,,31,19,10,29
13654,burke,,20,487,639,1126
13655,weaselheart,,13,14,15,29
13656,sofutofu,,1,33,9,42
13657,PimmyJalmer,,31,3,9,12
13658,redcrvtte05,,32,152,485,637
13659,stressedstoner,,29,7,9,16
13660,okcomputer,,0,1,4,5
13661,Inquisitor1,,22,69,136,205
13662,effjaygee,,6,1,1,2
13663,EllieElliott,,13,1509,131,1640
13664,unbelated,,19,13,19,32
13665,ovidiu_s,,20,3,2,5
13666,darwonka,,23,5,3,8
13667,filfakmaffia,,20,3,6,9
13668,OrcAndBeans,,18,35,11,46
13669,halb,,13,62,101,163
13670,futurespin,,19,27,23,50
13671,Torlek42,,32,25,12,37
13672,mordero,,22,7,7,14
13673,saturdayplace,,22,61,76,137
13674,lekisgoesbump,,43,1,2,3
13675,Whisper,,40,806,1142,1948
13676,CNBC-CNBC-CNBC,,8,6,3,9
13677,Dragoonie,,32,10,14,24
13678,leokennis,,29,207,236,443
13679,hoover,,20,2,4,6
13680,coditza,,20,69,111,180
13681,senatorpjt,,32,209,438,647
13682,gashford,,18,10,17,27
13683,ropers,,2,1735,2159,3894
13684,fignew,,17,2,2,4
13685,Pizzaboxknight,,18,40,36,76
13686,alisunwunderland,,18,2,3,5
13687,dlamarre,,16,14,8,22
13688,yel02,,34,1,3,4
13689,BelaLinguini,,31,1,1,2
13690,Capt_Kewl,,19,2,9,11
13691,drmc_coy,,8,172,370,542
13692,novafan,,27,3,4,7
13693,mr-jones,,33,5,4,9
13694,boskie,,18,71,2,73
13695,ricdit,,43,6,12,18
13696,liquid_kore,,22,69,70,139
13697,Spaceman_Spliff,,1,229,218,447
13698,mk_gecko,,20,255,270,525
13699,dontlookatmynameok,,18,2,8,10
13700,Mauwer,,7,35,23,58
13701,KrypieKat,,13,2,1,3
13702,rbalko,,13,16,4,20
13703,pitchblack16,,18,6,9,15
13704,IAmBroom,,19,6,6,12
13705,amynew,,43,13,12,25
13706,Nuli,,17,191,338,529
13707,fireworkkid,,18,6,17,23
13708,Scooson,,13,17,3,20
13709,drewcd1,,19,2,2,4
13710,diabede,,19,92,63,155
13711,CannonGod,,1,1,8,9
13712,groceryheist,,38,1,1,2
13713,eglinski,,12,147,19,166
13714,mgibbons,,10,241,279,520
13715,wtf___over,,22,8,17,25
13716,Chris_Hansen_,,6,1,1,2
13717,Darksaw,,1,2,3,5
13718,xwerebearx,,32,9,5,14
13719,gabrielus,,27,1,1,2
13720,pertsix,,13,11,13,24
13721,heart_pineapple,,1,1,5,6
13722,kapuzineralex,,20,5,13,18
13723,mustardman,,13,2,3,5
13724,pjiggalo,,43,25,16,41
13725,akov,,20,18,27,45
13726,kuhsay,,19,152,86,238
13727,DrFri,,14,1,1,2
13728,lostwombat,,14,2,1,3
13729,ltworek,,20,8,9,17
13730,artimas2,,43,5,3,8
13731,humpy,,31,13,15,28
13732,R_Kelly,,1,5,1,6
13733,physon,,41,23,35,58
13734,Ellsworthskate,,27,1,2,3
13735,mossycheong,,43,1,1,2
13736,maelnum,,0,1,8,9
13737,ganjablue,,18,3,5,8
13738,typ3,,18,3,4,7
13739,starffy,,5,1,1,2
13740,desrosiers,,22,292,410,702
13741,TheWaiter,,31,10,17,27
13742,joetakagi,,14,5,4,9
13743,exton,,13,73,142,215
13744,netturtle,,30,50,3,53
13745,Solmu,,22,2,4,6
13746,DonkeyShowPunchBowl,,5,1,2,3
13747,mangote,,32,2,2,4
13748,Herald_MJ,,20,121,65,186
13749,zakk,,20,44,19,63
13750,g4T0r,,18,7,7,14
13751,tarski,,18,3,5,8
13752,pifantastic,,1,1,1,2
13753,mooglor,,42,175,138,313
13754,SCK,,20,1,1,2
13755,mpr312,,13,1,1,2
13756,daload,,34,40,109,149
13757,stilldidntdoit,,19,5,8,13
13758,pointsofdata,,18,32,34,66
13759,goldfire,,1,2,5,7
13760,brispone,,9,132,175,307
13761,covertlyobvious,,13,6,4,10
13762,Chairmclee,,1,9,12,21
13763,Milligan,,32,26,44,70
13764,discom,,19,33,56,89
13765,Flankk,,22,120,176,296
13766,folderol,,19,90,137,227
13767,toomatoo,,19,12,8,20
13768,AllModerate,,13,122,86,208
13769,myklee,,18,3,5,8
13770,DrZoid,,43,4,12,16
13771,Killfile,,13,72,11,83
13772,wtfgecko,,20,21,19,40
13773,tudorama,,19,8,8,16
13774,Fidelpolpotbinhitler,,1,113,73,186
13775,kimora,,8,4,10,14
13776,rabyd,,36,2,1,3
13777,whyso,,20,3,14,17
13778,zutroy,,0,2,4,6
13779,elliottcable,,43,19,55,74
13780,kisielk,,20,4,3,7
13781,Gun-Jehuty,,30,10,4,14
13782,boyb,,15,111,65,176
13783,thevoid,,43,186,249,435
13784,miriku,,13,58,76,134
13785,elq,,20,109,26,135
13786,bradbeattie,,34,6,15,21
13787,girkabob,,28,8,6,14
13788,zmary,,22,1,1,2
13789,bitchkat,,18,8,14,22
13790,Autoclave,,43,18,33,51
13791,mrection,,20,1,1,2
13792,eidolontubes,,18,299,459,758
13793,teelynn,,6,2,1,3
13794,zq00,,19,4,6,10
13795,teacoder,,6,49,57,106
13796,pinkypornstar,,18,82,52,134
13797,Albatr0ss,,31,4,2,6
13798,Borgismorgue,,18,149,217,366
13799,megamanwich,,0,1,1,2
13800,andrewnorris,,20,136,157,293
13801,bittie,,1,4,3,7
13802,leexkor,,19,1,2,3
13803,chachacha,,34,19,1,20
13804,william4chao,,13,81,154,235
13805,troyec001,,13,2,3,5
13806,sprobertam,,0,2,2,4
13807,stroem,,13,1,1,2
13808,linknight,,18,2,5,7
13809,Multra,,1,16,22,38
13810,cgonzo,,13,1,1,2
13811,yanilkr,,32,14,18,32
13812,alesis,,13,136,236,372
13813,shrek-unit,,19,8,15,23
13814,karc,,32,12,12,24
13815,stumo,,18,292,369,661
13816,Benjaminsen,,14,2,2,4
13817,maheshee11,,5,69,6,75
13818,jay4r0,,1,1,2,3
13819,d_cox,,30,10,9,19
13820,funkymedina,,31,8,1,9
13821,reb42,,18,8,14,22
13822,ruipereira,,31,3,4,7
13823,greencourt,,30,4,13,17
13824,pariah_john,,18,4,10,14
13825,BizarreNews,,2,4,1,5
13826,katatonos,,13,1,7,8
13827,peeloo,,41,5,4,9
13828,I_love_energy_drinks,,5,23,48,71
13829,louisc,,42,27,42,69
13830,woodsmit,,10,15,23,38
13831,rechlin,,28,34,36,70
13832,klugerama,,1,4,6,10
13833,dbrose67,,41,2,4,6
13834,speedkills,,19,8,3,11
13835,snitko,,32,1,1,2
13836,pradador,,12,860,869,1729
13837,Slayback,,43,8,12,20
13838,ViolentRevolution,,13,1,3,4
13839,grey_0x2a,,20,10,15,25
13840,brreod,,13,10,4,14
13841,zzazz,,34,14,28,42
13842,nightlys,,19,2,5,7
13843,Xfocus,,22,126,158,284
13844,milliondollarbill,,13,28,49,77
13845,PJMurphy,,0,14,25,39
13846,DarthFenrir,,1,10,16,26
13847,imthedevil,,5,1,2,3
13848,OpticalAlchemy,,4,5,2,7
13849,uglyfunny,,13,6,3,9
13850,burlygurlyman,,13,9,5,14
13851,sleepysentry,,34,8,2,10
13852,jcalm28,,13,2,4,6
13853,brownbat,,20,1,1,2
13854,sites,,10,1,1,2
13855,maddmike,,13,54,42,96
13856,cainunable,,1,4,14,18
13857,MisterClaw,,19,3,8,11
13858,redditaccount77,,20,1,1,2
13859,winchells,,19,13,16,29
13860,techshift,,0,4,7,11
13861,psylent,,0,74,69,143
13862,kepple,,20,7,4,11
13863,andrejevas,,43,139,281,420
13864,mecablaze,,18,14,19,33
13865,deejaymc,,13,2,5,7
13866,icallbullshit,,20,1,1,2
13867,jshell,,20,1,3,4
13868,FoolsRun,,10,71,102,173
13869,Azr43L,,17,3,7,10
13870,snarks,,20,1,1,2
13871,aGorilla,,19,477,856,1333
13872,goonusrex,,18,18,22,40
13873,fbriggs,,20,19,5,24
13874,clubber_lang,,4,43,74,117
13875,vdot90,,13,11,1,12
13876,feefifofum,,19,3,8,11
13877,sarahkm,,18,10,9,19
13878,jodrellblank,,0,12,17,29
13879,Coridan,,22,95,91,186
13880,awongca,,31,3,4,7
13881,nornagon,,20,8,12,20
13882,newborn,,1,400,306,706
13883,saegiru,,34,2,6,8
13884,SpaceWorld,,22,5,10,15
13885,pumah,,30,6,4,10
13886,MizzAnon,,32,8,7,15
13887,TPDC130,,18,63,105,168
13888,clouwn,,32,5,9,14
13889,thatfellow,,18,29,16,45
13890,jesusistheway,,20,1,1,2
13891,TheKCGuy,,0,11,5,16
13892,Partario,,1,7,1,8
13893,Rosey,,19,22,29,51
13894,stephw8,,0,1,2,3
13895,swiftheart,,31,246,284,530
13896,contents,,13,23,15,38
13897,cwittiker22,,20,5,5,10
13898,lvov,,18,2,1,3
13899,joshbates15,,12,1,2,3
13900,oakenn,,43,2,2,4
13901,melchior_,,20,2,3,5
13902,WinerDinerSixtyNiner,,13,4,14,18
13903,FelixFelis,,19,7,15,22
13904,bennybreeze,,0,129,115,244
13905,serge_mamian,,19,8,3,11
13906,smeenz,,18,54,73,127
13907,turdf3rguson79,,13,4,3,7
13908,ValleyGirls,,19,1,1,2
13909,mattbert,,0,30,30,60
13910,p3ngwin,,18,85,161,246
13911,wearedevo,,20,315,313,628
13912,trifilij,,14,74,90,164
13913,dublued,,18,31,96,127
13914,spamham,,9,7,20,27
13915,ettubrute,,41,1,1,2
13916,frofro,,20,18,5,23
13917,DrGeneRay,,43,15,9,24
13918,AnonymousLOL,,26,1,1,2
13919,monk-e-boy,,31,2,1,3
13920,carldamien,,18,296,171,467
13921,nifran,,28,5,4,9
13922,chinajones,,4,2,1,3
13923,redditpuggle,,13,10,2,12
13924,kkrizs,,0,11,25,36
13925,tsxh,,5,1,2,3
13926,dudenextdoor00,,12,1,4,5
13927,sikkdog,,18,5,5,10
13928,konzahiker,,36,2,4,6
13929,metaperl,,20,20,26,46
13930,mr_ree,,20,25,9,34
13931,Itchinosi,,1,11,18,29
13932,pipecock,,43,1,3,4
13933,ChokingVictim,,18,15,10,25
13934,bacila,,20,21,8,29
13935,hobg,,20,25,6,31
13936,The_Voice_of_Reason,,31,125,105,230
13937,nepthar,,27,5,4,9
13938,jsfhejefkjelkj,,19,3,2,5
13939,I_Lurk,,19,2,4,6
13940,nachos,,28,2,4,6
13941,krasotkin,,22,41,58,99
13942,sdOverKill,,13,4,2,6
13943,SkeuomorphEphemeron,,9,153,300,453
13944,psb,,22,10,11,21
13945,fergie9275,,18,13,25,38
13946,SheauxDown,,11,3,3,6
13947,adibou,,4,94,183,277
13948,Th3Tru7h,,0,37,10,47
13949,Phoenixdying,,22,84,103,187
13950,Internet_Pirates,,13,1,1,2
13951,kmikz,,18,22,22,44
13952,lesbonics,,0,27,6,33
13953,jeffsimmermonTWC,,22,8,6,14
13954,anonymous2,,0,2,1,3
13955,tfinniga,,20,47,60,107
13956,neoryan,,5,1,1,2
13957,devro1040,,18,19,35,54
13958,MrFuzzywuzzle,,31,2,5,7
13959,TitaniumDreads,,32,21,26,47
13960,DiNovi,,32,16,7,23
13961,angeljoan,,19,1,6,7
13962,Svenski,,20,3,1,4
13963,drinnit,,1,7,9,16
13964,tfad,,1,1,2,3
13965,salty_oz,,14,2,3,5
13966,FortunesFool,,34,8,9,17
13967,Alaska_Brosef,,13,2,4,6
13968,moofus,,1,9,2,11
13969,surajbarkale,,20,131,151,282
13970,lukebox,,1,99,113,212
13971,tealc,,4,4,1,5
13972,wellofsouls,,20,1,1,2
13973,thomasfl,,20,13,9,22
13974,phoenix1701,,15,1,3,4
13975,carav,,18,3,11,14
13976,octopede,,18,40,44,84
13977,rodan1967,,13,6,6,12
13978,melhouse,,20,16,26,42
13979,chrishyde,,32,17,9,26
13980,c4rl,,36,8,8,16
13981,jlangr,,20,2,2,4
13982,ncsu1982,,2,6,6,12
13983,marisak,,43,3,14,17
13984,c4st,,1,3,2,5
13985,neurolux,,17,168,295,463
13986,zargon5,,5,14,11,25
13987,Marlyhalperngraser,,32,1,1,2
13988,IConrad,,3,1271,2216,3487
13989,bill04,,22,106,112,218
13990,crikey,,19,5,11,16
13991,lollerkeet,,4,6,8,14
13992,_Seo_,,34,10,4,14
13993,Cladari,,13,90,121,211
13994,tekprodfx16,,5,5,4,9
13995,forkbum,,31,9,5,14
13996,aphrodendrite,,29,6,4,10
13997,synctext,,20,2,3,5
13998,jsichol,,31,19,34,53
13999,johnnybazookajoe,,19,41,5,46
14000,theoraclesam,,18,5,1,6
14001,sarahkh66,,30,3,2,5
14002,harpes,,13,1,4,5
14003,mastertabemono,,19,1,1,2
14004,llamapeasant,,18,3,3,6
14005,mangda716,,13,50,12,62
14006,stateq2,,43,4,12,16
14007,meddlepal,,20,22,36,58
14008,radmarshallb,,12,52,27,79
14009,jbell,,14,7,15,22
14010,tuxracer,,9,279,269,548
14011,DarkSamus,,5,4,15,19
14012,spoileralert,,19,84,72,156
14013,PeterJerome,,15,2,2,4
14014,tmorton,,20,9,9,18
14015,FeralTitan,,31,8,8,16
14016,aspade,,4,2,5,7
14017,drunkentune,,32,42,58,100
14018,ulisse,,29,4,3,7
14019,matt_havener,,20,8,13,21
14020,rp1790,,34,4,20,24
14021,btgeekboy,,20,101,150,251
14022,dickcheney08,,31,111,142,253
14023,byzas,,18,229,18,247
14024,trav110,,0,10,16,26
14025,downdiagonal,,32,1884,589,2473
14026,strawberry,,13,33,5,38
14027,two0them,,19,14,32,46
14028,jcase,,34,13,18,31
14029,Scratchie_Chan,,6,2,3,5
14030,cactus,,20,26,24,50
14031,wallakoala,,22,6,3,9
14032,jasonmantey,,22,20,17,37
14033,thislooksfamiliar,,18,4,2,6
14034,Pyren,,27,1,2,3
14035,AllInOne,,29,4,5,9
14036,andmixtapes,,1,4,3,7
14037,jugbo,,14,5,2,7
14038,ineptsegue,,13,1,1,2
14039,dhpye,,19,103,194,297
14040,leavesoflorien,,34,234,145,379
14041,danth78,,4,1,2,3
14042,antheia,,19,1,2,3
14043,missreddit,,18,22,4,26
14044,sphs-873041,,30,1,1,2
14045,boradis,,31,1,1,2
14046,sriscarlet,,25,3,5,8
14047,CatsRein,,1,2,2,4
14048,datababble,,19,2,1,3
14049,midnightmoonbeam,,18,131,208,339
14050,zupatol,,31,16,19,35
14051,dukestravels,,13,22,1,23
14052,lemonescomy,,0,99,33,132
14053,farnz,,20,5,5,10
14054,nomdeplume,,19,123,106,229
14055,dantheman333,,18,32,39,71
14056,alogghe,,30,1,1,2
14057,laszlo,,32,4,4,8
14058,drona,,18,3,4,7
14059,poohneat,,29,1,1,2
14060,lulz,,6,276,340,616
14061,RisenPhoenix,,18,31,2,33
14062,letsinnovate,,13,3,3,6
14063,gsw07a,,20,47,73,120
14064,weekendlush,,18,8,12,20
14065,6c602,,43,2,3,5
14066,asyncster,,43,28,8,36
14067,nih777,,22,90,136,226
14068,HUNTUMBLINGCHRIST,,4,6,5,11
14069,jotaeme,,20,2,1,3
14070,2Legit,,19,1,1,2
14071,mbrezu,,20,16,22,38
14072,cliffmoon,,20,10,12,22
14073,randompower,,20,1,1,2
14074,knowmo,,4,2,4,6
14075,sunych,,34,9,1,10
14076,voolze,,6,1,3,4
14077,gmalva,,5,6,2,8
14078,Jhinra,,11,2,1,3
14079,libertas,,13,12,23,35
14080,JMSantos,,29,24,28,52
14081,newfag,,42,2,3,5
14082,Entropy,,20,384,636,1020
14083,bpg131313,,43,3,6,9
14084,catinahat1,,18,28,68,96
14085,garhole,,1,4,18,22
14086,Buckwheat469,,18,102,125,227
14087,nlogax,,34,8,15,23
14088,roast_beef,,20,24,51,75
14089,bling-bling,,20,689,49,738
14090,nellocin,,13,2,1,3
14091,peterwschlamp,,8,121,75,196
14092,foyf,,39,5,6,11
14093,unibeat,,43,1,1,2
14094,Prox,,18,11,27,38
14095,bugeats,,20,10,10,20
14096,seeandyspin,,43,48,20,68
14097,guinunez,,20,72,64,136
14098,alok0,,20,93,106,199
14099,iu34,,18,1,3,4
14100,x540x,,32,6,19,25
14101,somn,,32,423,400,823
14102,Vidd,,0,50,80,130
14103,shadowsurge,,22,684,527,1211
14104,InRehab,,31,13,13,26
14105,colas,,29,2,5,7
14106,T-man,,5,6,8,14
14107,yearrgh,,32,10,1,11
14108,misdirectomy,,42,1,4,5
14109,martingwalker,,0,1,1,2
14110,lechtitseb,,20,3,3,6
14111,badiozam,,31,103,155,258
14112,ANRAND,,22,5,11,16
14113,JTShultzy,,43,127,153,280
14114,Digger99,,19,1,1,2
14115,Semifreek,,1,6,2,8
14116,sbazerque,,16,2,1,3
14117,hongkonger,,18,1,1,2
14118,andrewglover87,,18,31,31,62
14119,Ingineer,,1,1,1,2
14120,MikeLinPA,,26,2,3,5
14121,ayoproduct,,18,6,12,18
14122,newagey,,42,1,3,4
14123,sfrank,,20,3,4,7
14124,frankthechicken,,27,8,4,12
14125,cbasst,,18,11,14,25
14126,d_ahura,,20,24,26,50
14127,leadtogold,,4,2,1,3
14128,Shepy,,34,11,15,26
14129,ivanfp1,,34,1,2,3
14130,wundagrrl,,7,1,3,4
14131,bahdler,,18,10,12,22
14132,kstauch,,18,3,8,11
14133,bwa32,,20,3,4,7
14134,jrs235,,19,14,17,31
14135,carwynllew,,43,193,50,243
14136,BadBroker,,19,3,2,5
14137,ian13,,18,15,2,17
14138,frooo,,0,7,1,8
14139,jubripley,,43,2,3,5
14140,uSeeEsBee,,1,20,33,53
14141,StoneCypher,,1,10,10,20
14142,tesserakt,,14,3,5,8
14143,gossipgrrl,,34,2,1,3
14144,CaptainDungtrumpet,,0,3,7,10
14145,pulaski,,19,6,3,9
14146,taxonimous,,5,57,24,81
14147,plazman30,,0,13,6,19
14148,AnimalMachine,,20,5,7,12
14149,Marcocchio,,0,3,4,7
14150,shorugoru,,19,44,61,105
14151,jbiz,,43,74,67,141
14152,artificialidiot,,20,2,4,6
14153,reddit_doe,,31,29,39,68
14154,thaen,,18,9,19,28
14155,kokooo,,0,36,69,105
14156,HaywoodJablomi,,31,65,114,179
14157,EightBelles,,22,1,1,2
14158,Mattfeliks,,43,23,16,39
14159,comwiz,,1,1,1,2
14160,WhatTheFuck,,19,65,102,167
14161,bigkahunaca,,1,6,9,15
14162,ledgersghost,,18,72,30,102
14163,bradz77,,34,1,1,2
14164,gnufied,,20,42,53,95
14165,gamergirl007,,18,12,8,20
14166,saladtossser,,22,24,16,40
14167,psublue,,4,9,22,31
14168,ttpmx,,18,10,5,15
14169,rimwalker,,31,58,43,101
14170,mattsavinar,,19,11,1,12
14171,oberon,,20,28,35,63
14172,karramel,,31,1,1,2
14173,dig1,,20,9,9,18
14174,superstar123,,20,7,3,10
14175,poopinator,,18,8,10,18
14176,traal,,12,349,382,731
14177,M4rk7r0n,,4,3,5,8
14178,byron,,19,272,280,552
14179,toekneelin,,31,3,6,9
14180,xurble,,20,26,35,61
14181,fridgetarian,,18,9,7,16
14182,SnowCrashv5,,20,58,39,97
14183,Asmodeus,,29,173,300,473
14184,redditator,,1,53,5,58
14185,bokka1,,18,1,4,5
14186,afuchs,,20,6,16,22
14187,Tze-Lu,,31,161,230,391
14188,CGM,,20,8,12,20
14189,miro781,,20,1,1,2
14190,horsebees,,20,13,12,25
14191,pwoolf,,39,4,3,7
14192,thelibrarian,,20,13,21,34
14193,wekt,,19,426,193,619
14194,hahahamonkeys,,20,5,10,15
14195,funnybong,,20,2,3,5
14196,moonsocket,,13,2,2,4
14197,phig,,17,12,24,36
14198,silverwoodchuck47,,13,63,111,174
14199,guiscard,,30,28,74,102
14200,JangusKhan,,18,251,171,422
14201,neologism,,19,3,1,4
14202,ahassan5,,19,3,3,6
14203,spadbob,,18,14,6,20
14204,ferret_fan,,32,48,9,57
14205,MyBrainIsTooBig,,8,1,1,2
14206,sliceofbread,,0,33,54,87
14207,zolaar,,1,34,72,106
14208,deskamess,,42,5,2,7
14209,clarkbmiller,,13,4,3,7
14210,ilmar,,20,4,1,5
14211,bnporter,,18,110,49,159
14212,kaervek,,6,2,1,3
14213,GJtheMahler,,19,39,62,101
14214,anybodyhome,,19,5,2,7
14215,Smokey_The_Bear,,19,1,1,2
14216,UnderBear,,23,1,1,2
14217,skews13,,19,1,2,3
14218,djiivu,,18,9,9,18
14219,alerolli1,,13,5,3,8
14220,cotl,,13,25,29,54
14221,kodak543,,34,16,22,38
14222,Mythrl,,16,2,4,6
14223,registrarsoffice,,31,1,1,2
14224,binnorie,,1,74,136,210
14225,qkwozz,,43,4,4,8
14226,mjklin,,32,4,7,11
14227,magicsammy,,13,25,25,50
14228,shadowofdeath15,,0,7,6,13
14229,adelle,,20,13,12,25
14230,jackau,,5,43,8,51
14231,bigears08,,13,11,12,23
14232,DaydreamNation,,22,40,34,74
14233,gtj,,34,340,123,463
14234,eeno,,9,2,3,5
14235,thedarklabs,,19,84,48,132
14236,sgtscherer,,12,1,2,3
14237,zotquix,,13,28,54,82
14238,thussey,,5,1,1,2
14239,Pikajabroni,,13,1018,1392,2410
14240,pablumite,,4,1,3,4
14241,pantherman,,13,2,9,11
14242,Farfalla,,43,94,50,144
14243,Shades87,,22,6,12,18
14244,cheeseburger,,18,3,4,7
14245,damienkatz,,20,119,116,235
14246,ImaginaryRadical,,18,4,4,8
14247,chiggah,,0,2,3,5
14248,this,,13,36,19,55
14249,chrisb,,1,53,19,72
14250,dentr0n,,13,6,7,13
14251,subterraneus,,20,20,22,42
14252,redditlessthan3,,12,10,1,11
14253,tenaciousJk,,18,63,103,166
14254,pmpott,,1,7,13,20
14255,storyofitall,,13,116,190,306
14256,alan7388,,13,22,45,67
14257,anchalsingh,,5,98,19,117
14258,lmtku,,18,6,31,37
14259,gebop,,11,2,2,4
14260,ryanguill,,20,8,12,20
14261,NotDarx,,10,21,28,49
14262,sliverlizard,,1,3,3,6
14263,joeljkp,,19,170,71,241
14264,myalternatelife,,1,3,8,11
14265,silentbob583,,13,13,18,31
14266,machinegunn,,39,9,20,29
14267,AlexTrebek,,13,4,5,9
14268,DV2,,12,7,19,26
14269,glenndanzig1984,,43,2,7,9
14270,dardan_aeneas,,1,141,51,192
14271,communomancer,,20,11,14,25
14272,ihope127,,20,1,3,4
14273,n00biz,,22,5,7,12
14274,SillyGrampa,,19,5,2,7
14275,omegasnk,,43,5,15,20
14276,mountainman,,13,90,133,223
14277,CPOliver,,18,6,16,22
14278,mfdoom,,1,4,8,12
14279,Aaronius,,13,56,74,130
14280,uklathemot,,20,1,1,2
14281,petron,,13,1,1,2
14282,Diderot,,36,13,12,25
14283,eatadonut,,13,69,103,172
14284,Vladomis,,16,4,2,6
14285,herkimer_sith,,13,34,65,99
14286,Kagi,,30,5,2,7
14287,leopoldbloom,,20,4,1,5
14288,eindbaas,,18,161,36,197
14289,joellevin,,19,13,6,19
14290,wuaha,,18,49,103,152
14291,planza,,32,17,6,23
14292,8418a65850d1df3486e3,,43,1,2,3
14293,veracity,,13,119,12,131
14294,jmuk,,41,25,15,40
14295,bigpun8601,,18,19,23,42
14296,VacuousTart,,43,5,13,18
14297,joeplayer91,,1,22,23,45
14298,masta,,42,1799,495,2294
14299,mcreeves,,18,1,11,12
14300,hoobyjuice,,20,9,20,29
14301,CLBumbc,,0,10,15,25
14302,kensington,,22,7,8,15
14303,sweetiepup,,5,6,6,12
14304,Dr-No,,34,551,1043,1594
14305,cybertron3,,34,10,8,18
14306,tsbardella,,19,10,13,23
14307,ltratt,,20,8,10,18
14308,linsage,,18,65,43,108
14309,tmilanese,,19,9,1,10
14310,_Lysis,,18,5,10,15
14311,permial,,13,11,38,49
14312,malicart,,1,111,174,285
14313,jroot,,1,5,5,10
14314,tritelife,,18,1,1,2
14315,300zxkyle,,32,15,25,40
14316,vgwe4i7,,13,1,1,2
14317,attractivechaos,,20,7,9,16
14318,stevomo,,11,3,1,4
14319,mctofuburger,,29,3,1,4
14320,pankakekid,,43,1,1,2
14321,Stereo,,20,31,22,53
14322,visage,,30,4,1,5
14323,subie,,6,3,3,6
14324,plight43,,13,18,54,72
14325,possummomma,,36,1,1,2
14326,dmacd,,28,2,12,14
14327,paulscholes,,31,1,1,2
14328,EnsignPaul,,20,2,10,12
14329,stacknuker,,38,1,3,4
14330,tech3399,,10,1,1,2
14331,reddit_already,,40,2,3,5
14332,oppenklein,,22,4,2,6
14333,Mikey_K,,0,1,2,3
14334,djpressplay,,32,1,1,2
14335,vinneh,,18,18,32,50
14336,jklyon,,43,5,5,10
14337,d1mension7,,19,1,1,2
14338,murf43143,,5,27,47,74
14339,forthewinyo,,32,1,1,2
14340,aruki,,32,14,32,46
14341,viperucf,,4,3,7,10
14342,bugbear,,0,1,1,2
14343,ochristmastree,,18,5,1,6
14344,biscuitgirl,,19,93,2,95
14345,dillywash,,1,19,32,51
14346,santacruzluke,,13,2,2,4
14347,tzimmerm,,4,1,1,2
14348,sceanti,,20,6,1,7
14349,Breeze99,,20,2,7,9
14350,refusedlud,,31,31,46,77
14351,Cpt2Slow,,13,16,22,38
14352,leavermentality,,31,7,9,16
14353,david_ncl,,20,42,66,108
14354,druzel,,43,25,49,74
14355,dizm,,19,4,6,10
14356,joecooool,,32,12,29,41
14357,reddit1964,,5,1,1,2
14358,mg0abraxas,,22,28,28,56
14359,katiedid382,,32,5,4,9
14360,askedandanswered,,19,2,3,5
14361,biogeek1,,13,1,2,3
14362,arianit,,31,5,9,14
14363,phoenixstrike,,8,4,3,7
14364,evangelos,,29,1,1,2
14365,fishandchips,,0,273,51,324
14366,derricks,,1,101,208,309
14367,BigFootsDick,,18,1,7,8
14368,mcmUK,,1,9,10,19
14369,nafki,,0,1,2,3
14370,starfox863,,19,152,203,355
14371,bparkey,,13,2,5,7
14372,jcarrea,,43,8,15,23
14373,LilBabyCakes,,13,3,5,8
14374,saintdaniel,,13,49,23,72
14375,i386,,20,14,16,30
14376,lesapeur,,32,9,6,15
14377,zorglubb,,1,2,4,6
14378,CharlieBlix,,31,1,1,2
14379,dminor04,,43,2,11,13
14380,largarararar,,6,44,56,100
14381,callingshotgun,,20,14,13,27
14382,brandaggio,,32,1,1,2
14383,xavier687,,32,22,2,24
14384,soonbesleeping,,18,1,1,2
14385,bigbob,,41,3,2,5
14386,misterO,,22,1,2,3
14387,secularhumanismsucks,,9,4,3,7
14388,aardvarkious,,30,783,946,1729
14389,sjn,,20,1,1,2
14390,redriot,,35,1,2,3
14391,youngNactive,,18,1,1,2
14392,jungle,,0,3,3,6
14393,ziusudra,,1,107,120,227
14394,null0ne,,18,48,66,114
14395,denser,,18,1,1,2
14396,jeffkilliandotcom,,18,5,3,8
14397,sleepyslim,,18,1,3,4
14398,rayhoffman,,18,302,19,321
14399,tcz06a,,34,1,3,4
14400,meg1,,13,1545,2,1547
14401,ZEUS_SKY_FATHER,,19,2,3,5
14402,Kreatienmonster,,31,3,6,9
14403,meinpresident,,42,1,1,2
14404,watso4183,,18,4,1,5
14405,nullxposur,,18,38,63,101
14406,Locke,,20,5,10,15
14407,analogy6,,13,49,69,118
14408,wombatz,,16,45,28,73
14409,mrp,,1,245,363,608
14410,fullerenedream,,18,3,9,12
14411,noirling,,18,42,170,212
14412,_batman_,,13,1,1,2
14413,eatwithaspork,,32,84,24,108
14414,packer64,,13,52,93,145
14415,agracey,,33,3,2,5
14416,chalkdrinker,,18,1,1,2
14417,noxyu,,31,237,73,310
14418,free-book,,20,2,1,3
14419,alex77,,3,2,1,3
14420,Unhandled,,18,11,9,20
14421,wetwarehacker,,1,1,2,3
14422,Jack-Sparrow,,19,4,12,16
14423,illuder,,29,1,1,2
14424,Madcat407,,22,6,7,13
14425,one010101,,13,533,363,896
14426,ironeus,,5,2,6,8
14427,thelivingk,,5,3,8,11
14428,Jegschemesch,,18,17,25,42
14429,dtz_prokyon,,34,4,7,11
14430,NotSocrates,,19,99,146,245
14431,noiserr,,1,127,172,299
14432,redditblowz,,0,18,37,55
14433,ashinohara,,20,4,2,6
14434,noahking,,18,14,10,24
14435,sher14,,13,70,34,104
14436,highgear,,10,8,15,23
14437,williambeaufoy,,15,11,2,13
14438,darkness,,20,16,15,31
14439,moosemanca,,34,67,143,210
14440,wainstead,,19,188,171,359
14441,natepurvis,,19,8,36,44
14442,jonbwhite,,18,9,9,18
14443,impulsiveboy,,1,62,71,133
14444,zieski,,41,3,2,5
14445,youAreHere,,17,2,2,4
14446,palin_drome,,14,7,7,14
14447,sickofthisshit,,20,286,468,754
14448,sambo_the_ninja,,0,2,3,5
14449,justanotheraccount,,20,13,15,28
14450,gserafini,,22,4,5,9
14451,manna18,,12,1,2,3
14452,joshstix,,0,42,61,103
14453,geost77,,34,16,1,17
14454,audacityofchope,,13,4,2,6
14455,bisserke,,42,4,7,11
14456,netkitten22,,13,2,3,5
14457,aarondbaron,,34,16,23,39
14458,outlawdba,,6,2,1,3
14459,morefish,,15,2,10,12
14460,tryk48s,,1,141,226,367
14461,jramon,,14,158,163,321
14462,numtel,,34,6,15,21
14463,GoWithTheFlow,,34,327,1,328
14464,dcanatsey,,4,1,1,2
14465,Biohazix,,22,1,1,2
14466,qeorge,,22,1,7,8
14467,yambo,,18,3,1,4
14468,wolof,,13,12,20,32
14469,Adam_B,,19,18,8,26
14470,sunbright,,13,59,73,132
14471,SanBenito,,34,142,3,145
14472,hoppaaaa,,13,7,4,11
14473,sybilll,,13,4,3,7
14474,uptoyou,,0,468,11,479
14475,atomicpoet,,18,73,7,80
14476,krava,,0,1,1,2
14477,iam413x,,8,7,7,14
14478,deadilyduplicate,,20,27,43,70
14479,fiddlefaddle,,1,2,6,8
14480,jgsfcaus,,13,7,17,24
14481,ihendley,,18,2,3,5
14482,austinpete3,,18,2,1,3
14483,Nemo84,,31,266,277,543
14484,cheetahforce,,29,55,59,114
14485,davidzilla27,,34,2,1,3
14486,nixx,,30,2,1,3
14487,brubsy,,13,739,102,841
14488,MikeCapone,,19,1107,192,1299
14489,gonorrhea,,0,139,209,348
14490,zanshin,,20,1,2,3
14491,burnte,,14,35,31,66
14492,zhz,,18,29,1,30
14493,glazedham,,19,2,5,7
14494,myriad,,14,6,6,12
14495,Cbosselman,,15,3,1,4
14496,garagumu,,20,1,2,3
14497,smokinsamsim,,13,347,498,845
14498,gonzopancho,,20,157,310,467
14499,LKPGKS,,42,1,1,2
14500,too-much-4chan,,40,3,1,4
14501,temujin9,,19,12,9,21
14502,qwertyboy,,20,13,31,44
14503,herb_lubalin,,20,1,1,2
14504,PhilA,,32,58,94,152
14505,seoredditspammer,,15,1,2,3
14506,jvboom,,18,3,9,12
14507,elljazz,,21,1,1,2
14508,Loggie,,13,9,5,14
14509,saadghauri,,31,17,12,29
14510,benjimix,,13,16,16,32
14511,rabbitz,,3,3,1,4
14512,leastwise,,0,1,1,2
14513,DaSuHouse,,31,109,98,207
14514,mellowmuppet,,34,6,4,10
14515,xxshteviexx,,31,12,3,15
14516,crawfishsoul,,43,926,757,1683
14517,emeraldchild,,6,35,13,48
14518,degustibus,,31,639,719,1358
14519,Tomasd,,18,27,85,112
14520,sanshou,,32,1,1,2
14521,DemonWasp,,18,36,38,74
14522,taliesinsmuse,,16,2,3,5
14523,anneas,,19,4,33,37
14524,markansoul,,19,319,220,539
14525,swanrt,,1,1,1,2
14526,Tumbler,,13,28,73,101
14527,GuruM,,30,36,31,67
14528,heirenton,,29,3,6,9
14529,skuttlesSUPERHOTwife,,0,1,1,2
14530,y0ssarian_lives,,3,5,4,9
14531,francomanco,,34,1,1,2
14532,narf760,,19,8,14,22
14533,jingo04,,42,193,252,445
14534,stevob2007,,0,20,7,27
14535,xsvfan,,18,52,78,130
14536,mrpeepers,,19,146,51,197
14537,Keedo,,43,114,107,221
14538,TJ700,,31,12,17,29
14539,SCThornley,,32,14,28,42
14540,keghiaguy,,1,1,1,2
14541,fdsawrefsdf,,13,3,6,9
14542,Carleton,,19,46,56,102
14543,nejda,,13,1,1,2
14544,dfn_doe,,19,10,17,27
14545,trebok,,32,9,2,11
14546,nibulis,,26,1,1,2
14547,Terry_Wogan,,1,1,1,2
14548,KauLad,,19,56,175,231
14549,canadianstudent,,36,4,5,9
14550,juri,,20,152,54,206
14551,bigman11,,18,39,41,80
14552,quandrum,,32,3,2,5
14553,towel106,,18,2,6,8
14554,BarkingIguana,,31,60,2,62
14555,leofellmann,,42,1,1,2
14556,jarnot,,18,26,17,43
14557,4Kitch,,21,5,6,11
14558,alrecruits,,13,3,11,14
14559,n3sky,,1,3,2,5
14560,supersix8,,19,2,6,8
14561,all4one,,13,31,2,33
14562,kdevilbiss,,43,4,2,6
14563,FrazRoc,,1,2,5,7
14564,DorkAvenue,,13,1,1,2
14565,neuquino,,22,337,469,806
14566,allisonschest,,13,10,11,21
14567,roflcoptars,,20,9,5,14
14568,Franey97,,18,40,75,115
14569,mudita4,,5,2,7,9
14570,refuch,,18,254,206,460
14571,toast_and_oj,,22,90,100,190
14572,RoboHobo,,1,6,10,16
14573,lesbianmonad,,20,2,2,4
14574,Mondex,,34,4,8,12
14575,moxy,,12,98,56,154
14576,Kythas,,13,1,3,4
14577,malte,,8,4,10,14
14578,ejegg,,32,18,19,37
14579,novan_leon,,20,4,6,10
14580,hatboysam,,43,23,24,47
14581,Tspyder90,,31,9,4,13
14582,xanados,,31,27,34,61
14583,brownmajik,,36,3,4,7
14584,Seizure,,18,4,5,9
14585,vanNood,,17,15,20,35
14586,realrbman,,18,4,8,12
14587,lockhart000,,29,373,734,1107
14588,treefrog3,,22,8,7,15
14589,wacky,,1,58,82,140
14590,staticflux,,4,3,5,8
14591,sergiu,,20,34,36,70
14592,MostUsually,,20,587,185,772
14593,jdubba,,1,12,13,25
14594,drluke21,,31,2,1,3
14595,zdiggler,,1,59,108,167
14596,gardsmyg,,39,2,1,3
14597,zybler,,20,2,5,7
14598,erinswake11,,19,1,1,2
14599,pythor,,30,208,183,391
14600,fjohnson,,41,7,6,13
14601,frycook,,13,1086,150,1236
14602,onymous,,13,26,49,75
14603,Smitty1315,,21,35,51,86
14604,robotify,,20,7,4,11
14605,wmdeez,,23,1,1,2
14606,potheadpaul,,13,1,5,6
14607,GeDaMo,,20,33,36,69
14608,diggtard,,31,1,1,2
14609,andoy,,13,44,59,103
14610,andrew2825,,19,14,19,33
14611,nikron,,20,59,66,125
14612,potesf,,12,2,2,4
14613,Recycle_Grav_Water,,22,9,5,14
14614,illuminati11_13,,6,29,50,79
14615,sabliss,,13,5,11,16
14616,tolmeda,,13,2,2,4
14617,fbsdaemon,,20,2,1,3
14618,ThePantsParty,,32,606,666,1272
14619,machotaco,,18,33,13,46
14620,HeywoodFloyd,,18,17,38,55
14621,chedabob,,18,14,27,41
14622,blahblah984,,10,125,116,241
14623,clashradio,,19,1,1,2
14624,motd,,14,127,7,134
14625,vademecum,,4,17,14,31
14626,The_Slinky,,35,7,5,12
14627,myshambar,,13,11,9,20
14628,HipX,,43,74,108,182
14629,stratoscope,,20,60,112,172
14630,oliverhulland,,34,1,1,2
14631,peanutcruncher,,31,7,6,13
14632,thewaxtadpole,,43,1,1,2
14633,jsinger,,20,58,82,140
14634,Caledo,,31,5,11,16
14635,drp,,32,23,19,42
14636,jimmyw,,13,7,4,11
14637,Waven,,6,2,7,9
14638,Dick-Cheney,,19,3,2,5
14639,miramesa,,19,64,4,68
14640,anticompany,,13,1,1,2
14641,bdpf,,13,4,22,26
14642,Underbelly,,18,1,3,4
14643,macworks,,20,1,1,2
14644,hunter-man,,12,227,493,720
14645,r2002,,32,2524,400,2924
14646,richroger68,,39,2,1,3
14647,monsterchaos,,42,16,15,31
14648,thomaspaine23,,0,63,18,81
14649,mberning,,20,8,6,14
14650,wedsngr,,13,6,17,23
14651,jdiggity,,18,6,15,21
14652,wat,,19,161,341,502
14653,englishpaulm,,18,14,20,34
14654,nullpuppy,,10,1,1,2
14655,Tits,,0,1,2,3
14656,dfdemar,,19,1,3,4
14657,gunzler,,33,5,2,7
14658,Unlucky13,,18,963,1026,1989
14659,Stani,,43,4,1,5
14660,jftduncan,,30,18,54,72
14661,nagycalsmom,,18,20,22,42
14662,MinionKeeper,,22,1,1,2
14663,admiralteal,,6,324,357,681
14664,v1p3r,,5,119,11,130
14665,stnkyme,,18,1,2,3
14666,RecycleBin,,20,7,5,12
14667,mozinator,,20,5,3,8
14668,ABoringStory,,22,3,3,6
14669,sorinescu,,5,1,1,2
14670,jbourne,,43,58,84,142
14671,morgawr,,4,3,3,6
14672,xeferae,,32,2,2,4
14673,haliquim,,41,3,6,9
14674,educ8r,,32,1,1,2
14675,dmead,,9,227,439,666
14676,petert111,,19,2,2,4
14677,revence27,,20,93,27,120
14678,locke-peter,,0,1,4,5
14679,mhatmaker,,19,79,8,87
14680,an_idiot,,18,7,24,31
14681,jarwiz,,5,10,3,13
14682,fryfut,,1,5,1,6
14683,Reeking_Havoc,,19,10,31,41
14684,slacker_express,,13,1,3,4
14685,cray,,19,47,2,49
14686,walkerandtexasranger,,18,26,45,71
14687,f350,,36,2,1,3
14688,alaithea,,19,9,4,13
14689,killswithspoon,,18,85,161,246
14690,cmatta,,18,27,8,35
14691,inataysia,,20,56,78,134
14692,mokba,,18,14,28,42
14693,mrmch,,12,1,1,2
14694,savyboy,,6,3,3,6
14695,lostcause,,43,2,1,3
14696,CrawstonWaffle,,18,43,60,103
14697,qiwi,,20,206,142,348
14698,OnkelOnd,,31,1,2,3
14699,six2one,,18,27,54,81
14700,honkytonks,,13,259,355,614
14701,austinap,,18,24,45,69
14702,rodbibeau,,18,365,40,405
14703,heasmo,,43,3,4,7
14704,Sivart,,19,136,16,152
14705,amburka,,18,10,29,39
14706,deputy,,20,3,2,5
14707,lobster_johnson,,20,17,17,34
14708,twistedlogix,,20,17,24,41
14709,acm,,13,149,144,293
14710,w-smith,,31,762,345,1107
14711,find_the_orphan,,18,143,303,446
14712,spinelssinvrtebrate,,19,9,12,21
14713,iamdeirdre,,1,1,4,5
14714,trixare4kids,,18,2,2,4
14715,jamieg77,,13,264,83,347
14716,fivekitten,,13,1,1,2
14717,corser,,31,12,16,28
14718,vogella,,17,2,1,3
14719,FlySwat,,20,1340,1207,2547
14720,lmaurits,,31,46,40,86
14721,geldan01,,12,1,3,4
14722,hammerfist,,31,4,3,7
14723,salival,,13,11,6,17
14724,867_5309,,14,2,2,4
14725,arumalla,,5,5,2,7
14726,derosabomb,,18,34,71,105
14727,ireddit_didu,,8,10,9,19
14728,raaaaaj,,34,1,1,2
14729,redditer029,,5,3,1,4
14730,GhostSonata,,0,107,154,261
14731,atc,,18,246,100,346
14732,finreddit,,13,156,96,252
14733,nbomberger,,22,1,1,2
14734,boo_radley,,13,410,176,586
14735,desperatechaos,,13,1,1,2
14736,quark2universe,,1,2,4,6
14737,lazyl,,32,10,12,22
14738,takezo,,20,6,9,15
14739,rwattonville,,32,21,4,25
14740,jsmith55,,13,7,11,18
14741,CannonBall7,,30,8,9,17
14742,culalem,,0,20,21,41
14743,M-Jo,,1,27,27,54
14744,mrossi,,20,1,1,2
14745,vypermann,,18,45,116,161
14746,NucularOption,,42,19,15,34
14747,kbax,,29,1,1,2
14748,kahlveen,,18,3,6,9
14749,Bluebuilder,,19,4,20,24
14750,vasi,,22,6,1,7
14751,davidkclark,,1,55,104,159
14752,Otis_Inf,,31,45,67,112
14753,kraemahz,,22,560,784,1344
14754,SyndicatedCynic,,13,17,8,25
14755,asses4all,,13,18,16,34
14756,blindsideboarder,,38,5,2,7
14757,radix2,,32,278,435,713
14758,knutert,,20,13,25,38
14759,insaneferret,,11,2,2,4
14760,EcoLogic,,5,6,18,24
14761,thomasjkeeley,,13,2,2,4
14762,beta_pup,,43,3,5,8
14763,Corosus,,1,12,20,32
14764,zjohnson,,22,2,2,4
14765,Nulli,,43,8,20,28
14766,positiveexperience,,23,1,4,5
14767,QueryNerd,,19,14,12,26
14768,BenderBRodriguez,,12,1,1,2
14769,kunal,,18,3,3,6
14770,L505,,20,1,5,6
14771,troofs,,0,1,1,2
14772,relativityboy,,5,1,2,3
14773,BBHoss,,18,9,8,17
14774,yamahaha,,18,7,16,23
14775,karlgluck,,20,20,18,38
14776,booku,,20,2,4,6
14777,photoho,,18,41,65,106
14778,senorsam,,31,1,1,2
14779,blindmikey,,30,12,21,33
14780,vezquex,,1,93,165,258
14781,stevos,,8,2,1,3
14782,User-Name-,,22,2,1,3
14783,czone2,,31,11,12,23
14784,qvtsd,,19,109,94,203
14785,Stupid_boy,,13,13,13,26
14786,j3anjean,,19,3,11,14
14787,jasondm,,20,32,28,60
14788,xcbsmith,,20,296,464,760
14789,goodfun,,42,344,344,688
14790,aquowf,,22,1,1,2
14791,snerfu,,20,12,3,15
14792,hahabitch,,19,1,1,2
14793,skypedia,,43,171,3,174
14794,catpartyletsgo,,18,7,1,8
14795,honeyguy,,13,16,16,32
14796,slarti101,,3,4,3,7
14797,InfamousMrSatan,,20,1,1,2
14798,Raegnar,,20,2,2,4
14799,raskolnikov027,,32,7,11,18
14800,nohtyp,,20,81,98,179
14801,Jenkin,,42,5,6,11
14802,bdj789,,19,2,1,3
14803,moontalyn,,13,1,1,2
14804,myjunkmailblog,,18,139,19,158
14805,renumeratedfrog,,43,106,188,294
14806,decode,,20,34,41,75
14807,MrDectol,,18,362,205,567
14808,themightytimmah,,9,34,43,77
14809,spirithappy,,13,5,1,6
14810,oneredshoe,,34,2,2,4
14811,gudolph,,18,49,1,50
14812,cheerstothat,,20,1,4,5
14813,lookyhere,,19,55,110,165
14814,Ian1971,,20,39,62,101
14815,patrickthebeerguy,,18,1,7,8
14816,Kydosa,,14,30,28,58
14817,pattister,,43,12,20,32
14818,locke2002,,22,810,1116,1926
14819,siff,,0,8,16,24
14820,YakumoFuji,,20,14,15,29
14821,mdaniel018,,4,1,4,5
14822,mfritze,,1,2,1,3
14823,corbet,,20,115,6,121
14824,jerfalco,,1,1,1,2
14825,lolret,,34,37,40,77
14826,chaimonster,,34,14,28,42
14827,mm256,,20,1,1,2
14828,cunning_alias,,42,2,6,8
14829,FapFapFapSquirt,,0,39,54,93
14830,imp4hire,,19,53,83,136
14831,exteNz,,13,1,1,2
14832,mozo,,19,18,43,61
14833,nakul,,0,29,2,31
14834,uri2007,,22,2,2,4
14835,EgoEater,,39,1,1,2
14836,charlieb,,43,28,7,35
14837,Media_Offline,,18,16,19,35
14838,kluikens,,32,2,1,3
14839,HaloShy,,31,2,7,9
14840,mahlankeruu,,12,1,1,2
14841,papared,,32,29,44,73
14842,stevage,,18,27,64,91
14843,runo,,20,1,2,3
14844,molasses,,3,7,7,14
14845,booc0mtaco,,1,125,237,362
14846,misterguy,,18,32,39,71
14847,Volred,,30,5,2,7
14848,ariessoul,,1,5,13,18
14849,noob09,,4,2,5,7
14850,ichae,,0,243,266,509
14851,laffer82,,18,2,8,10
14852,MarginalMeaning,,31,15,23,38
14853,donutwant,,19,1,1,2
14854,lmpinto,,34,26,25,51
14855,ampwoden,,34,1,1,2
14856,pstryder,,32,18,14,32
14857,joshery420,,34,1,1,2
14858,toolhater,,31,49,71,120
14859,shelter33,,19,21,27,48
14860,squishee,,18,2,3,5
14861,easlern,,20,18,36,54
14862,pRtkL_xLr8r,,18,34,24,58
14863,BizCoach,,13,3,1,4
14864,davros,,5,2,2,4
14865,quaesitum,,1,1,1,2
14866,fenalphthalein,,22,1,1,2
14867,wirehead,,20,20,19,39
14868,RevFred,,13,31,75,106
14869,Omar_Little,,43,7,8,15
14870,maven1000,,6,12,17,29
14871,MindStalker,,13,99,136,235
14872,tyler0is0sexy,,20,12,17,29
14873,jonimius,,39,1,1,2
14874,rfriendselectric,,13,13,28,41
14875,john1968,,20,1,1,2
14876,almeerow,,34,1,1,2
14877,notoryious,,19,77,14,91
14878,BossColo,,1,70,36,106
14879,stashu,,43,42,53,95
14880,pineapplecharm,,20,189,136,325
14881,mnckelly,,18,168,11,179
14882,wildjasmyne,,19,3,1,4
14883,AlanisMorissette,,0,2,3,5
14884,Quantic,,4,13,22,35
14885,soWifeWontRead,,22,1,1,2
14886,mgdmw,,32,21,2,23
14887,jonndailey,,8,2,5,7
14888,jechasteen,,18,15,24,39
14889,zuiop,,20,2,2,4
14890,TW9zc2Fk,,31,49,47,96
14891,Cyn_Helen,,31,5,9,14
14892,Russss,,20,4,2,6
14893,NealJiutai,,19,8,4,12
14894,BrkneS,,22,44,81,125
14895,wurtis16,,34,317,508,825
14896,gorgonette,,31,3,3,6
14897,Insurrexi,,34,16,13,29
14898,tckearns,,1,27,17,44
14899,FritzGuy,,4,34,32,66
14900,Libertwriter,,13,85,3,88
14901,flashgasoline,,1,126,49,175
14902,cancer_will_kill_you,,5,1,1,2
14903,Polarisman,,30,60,78,138
14904,Ai3d,,26,11,19,30
14905,rozbluewhite,,25,2,1,3
14906,diddy223,,18,16,32,48
14907,jmr81,,5,9,9,18
14908,ric_astley,,22,4,5,9
14909,seaport,,13,24,2,26
14910,chiragshah1,,20,11,12,23
14911,Jivlain,,22,523,691,1214
14912,rhpk,,20,18,5,23
14913,grendel001,,12,66,81,147
14914,fisheyeguy,,13,1,1,2
14915,radar-luv,,18,29,26,55
14916,xtra_sharp,,22,114,202,316
14917,Bloaf,,32,36,63,99
14918,pmctosh,,0,12,5,17
14919,bakekitsune,,0,2,2,4
14920,sablewing,,13,2,1,3
14921,thepenismightier,,18,2,1,3
14922,myclone,,20,6,6,12
14923,ratley,,13,1,2,3
14924,RRightmyer,,10,8,10,18
14925,goldenbug,,31,4,3,7
14926,yugurta,,43,1,1,2
14927,leapinleopard,,13,26,18,44
14928,mronge,,20,1,1,2
14929,Gauze,,36,2,1,3
14930,rufosanch,,41,3,5,8
14931,glaeken,,31,18,19,37
14932,theneonwind,,5,2,2,4
14933,zplot,,31,2,7,9
14934,lostangelonline,,4,59,114,173
14935,orrizo,,0,17,34,51
14936,swervely,,3,3,2,5
14937,Ember357,,0,2,1,3
14938,nopenotreally,,11,1,1,2
14939,Sarkwa,,19,3,3,6
14940,atoztoa,,0,1,1,2
14941,Eminence120,,18,111,153,264
14942,7amWDG,,32,10,7,17
14943,sal4321,,1,6,3,9
14944,gdupe,,18,3,3,6
14945,grau,,43,22,45,67
14946,christopherness,,18,3,1,4
14947,superdupertigercat,,22,5,6,11
14948,wanderful,,32,36,78,114
14949,lemonheadzzz,,9,1,1,2
14950,aethauia,,23,34,60,94
14951,jmesserly,,20,1,2,3
14952,johannesfarr,,18,2,4,6
14953,RogueJediX,,42,18,31,49
14954,geneticmaterial,,13,10,27,37
14955,etrochim,,34,3,1,4
14956,furless,,13,1,4,5
14957,Calamaro,,4,1,5,6
14958,pookiey,,4,1,1,2
14959,smarterthanyoda,,5,8,16,24
14960,NLP,,19,12,18,30
14961,Spoots,,23,1,1,2
14962,Tygerdave,,20,2,3,5
14963,giantstonedbot,,18,18,13,31
14964,tanglisha,,22,88,108,196
14965,tenpastmidnight,,20,5,12,17
14966,americanadian,,1,55,41,96
14967,rurias1,,18,3,2,5
14968,zodpower,,19,11,38,49
14969,Jonno94,,29,1,1,2
14970,shawnwasson,,13,420,21,441
14971,dhays2000,,18,9,15,24
14972,Ionice,,34,215,6,221
14973,alecthomas,,20,2,8,10
14974,fuzzmop,,32,70,76,146
14975,oimeetsgrrl,,0,18,13,31
14976,thisuserisapipe_bomb,,16,6,5,11
14977,exitjudas,,1,8,4,12
14978,wmarcello,,30,114,126,240
14979,MSchmahl,,22,104,85,189
14980,eviladam,,22,1,1,2
14981,dangboi,,13,4,10,14
14982,captaink,,32,17,22,39
14983,jhrf,,18,8,6,14
14984,bdgr,,18,2,2,4
14985,wiccan333,,19,11,14,25
14986,josh42042,,0,4,9,13
14987,tjuric,,13,3,1,4
14988,PacoDG,,42,87,1,88
14989,vckt,,22,1,1,2
14990,mydyingdreams,,20,28,39,67
14991,bjornhallberg,,13,13,4,17
14992,gwn,,19,2,1,3
14993,Sippin40z,,18,2,4,6
14994,Pyroice04,,1,5,6,11
14995,otnug,,19,19,34,53
14996,sshannon,,22,5,6,11
14997,PeteMoss,,9,1,2,3
14998,elvenrunelord,,1,81,7,88
14999,HARTempire,,34,35,3,38
15000,Murkt,,20,1,7,8
15001,ehcolem,,19,204,202,406
15002,teskoner,,5,6,8,14
15003,johnwally54,,1,30,2,32
15004,locket42,,20,1,2,3
15005,kdeforche,,20,6,4,10
15006,glatisant,,18,7,14,21
15007,bad_llama,,42,639,717,1356
15008,alcan_100,,11,2,2,4
15009,lollapaulooza,,18,13,16,29
15010,N4X,,1,3,3,6
15011,mareacaspica,,5,262,28,290
15012,lucyd,,43,21,19,40
15013,omokoro,,31,3,2,5
15014,myfivelies,,18,70,121,191
15015,IhateRedditors,,18,1,1,2
15016,mongreloctopus,,36,7,13,20
15017,psionicman,,31,2,2,4
15018,clevername,,19,5,18,23
15019,ronoe0,,19,1,6,7
15020,visik7,,20,4,3,7
15021,lifeform,,22,5,6,11
15022,anamorphosis,,18,3,2,5
15023,anmol2k4,,31,134,178,312
15024,timclark,,20,75,29,104
15025,mario64,,13,32,33,65
15026,bigorangehippo,,19,3,4,7
15027,Magneon,,27,2,3,5
15028,Atheinostic,,19,748,258,1006
15029,skynxnex,,0,2,5,7
15030,sporksmith,,20,8,9,17
15031,rstanny,,16,6,6,12
15032,deathbychopsticks,,21,2,1,3
15033,mdipierro,,20,105,121,226
15034,flyernati,,6,24,13,37
15035,ephemerat,,20,6,18,24
15036,Raerth,,1,189,119,308
15037,Dreynsen,,1,1,5,6
15038,waxandwane,,18,34,81,115
15039,sgillies,,20,6,10,16
15040,priest,,13,33,28,61
15041,freeradical,,22,16,10,26
15042,great-pumpkin,,20,201,135,336
15043,kittish,,6,39,79,118
15044,Mediabalance,,31,2,1,3
15045,bhavi,,19,79,13,92
15046,hzuigq,,43,3,2,5
15047,onemadfool,,1,55,27,82
15048,sheasie,,18,13,8,21
15049,brianary,,19,90,91,181
15050,mentat,,22,81,95,176
15051,cdsmith,,20,143,158,301
15052,Fucknut,,43,49,43,92
15053,despirit,,22,150,168,318
15054,AndrewO,,20,27,50,77
15055,GeeWhiz2000,,22,6,7,13
15056,ginkster88,,15,5,3,8
15057,XTL,,9,29,34,63
15058,strazzerj,,18,69,99,168
15059,cafedude,,20,54,40,94
15060,wham,,43,2,4,6
15061,rsander,,1,40,13,53
15062,Slick42,,19,4,7,11
15063,ir8prim8,,19,49,23,72
15064,slackwalker,,43,35,36,71
15065,schleyfox,,20,17,18,35
15066,redlemon,,31,5,4,9
15067,d4r4ki4n,,19,4,7,11
15068,Bliumchik,,3,1,1,2
15069,PhagsRU,,18,1,7,8
15070,jason_w87,,19,103,183,286
15071,Barto246,,18,27,49,76
15072,fyl999,,34,22,22,44
15073,dep,,0,1,2,3
15074,xlxcigaroxlx,,18,9,1,10
15075,flaneur,,18,84,14,98
15076,Raoulmeister,,19,6,23,29
15077,mspang,,20,1,1,2
15078,asdf333,,19,34,45,79
15079,ottothebobcat,,20,1,1,2
15080,Wavicle,,20,245,330,575
15081,Sandkat,,1,2,9,11
15082,Abhorrence,,18,4,1,5
15083,FrankJov,,13,103,10,113
15084,mickrobk,,7,4,3,7
15085,AvailableName,,20,28,5,33
15086,acowno,,0,44,48,92
15087,Leinistar,,30,3,8,11
15088,tpyo,,33,4,17,21
15089,theg2,,4,130,162,292
15090,joaomc,,20,103,150,253
15091,fijal,,20,2,2,4
15092,chickenofthewoods,,43,68,205,273
15093,veri69e,,19,1,28,29
15094,truthseeker8,,8,1,1,2
15095,tkilgore,,29,4,3,7
15096,StinkyLetters,,34,6,3,9
15097,Cenobite,,18,39,63,102
15098,IHateCrocs,,0,21,24,45
15099,AntiStar,,32,1,4,5
15100,corkill,,8,451,381,832
15101,enry,,19,190,283,473
15102,bvm,,18,5,2,7
15103,intheoryiamworking,,20,63,67,130
15104,justinvh,,20,1,1,2
15105,Lx_Rogue,,43,2,9,11
15106,wopr,,14,1,3,4
15107,damnwhity,,1,17,53,70
15108,peterjoel,,43,1,1,2
15109,foonly,,22,531,1301,1832
15110,random393508375,,13,1,2,3
15111,kiwimonster,,0,195,156,351
15112,impiri,,32,83,92,175
15113,seymour85202,,18,2,2,4
15114,badgerken,,0,3,2,5
15115,youssef,,42,16,8,24
15116,Mooshiga,,13,88,123,211
15117,UofCstudent,,1,18,2,20
15118,BillyBoyJoy,,15,8,1,9
15119,bluto20,,1,6,7,13
15120,mozfan,,20,87,7,94
15121,qwidjibo,,1,2,4,6
15122,SirEdmund,,28,85,170,255
15123,option08,,13,241,102,343
15124,linuxlass,,32,517,778,1295
15125,mja333,,13,10,20,30
15126,crkota,,18,28,5,33
15127,aprelog,,19,11,1,12
15128,dfndoe,,20,190,162,352
15129,snb,,43,29,53,82
15130,Escapism,,5,1,3,4
15131,orlock,,22,2,11,13
15132,tbeanz,,18,181,304,485
15133,AndrewTerry,,30,11,5,16
15134,thegman,,0,1,2,3
15135,mycatverbs,,20,28,65,93
15136,JamesieAB,,13,2,3,5
15137,threedaymonk,,20,9,28,37
15138,frobots,,2,4,4,8
15139,judeofascism,,14,1,4,5
15140,tghw,,20,105,117,222
15141,akasan,,1,22,37,59
15142,RonnieRaygun,,18,32,53,85
15143,gwarmerdam,,13,1,1,2
15144,jmwilliams,,13,13,5,18
15145,ICantReadThis,,4,215,192,407
15146,waqsax,,32,5,1,6
15147,akitaonrails,,20,2,1,3
15148,confuseme,,20,25,10,35
15149,tarjan,,42,4,3,7
15150,ounfsfbosdfb,,20,79,125,204
15151,spatialmongrel,,30,6,3,9
15152,paulsteinway,,19,70,240,310
15153,linkbackproject,,13,35,16,51
15154,Juan0325,,30,1,2,3
15155,dtxBullet,,10,5,1,6
15156,josetavares,,13,66,52,118
15157,anexxus,,31,2,2,4
15158,harinath,,20,7,4,11
15159,trjames,,43,9,17,26
15160,jetcombo15,,18,64,104,168
15161,lldmer,,1,2,1,3
15162,acrim,,20,62,74,136
15163,GowdTeefs,,19,2,4,6
15164,zenchess,,32,15,29,44
15165,didroe,,20,254,330,584
15166,xen0cide,,17,2,1,3
15167,macholusitano,,31,20,21,41
15168,AJSmithy91,,18,7,4,11
15169,SaveOurSouls,,13,502,141,643
15170,Sickly404,,18,3,4,7
15171,pingwax,,18,25,25,50
15172,lilliwhite,,13,4,6,10
15173,Caper,,19,15,13,28
15174,meshko,,6,14,6,20
15175,uncannybuzzard,,18,12,12,24
15176,Thud,,31,25,18,43
15177,alistaircroll,,0,12,9,21
15178,nekidchickens,,31,2,2,4
15179,Thestormo,,18,83,122,205
15180,itstoobad,,13,3,6,9
15181,xiojqwnko,,34,1,1,2
15182,grandson39,,20,1,2,3
15183,Burnage,,29,77,79,156
15184,PixelatorOfTime,,13,30,52,82
15185,daphnl,,31,4,4,8
15186,WHERE_IS_THE_RAGE,,16,1,2,3
15187,byrule62,,31,6,3,9
15188,inspired1,,19,4,2,6
15189,byte1918,,18,67,103,170
15190,wandula,,19,3,3,6
15191,oakes,,19,50,44,94
15192,mgoflash,,18,1,3,4
15193,grandmclargehuge,,13,6,1,7
15194,Random_Redditor,,19,10,19,29
15195,Conservativepublican,,13,282,116,398
15196,DOGA,,39,986,2046,3032
15197,Shaper_pmp,,4,1172,1737,2909
15198,randomb0y,,8,2319,3296,5615
15199,TheGonzo,,18,81,186,267
15200,SamIWas,,3,10,4,14
15201,gomtuu123,,43,1,2,3
15202,mrplinko,,5,28,53,81
15203,rachael02,,10,24,37,61
15204,lokal,,18,1,5,6
15205,lexiticus,,18,4,7,11
15206,The_RePoster,,12,1,1,2
15207,ufh8rjhf,,8,2,5,7
15208,tdrusk,,42,26,22,48
15209,Nosher,,31,21,19,40
15210,KILL_YOURSELF,,6,1,3,4
15211,jwag57,,13,76,2,78
15212,jstraszheim,,20,4,3,7
15213,lovestofail,,43,37,46,83
15214,socketwiz,,20,7,9,16
15215,dogsbody,,6,9,2,11
15216,zan_shikai,,4,1,3,4
15217,FionaSarah,,20,351,530,881
15218,lzm,,20,52,45,97
15219,Tobblo,,18,4,1,5
15220,MosquitoXR13,,18,6,39,45
15221,MaddenedMan,,22,101,240,341
15222,astroheadzombie,,43,2,3,5
15223,MalachiConstant,,13,84,17,101
15224,cls2deg,,20,1,1,2
15225,yyme,,14,1,4,5
15226,bsterne,,13,3,13,16
15227,damageCTRL,,1,67,39,106
15228,niddleplexto,,43,1,2,3
15229,ivanpw,,34,51,1,52
15230,dex_paranoia,,22,26,27,53
15231,Establishment,,32,1,1,2
15232,ladymeg,,5,7,3,10
15233,myotheruserid,,31,16,15,31
15234,krypteia,,31,34,3,37
15235,pimpdown,,31,33,47,80
15236,gsxrman,,30,7,7,14
15237,alexcabrera,,19,1,1,2
15238,krafdkat,,42,15,31,46
15239,ahnunahki,,20,12,8,20
15240,NameSpaceCollision,,18,2,4,6
15241,Santito,,31,10,19,29
15242,tjw,,39,263,343,606
15243,Fat_Trevor,,26,1,1,2
15244,Hippo78,,20,4,3,7
15245,Locke005,,42,38,35,73
15246,chriszf13,,22,14,8,22
15247,rchase,,31,1,1,2
15248,huntercrimson,,42,4,1,5
15249,Glaeal,,19,8,19,27
15250,bmorlok,,19,43,67,110
15251,kilometer,,5,5,8,13
15252,lion22,,18,35,2,37
15253,gbdc01,,0,1,1,2
15254,BenPS,,20,8,7,15
15255,diamond9,,43,259,34,293
15256,zach_jdia,,43,184,118,302
15257,flaxeater,,20,220,335,555
15258,jerrysinful,,0,11,8,19
15259,mvsac,,18,2,4,6
15260,the_mgt,,5,16,17,33
15261,acgourley,,27,40,16,56
15262,velvus,,13,1,1,2
15263,walrusgumboot,,1,17,22,39
15264,GhostofGod,,32,7,9,16
15265,allthor,,34,8,2,10
15266,Gatecrasherc6,,18,20,27,47
15267,ModerateDbag,,13,1,11,12
15268,johnnyaardvark,,0,12,6,18
15269,esoterik,,15,185,64,249
15270,mrcow,,29,18,5,23
15271,PaperSkyline,,43,1,8,9
15272,tongue,,43,1,1,2
15273,grimitar,,19,45,10,55
15274,shinta9,,20,25,25,50
15275,LuvKrahft,,36,5,8,13
15276,Chandon,,20,168,236,404
15277,gurami,,34,2,5,7
15278,pist,,13,298,220,518
15279,frezzi,,19,2,1,3
15280,picklepete,,18,7,7,14
15281,NjoyDaSilence93,,1,1,1,2
15282,crumblenaut,,20,2,3,5
15283,dpark,,6,114,118,232
15284,radiofreeearth,,13,13,3,16
15285,chata8,,13,86,133,219
15286,Gorbama,,19,204,189,393
15287,sandyenglish,,19,70,7,77
15288,spaceghoti,,13,445,916,1361
15289,evad04,,13,1,1,2
15290,Deewiant,,20,47,58,105
15291,jhoelybabyblue,,25,1,1,2
15292,ISeriouslyDoubtIt,,18,1,5,6
15293,tertiary,,31,229,245,474
15294,csw,,43,28,9,37
15295,asereth,,18,4,7,11
15296,Phrodo_00,,20,80,135,215
15297,yuin,,19,1,1,2
15298,profpan,,19,34,32,66
15299,A-Jota,,31,3,4,7
15300,hypertor,,23,2,2,4
15301,thegeoffmeister,,18,6,9,15
15302,viggity,,0,16,13,29
15303,Resilience,,1,651,556,1207
15304,Adduc,,42,13,24,37
15305,l0rn,,0,8,13,21
15306,kopo27,,13,73,79,152
15307,blacking_out,,11,1,1,2
15308,nickisnt,,5,1,3,4
15309,guyincorporated,,32,6,13,19
15310,jplindstrom,,20,35,73,108
15311,gurudatt,,5,837,19,856
15312,urrtha,,19,5,5,10
15313,furiousc,,34,11,8,19
15314,Username314,,22,1,8,9
15315,muckraker,,19,1,1,2
15316,Jewmerica,,31,7,5,12
15317,notmyrealaccount,,13,2,2,4
15318,zeazzz,,11,20,1,21
15319,radbean,,36,3,3,6
15320,Alumman,,34,7,13,20
15321,shitfuck,,19,8,5,13
15322,apage43,,20,9,8,17
15323,kylemax,,20,28,20,48
15324,schokn,,29,16,10,26
15325,atsparagon,,5,1,2,3
15326,thaislump,,20,11,10,21
15327,TomaszD,,18,21,24,45
15328,warlock_05,,17,1,1,2
15329,ghost911,,15,9,6,15
15330,Awwdok,,20,1,1,2
15331,vaporgriffin,,18,6,7,13
15332,asmith1243,,42,45,2,47
15333,freedomfighter666,,4,4,1,5
15334,ezrastiles,,19,122,11,133
15335,karmasquirrel,,18,3,3,6
15336,theCorrectorator,,20,1,1,2
15337,carakor,,29,1,2,3
15338,NukeAMuslimForYHWH,,1,1,2,3
15339,ScantilyClad,,30,3,12,15
15340,otaku,,6,4,4,8
15341,TheSimkin,,20,13,10,23
15342,zodirento,,33,3,7,10
15343,Hybird21,,18,13,4,17
15344,Khawaga,,18,1,1,2
15345,aburton,,13,46,82,128
15346,whiskeysquared,,19,35,82,117
15347,ppcpunk,,18,17,18,35
15348,Thorts,,13,1,3,4
15349,green_gums,,10,1,1,2
15350,danielroundy,,20,2,2,4
15351,jjcwalker,,10,6,1,7
15352,ihaveapuma,,18,3,4,7
15353,mleonhard,,20,12,24,36
15354,corvidae,,29,3,4,7
15355,Cpt_Winterbottom,,0,1,1,2
15356,mbracken,,10,3,1,4
15357,loginator,,19,16,30,46
15358,frozu,,32,17,2,19
15359,tchen3,,13,30,5,35
15360,A_Smooth,,43,2,4,6
15361,pponso1,,20,22,28,50
15362,mercere99,,10,5,5,10
15363,CRUISECONTROLFORCOOL,,18,1,1,2
15364,sgtpepper,,18,255,269,524
15365,Slices,,5,3,5,8
15366,andrewkantor,,0,9,1,10
15367,johnboyer,,19,30,44,74
15368,marrip,,20,1,1,2
15369,A_Moose,,13,1,1,2
15370,the_other,,19,1,5,6
15371,Fran,,32,111,160,271
15372,firsthander,,20,3,3,6
15373,r888888888,,20,3,2,5
15374,reditttroll,,34,7,8,15
15375,gedden,,43,4,6,10
15376,toussaint,,19,6,9,15
15377,suricatta79,,1,14,33,47
15378,CoconutPete,,19,30,32,62
15379,summary,,32,2,4,6
15380,WildYams,,12,40,57,97
15381,dhull,,20,18,2,20
15382,lamontredditthethird,,19,216,281,497
15383,turdpusher,,10,1,1,2
15384,peyton,,39,2,3,5
15385,awsaws,,1,4,7,11
15386,hilzfuld,,31,2,1,3
15387,race_traitor,,32,8,8,16
15388,reddit_user13,,19,1115,1940,3055
15389,veggiedog,,20,4,2,6
15390,aldenhg,,1,473,564,1037
15391,g27radio,,13,4,4,8
15392,BMeph,,20,2,6,8
15393,maple-syrup,,18,19,24,43
15394,Kanye_West,,6,1,1,2
15395,AlpT,,20,2,3,5
15396,vay,,13,2,1,3
15397,Courtie,,22,1,1,2
15398,Amdijefri,,34,110,30,140
15399,way_instain_mother,,26,1,3,4
15400,riotgrrl421,,31,1,5,6
15401,blingmaster,,34,4,3,7
15402,ifatree,,1,241,477,718
15403,myeye,,27,1,1,2
15404,Haga,,15,4,2,6
15405,isleshocky,,1,98,88,186
15406,jarvis400,,18,166,373,539
15407,mmac,,13,1,1,2
15408,vocoder,,42,3,1,4
15409,SnakeO,,1,23,19,42
15410,ogos,,13,1,2,3
15411,fusiat,,0,7,8,15
15412,math20,,19,11,10,21
15413,CyberSkull,,18,27,2,29
15414,thenewgray,,13,2,11,13
15415,freejack,,3,9,2,11
15416,oznob,,2,3,4,7
15417,youremyjuliet,,1,294,288,582
15418,BobII,,14,2,1,3
15419,emil-63,,5,1,1,2
15420,babybearishungry,,22,1,1,2
15421,sberan,,20,18,26,44
15422,c00pa,,43,5,3,8
15423,wiredfu,,18,3,11,14
15424,zed857,,5,101,107,208
15425,xdrone,,20,3,4,7
15426,univerio,,18,92,149,241
15427,chags,,1,36,96,132
15428,dzhezus,,32,36,73,109
15429,pierluc,,18,9,21,30
15430,tomchuk,,42,2,2,4
15431,spurton,,32,20,8,28
15432,paulydavis,,2,11,23,34
15433,BjornSlippy,,18,247,420,667
15434,voidv2,,34,1,2,3
15435,Chuck-Norris,,43,7,8,15
15436,barnaclebill,,19,3,4,7
15437,Urbatect,,31,128,271,399
15438,GrammarJew,,19,7,16,23
15439,obamawins,,31,7,4,11
15440,77or88,,18,1,1,2
15441,wccarrington,,20,21,20,41
15442,revicon,,41,2,2,4
15443,tbthomps,,3,57,33,90
15444,mystikraven,,15,6,10,16
15445,RightWing,,20,13,32,45
15446,LiberalHippies10,,32,10,8,18
15447,MikeRT,,10,11,12,23
15448,sarahsynonymous,,12,2,2,4
15449,Reso,,31,26,29,55
15450,ozmotion,,0,65,66,131
15451,AnarchoCapitalist,,19,51,49,100
15452,dacoatne,,18,31,6,37
15453,imaweirdo,,19,37,66,103
15454,AllLiquid,,43,25,39,64
15455,SonOfAJudge,,31,1,1,2
15456,kobyk,,20,5,1,6
15457,kingkilr,,20,504,681,1185
15458,Derelict,,18,9,9,18
15459,otakucode,,4,2283,3027,5310
15460,thunderbay-expat,,29,2,1,3
15461,JeromeB,,20,3,12,15
15462,qquicksilver,,18,269,307,576
15463,adjc,,31,1,1,2
15464,strangerzero,,13,63,152,215
15465,idynkydnk,,1,5,11,16
15466,zora,,34,1,2,3
15467,dent424,,34,19,4,23
15468,silent719,,42,7,4,11
15469,passwordiswordpass,,20,5,5,10
15470,Drebin,,12,1,1,2
15471,Wilfried,,19,1,1,2
15472,kazzyD,,19,130,15,145
15473,roadtripgirl,,19,1,5,6
15474,zeker,,42,59,40,99
15475,TeamZissou,,18,40,64,104
15476,quink,,20,270,341,611
15477,rmassart,,20,1,1,2
15478,Hufnagel,,42,52,81,133
15479,mdarnton,,13,9,7,16
15480,lowerdown,,0,188,207,395
15481,comety,,0,21,14,35
15482,Gunson,,18,16,1,17
15483,rankible,,13,1,1,2
15484,crckr,,20,1,1,2
15485,Rhomboid,,28,3,2,5
15486,pokerface,,31,4,9,13
15487,hanten,,13,2,1,3
15488,snarfy,,20,137,158,295
15489,opiii,,20,2,2,4
15490,pquoi,,13,8,4,12
15491,taner7812,,0,30,5,35
15492,penisland,,13,12,1,13
15493,ZachPruckowski,,13,16,22,38
15494,collintmiller,,19,2,2,4
15495,smeg_head,,34,2,4,6
15496,chiggeybean,,1,10,8,18
15497,Undermined,,1,6,6,12
15498,jarrodtrainque,,1,9,4,13
15499,schwann,,3,1,1,2
15500,sc71,,15,1,1,2
15501,gcalpo,,22,172,333,505
15502,reddista3,,20,1,2,3
15503,causticmango,,13,9,15,24
15504,Schpariel,,19,24,25,49
15505,vondelpark420,,34,7,5,12
15506,jvciv3,,34,32,50,82
15507,Whatsisname,,19,1,14,15
15508,binstock,,20,1,1,2
15509,gl0bals0j0urner,,39,9,21,30
15510,raresilk9,,13,136,206,342
15511,trigo,,0,1,2,3
15512,harmreduction,,13,1,1,2
15513,l1lll,,31,2,5,7
15514,facezappa,,18,17,7,24
15515,uptwolait,,18,16,61,77
15516,Tokugawa,,16,506,515,1021
15517,mastadonstomping,,20,3,5,8
15518,abaddon1125,,32,42,66,108
15519,ffi,,8,1,1,2
15520,uglor,,7,103,7,110
15521,eyespypro,,31,2,6,8
15522,TheOne11,,1,1,1,2
15523,slorenzo,,13,1,1,2
15524,thedeadparrot,,19,1,1,2
15525,eulogious,,13,1,3,4
15526,moonshn,,19,19,20,39
15527,regnadkcin,,34,2,6,8
15528,buckwilson,,34,15,28,43
15529,____,,20,16,30,46
15530,sw32,,5,8,10,18
15531,deterak1,,13,1,3,4
15532,mookst3r,,19,5,4,9
15533,spectrus,,4,6,2,8
15534,beatyatoit,,13,1,5,6
15535,rafuzo2,,19,463,577,1040
15536,nitram9,,19,3,2,5
15537,devicenull,,11,1,1,2
15538,DaRabidDuckie,,22,6,8,14
15539,superrationalist,,29,22,17,39
15540,reprobation,,39,1,4,5
15541,tylerdmace,,1,160,290,450
15542,timlol,,30,2,2,4
15543,quixote_arg,,20,3,2,5
15544,rascalnet,,13,1,1,2
15545,mega,,20,2,3,5
15546,The_If,,32,149,347,496
15547,paganize,,17,142,183,325
15548,dj3strikes,,13,67,1,68
15549,narr,,16,2,1,3
15550,ham1,,20,5,7,12
15551,Avantcore,,20,8,10,18
15552,littlebuddha2004,,13,427,17,444
15553,marmalito,,18,1,1,2
15554,outsiderplay,,43,128,24,152
15555,sportz103,,42,2,3,5
15556,wishninja,,19,2,1,3
15557,moginspace,,18,61,91,152
15558,BooshPilot,,13,2,3,5
15559,VersusGod,,34,10,13,23
15560,Epistemologist,,19,62,108,170
15561,sieb,,32,2,7,9
15562,inventor2010,,18,23,54,77
15563,banden,,13,2,4,6
15564,ansigt,,30,1,3,4
15565,cbg,,22,50,47,97
15566,pseale,,20,8,17,25
15567,drdan78,,32,1,2,3
15568,ryan101,,18,6,2,8
15569,senfood,,1,6,7,13
15570,fishpi,,16,5,2,7
15571,delta5,,29,1,1,2
15572,So_Fresh,,18,3,8,11
15573,bobbyi,,20,276,487,763
15574,AtomicCow,,1,1,2,3
15575,skulltula,,42,18,10,28
15576,NoYou,,12,32,15,47
15577,imbaczek,,20,223,323,546
15578,niktavalos,,1,63,102,165
15579,MaFibOsheth,,32,1,1,2
15580,cr0s1s,,5,2,2,4
15581,epdx,,13,66,130,196
15582,silent3,,9,2,3,5
15583,quoderat,,20,10,10,20
15584,ghotibait,,16,1,1,2
15585,osmenl,,18,1,1,2
15586,thoaCrl4,,20,1,3,4
15587,jimmyfreddy,,18,20,10,30
15588,FcukingThingSucks,,0,10,29,39
15589,youmissedthepoint,,20,24,32,56
15590,edzillion,,13,71,100,171
15591,okpgreg,,22,6,7,13
15592,inthefade,,32,4,7,11
15593,vanjulio,,20,4,12,16
15594,davidrools,,13,10,16,26
15595,dujek,,43,4,4,8
15596,assram,,30,24,13,37
15597,katto,,31,11,9,20
15598,funkytimes,,19,55,59,114
15599,cdny,,32,3,1,4
15600,mediumblack,,20,2,2,4
15601,interalia,,0,48,34,82
15602,FrenchPrince,,10,2,1,3
15603,antonjenkins,,30,4,4,8
15604,Nodatilu,,19,87,1,88
15605,MattJayP,,18,87,63,150
15606,murki,,18,14,17,31
15607,queerunity,,13,136,10,146
15608,canuckistani,,19,93,82,175
15609,andyeff,,32,14,4,18
15610,flanged,,39,2,1,3
15611,justsomedood,,20,82,71,153
15612,verifex,,3,34,34,68
15613,rayx,,18,273,130,403
15614,space1999,,1,149,150,299
15615,mig174,,13,313,348,661
15616,mshoe,,20,1,1,2
15617,AmosYoder,,18,23,21,44
15618,eton,,13,34,15,49
15619,megamiyawn,,1,7,7,14
15620,andrea-janine,,22,3,5,8
15621,holypumpkins,,1,9,5,14
15622,len69,,1,159,229,388
15623,LuxOFlux,,20,61,193,254
15624,usicafterglow,,32,72,19,91
15625,potatoe,,19,9,26,35
15626,PowerPill,,14,3,1,4
15627,jcolman,,34,70,36,106
15628,jmzachary,,6,7,4,11
15629,jawngee,,20,15,18,33
15630,TrollsSuck,,13,14,20,34
15631,TheKorn,,0,158,225,383
15632,polarbear2,,19,3,1,4
15633,NovaProspekt,,32,32,28,60
15634,bobdole,,20,2,1,3
15635,piratepanties,,6,6,10,16
15636,ratbear,,5,47,85,132
15637,njhbftd567yu,,5,2,1,3
15638,creysoft,,31,6,8,14
15639,flapcats,,18,15,31,46
15640,wooosh,,19,8,6,14
15641,rpeters,,8,2,3,5
15642,bumpinthosebeats,,5,5,4,9
15643,eugenianus,,10,3,4,7
15644,Karmaa,,29,41,6,47
15645,Briney_Spears,,19,18,25,43
15646,mr420,,9,107,159,266
15647,shmooth,,19,1,7,8
15648,policestateterrorism,,4,5,2,7
15649,bigandyuk,,19,4,1,5
15650,EvolutionTheory,,13,9,20,29
15651,kkks,,19,21,8,29
15652,marcog,,20,85,13,98
15653,michaeljsmalley,,5,32,46,78
15654,cairnsa,,19,1,1,2
15655,dansherman,,13,2,1,3
15656,annainpajamas,,31,1,1,2
15657,debbie_debater,,42,2,1,3
15658,japowl,,29,10,9,19
15659,frankichiro,,32,31,16,47
15660,cskaryd,,20,13,20,33
15661,yellowstuff,,20,87,81,168
15662,Guairdean,,13,2,2,4
15663,knappz,,13,36,77,113
15664,gumbril,,16,2,4,6
15665,WooHooFirst,,19,2,4,6
15666,obamabatmitsfa,,18,3,15,18
15667,whywhywhy,,0,33,67,100
15668,deadzebra,,18,31,6,37
15669,stringparts,,18,28,4,32
15670,08734152,,20,1,3,4
15671,colanderman,,20,36,51,87
15672,deafsound,,33,57,70,127
15673,thewupka,,12,9,4,13
15674,kreihst,,18,18,43,61
15675,nandemoari,,13,38,1,39
15676,ubermu,,31,27,35,62
15677,adremeaux,,42,768,905,1673
15678,handschristian,,7,7,6,13
15679,2_of_8,,18,54,59,113
15680,pastafaria,,19,83,141,224
15681,dillmunch3d,,5,60,135,195
15682,MrHaHaHaaaa,,19,23,55,78
15683,BELAZER,,18,6,22,28
15684,Eigard,,8,27,2,29
15685,mrwabu,,43,5,7,12
15686,synaestring,,0,27,49,76
15687,cunningjames,,20,209,269,478
15688,killian35,,18,2,9,11
15689,jimofwales,,18,32,17,49
15690,snakehunter17,,32,1,2,3
15691,lowtechmagazine,,31,1,1,2
15692,FadieZ,,18,45,67,112
15693,duhblow7,,34,242,380,622
15694,thoughto,,18,6,7,13
15695,LeftFairDotCom,,13,3,2,5
15696,Irioth,,13,5,6,11
15697,eungyu,,34,3,1,4
15698,Cereo,,15,9,11,20
15699,jamesatracy,,32,152,25,177
15700,Homeoftheben,,20,2,2,4
15701,horseloverfat,,30,78,47,125
15702,RedditIsAnInsideJob,,13,4,2,6
15703,BetiBeti,,1,1,2,3
15704,schleppy,,23,7,9,16
15705,IamBatman,,42,1,1,2
15706,rontothelight,,0,1,1,2
15707,jeremyis,,13,5,2,7
15708,HiyooyiH,,22,13,27,40
15709,gavtar,,32,4,7,11
15710,knomknomknom,,34,1,1,2
15711,mightychicken,,1,21,22,43
15712,chall85,,0,752,444,1196
15713,politicalfan08,,13,21,2,23
15714,muttleee,,19,59,28,87
15715,l0lwut,,32,3,10,13
15716,RuarriS,,4,11,14,25
15717,vardyr,,30,14,23,37
15718,johndango,,34,84,56,140
15719,dudeznothappy,,13,5,3,8
15720,joefukinsixpack,,13,19,31,50
15721,nickesson,,18,137,131,268
15722,davidcrookes,,6,1,1,2
15723,lolkittah,,19,3,9,12
15724,ibetstewarthasabigD,,16,1,1,2
15725,lan3y,,26,1,2,3
15726,mathmojo,,13,6,6,12
15727,rabidlizzy,,1,6,9,15
15728,matthendrix,,15,43,48,91
15729,ilikesboobs,,28,10,7,17
15730,RubyisRails,,0,41,47,88
15731,Tobicles,,22,20,52,72
15732,sciolizer,,20,118,90,208
15733,hwaara,,18,1,2,3
15734,blatta,,20,2,1,3
15735,zizzerzazus,,18,3,11,14
15736,ihateyouall,,29,4,6,10
15737,dogwatchinghdtv,,14,12,18,30
15738,habitue,,20,14,17,31
15739,ManaSmoker,,0,209,201,410
15740,edgan,,43,1,2,3
15741,trenchy,,0,6,3,9
15742,ConfuciusDamnIt,,0,1,1,2
15743,dantaeos,,1,1,3,4
15744,finalcut,,32,35,53,88
15745,rkalajian,,1,3,2,5
15746,ReligiousTurd,,34,6,26,32
15747,dougfelt,,10,1,1,2
15748,terrilldent,,42,1,2,3
15749,gnz,,22,7,20,27
15750,bricksandwind0ws,,43,23,49,72
15751,ofimmsl,,4,4,4,8
15752,heretikdclxvi,,19,1,1,2
15753,amerikaisfrii,,19,1,1,2
15754,tangled,,8,524,548,1072
15755,futatorius,,13,152,289,441
15756,settrans,,20,15,16,31
15757,sjraptor,,20,2,3,5
15758,sckpppt,,27,1,1,2
15759,NewAurora,,13,3,7,10
15760,OryTheSaint,,42,2,7,9
15761,d_lay123,,8,66,95,161
15762,signalfirerock,,7,1,1,2
15763,fredgrigg,,1,3,5,8
15764,residentwork,,18,11,30,41
15765,cozzyd,,20,9,16,25
15766,mdg09,,13,22,1,23
15767,franksands,,18,3,5,8
15768,dse,,20,38,37,75
15769,thethb,,1,1,1,2
15770,azanar,,20,14,19,33
15771,Lhall2008,,17,1,1,2
15772,F_C,,20,15,14,29
15773,gnome94,,13,114,28,142
15774,ziv_TA,,34,15,20,35
15775,CAPTAlN_OBVIOUS,,22,82,117,199
15776,ChickenFriedTroll,,19,31,41,72
15777,Kelvin,,32,11,32,43
15778,iq9,,34,13,9,22
15779,abenton,,31,1,1,2
15780,canthony,,20,26,19,45
15781,Dyken,,14,1,2,3
15782,passwordispassword1,,34,1,3,4
15783,keithobambertman,,18,43,38,81
15784,strentax,,34,109,99,208
15785,johnry07,,6,38,39,77
15786,remiserg,,22,1,1,2
15787,windynights,,30,850,1159,2009
15788,MrSane,,20,3,10,13
15789,Korben82,,18,30,53,83
15790,DyceFreak,,7,6,10,16
15791,lowlyGiant,,29,3,1,4
15792,weezierocks,,43,1,2,3
15793,shepheb,,20,1,1,2
15794,cthouse13,,19,7,2,9
15795,jwstaddo2,,20,23,16,39
15796,gina_g,,1,3,1,4
15797,loadmoarcomments,,14,1,3,4
15798,9jack9,,20,469,368,837
15799,keyj63,,29,46,9,55
15800,LASERGangsta,,5,3,5,8
15801,acegibson,,13,107,190,297
15802,NineDeuce,,32,3,5,8
15803,josephmotha,,20,2,5,7
15804,dimacq,,13,12,6,18
15805,Iconical,,4,1,3,4
15806,adjei7,,5,108,79,187
15807,timshead,,34,41,18,59
15808,Dinkerdoo,,12,1,5,6
15809,Ugly_Pete,,0,7,8,15
15810,frasoftw,,22,29,59,88
15811,unperson,,34,1,2,3
15812,dicey,,4,694,620,1314
15813,savagecat,,20,130,273,403
15814,creativeembassy,,1,43,24,67
15815,uvdiv,,20,2,2,4
15816,charloBravie,,19,7,12,19
15817,RCDL,,16,12,3,15
15818,odoylerulez,,6,2,2,4
15819,cheska21,,19,3,1,4
15820,Brochtrup,,13,162,8,170
15821,doken,,20,6,7,13
15822,mcdg,,31,112,201,313
15823,buu700,,20,359,565,924
15824,tomakin1217,,13,1,2,3
15825,MarquisdeBad,,8,141,176,317
15826,gentlemen,,18,18,20,38
15827,freefood,,1,3,5,8
15828,katerose26,,34,559,124,683
15829,mgalvin,,22,59,70,129
15830,piracy,,1,14,12,26
15831,Phranqlin,,31,31,20,51
15832,adambrewster,,20,11,6,17
15833,cookier35,,32,1,1,2
15834,paja1954,,32,1,1,2
15835,d0k,,20,1,4,5
15836,p1dbull,,30,22,32,54
15837,ameancupoftea,,29,2,5,7
15838,namemanresu,,19,12,16,28
15839,themoshez,,20,33,6,39
15840,Johnny_Weeks,,31,1,1,2
15841,barsae,,20,1,6,7
15842,nothingWrong,,10,1,1,2
15843,p1r4nh4,,20,39,23,62
15844,chiaolun,,22,8,13,21
15845,ReallyStoned,,22,4,1,5
15846,JimmyLeach,,1,14,1,15
15847,albinoth,,4,1,2,3
15848,jewbacca,,30,16,6,22
15849,ymagynatyf,,31,1,3,4
15850,cct,,31,14,9,23
15851,a_calder,,31,1,1,2
15852,caspper69,,13,1,1,2
15853,dosed,,43,46,74,120
15854,albinofrenchy,,4,318,397,715
15855,mrnoir,,43,16,15,31
15856,NoIWillNot,,19,4,40,44
15857,skydaddy,,19,9,8,17
15858,madenvoy,,18,29,41,70
15859,spud438,,19,107,7,114
15860,stelriah,,0,9,16,25
15861,fidoburger,,32,2,10,12
15862,Trendy2,,42,8,10,18
15863,GlennLThompson,,12,1,3,4
15864,cheebmonger,,31,50,22,72
15865,REBELinBLUE,,31,13,14,27
15866,limpet,,19,8,23,31
15867,slowdive,,19,508,13,521
15868,vintagegatos,,13,1,1,2
15869,Deniol,,23,26,1,27
15870,PlenoJure,,22,2,2,4
15871,gandhiofdoom,,43,10,16,26
15872,jrohila,,31,147,145,292
15873,Chr1831,,9,3,5,8
15874,skyshock21,,18,66,126,192
15875,schoolhard,,18,7,7,14
15876,canadianking,,18,1,13,14
15877,Xineph,,15,1,2,3
15878,astrocry,,20,1,2,3
15879,shekmalhen,,20,69,121,190
15880,sherina,,5,22,5,27
15881,x-cubed,,42,3,4,7
15882,dustinbrewer,,0,32,6,38
15883,altano,,20,45,26,71
15884,Emarpi,,32,1,3,4
15885,tylerni7,,3,20,20,40
15886,myared,,13,6,3,9
15887,dzitam,,19,4,2,6
15888,fbru02,,20,63,61,124
15889,mschaef,,20,322,519,841
15890,Jody_Imus_Rules,,14,1,1,2
15891,dontforgetcarlos,,19,1,1,2
15892,beero,,30,170,258,428
15893,harm064,,0,6,19,25
15894,delrinian,,32,7,2,9
15895,digiphaze,,13,95,122,217
15896,BlackSquirrel,,0,215,274,489
15897,almery,,20,2,3,5
15898,_Pedobear_,,1,2,1,3
15899,daerana,,19,2,4,6
15900,lesbiatopia,,42,3,1,4
15901,flandersuea,,20,1,2,3
15902,Tal71,,5,1,2,3
15903,msheyw37,,0,36,46,82
15904,DiarrheaMonkey,,13,155,351,506
15905,abdelazer,,20,13,24,37
15906,88p,,34,19,16,35
15907,Junckaroo,,1,21,45,66
15908,predigested,,41,7,3,10
15909,GaxLover,,1,3,7,10
15910,GenericUserName,,31,39,31,70
15911,defacedcreation,,43,16,3,19
15912,Daleo,,18,19,38,57
15913,ohno,,19,270,383,653
15914,mightybyte,,20,30,5,35
15915,ozziegt,,13,37,29,66
15916,pursatrat,,1,11,13,24
15917,dchurch0,,6,4,2,6
15918,unsigned,,12,77,37,114
15919,uninformative,,42,1,1,2
15920,robinthehood,,0,291,394,685
15921,astrallab,,34,1,1,2
15922,RedHawk,,29,1,2,3
15923,snargle,,19,3,9,12
15924,OhReelee,,13,1,1,2
15925,raustin,,20,7,7,14
15926,elbagerena,,13,3,1,4
15927,voracious_id,,13,1,4,5
15928,Imbob,,34,2,7,9
15929,brelson,,18,28,19,47
15930,Aanidaani,,32,3,4,7
15931,carc,,13,28,22,50
15932,chrishan,,20,1,2,3
15933,lolcat_scratch_fever,,0,5,2,7
15934,dogster,,19,9,1,10
15935,cryptid,,1,463,8,471
15936,DocBaker69,,18,18,27,45
15937,rek,,7,527,792,1319
15938,bms42,,32,21,19,40
15939,sambeatty,,32,4,3,7
15940,girlxgenius,,19,33,77,110
15941,BryceW,,18,16,27,43
15942,freeradical97,,19,54,81,135
15943,55ten,,3,48,13,61
15944,agnokapathetic,,20,26,37,63
15945,Smock511,,18,6,2,8
15946,bhagany,,20,200,288,488
15947,friism,,20,5,1,6
15948,tophatstuff,,20,121,146,267
15949,margeriedrinkwater,,31,1,5,6
15950,Haggismaximus,,18,15,8,23
15951,absconditus,,19,26,35,61
15952,jkga,,6,16,8,24
15953,dabombnl,,18,66,124,190
15954,ichor,,39,10,13,23
15955,simplekismet,,17,4,3,7
15956,ericsink,,20,23,14,37
15957,lolmancologne,,18,3,9,12
15958,ultramega,,43,1,1,2
15959,ahdn,,1,7,14,21
15960,gordonlovesgordon,,1,18,26,44
15961,xhandler,,32,86,123,209
15962,trevordtodd,,7,2,1,3
15963,jayktar,,36,1,3,4
15964,JackPlant,,6,1,1,2
15965,arrowoftime,,18,232,163,395
15966,pacifiedcitizen,,22,7,18,25
15967,waffleninja,,19,205,345,550
15968,kawarazu,,1,40,48,88
15969,kromlic,,22,171,278,449
15970,TheMiddle,,30,3,8,11
15971,petrochrist,,22,28,5,33
15972,Lobosch,,12,4,6,10
15973,Ludovico,,31,2,5,7
15974,adam_von_indypants,,1,13,13,26
15975,somazx,,13,22,39,61
15976,brash,,13,8,8,16
15977,andykcom,,13,14,4,18
15978,LisPark,,22,7,1,8
15979,donio,,20,25,29,54
15980,Kafteinn,,34,1,1,2
15981,squashai,,43,140,97,237
15982,mindependent,,8,2,4,6
15983,dwwatk01,,20,16,15,31
15984,SlowDown,,18,4,4,8
15985,vexeffect,,20,17,24,41
15986,ZildjianLudwig,,13,24,3,27
15987,Nietecht,,11,4,4,8
15988,maydayusa,,13,4,31,35
15989,BrainTwinkey,,13,52,4,56
15990,sypavion,,36,1,1,2
15991,feckya,,13,6,3,9
15992,snowforts,,18,2,3,5
15993,PopeRalphIV,,18,7,10,17
15994,greggh,,18,1,1,2
15995,firemillen2,,18,10,5,15
15996,TheGrammarCommie,,22,1,1,2
15997,lowrentkicker,,33,1,4,5
15998,tjskydive,,13,39,31,70
15999,misterlang,,14,9,12,21
16000,anon_troll,,19,4,3,7
16001,camotito,,18,16,21,37
16002,excite_bike,,8,1,2,3
16003,sgclarke,,22,2,1,3
16004,dazmax,,18,57,55,112
16005,marley88,,32,16,4,20
16006,Shaman666,,13,25,63,88
16007,wolfos,,0,13,11,24
16008,rubicon_crossed,,23,2,3,5
16009,seafowl,,20,1,1,2
16010,dasstrooper,,42,480,722,1202
16011,lucidguru,,5,111,34,145
16012,mrdevin,,27,1,1,2
16013,davemcdave,,42,1,1,2
16014,maaz,,12,494,223,717
16015,ecombatant,,13,15,8,23
16016,robert2734,,31,4,15,19
16017,kangas,,31,1,1,2
16018,onisamsha,,15,2,1,3
16019,tttppp,,19,1,2,3
16020,get_a_brain_moran,,20,3,3,6
16021,mikerouse,,19,1,3,4
16022,lhmathys,,13,7,5,12
16023,jcypher,,19,8,10,18
16024,CamelTap,,18,116,8,124
16025,chikkensoop,,8,2,3,5
16026,pliu22,,22,29,28,57
16027,opix,,31,1,1,2
16028,retired_raganwald,,20,4,2,6
16029,herval,,20,2,1,3
16030,BigDumbMoron,,31,7,2,9
16031,RichardPeterJohnson,,22,552,796,1348
16032,JonFugeEverybody,,19,50,52,102
16033,angry_guy,,3,3,8,11
16034,MeanFoo,,0,7,19,26
16035,bigdadro,,29,2,1,3
16036,male_salmon,,26,5,3,8
16037,MrTibbs,,9,2,1,3
16038,questionmark,,19,351,400,751
16039,yeahyeahyeahyeah,,6,97,198,295
16040,waful,,1,26,58,84
16041,Trogdor66,,13,3,3,6
16042,fandiddy,,34,1,1,2
16043,JoKerHill,,8,26,9,35
16044,cedars,,29,16,25,41
16045,sosoez,,19,129,95,224
16046,CyphirX,,18,11,31,42
16047,falc0n2600,,1,20,3,23
16048,Stabback,,30,95,113,208
16049,shadowplay,,20,1,5,6
16050,wilsonics,,13,1,5,6
16051,dangerfan,,0,10,7,17
16052,LordHelmet,,1,7,5,12
16053,GiveYouBadPun,,43,6,26,32
16054,eoinmadden,,22,61,73,134
16055,billy24,,19,2,1,3
16056,jessiecafe,,16,2,1,3
16057,chochazel,,19,11,14,25
16058,asamorris,,18,21,41,62
16059,evrosl,,6,32,29,61
16060,OldBoots,,18,1,5,6
16061,draketherake,,18,28,5,33
16062,cjlesh,,20,2,2,4
16063,mwcraig,,31,4,2,6
16064,mikepaco,,34,71,106,177
16065,williamsburgnerd,,30,7,4,11
16066,emn13,,20,1,1,2
16067,ttyy,,1,15,19,34
16068,eelaws,,18,222,233,455
16069,newspower,,18,2,2,4
16070,JoeCracker,,0,22,43,65
16071,flatlander30,,33,18,14,32
16072,dcrapier,,6,1,2,3
16073,paulshannon,,18,98,63,161
16074,Gormogon,,32,9,21,30
16075,OminousG,,20,2,1,3
16076,DrDooom,,43,1,1,2
16077,jedankitty,,34,64,7,71
16078,simon1,,20,7,9,16
16079,6degreesbranding,,31,2,1,3
16080,clearly,,15,27,20,47
16081,reallifepixel,,18,278,126,404
16082,Obama_Why_No_Flagpin,,31,18,28,46
16083,Bascome,,31,188,264,452
16084,m741,,42,3,4,7
16085,brio1337,,22,11,8,19
16086,thires,,20,4,5,9
16087,allstar22,,18,403,51,454
16088,tygergolf,,6,7,7,14
16089,peacebob,,43,616,36,652
16090,intranets,,20,1,1,2
16091,ddipaolo,,20,40,39,79
16092,gh0st32,,34,257,290,547
16093,periwinkles,,22,3,4,7
16094,olshfski,,1,13,13,26
16095,optimis344,,31,9,10,19
16096,marks1,,31,1,1,2
16097,kunia,,42,1,1,2
16098,falingodingo,,1,1,5,6
16099,besonen,,20,3,3,6
16100,bigbengb,,30,13,7,20
16101,TimmyCracKorn,,43,111,2,113
16102,sleepy_emoticon,,37,1,1,2
16103,cirra,,22,3,7,10
16104,shentou,,20,2,1,3
16105,esquire_rsa,,0,96,122,218
16106,ririd,,31,5,7,12
16107,bsiviglia9,,19,868,1300,2168
16108,Selenolycus,,23,72,72,144
16109,Daemoncoder,,30,4,7,11
16110,caudicus,,19,13,4,17
16111,badbadman2,,18,246,228,474
16112,o0bluewater0o,,18,33,47,80
16113,nubesauce,,1,2,1,3
16114,davorg,,20,4,3,7
16115,dacjames,,32,1,1,2
16116,StupidObamaSupporter,,19,1,2,3
16117,Magical_Trevor,,1,22,34,56
16118,michdoch,,11,3,3,6
16119,Wewento,,18,12,14,26
16120,arturo227,,20,28,34,62
16121,randy9876,,13,291,391,682
16122,dingleberry_gary,,13,41,48,89
16123,nubi78,,18,30,26,56
16124,PateraSilk,,42,3,5,8
16125,dmunro,,34,8,2,10
16126,Vaerok,,42,25,17,42
16127,jackson8,,18,4,2,6
16128,ellingthepirate,,18,6,15,21
16129,lemonjello,,13,11,15,26
16130,QWERTYmustDie,,20,3,1,4
16131,newtonic83,,18,3,21,24
16132,The_Oblivious,,10,1,1,2
16133,rstevenson,,34,82,8,90
16134,LordyLordyGeordie,,22,23,7,30
16135,joshwoodward,,23,3,3,6
16136,xfiles,,43,1,3,4
16137,mastercockblocker,,18,4,3,7
16138,maatc,,43,1,1,2
16139,stoertebeker,,19,29,44,73
16140,gdienahrt,,13,67,2,69
16141,aaronp,,20,15,4,19
16142,cyanobyte,,19,8,5,13
16143,hilaricat,,42,1,2,3
16144,ander501,,20,2,2,4
16145,sleming,,19,3,8,11
16146,Redivivus,,1,1,6,7
16147,Kibatsu,,5,12,9,21
16148,euphoria,,20,2,3,5
16149,dfaskflhaiu234ry89er,,19,4,14,18
16150,ataraxian,,20,17,14,31
16151,Shrill,,22,1,2,3
16152,solstice680,,13,7,12,19
16153,flostre,,32,68,108,176
16154,XanKiran,,32,1,2,3
16155,bmathieu,,18,18,1,19
16156,wheeloofah,,1,119,170,289
16157,sema4,,20,1,1,2
16158,dodicula,,13,79,124,203
16159,Skavenblight,,30,249,248,497
16160,CraigTorso,,31,285,451,736
16161,PermanentDamage,,1,3,4,7
16162,mykezebb,,1,10,1,11
16163,killyourfm,,42,6,4,10
16164,SpicyTacos,,13,77,122,199
16165,jamesallen74,,0,295,174,469
16166,acinonys,,20,6,15,21
16167,oceanographer,,5,8,20,28
16168,ninex,,13,1,1,2
16169,wizbor,,31,38,43,81
16170,stegodone,,18,1,5,6
16171,davehansen,,13,4,10,14
16172,astromanbearpig,,29,1,1,2
16173,patrician,,19,3,2,5
16174,adfdsfas,,18,1,1,2
16175,redhatcat,,20,15,34,49
16176,shaft0rz,,13,10,16,26
16177,dukephoenix,,18,4,15,19
16178,9398348,,21,2,1,3
16179,fallingbrick,,1,1,4,5
16180,hotredditaction,,1,95,90,185
16181,sigh,,32,49,55,104
16182,Asekigal,,32,1,2,3
16183,junaman,,2,17,7,24
16184,urlwolf,,20,5,3,8
16185,hopeless_case,,31,170,287,457
16186,f00sion,,18,23,33,56
16187,vahan,,8,2,1,3
16188,tkdguy,,22,18,27,45
16189,bink821,,31,41,66,107
16190,mismetti,,18,93,198,291
16191,froderick,,32,860,1213,2073
16192,conan08,,6,2,1,3
16193,eheller,,13,1,1,2
16194,iPood,,1,2,2,4
16195,incalcitrant,,12,5,13,18
16196,ericN,,19,70,97,167
16197,diggit08,,18,83,5,88
16198,stedwick,,20,35,24,59
16199,jcorkern,,6,468,358,826
16200,pmill001,,35,3,1,4
16201,n8shac78,,18,11,10,21
16202,dthompsn,,19,2,3,5
16203,sikosmurf,,43,3,4,7
16204,kogus,,43,91,63,154
16205,AM088,,18,111,167,278
16206,ejt,,1,1,1,2
16207,heath_ledger,,43,13,12,25
16208,damg,,20,212,133,345
16209,unkleman,,19,17,50,67
16210,lisak,,27,4,8,12
16211,CUNexTuesday,,18,151,222,373
16212,oilmonkey,,43,6,2,8
16213,jeepdays,,18,4,12,16
16214,greenion,,13,3,5,8
16215,digindrivefast,,13,7,32,39
16216,srgntpoliteness,,5,14,20,34
16217,Bzzt,,1,21,53,74
16218,GLneo,,1,42,64,106
16219,brienf18,,18,27,31,58
16220,greatgrandpa,,30,1,1,2
16221,Mikeybarnes,,29,9,19,28
16222,vatavr,,0,6,8,14
16223,matthiasB,,20,51,84,135
16224,doteedoot,,4,1,1,2
16225,skitzy,,20,1,7,8
16226,GreenSmithC,,34,20,13,33
16227,initself,,43,88,86,174
16228,kanuk877,,29,5,11,16
16229,t0r,,35,7,2,9
16230,vheissu1974,,19,19,4,23
16231,factgirl,,22,9,1,10
16232,iWasMolested,,0,1,1,2
16233,vesci,,1,1,2,3
16234,bluetahoe99,,18,30,3,33
16235,talkingwires,,18,32,67,99
16236,tripclaw,,18,34,72,106
16237,molbio,,8,29,33,62
16238,supersurfer,,13,26,15,41
16239,kishoba,,19,6,7,13
16240,elbekko,,20,3,14,17
16241,jiaco,,18,135,269,404
16242,G_Morgan,,20,909,1373,2282
16243,charltones,,20,16,20,36
16244,EnosDrawkCabeht,,6,5,9,14
16245,BradBlog,,13,109,10,119
16246,sinkface,,33,9,13,22
16247,godsfire,,34,2,2,4
16248,WG55,,29,204,255,459
16249,TheNoxx,,34,494,478,972
16250,frankzappa,,20,6,10,16
16251,9ner,,20,101,270,371
16252,wegoin2sizzla,,18,7,8,15
16253,redveg,,13,9,16,25
16254,emptyhead75,,20,8,9,17
16255,reisyboy,,14,6,7,13
16256,Sir_Isaac_Brock,,30,113,287,400
16257,Kosko,,0,4,8,12
16258,pielud,,19,3,3,6
16259,rexraygun,,39,2,4,6
16260,nman,,32,5,17,22
16261,r_u_stupid2,,28,3,2,5
16262,mosha48,,20,76,149,225
16263,semanticart,,31,3,8,11
16264,anatinus,,29,143,277,420
16265,MarlonBain,,36,1294,1563,2857
16266,snnmnd,,6,2,5,7
16267,DaveyC,,1,45,67,112
16268,demonofthefall,,0,33,64,97
16269,fisheye1999,,21,2,4,6
16270,stevedrew,,18,22,10,32
16271,st3fan,,20,2,1,3
16272,jaymill,,19,3,3,6
16273,yoss86,,22,2,4,6
16274,Mystae,,31,3,7,10
16275,JosephSmithOverdrive,,13,1,3,4
16276,jankphil,,18,1,2,3
16277,snahor,,20,3,2,5
16278,Nitron,,20,31,53,84
16279,mhermans,,20,28,30,58
16280,aitzim,,4,9,18,27
16281,Jeff_Albertson,,9,39,73,112
16282,ellrjay,,1,3,10,13
16283,psyklohps,,34,15,19,34
16284,h00dwink,,19,24,39,63
16285,crucifer,,29,2,4,6
16286,rakantae,,18,92,111,203
16287,slana,,13,2,3,5
16288,gtoal,,20,1,1,2
16289,dust_that_moves,,14,1,1,2
16290,huronbikes,,22,2,7,9
16291,deflective,,18,88,144,232
16292,zentsunami,,13,66,148,214
16293,mr_qwerty,,1,5,4,9
16294,toogy,,31,2,3,5
16295,The_Funny,,40,96,112,208
16296,natehamilton82,,32,1,1,2
16297,avenue22,,4,1,1,2
16298,JBecerra,,8,7,7,14
16299,MrBabyMan,,12,1,2,3
16300,LRonPaultard1,,19,4,20,24
16301,RickyGervais,,11,1,1,2
16302,ninjawarrior,,18,54,6,60
16303,highd,,0,19,28,47
16304,redkamel,,5,1,1,2
16305,lowfat,,30,4,11,15
16306,wearebeingliedto,,30,3,1,4
16307,zandi,,1,2,4,6
16308,benjc,,1,19,2,21
16309,monkeyjoebla,,22,1,1,2
16310,thelilacgirl,,13,2,12,14
16311,cknipe,,32,20,22,42
16312,Blammo,,31,8,4,12
16313,akamakavely,,5,23,2,25
16314,MichaelGScott,,0,1,3,4
16315,aychberg,,43,34,6,40
16316,zachm,,43,70,66,136
16317,mac_hater,,20,1,1,2
16318,tomato00,,19,1,1,2
16319,mogrify,,19,28,13,41
16320,amscadding,,43,1,1,2
16321,ChiefWanker,,13,9,5,14
16322,rnayden,,20,11,1,12
16323,sofal,,20,59,93,152
16324,wpfeffer,,35,1,2,3
16325,frotorious,,10,3,7,10
16326,Blisslyke,,13,91,66,157
16327,Hemiptera,,20,4,14,18
16328,RKom,,34,4,4,8
16329,OhCobblers,,20,162,1,163
16330,jdunck,,20,37,49,86
16331,projectpaul,,13,2,1,3
16332,AllForChange,,13,223,135,358
16333,imkwtrz0r,,32,5,14,19
16334,kolloid,,20,17,8,25
16335,stevecooper,,20,9,6,15
16336,crazybones,,6,1316,835,2151
16337,djaltitude,,18,9,8,17
16338,tys022,,0,1,1,2
16339,Shutterbug,,18,17,15,32
16340,dwliving,,31,2,2,4
16341,marathi_mulgaa,,32,12,15,27
16342,xiorlanth,,20,36,79,115
16343,shabonkerz,,33,4,5,9
16344,lwgoodman,,19,7,11,18
16345,MSC,,14,1,1,2
16346,dr_gonzo,,19,89,30,119
16347,jj_williams08,,0,8,3,11
16348,stoptypingnow,,43,2,4,6
16349,doktaru,,20,27,21,48
16350,selfprodigy,,5,2,2,4
16351,werebear,,13,18,20,38
16352,soillife,,1,6,8,14
16353,iceplanethoth,,5,1,2,3
16354,bythewar,,13,12,14,26
16355,sirbarrums,,30,2,1,3
16356,the1pato,,19,64,35,99
16357,kefeer,,20,6,16,22
16358,rooskie,,27,31,9,40
16359,nmrk,,15,198,209,407
16360,Celsius233,,34,38,46,84
16361,katqanna,,19,1,2,3
16362,kryx,,6,3,1,4
16363,Macchu,,31,15,11,26
16364,obixx,,23,2,3,5
16365,timbro1,,42,136,183,319
16366,badassumption,,19,209,165,374
16367,rengeek,,18,29,22,51
16368,Tickthokk,,1,5,14,19
16369,the_unbroken_broken,,18,1,5,6
16370,novamortis,,1,25,44,69
16371,LordofMelancholy,,4,26,21,47
16372,trekman,,21,93,17,110
16373,solly_cardy,,13,3,1,4
16374,plorelle,,1,49,100,149
16375,sportsman1000,,18,1,2,3
16376,xuhu,,20,43,48,91
16377,Un_Suppressed,,19,78,94,172
16378,karamorf,,31,26,32,58
16379,dolbydog,,1,5,5,10
16380,bradtwo,,0,1,1,2
16381,driftdesigns,,31,4,8,12
16382,BlackGlass,,34,25,34,59
16383,zargon1978,,13,9,11,20
16384,infinitysnake,,1,83,206,289
16385,evabungle,,13,24,58,82
16386,HeDiBo,,20,3,1,4
16387,Rocky22,,34,27,68,95
16388,Hoodlum,,1,2,1,3
16389,werepika,,11,21,33,54
16390,TH3_Dude,,19,83,204,287
16391,peter_wiggins,,1,8,6,14
16392,changeocracy,,13,1,1,2
16393,hxcldy,,20,1,2,3
16394,croooner,,2,3,4,7
16395,bigdog05,,34,1,1,2
16396,neror,,0,56,2,58
16397,magic6435,,32,6,10,16
16398,gtranbot,,29,48,75,123
16399,wisp,,31,11,12,23
16400,seanzer,,29,9,28,37
16401,innerspirit,,43,185,162,347
16402,lhp,,6,5,2,7
16403,larryni,,20,9,3,12
16404,Delmarc,,18,19,31,50
16405,xpatkat,,5,1,1,2
16406,abennett,,18,26,51,77
16407,jasoncollin,,29,2,3,5
16408,petrograd,,17,3,3,6
16409,speedwagin,,31,12,2,14
16410,beedee,,20,22,46,68
16411,petuniapredator,,34,16,17,33
16412,dblyth,,19,8,2,10
16413,Kattana,,42,11,29,40
16414,deepthot42,,32,78,180,258
16415,damovisa,,1,7,3,10
16416,brownsauce,,18,8,2,10
16417,lattepiu,,20,25,13,38
16418,threetimepostaccount,,4,5,3,8
16419,Wiggles2,,19,1,2,3
16420,mcavoybn,,15,1,1,2
16421,flava_flav,,34,9,12,21
16422,salkhan,,31,5,6,11
16423,bigbigdolphin,,13,3,2,5
16424,fleaflicker51,,18,12,5,17
16425,sarhoshamiral,,5,1,1,2
16426,latkahgravis,,18,1,9,10
16427,cynicizm,,18,72,95,167
16428,chickenontop,,13,2,1,3
16429,gimpy21,,31,7,7,14
16430,camlllama,,20,1,1,2
16431,lebonzo,,18,2,5,7
16432,benyaminshoham,,18,15,3,18
16433,bobby999,,13,3,6,9
16434,paternoster,,12,340,643,983
16435,gmonkey1972,,38,1,1,2
16436,joebert72,,13,2,2,4
16437,Som12H8,,1,4,8,12
16438,irrationalpie,,13,1,4,5
16439,Zero1328,,6,1,2,3
16440,robywar,,19,366,565,931
16441,avecfrites,,31,7,10,17
16442,POLAR_BEAR,,1,6,7,13
16443,capt_awesome,,34,9,11,20
16444,gen3ric,,5,1,2,3
16445,zscheidt,,5,1,2,3
16446,SLAUTCAANS,,19,605,1066,1671
16447,stormboy,,1,12,30,42
16448,LWRellim,,13,195,245,440
16449,midge,,9,55,115,170
16450,ctp6360,,22,5,7,12
16451,grungefan,,14,1,3,4
16452,prayerforengland,,16,24,25,49
16453,texodus,,20,2,1,3
16454,CommentRevealer,,20,3,5,8
16455,devvie,,20,55,85,140
16456,itwasntmenana,,13,76,171,247
16457,arkool,,32,102,100,202
16458,vonoy,,8,17,38,55
16459,mejaredme1,,5,1,1,2
16460,equal,,34,8,1,9
16461,plaguey,,31,4,8,12
16462,bobcat,,36,2958,1797,4755
16463,bitshifter,,30,39,36,75
16464,MrDowntown,,1,20,21,41
16465,fukkndog,,20,1,1,2
16466,Flatline_hun,,19,20,52,72
16467,josh8227,,36,5,6,11
16468,gayniggerfetus,,8,1,1,2
16469,billbillbilly,,22,20,33,53
16470,rks404,,20,7,10,17
16471,misterswarvey,,36,2,3,5
16472,userreddit,,1,56,48,104
16473,Afro-Ninja,,13,3,3,6
16474,Fishy_McFish,,34,110,238,348
16475,wilberforce,,20,10,12,22
16476,zapdos,,19,12,4,16
16477,Spanners,,11,2,6,8
16478,afreddy87,,13,2,1,3
16479,musikal1,,17,1,1,2
16480,gmax,,18,1,3,4
16481,fuzzyfuzz,,22,15,13,28
16482,Unbathed,,20,9,10,19
16483,locolan,,22,23,47,70
16484,OpticsFiber,,34,12,22,34
16485,alanbrunsdon,,21,71,101,172
16486,therp,,20,1,1,2
16487,tortito,,19,2,3,5
16488,Flower2112,,19,136,272,408
16489,notzach,,1,5,3,8
16490,surlymcbastard,,12,12,16,28
16491,lpslogan,,17,14,4,18
16492,szopa,,20,8,7,15
16493,forkula,,19,7,1,8
16494,monximus,,32,5,11,16
16495,sghe,,20,1,2,3
16496,nadnate,,1,3,5,8
16497,armchaircritic,,20,2,5,7
16498,mknight44,,42,33,26,59
16499,jashsu,,12,2,2,4
16500,BetterWorld,,31,2,1,3
16501,tmiya,,41,1,1,2
16502,topsyturvy,,18,7,12,19
16503,theoppositeofleft,,33,3,2,5
16504,GrnLight,,8,1,1,2
16505,ellimayhem,,18,53,140,193
16506,matt7718,,16,1,1,2
16507,MrXfromPlanetX,,13,48,43,91
16508,billorites,,19,69,74,143
16509,supersloth666,,43,1,1,2
16510,fap2loli,,43,3,3,6
16511,leemy,,16,150,174,324
16512,Satook2,,20,5,5,10
16513,ARABS_DID_911,,31,14,24,38
16514,dkbaehr,,28,2,3,5
16515,Slattz,,32,1,2,3
16516,johnbentley,,32,48,101,149
16517,random5820350235,,18,32,18,50
16518,projectileboy,,31,17,20,37
16519,redline6561,,20,9,16,25
16520,Stingray88,,18,614,997,1611
16521,CLaBo,,13,2,2,4
16522,Wartz,,22,255,463,718
16523,pcmxa,,29,38,36,74
16524,ahotdog4life,,19,2,1,3
16525,lroselg,,13,92,175,267
16526,drizzle,,31,153,220,373
16527,thanatosys,,32,8,24,32
16528,bodenplukt,,31,78,271,349
16529,zohyil,,31,8,4,12
16530,dubu2584,,13,143,85,228
16531,bullfrog047,,33,1,1,2
16532,danjerman,,13,3,1,4
16533,dubphonics,,19,21,28,49
16534,MZepeda,,34,4,2,6
16535,idontreadthearticles,,5,1,3,4
16536,0oruneo0,,1,4,7,11
16537,CaptainComboBreaker,,18,1,1,2
16538,floweryleatherboy,,32,87,117,204
16539,mount_earnest,,32,254,383,637
16540,werewhale,,32,1,2,3
16541,diversey,,8,1,1,2
16542,letloosegal,,13,8,4,12
16543,gloushire,,1,8,12,20
16544,trippp,,42,2,3,5
16545,black_swan,,31,14,10,24
16546,Kiz11,,9,4,5,9
16547,knowsguy,,18,320,472,792
16548,Brocklesocks,,32,391,398,789
16549,1ickitung,,6,14,13,27
16550,Genetics,,18,35,37,72
16551,foxyvixen,,22,451,352,803
16552,pro_sephiroth,,18,26,43,69
16553,epicanis,,15,17,28,45
16554,znine,,32,1,1,2
16555,HaiNewUser,,13,3,3,6
16556,Epistaxis,,32,296,454,750
16557,InstantIndian,,1,111,130,241
16558,andreiru,,34,3,5,8
16559,thetimeisnow,,6,281,523,804
16560,tekrat,,5,39,52,91
16561,Speaktomenow,,15,40,84,124
16562,tamersalama,,18,19,39,58
16563,banchai,,1,29,45,74
16564,TUstudent,,30,2,1,3
16565,fuzznight,,43,4,4,8
16566,irafews,,32,72,4,76
16567,gtalmond,,13,11,14,25
16568,risend,,12,2,5,7
16569,ramhick,,20,1,1,2
16570,lcm133,,17,59,32,91
16571,ninjarobot,,19,18,49,67
16572,artofwar,,5,8,10,18
16573,cute_lil_bun_bun,,2,5,3,8
16574,severn,,32,12,10,22
16575,Fosnez,,15,61,75,136
16576,Brinna,,13,6,3,9
16577,cryo,,20,8,15,23
16578,ancient_multix,,13,1,5,6
16579,clandestin,,27,4,5,9
16580,surge1,,43,6,3,9
16581,ShrimpCrackers,,19,96,111,207
16582,EODTEC85,,4,1,1,2
16583,Space_Guy,,4,1,2,3
16584,kowzler,,31,8,28,36
16585,PGRacer,,8,11,14,25
16586,toodytang,,33,9,14,23
16587,fallentree,,32,3,4,7
16588,pootiechang,,18,3,2,5
16589,xvst,,0,21,23,44
16590,Zernhelt,,32,1,1,2
16591,Dru89,,32,17,26,43
16592,oPerrin,,19,10,15,25
16593,blacksuit,,19,52,61,113
16594,buddhahead,,43,15,29,44
16595,ihmc,,32,2,2,4
16596,wreese,,22,7,4,11
16597,myg204,,12,3,3,6
16598,Inspired,,18,9,27,36
16599,jpotell,,14,1,3,4
16600,itsjustajoy,,13,66,67,133
16601,toppredditor,,6,80,4,84
16602,sesse,,42,90,134,224
16603,xChrisk,,5,15,22,37
16604,amazingman,,19,7,17,24
16605,sjbrown,,5,2,5,7
16606,rachid116460,,17,1,2,3
16607,invalid-user-name,,20,55,23,78
16608,aintbroke,,19,5,5,10
16609,casualcollapse,,18,2,4,6
16610,claesh1,,20,15,26,41
16611,Cruise4,,19,2,4,6
16612,gsurface,,13,11,8,19
16613,kor_revelator,,31,1,2,3
16614,dickensian,,32,4,3,7
16615,pennyscan,,19,4,7,11
16616,rztwkk,,30,2,1,3
16617,hillad,,43,2,4,6
16618,darkandscary,,29,13,9,22
16619,dontstop,,18,86,4,90
16620,Niuk,,18,5,11,16
16621,aqbd,,20,6,5,11
16622,agiaccone,,13,35,17,52
16623,dkaz,,20,18,21,39
16624,Fanatixxx,,18,16,2,18
16625,timf3d,,1,22,18,40
16626,SinusTate,,36,18,28,46
16627,Volt,,20,3,5,8
16628,Radical_Centrist,,12,76,104,180
16629,mrekted,,13,84,21,105
16630,pranksomequaine,,1,31,51,82
16631,ThomK,,13,12,35,47
16632,joshuaahatfield,,1,20,23,43
16633,MrDrego,,13,29,25,54
16634,aaneton,,22,7,5,12
16635,b04877054,,31,7,8,15
16636,Palex95,,13,12,2,14
16637,AtheismFTW,,29,234,136,370
16638,fordf150,,13,5,5,10
16639,cranktheguy,,34,164,186,350
16640,Kinokokao,,16,1,2,3
16641,shaunanigans,,18,56,104,160
16642,ebrake,,0,50,11,61
16643,LordBodak,,19,22,14,36
16644,polarfire,,1,6,7,13
16645,showermanager,,6,2,1,3
16646,conanobrien,,32,9,5,14
16647,moroccobama,,32,1,2,3
16648,mrappard,,22,1,1,2
16649,jsichkaryk,,19,2,7,9
16650,mojonone,,33,1,1,2
16651,workisglory,,13,49,5,54
16652,ChrisAndersen,,4,218,494,712
16653,SorryReddit,,13,13,11,24
16654,fadeddata,,20,8,3,11
16655,xobs,,20,6,11,17
16656,WHAKATE,,30,5,3,8
16657,caster,,43,12,27,39
16658,I_AM_A_TROLL,,28,7,12,19
16659,butcandy,,42,273,440,713
16660,yerfired,,10,5,3,8
16661,wrekone,,39,1,7,8
16662,crowdadmin,,18,21,2,23
16663,vanibahl,,0,33,4,37
16664,Sarstan,,6,1,1,2
16665,trpcicm,,20,166,140,306
16666,smonsoon,,22,13,20,33
16667,b0jangles,,36,25,31,56
16668,itdev2,,5,1,1,2
16669,markrmarkr,,19,2,3,5
16670,evilcharles,,18,1,2,3
16671,Sevenduolux,,18,2,2,4
16672,termdark,,42,1,2,3
16673,mgodswell,,35,1,2,3
16674,bellgong,,29,14,17,31
16675,melb_ev,,17,14,19,33
16676,banister,,20,1,2,3
16677,raendrop,,27,60,139,199
16678,altmiket,,20,3,2,5
16679,jonnablaze,,18,86,19,105
16680,falcon8,,0,63,37,100
16681,Elbarfo,,18,5,16,21
16682,robtw,,1,1,5,6
16683,outsideofapex,,19,23,18,41
16684,uday0210,,13,31,7,38
16685,mistermoxy,,22,675,1098,1773
16686,IvyPhilly,,0,37,79,116
16687,Durric,,10,5,5,10
16688,cousinavi,,13,54,44,98
16689,hollipop,,43,2,1,3
16690,DortP,,0,38,74,112
16691,Phineaus,,13,11,11,22
16692,franzer,,1,16,13,29
16693,SohumB,,20,75,85,160
16694,xoswald,,20,1,3,4
16695,tofergregg,,18,36,11,47
16696,Talamasca,,0,39,139,178
16697,zachg,,5,26,35,61
16698,doctorlw,,31,4,3,7
16699,gregular,,13,1,2,3
16700,jvnk,,18,4,6,10
16701,TakaIta,,17,70,139,209
16702,zaphodi,,12,68,118,186
16703,WasForClinton,,19,144,111,255
16704,rastermon,,20,2,3,5
16705,vlkun,,20,6,2,8
16706,carcharodon,,22,4,6,10
16707,elspif,,20,5,2,7
16708,PracticalPanda,,1,30,38,68
16709,smokeweed,,18,57,27,84
16710,TheWiseNoob,,32,7,7,14
16711,horacevsthespiders,,18,24,26,50
16712,eallan,,22,160,216,376
16713,HaxorParadox,,13,8,9,17
16714,hipitarius,,20,4,6,10
16715,cyancynic,,20,628,1035,1663
16716,HiveMind118,,12,1,1,2
16717,san1ty,,20,328,244,572
16718,exec721,,32,5,9,14
16719,breakneckridge,,4,774,784,1558
16720,terumo,,34,39,137,176
16721,Nexum,,20,150,175,325
16722,crunkchip,,30,2,3,5
16723,andaleguero,,43,60,30,90
16724,tstorm,,32,8,35,43
16725,Kanin,,18,113,302,415
16726,theRIAA,,19,3,4,7
16727,willmorgan,,1,1,2,3
16728,alanis_morissette,,12,1,4,5
16729,David31337,,18,8,7,15
16730,mokopa,,31,8,14,22
16731,hwkns,,13,96,351,447
16732,droyal,,2,10,11,21
16733,Lightfiend,,29,3,7,10
16734,For_Iconoclasm,,18,7,18,25
16735,adamjay28,,39,1,3,4
16736,munnabhai,,20,52,30,82
16737,drjonez,,1,20,21,41
16738,Tony_Reaves,,18,2,3,5
16739,cgrand,,20,38,21,59
16740,goo321,,19,56,88,144
16741,charred,,20,1,1,2
16742,acepukas,,19,7,12,19
16743,Othello,,26,601,983,1584
16744,Anomolies,,1,19,4,23
16745,japhet,,18,8,37,45
16746,m1a2c2kali,,0,7,12,19
16747,DarkSideofOZ,,18,387,489,876
16748,3Scorpion,,0,1,3,4
16749,peanut_butter,,18,21,15,36
16750,starkinter,,1,161,168,329
16751,OrangeCoconut,,42,23,22,45
16752,commonmanuser,,18,6,7,13
16753,I_AM_A_LIBERAL,,13,32,5,37
16754,jfklein13,,20,1,5,6
16755,crabe1,,15,1,1,2
16756,C_istheroot,,13,1,2,3
16757,tejmin,,29,1,2,3
16758,aislingdarby,,31,16,24,40
16759,fortyhands,,29,6,4,10
16760,docgravel,,18,145,190,335
16761,aoru,,19,2,1,3
16762,w00ty,,20,208,139,347
16763,anthropic,,1,133,87,220
16764,crakthm,,32,1,1,2
16765,Canucklechuck,,31,3,4,7
16766,the_real_one,,17,8,3,11
16767,gosub,,20,63,24,87
16768,itsandrew,,1,1,2,3
16769,webjunkie1,,20,6,14,20
16770,ecks,,20,5,9,14
16771,friendly_titan,,13,3,6,9
16772,marmalade,,18,198,116,314
16773,zark,,20,10,1,11
16774,macneib,,0,68,99,167
16775,roryokane,,20,7,18,25
16776,NeoPaladin394,,6,45,63,108
16777,rgalan,,43,130,21,151
16778,clueless,,1,110,47,157
16779,2sjh1,,6,14,27,41
16780,tomparker,,16,5,5,10
16781,DINKDINK,,18,59,52,111
16782,bluesman03,,12,2,2,4
16783,KanadaRux,,30,16,2,18
16784,redpirate,,6,19,4,23
16785,lilzilla,,16,1,1,2
16786,stp6435,,5,343,69,412
16787,lurker00110,,29,26,46,72
16788,CXI,,20,4,3,7
16789,max_w,,18,2,4,6
16790,backcatalogue,,19,9,12,21
16791,pranayshrestha,,18,61,3,64
16792,infcow,,20,2,3,5
16793,chimmyc,,13,4,1,5
16794,dharmon555,,1,186,159,345
16795,duckduckdog,,31,1,1,2
16796,jokekiller,,29,7,15,22
16797,joelhardi,,20,122,186,308
16798,dupin,,20,5,2,7
16799,futureman19,,43,2,9,11
16800,verizonguy,,1,1,1,2
16801,mliving,,0,131,222,353
16802,run_citizen,,42,2,1,3
16803,Wonderama,,19,4,6,10
16804,troseph,,38,1,5,6
16805,hx219,,32,3,3,6
16806,messlah,,13,2,3,5
16807,RKBA,,17,406,642,1048
16808,AmidTheSnow,,32,122,212,334
16809,Hesperus,,18,93,152,245
16810,nextag82,,43,1,1,2
16811,mrstrongsad,,0,1,1,2
16812,xsp,,43,37,61,98
16813,neelk,,20,37,37,74
16814,nathan,,1,20,6,26
16815,rossta,,5,270,14,284
16816,DorothyNed,,13,3,1,4
16817,rrra,,20,71,100,171
16818,kuqumi,,19,48,92,140
16819,Taomongoose,,1,3,5,8
16820,rlancefield,,31,16,18,34
16821,ngroot,,39,352,518,870
16822,Arelius,,20,12,19,31
16823,beachking777,,43,2,3,5
16824,evolent,,22,147,23,170
16825,neophytoplasm,,1,42,67,109
16826,gooz,,22,25,41,66
16827,dubyabinlyin,,13,373,583,956
16828,jodv,,1,516,443,959
16829,Tobias42,,31,6,8,14
16830,lliiffee,,19,85,95,180
16831,bugged11,,18,20,30,50
16832,enitine,,43,18,28,46
16833,Penosaurus_Sex,,18,6,8,14
16834,harmonik,,0,135,173,308
16835,al-khanji,,20,8,5,13
16836,orph3us,,6,4,12,16
16837,ancientgreekredditor,,19,8,1,9
16838,ye_prasad,,13,78,2,80
16839,rephlektiv,,18,25,11,36
16840,thebizer,,19,18,2,20
16841,fernandoacorreia,,20,39,49,88
16842,surfinsoljah,,19,41,82,123
16843,rerentyourhot,,19,1,1,2
16844,Kingham,,13,4,2,6
16845,c0y0te,,19,18,4,22
16846,XS4Me,,8,456,568,1024
16847,bobsmo,,13,74,130,204
16848,potus445566,,11,2,1,3
16849,sheen7334,,13,1,5,6
16850,ehwot,,20,1,1,2
16851,dorkboat,,18,61,179,240
16852,djmichaelb,,13,1,1,2
16853,checksinthemail,,20,141,354,495
16854,jbrechtel,,20,2,1,3
16855,lisapisa77,,20,1,1,2
16856,vegasbomber,,43,1,1,2
16857,fancyman,,43,37,60,97
16858,Faustyna,,41,33,27,60
16859,molsoncanadian,,0,1,1,2
16860,Selina1,,31,1,1,2
16861,kazoodude,,1,3,4,7
16862,rodsgottit,,4,5,11,16
16863,startchangego,,18,226,90,316
16864,joshmcfarlane,,4,24,27,51
16865,eee777,,20,1,4,5
16866,sleeepykenny,,19,24,54,78
16867,nothingtodo,,13,3,2,5
16868,sqerl,,13,60,118,178
16869,whisperthis,,13,425,79,504
16870,ovets,,1,109,113,222
16871,SirSandGoblin,,10,139,310,449
16872,jdkeith,,31,18,20,38
16873,mvnu07,,13,7,1,8
16874,a_kind_stranger,,20,45,11,56
16875,maiacoop,,31,1,1,2
16876,allywilson,,1,30,30,60
16877,micdundee,,13,12,23,35
16878,311_was_a_rockin_job,,43,4,3,7
16879,suzwatkins,,13,12,12,24
16880,isthatarabbit,,38,1,1,2
16881,mrbillabong,,0,10,10,20
16882,truth_will_out,,19,6,7,13
16883,CDubbs,,35,1,2,3
16884,heymikedude,,1,4,20,24
16885,randomnebula,,30,3,1,4
16886,WTFppl,,18,38,72,110
16887,clownshoes_,,34,1,1,2
16888,abulfurqan,,13,1,1,2
16889,dngrmouse,,20,53,82,135
16890,yoboyhoy,,13,96,8,104
16891,Jezekiah,,13,331,227,558
16892,redditacct,,38,308,768,1076
16893,TheHulk,,29,2,1,3
16894,misouza,,20,23,1,24
16895,mddawso,,1,253,182,435
16896,inquirer,,19,371,58,429
16897,HarleyJane,,34,1540,114,1654
16898,spipe,,0,27,4,31
16899,logoswar,,19,313,167,480
16900,ehs,,31,8,10,18
16901,leski,,31,59,22,81
16902,robodale,,5,176,271,447
16903,kDubya,,13,11,12,23
16904,LeoDaCat,,19,1,1,2
16905,klugefoo,,20,6,13,19
16906,tapnclick,,22,33,53,86
16907,dhbanes,,14,213,388,601
16908,Ammit,,19,24,70,94
16909,essellewohc,,5,9,3,12
16910,spinfire,,20,284,458,742
16911,chrsprec,,16,4,1,5
16912,chungkaishek,,42,190,77,267
16913,sleepysheeple,,1,2,4,6
16914,skinnybuddha,,31,7,10,17
16915,Ravenlock,,19,62,98,160
16916,jtq1,,18,54,35,89
16917,samuraiswordsman,,28,23,60,83
16918,sapere_aude,,18,16,26,42
16919,y78u,,22,2,5,7
16920,wreckula,,10,13,9,22
16921,Deuce,,0,18,19,37
16922,symmetry,,13,1,4,5
16923,nc6220,,18,8,9,17
16924,masterudia,,18,6,7,13
16925,dacracot,,20,1,1,2
16926,popcorn2000,,19,18,23,41
16927,CACuzcatlan,,18,16,17,33
16928,MuttBuncher,,19,16,46,62
16929,foolio,,12,4,1,5
16930,omierbej,,19,2,5,7
16931,mikeporter,,1,7,2,9
16932,shamrin,,20,12,3,15
16933,greml1n,,4,27,1,28
16934,totsuka,,19,6,6,12
16935,someonelse,,31,108,256,364
16936,StvYzerman,,34,126,73,199
16937,lienny,,18,36,2,38
16938,theprime,,20,27,50,77
16939,schubart,,20,23,6,29
16940,wnecsdamion,,42,7,23,30
16941,murphy11211,,18,7,14,21
16942,kasutori_Jack,,1,252,275,527
16943,phargarten,,5,18,18,36
16944,afaircomparison,,1,11,7,18
16945,redbulluk,,12,1,1,2
16946,likeyrhst,,0,15,2,17
16947,indycysive,,13,311,628,939
16948,Snazz,,15,45,98,143
16949,kuking,,20,18,27,45
16950,eygy54yg,,34,2,1,3
16951,chaosgroove,,34,5,15,20
16952,runfaster27,,18,6,4,10
16953,citrivium,,32,14,22,36
16954,karlhungus,,20,38,65,103
16955,mspmsp,,1,11,12,23
16956,thecave,,19,22,70,92
16957,danzimakittykat,,13,3,9,12
16958,dar512,,34,3,12,15
16959,AnnArchist,,13,246,290,536
16960,mouron,,5,4,11,15
16961,tnadas,,42,1,1,2
16962,jackalope,,20,27,40,67
16963,Kingsox,,13,21,16,37
16964,icey,,20,189,277,466
16965,howardhus,,22,67,130,197
16966,mattindustries,,22,431,665,1096
16967,mistermilo,,34,2,1,3
16968,SlackerCS,,32,5,9,14
16969,martoo,,20,609,685,1294
16970,LilatheCetacean,,13,80,71,151
16971,Apostrophe,,13,11,3,14
16972,Roninspoon,,22,73,102,175
16973,b_billy_bosco,,18,131,47,178
16974,macncheese,,43,147,196,343
16975,contrastingsounds,,32,40,62,102
16976,captanonymous,,18,372,108,480
16977,3badcats,,13,1,7,8
16978,dutchbag,,1,22,26,48
16979,scrottie,,3,1,1,2
16980,xempathy,,32,5,8,13
16981,StarlitEyes,,11,1,2,3
16982,HydroCabron,,20,72,96,168
16983,robertson_davies,,42,1,6,7
16984,reDust,,30,2,3,5
16985,SunnyPessimist,,1,1,3,4
16986,newton_dave,,20,848,1316,2164
16987,Anocka,,20,29,35,64
16988,jamesaimonetti,,19,1,1,2
16989,ebonio,,31,25,41,66
16990,kkille1lsu,,13,19,7,26
16991,riddles,,20,2,3,5
16992,TDaulnay,,19,26,23,49
16993,Sheridan,,20,14,25,39
16994,docgnome,,10,47,21,68
16995,mrgatorboy,,13,25,30,55
16996,Darbro,,18,2,2,4
16997,lynnmag,,19,1,1,2
16998,zuben,,32,16,13,29
16999,LiberalHippies9,,26,210,267,477
17000,amrathelion,,8,1,1,2
17001,koverda,,42,3,4,7
17002,eikonos,,31,2,2,4
17003,feral_nick,,16,1,2,3
17004,Zapatero,,19,1,1,2
17005,Bengt77,,22,32,67,99
17006,dallashigh,,19,57,1,58
17007,fiddlerpaul,,32,10,8,18
17008,IlliterateJedi,,34,294,438,732
17009,philixthecat,,13,7,3,10
17010,jyoull,,12,1,1,2
17011,PunThreadPolice,,22,42,32,74
17012,ADoc,,23,4,2,6
17013,KMAR,,15,1,2,3
17014,bruce779,,18,15,15,30
17015,gradualunderstanding,,6,4,5,9
17016,tictock,,5,21,27,48
17017,jamiribon,,0,22,3,25
17018,soulonfirexx,,1,3,1,4
17019,ProudNativeTexan,,19,13,6,19
17020,btsr7414,,23,6,4,10
17021,hork,,19,168,71,239
17022,BobLoco64,,13,3,4,7
17023,DGolden,,20,139,241,380
17024,repete,,5,93,162,255
17025,Nhoj,,13,51,130,181
17026,icaruswings,,30,1,1,2
17027,The_Wolf,,0,9,25,34
17028,hng_rval,,43,8,5,13
17029,nebbugvrok,,31,7,15,22
17030,halcyon,,19,37,73,110
17031,LindaDanvers,,32,2,3,5
17032,dageshi,,19,2,1,3
17033,sweatervest,,18,174,159,333
17034,Spazum,,32,27,40,67
17035,boomshanka,,18,1,2,3
17036,lonely_forest,,18,2,1,3
17037,movzx,,18,1083,1787,2870
17038,LucidFate,,1,1,5,6
17039,pinghuan,,31,2,6,8
17040,eyes24,,29,4,4,8
17041,rdomanski1,,18,31,2,33
17042,liscio,,12,4,4,8
17043,smokingbabies,,31,6,9,15
17044,maudite,,0,6,14,20
17045,invisibastard,,42,1,1,2
17046,Capt_Redbeard,,18,30,6,36
17047,I_Am_Trent_Reznor,,19,1,1,2
17048,chortle23,,10,1,1,2
17049,yojustkeepitreal,,0,91,27,118
17050,stupid_reddit,,22,25,25,50
17051,derpderp,,32,11,4,15
17052,shdwflyr,,31,1,2,3
17053,adrianmonk,,20,1183,1509,2692
17054,pfunkman,,10,1,1,2
17055,redwhale,,5,18,23,41
17056,groupShout,,1,1,8,9
17057,buddhahat,,13,284,314,598
17058,XXchromosome,,1,4,4,8
17059,Ref,,20,1,1,2
17060,sleepymeme,,42,321,23,344
17061,cacylist,,13,6,9,15
17062,a-p,,20,5,26,31
17063,brauhze,,34,16,8,24
17064,miner60,,1,8,8,16
17065,Jur,,42,5,7,12
17066,exocet_uk,,13,1,2,3
17067,leehar24,,13,261,903,1164
17068,magpie707,,20,3,9,12
17069,cl3ft,,15,52,84,136
17070,wrongtoothbrush,,6,10,28,38
17071,OTN,,16,33,25,58
17072,TeddGCM,,43,30,14,44
17073,jmjinks,,18,50,40,90
17074,perkonis,,5,7,4,11
17075,nappy-doo,,31,36,30,66
17076,audio_addict,,32,5,6,11
17077,hajid,,13,1,5,6
17078,vhs,,34,8,29,37
17079,tallow,,20,1,2,3
17080,FordStang,,19,2,8,10
17081,kmactane,,20,33,58,91
17082,James_T_Kirk,,42,1,4,5
17083,digitalfever,,5,2877,261,3138
17084,rayburt,,31,8,5,13
17085,mikero,,43,9,1,10
17086,marleymarl,,18,18,11,29
17087,lennon,,20,11,9,20
17088,worldputra,,0,24,11,35
17089,syowr,,43,1,1,2
17090,TheJeff,,12,24,22,46
17091,879,,19,1,3,4
17092,DeadIrwin,,32,1,2,3
17093,streo,,19,87,25,112
17094,IanOsgood,,20,2,3,5
17095,Fitzsimmons,,31,40,61,101
17096,Cactus44,,43,7,7,14
17097,unikuser,,20,18,29,47
17098,rossdakin,,20,2,2,4
17099,evanfp,,1,8,11,19
17100,discontinuity,,18,10,22,32
17101,cynest,,32,10,44,54
17102,lengau,,20,122,271,393
17103,Taladar,,20,775,1168,1943
17104,chubby_chaser,,19,3,1,4
17105,IceX,,22,171,159,330
17106,pyroman,,22,30,32,62
17107,Microfoot,,1,44,60,104
17108,Gman8941,,0,66,41,107
17109,pngl,,13,4,3,7
17110,RaspberryTurtle,,22,2,1,3
17111,tjg05,,20,11,9,20
17112,Hetisjantje,,43,182,110,292
17113,GreenPlastik,,0,1,3,4
17114,stoned_cat,,6,13,24,37
17115,realblublu,,1,1,6,7
17116,ItsNotMyRealAccount,,1,5,1,6
17117,chaohan,,41,14,18,32
17118,mspiels,,19,1,3,4
17119,atlbeer,,13,22,6,28
17120,Rudy9iu11ani,,20,5,2,7
17121,Hexquan,,20,4,4,8
17122,Slackbeing,,6,25,30,55
17123,RockSci,,19,2,4,6
17124,itgoesthere,,22,323,568,891
17125,plzthx,,1,3,1,4
17126,KrazeeEyezKilla,,20,12,11,23
17127,anti-neonominator,,1,4,2,6
17128,beatmonger,,3,2,1,3
17129,Saucepan,,34,4,1,5
17130,inferno0000,,0,620,850,1470
17131,supegruicho2000,,14,2,4,6
17132,MrSomeone,,4,21,2,23
17133,xenusaves,,18,9,22,31
17134,newsmanwebber,,32,3,1,4
17135,BinderGang,,13,6,10,16
17136,salt44,,31,7,17,24
17137,magelisk,,13,27,45,72
17138,opportuneport,,3,5,7,12
17139,sry_not4sale,,20,2,2,4
17140,GodBreedsU,,32,2,1,3
17141,thedaveg,,19,17,10,27
17142,pancakeradio,,18,10,16,26
17143,zexus,,31,5,5,10
17144,wdr1,,13,9,23,32
17145,Jakary,,18,10,48,58
17146,simonthesnail,,13,10,2,12
17147,tagawa,,35,11,9,20
17148,Kelevra,,18,31,70,101
17149,luxazur,,32,89,222,311
17150,theseb,,18,9,14,23
17151,Mosz,,32,5,10,15
17152,mintwhip,,22,1,2,3
17153,loginx,,31,49,21,70
17154,TMaples,,13,9,13,22
17155,blotus,,0,1,2,3
17156,english_guy_78,,19,30,35,65
17157,joelax02,,14,2,4,6
17158,boobsbr,,18,18,30,48
17159,zphantom,,5,2,1,3
17160,TheMemlingIndex,,19,46,1,47
17161,360news,,32,4,7,11
17162,apoc123,,2,2,2,4
17163,sumnihil,,18,3,2,5
17164,FireAtWill,,6,1,1,2
17165,emacsenorg,,4,5,1,6
17166,mohanji,,8,1,2,3
17167,bontaq,,20,12,16,28
17168,Liquid_2,,0,49,77,126
17169,thekong,,18,2,5,7
17170,darrenk,,43,10,15,25
17171,crapfoodpants,,18,338,141,479
17172,simpwn,,13,49,67,116
17173,3HackBug77,,18,234,252,486
17174,perlgeek,,20,16,13,29
17175,freeyourself,,7,8,9,17
17176,blankblix,,19,4,2,6
17177,ishmal,,20,146,215,361
17178,valkyrie120,,1,3,1,4
17179,laydens,,13,49,8,57
17180,BakersDozen,,43,5,6,11
17181,UpVoteWhore,,42,2,2,4
17182,Nevyn_Etharr,,4,3,5,8
17183,ungulation,,34,31,27,58
17184,fishypants,,19,66,127,193
17185,cmer,,20,15,34,49
17186,g2g079,,32,20,19,39
17187,arkavianx,,40,1,3,4
17188,fanniepop,,30,1,1,2
17189,Gendron5000,,20,1,1,2
17190,niko7865,,32,8,10,18
17191,fduffner,,20,40,13,53
17192,justturned2,,35,3,4,7
17193,nostradamnit,,14,5,15,20
17194,weinerman,,8,3,3,6
17195,jasonstatham,,18,154,26,180
17196,jz_,,20,18,15,33
17197,ilf,,4,1,3,4
17198,mattbeetee,,1,107,51,158
17199,leshrac55,,42,25,6,31
17200,mtklein,,20,4,5,9
17201,a_scientologist,,43,12,7,19
17202,forgotpwx4,,20,10,9,19
17203,Borniet,,34,16,1,17
17204,riderclimber,,1,22,1,23
17205,econo,,31,16,10,26
17206,cwbrandsma,,20,15,29,44
17207,qwerty_dvorak,,8,1,5,6
17208,oookiezooo,,7,1,1,2
17209,onor,,19,3,3,6
17210,tallpizza,,19,1,1,2
17211,jingleman,,6,45,6,51
17212,3d3m0n,,13,3,6,9
17213,mkk144,,34,9,1,10
17214,ATsDIGwagon,,18,2,4,6
17215,plaintext,,1,17,18,35
17216,WineGlass,,1,38,41,79
17217,Barbaricfellow,,13,4,11,15
17218,PMolinero,,1,21,4,25
17219,shoseki,,18,78,181,259
17220,Mr45,,0,25,37,62
17221,elfan,,20,7,16,23
17222,readdit7,,20,77,77,154
17223,tendentious,,20,13,20,33
17224,illuminaris,,19,9,9,18
17225,unoriginal42,,22,33,28,61
17226,Clothos,,43,763,1408,2171
17227,kantapro,,6,1,1,2
17228,daywalker1,,9,4,3,7
17229,cashmoneylife,,16,32,11,43
17230,drdrang,,18,1,1,2
17231,martinsulistio,,9,1,3,4
17232,barclay,,20,19,35,54
17233,ghoest,,1,2,8,10
17234,eshinshin,,13,3,3,6
17235,bucknasty,,18,3,1,4
17236,carpathian,,0,1,1,2
17237,SarahWPalin,,13,4,2,6
17238,gijsbert_h,,20,2,2,4
17239,timmins,,19,111,133,244
17240,paulVeraguth,,34,35,16,51
17241,gtg681r,,3,15,15,30
17242,omegahinny,,1,2,2,4
17243,nograj,,27,1,1,2
17244,howdoyoustopit,,17,1,2,3
17245,mayfer,,20,2,1,3
17246,makkz,,28,3,5,8
17247,djloche,,19,22,93,115
17248,omegapoint,,20,63,67,130
17249,makingspace,,19,370,128,498
17250,SreeramKS,,20,2,2,4
17251,BadassVonWhitebeard,,43,1,1,2
17252,Diddit,,12,9,9,18
17253,othilien,,32,4,8,12
17254,softbatch,,32,4,5,9
17255,cornball,,22,2,2,4
17256,ianoji,,17,6,11,17
17257,maetl,,20,7,11,18
17258,flowithego,,1,182,224,406
17259,archister,,20,64,75,139
17260,dilithium,,20,2,5,7
17261,heepajunk,,22,115,179,294
17262,donkeypunch2,,30,2,1,3
17263,0-0,,13,3,3,6
17264,keatsta,,42,26,21,47
17265,lteague,,19,34,17,51
17266,charliie,,13,12,6,18
17267,LSU_Tiger,,13,84,35,119
17268,demoneyes1,,34,2,1,3
17269,voicereason,,31,1,2,3
17270,ecrunner,,18,6,7,13
17271,ultrasupergenius,,33,2,3,5
17272,PathologyOfPower,,0,1,2,3
17273,Submission_Critic,,13,2,1,3
17274,micampe,,20,78,75,153
17275,rsuavenator,,31,21,34,55
17276,ragweed,,12,112,97,209
17277,jhumphries,,1,2,2,4
17278,dasponge,,13,5,13,18
17279,RECURSIVE_META_JOKE,,4,6,4,10
17280,iudex,,22,10,20,30
17281,waldoj,,29,69,5,74
17282,bluegrey,,32,10,11,21
17283,projectshr,,21,5,5,10
17284,6hdC91ePMcwk0K1wsogZ,,1,4,2,6
17285,seeya,,31,367,174,541
17286,biggusjimmus,,42,1,3,4
17287,Chocobean,,19,9,2,11
17288,revonrat,,20,14,23,37
17289,ahsan_m87,,17,5,4,9
17290,macvijay1985,,41,5,3,8
17291,cappslocke,,20,2,3,5
17292,BicyclesforPeace,,31,381,456,837
17293,redditaddicttt,,13,8,1,9
17294,phish27134,,13,2,2,4
17295,ariesfatboy2,,13,12,12,24
17296,bibster,,43,10,7,17
17297,manixus,,14,1,1,2
17298,wardrox,,42,280,142,422
17299,mecazrz,,18,1,7,8
17300,tomhagen,,18,24,11,35
17301,GoogilyMoogily,,32,35,35,70
17302,WWWWWWWWWW,,26,1,2,3
17303,StevenMussel,,18,4,1,5
17304,leftpan,,17,58,95,153
17305,Fen_,,30,63,20,83
17306,kick11,,18,125,45,170
17307,nomadic,,22,8,8,16
17308,mrdatter,,11,1,2,3
17309,cedd82,,1,4,5,9
17310,applextrent,,39,3,1,4
17311,pescek,,13,21,2,23
17312,ennuionwe,,42,2,4,6
17313,fauge,,6,2,1,3
17314,codeninja,,32,9,1,10
17315,precip,,13,51,47,98
17316,noface,,18,170,56,226
17317,VPDickCheney,,1,1,1,2
17318,manewitz,,42,25,6,31
17319,briank,,5,7,13,20
17320,kevincobarno,,0,292,31,323
17321,stewy_w,,1,4,8,12
17322,bitshifternz,,20,2,7,9
17323,neels,,20,1,1,2
17324,BLG89,,42,1,2,3
17325,Sylveran-01,,1,385,503,888
17326,thrakhath,,4,391,577,968
17327,FeebleAntelope,,5,2,4,6
17328,ouztopia,,13,1,3,4
17329,sidenote,,13,5,4,9
17330,kranix,,11,169,282,451
17331,bellabelial,,18,96,136,232
17332,otlmath,,34,104,62,166
17333,VRFour,,18,13,13,26
17334,matteyes,,18,44,39,83
17335,slomo68,,29,264,340,604
17336,fortfive,,34,3,6,9
17337,daravinne,,43,10,17,27
17338,shsmurfy,,20,16,14,30
17339,intrepidlytrite,,12,17,13,30
17340,PhilK,,20,3,7,10
17341,titaniumjackal,,32,280,433,713
17342,scrumpydoo23,,18,216,448,664
17343,bobby200,,42,73,23,96
17344,blueaugur,,30,6,3,9
17345,tdreyno,,1,2,1,3
17346,stix1972,,13,3,1,4
17347,rationalitate,,32,8,10,18
17348,bertrand,,32,387,232,619
17349,robotron2000,,18,4,3,7
17350,wetelectric,,20,178,173,351
17351,Ventura,,4,4,5,9
17352,LilHumanist,,28,2,4,6
17353,AgentFireWire,,34,4,8,12
17354,jrbored,,16,3,8,11
17355,bluser,,19,10,1,11
17356,thedailynathan,,12,1,1,2
17357,amniarix,,32,24,23,47
17358,chorankates,,13,1,4,5
17359,chaz6,,18,10,12,22
17360,ademus05,,29,1,1,2
17361,hamsterboy,,20,12,7,19
17362,talso,,4,1,2,3
17363,salstress,,31,3,5,8
17364,ComcastRapesPuppies,,18,48,84,132
17365,yemenim,,6,1,4,5
17366,monkeymynd,,13,344,353,697
17367,danieldayblood,,5,11,14,25
17368,dbeck21,,20,5,5,10
17369,stupidis,,18,3,4,7
17370,LawDog54,,13,3,2,5
17371,apatton19,,22,66,53,119
17372,patmcnally,,15,2,2,4
17373,ThisIsMyProfile,,13,27,93,120
17374,sudarkoff,,20,1,1,2
17375,Samzo,,34,311,211,522
17376,syslinkdown,,18,15,20,35
17377,llaurent,,13,1,1,2
17378,siyang11,,41,1,1,2
17379,twosteptothatyo,,9,28,6,34
17380,Revidescent,,3,1,3,4
17381,moliket,,18,4,13,17
17382,seacollie,,5,6,2,8
17383,ucsmc_izzy,,43,2,4,6
17384,growt,,20,8,10,18
17385,jinkim,,13,2,2,4
17386,jmhodges,,20,29,20,49
17387,natlekkas,,39,3,1,4
17388,winbert,,43,24,28,52
17389,Cacophonny,,6,2,1,3
17390,stone_fox,,0,9,9,18
17391,Cygnus16,,7,2,7,9
17392,bradlingdale,,1,2,3,5
17393,bigpresh,,20,15,28,43
17394,hoppy44,,0,102,70,172
17395,ZachWasTaken,,43,1,1,2
17396,mugu22,,32,39,36,75
17397,boomerxl,,22,307,93,400
17398,OldDoper,,33,4,2,6
17399,BucketofTruth,,14,3,3,6
17400,tammberlin,,20,12,14,26
17401,nertzy,,19,93,3,96
17402,inoe,,12,3,1,4
17403,grayFalcon,,18,11,8,19
17404,woodsrunner77,,31,1,1,2
17405,matthewmoore2,,34,35,11,46
17406,tbp,,20,2,1,3
17407,chudgooo,,13,1,6,7
17408,MC-Master-Bedroom,,0,40,45,85
17409,sirormadame,,18,408,644,1052
17410,fitfreak,,0,3,1,4
17411,Skeeter19,,13,14,3,17
17412,F4ion1,,0,1,1,2
17413,thetickisblue,,34,7,13,20
17414,indigocc,,8,26,19,45
17415,dimensional_dan,,31,46,82,128
17416,BlackSails,,22,11,14,25
17417,dfbbjr,,30,4,2,6
17418,billyk,,18,1,6,7
17419,bootsinowski,,32,4,5,9
17420,Cody2,,18,11,17,28
17421,motch,,18,1,5,6
17422,hubris,,3,1,1,2
17423,jgagnon,,34,2,8,10
17424,deckman,,13,418,270,688
17425,pvidler,,20,16,31,47
17426,ac3raven,,13,31,35,66
17427,triangles,,34,1,1,2
17428,davidcthompson,,34,1,5,6
17429,gubatron,,4,12,10,22
17430,Pushkin23,,15,72,22,94
17431,gmcg_abidesII,,13,560,684,1244
17432,Bakrain,,22,50,94,144
17433,chordonblue,,31,60,72,132
17434,sarcastro,,13,4,12,16
17435,bithead,,32,650,985,1635
17436,tialys,,1,4,5,9
17437,sherlok,,42,114,119,233
17438,glnkb,,20,1,1,2
17439,KazamaSmokers,,0,1563,1490,3053
17440,sallah,,20,5,2,7
17441,MyPantsAreWet,,18,37,88,125
17442,gethought,,4,7,10,17
17443,iritanium,,19,63,3,66
17444,kuhlmanngj,,20,6,9,15
17445,ch1xx0r,,8,7,3,10
17446,kobes,,20,61,92,153
17447,Dazureus,,13,11,17,28
17448,mandolinpicker,,1,39,63,102
17449,inaciog,,19,3,3,6
17450,LordSlashstab,,0,68,213,281
17451,auspex,,13,1,3,4
17452,Teoti,,0,15,50,65
17453,rgawenda,,20,17,32,49
17454,dyncon,,13,26,30,56
17455,eldertaco,,22,14,16,30
17456,0rca,,13,21,17,38
17457,octavious,,20,2,8,10
17458,BaconUpThatSausage,,1,2,1,3
17459,DENelson83,,14,16,43,59
17460,litebright,,19,1,1,2
17461,alaric1224,,19,113,50,163
17462,eheheh,,42,3,5,8
17463,Darrin-J-Viccione,,22,1,1,2
17464,blinkenlightz,,20,13,3,16
17465,jon_titor,,22,1430,2517,3947
17466,dustwads_101,,34,10,31,41
17467,kuruptr,,1,128,20,148
17468,anoncoward101,,13,325,161,486
17469,typicalatypical,,31,15,8,23
17470,kwangqengelele,,39,43,68,111
17471,mrwormwood,,39,1,1,2
17472,reltuk,,17,5,3,8
17473,Aybraus,,1,53,77,130
17474,_tornado_,,20,18,10,28
17475,dr_root,,20,57,83,140
17476,SilverliningSB,,13,1,1,2
17477,postrad,,13,5,3,8
17478,Ramulus16,,0,1,2,3
17479,hotlemon,,34,17,33,50
17480,fraser11,,22,7,8,15
17481,ZuSpat,,32,9,24,33
17482,Shimbouzi,,5,1,3,4
17483,mmiiss,,19,1,4,5
17484,Apox66,,18,93,115,208
17485,Hypnotod,,1,5,7,12
17486,samp,,20,81,67,148
17487,silverwolfe,,22,13,17,30
17488,LazyWolfman,,32,301,190,491
17489,wvenable,,20,18,22,40
17490,Factran,,13,1,1,2
17491,antonius_block,,20,4,6,10
17492,shniken,,18,775,388,1163
17493,Megakazbek,,31,43,34,77
17494,Gaylard,,31,17,29,46
17495,Random_Username,,30,18,19,37
17496,Adqam,,20,63,75,138
17497,rickyspears,,20,2,3,5
17498,Shiggityx2,,18,79,120,199
17499,jensenw,,43,18,23,41
17500,manbefree,,34,40,29,69
17501,PenName,,18,445,104,549
17502,nehpets,,20,28,3,31
17503,perlandsen,,9,2,3,5
17504,vlabakje,,34,9,5,14
17505,neohx_7,,35,2,4,6
17506,jaw762,,18,1,2,3
17507,zeco,,9,81,62,143
17508,rkhoyh,,19,2,3,5
17509,ashishkh,,20,1,1,2
17510,Tivmic,,1,3,4,7
17511,fakeredditaccount,,1,1,3,4
17512,ewokskick,,1,46,48,94
17513,ammut,,18,43,59,102
17514,cygnosis,,10,2,1,3
17515,cwy,,31,36,17,53
17516,JesseOnReddit3,,1,410,502,912
17517,eroevo,,18,15,1,16
17518,ioi,,18,2,1,3
17519,ourmet,,32,2,1,3
17520,Wengchun,,18,94,1,95
17521,nmarchet,,13,1,1,2
17522,vima,,31,1,2,3
17523,lbyrd6,,43,1,1,2
17524,graverubber,,22,1,1,2
17525,extempore42,,1,1,1,2
17526,KaseyKasem,,18,41,53,94
17527,behanger,,22,92,45,137
17528,thothamon,,31,5,5,10
17529,ima_coder,,13,5,12,17
17530,flappymcflappypants,,34,18,12,30
17531,webdoodle,,0,202,7,209
17532,kfury,,0,76,46,122
17533,hydraxis,,18,12,25,37
17534,Khaaaaaan,,19,1,1,2
17535,ed-admin,,20,24,8,32
17536,johnwastson11218,,1,1,1,2
17537,mason55,,20,4,9,13
17538,micro506,,4,2,2,4
17539,bluequail,,13,472,1260,1732
17540,undertow,,18,3,4,7
17541,emelpy,,1,19,17,36
17542,stun,,10,1,1,2
17543,supplyandcommand,,29,3,16,19
17544,hexed,,0,20,20,40
17545,monototo,,3,3,6,9
17546,imsteve22,,18,17,40,57
17547,carlthejumper,,18,6,4,10
17548,richardma00,,13,2,4,6
17549,crapuser371,,43,28,20,48
17550,inmatarian,,20,84,147,231
17551,affliction,,0,1,9,10
17552,xmarxspot,,13,1,6,7
17553,shemule,,43,4,20,24
17554,yvelle,,19,10,19,29
17555,zorroplata,,13,1,2,3
17556,decorral,,4,1,1,2
17557,zaqwer,,22,1,1,2
17558,speedmaster,,13,53,2,55
17559,vic42482,,5,303,37,340
17560,mnsugi,,34,43,48,91
17561,djspray,,20,48,100,148
17562,redditex2,,13,16,51,67
17563,skipperdoo,,1,2,2,4
17564,shalabh,,19,3,7,10
17565,sivananda,,19,2,3,5
17566,Alvin666,,8,1,2,3
17567,PeEll,,20,3,2,5
17568,blisar,,35,1,1,2
17569,hellfish,,1,247,238,485
17570,internationale,,1,25,25,50
17571,revjrbobdodds,,13,2,7,9
17572,olaf_peterson,,0,1,1,2
17573,JustOneWord,,19,9,37,46
17574,mtulia,,8,4,5,9
17575,Rieuxx,,34,27,18,45
17576,giapet,,18,1,3,4
17577,vbh61422,,12,7,14,21
17578,fakeaccount2,,1,4,3,7
17579,sets13,,22,7,3,10
17580,Nibaritone,,14,17,13,30
17581,mike774,,1,2,10,12
17582,monkey_zen,,18,190,131,321
17583,jaguar92,,34,2,1,3
17584,huima,,20,4,11,15
17585,MasterManipulator,,42,2,2,4
17586,dog_banger,,20,2,5,7
17587,beginner,,4,17,35,52
17588,paul41982,,13,2,1,3
17589,leviself,,1,18,3,21
17590,wobblebonk,,18,5,7,12
17591,QuestionObama,,13,24,6,30
17592,gkaukola,,23,2,8,10
17593,vilaca,,20,5,18,23
17594,banditoitaliano,,31,97,107,204
17595,bstone17,,19,3,6,9
17596,PibbTibbs,,30,13,11,24
17597,rekka,,19,25,28,53
17598,kylebaked,,19,7,4,11
17599,trickyphillips,,18,15,1,16
17600,shipwrecker,,5,1,1,2
17601,RonaldHartman,,43,4,8,12
17602,AnarkeIncarnate,,4,9,13,22
17603,redtit,,19,6,5,11
17604,abcd,,0,1,1,2
17605,nuggetchap,,0,20,20,40
17606,aneeley,,22,10,20,30
17607,redrom,,0,1,1,2
17608,bizzykehl,,5,225,197,422
17609,hwerdna,,0,7,8,15
17610,omicron8,,18,33,29,62
17611,RodionsRache,,18,4,6,10
17612,qenbirqeni,,19,5,2,7
17613,adavies42,,20,3,3,6
17614,cesarosummary,,43,4,3,7
17615,huntmaster,,6,1,5,6
17616,tuskefege,,18,1,1,2
17617,chefjulia,,18,1,3,4
17618,amnezia,,27,397,431,828
17619,Xenthan,,0,20,64,84
17620,Ritchell,,18,45,36,81
17621,jk4net,,5,11,1,12
17622,misterjoker,,20,5,6,11
17623,realgame84,,6,8,1,9
17624,b3nj4m,,19,2,1,3
17625,jaegerian,,18,7,5,12
17626,crybelovedcountry,,36,1,1,2
17627,eightysix,,34,39,17,56
17628,guessishould,,29,2,1,3
17629,kevinweb55,,13,59,3,62
17630,zxxx,,19,2,2,4
17631,CircusMaximo,,18,2,1,3
17632,mrkyle72,,43,1,3,4
17633,grosvenor,,39,137,104,241
17634,jsares,,20,1,2,3
17635,chromehound47,,12,55,90,145
17636,curtisw,,20,231,374,605
17637,Nuggit,,20,17,28,45
17638,murx,,43,7,10,17
17639,silentscape,,13,1,1,2
17640,man_from_nantucket,,29,4,3,7
17641,natesavestheday,,18,4,5,9
17642,PogoPoutine,,30,28,13,41
17643,dontal,,14,30,59,89
17644,gcandela,,18,55,93,148
17645,slartibartfast75,,8,1,1,2
17646,fooshoe,,18,3,4,7
17647,DuquanWeems,,31,1,1,2
17648,chewybass,,19,29,32,61
17649,edwin,,20,9,10,19
17650,NoSalt,,5,997,1524,2521
17651,mattmahon,,1,8,7,15
17652,Lighting,,19,284,44,328
17653,Keri29,,18,5,6,11
17654,figley,,40,76,10,86
17655,loonytoad,,34,132,42,174
17656,Ilici,,20,4,3,7
17657,cainmadness,,13,5,4,9
17658,zaidr,,42,1,7,8
17659,anodari,,43,12,20,32
17660,bigshum,,20,11,17,28
17661,brave_heart,,19,8,44,52
17662,flamingmb,,32,9,7,16
17663,Togakangaroo,,20,81,18,99
17664,NattyBumppo,,13,46,26,72
17665,jlrobins_uncc,,20,1,3,4
17666,tavago1,,13,1,3,4
17667,VincentVega12,,19,167,245,412
17668,PainIsMyFreind,,34,1,2,3
17669,reader,,20,4,3,7
17670,fallacious,,29,118,162,280
17671,ch1d3th,,20,10,5,15
17672,AmericanElephant,,13,37,2,39
17673,Justintoxicated,,19,18,43,61
17674,deep_thinker,,29,21,45,66
17675,bus3nsc,,34,189,227,416
17676,Wokcus,,19,24,42,66
17677,rogpeppe,,8,2,3,5
17678,localmaximum,,36,3,5,8
17679,Rachel69,,16,16,4,20
17680,ctrocks,,19,7,5,12
17681,TheMagoozer,,18,121,106,227
17682,bs9tmw,,14,33,39,72
17683,sevans59,,0,7,10,17
17684,iamhrh,,3,5,7,12
17685,schmecky,,18,60,124,184
17686,pbogatsky,,18,2,2,4
17687,zoephoenix,,32,12,19,31
17688,thombrady,,1,3,11,14
17689,tjdziuba,,20,466,552,1018
17690,dec10,,11,44,56,100
17691,pocketpencil,,1,3,4,7
17692,qpdb,,10,1,2,3
17693,wtfjoel,,20,21,2,23
17694,NOLAsigma,,18,2,1,3
17695,RandomWords,,42,2,3,5
17696,driftware,,19,1,3,4
17697,theodoregray,,20,3,7,10
17698,jergens,,34,104,202,306
17699,karacho,,1,49,9,58
17700,bobraham,,19,2,11,13
17701,srulik001,,5,2,4,6
17702,OpT1mUs,,18,6,8,14
17703,ba3boos,,0,1,1,2
17704,CAPSLOCKED,,0,91,83,174
17705,irrelative,,20,85,40,125
17706,starbuck2,,13,73,29,102
17707,faintdeception,,4,85,126,211
17708,lukelephant,,19,6,5,11
17709,zorlack,,43,94,78,172
17710,pennyroyal,,18,4,8,12
17711,qotile,,32,15,10,25
17712,Abaaba,,43,1,2,3
17713,borland,,20,10,7,17
17714,citizen511,,32,34,60,94
17715,lostintime,,1,1,1,2
17716,rsn112,,20,64,87,151
17717,netgear1,,13,10,4,14
17718,p-smith,,18,3,5,8
17719,acvterr,,18,3,5,8
17720,nsfwdreamer,,13,145,33,178
17721,dan525,,0,168,90,258
17722,the_nil,,1,8,19,27
17723,chemprofmatt,,12,1,1,2
17724,WritertotheWorld,,13,2,1,3
17725,Valkyrie1234,,43,5,13,18
17726,arkx,,20,16,12,28
17727,dani,,31,72,20,92
17728,ceqw4o8b,,32,9,17,26
17729,westlib,,31,614,456,1070
17730,Kadin2048,,10,105,170,275
17731,toddtyrtle,,30,11,8,19
17732,enki,,20,92,16,108
17733,ewokjedi,,13,104,190,294
17734,psyno,,20,83,168,251
17735,lovebandit,,0,868,160,1028
17736,Unbound,,18,10,1,11
17737,thef1sh,,42,4,1,5
17738,iiiiiooooo,,20,1,1,2
17739,theseusastro,,30,193,335,528
17740,springfawn,,13,62,148,210
17741,stefanrusek,,20,36,17,53
17742,bastardoperator,,6,1,3,4
17743,artgreen,,18,3,3,6
17744,donger,,18,1,1,2
17745,ErikDaReddit,,32,2,4,6
17746,Synthetik,,1,55,61,116
17747,nick09,,13,2,3,5
17748,subesc,,1,56,85,141
17749,moskaudancer,,22,201,321,522
17750,magnav0x,,13,21,34,55
17751,antisocialite,,32,1,5,6
17752,jenna_malia,,20,6,1,7
17753,McCain08,,18,46,56,102
17754,PaulRay,,32,108,206,314
17755,rationalreflections2,,19,2,1,3
17756,SSJDouche,,18,4,1,5
17757,fktubby,,31,10,1,11
17758,steppenfox,,32,2,2,4
17759,oblivion95,,20,60,105,165
17760,jwalk,,14,65,71,136
17761,glottis,,18,59,69,128
17762,iancwishlist,,18,2,6,8
17763,pebrain66,,18,12,32,44
17764,InfinateJane,,1,200,178,378
17765,sempf,,43,101,146,247
17766,bangsilverhammer,,20,4,1,5
17767,Permagrin,,18,1,3,4
17768,Expez,,41,1,2,3
17769,kucinichFTW,,19,1,1,2
17770,LoKi128,,20,18,18,36
17771,Atomsk0042,,22,6,1,7
17772,jharlequin,,7,2,3,5
17773,normality_inc,,34,12,8,20
17774,ProudAmerican1,,36,2,1,3
17775,docomo,,31,283,97,380
17776,qu6767,,10,1,4,5
17777,kmunse,,5,3,7,10
17778,mattletron,,19,18,43,61
17779,ImAFriendlyGuy,,1,628,168,796
17780,keldy,,34,1,5,6
17781,Malaclypze,,32,2,2,4
17782,TopherT,,13,51,60,111
17783,kp2575,,18,591,62,653
17784,lobsterrocket,,43,4,2,6
17785,megawhiz,,40,8,9,17
17786,mobekigala,,8,301,4,305
17787,jggube,,5,17,14,31
17788,Rayge,,43,3,7,10
17789,NoMoreNicksLeft,,6,2818,4155,6973
17790,girlvinyl,,8,116,124,240
17791,red18hawk,,32,25,54,79
17792,megaman821,,20,9,1,10
17793,ShaneFalco,,18,1,5,6
17794,zhx,,1,61,56,117
17795,greenbes,,2,3,6,9
17796,desertc,,31,4,1,5
17797,92873893474,,2,13,12,25
17798,fatpat,,23,3,5,8
17799,oglu,,20,1,2,3
17800,temp_anon_account,,0,1,1,2
17801,batiste,,20,47,32,79
17802,stefbra,,18,2,5,7
17803,apowers,,1,295,342,637
17804,drinktomeonly,,1,12,8,20
17805,abrahamhlincoln,,34,3,10,13
17806,veresp,,43,47,1,48
17807,drdrewfus,,31,2,6,8
17808,buzzedition,,5,1,1,2
17809,sllouis,,13,2,5,7
17810,alphabetagamma,,19,23,61,84
17811,delphonso,,19,9,7,16
17812,uberalles2,,13,31,30,61
17813,titan88c,,0,18,4,22
17814,l0c0dantes,,22,27,32,59
17815,NUNick06,,22,1,1,2
17816,lokiexinferis,,1,20,8,28
17817,ph34rb0t,,18,8,14,22
17818,capriceclassic,,13,303,130,433
17819,tony_vipros,,29,2,2,4
17820,ohell,,43,4,3,7
17821,cyber_rigger,,19,437,773,1210
17822,smenger,,13,2,1,3
17823,celphafiael,,1,3,5,8
17824,thuper,,20,9,20,29
17825,czernyman,,20,23,23,46
17826,threecheersfornick,,31,1,3,4
17827,klibbersoo,,42,15,35,50
17828,IgnatiousReilly,,11,321,148,469
17829,jaymz168,,1,56,129,185
17830,stokedone,,0,13,14,27
17831,Wonton,,13,1,1,2
17832,whitross,,13,6,3,9
17833,operativ3,,31,1,3,4
17834,5tevef,,31,5,4,9
17835,stevegasm,,18,8,11,19
17836,WilmaM,,1,3,1,4
17837,megafreedom,,4,53,56,109
17838,Goeran,,19,480,109,589
17839,mshiltonj,,7,193,382,575
17840,moon,,29,5,6,11
17841,mmazing,,33,499,663,1162
17842,oscabat,,16,35,76,111
17843,dani0100,,6,31,11,42
17844,comocomo,,5,1,4,5
17845,oreng,,13,345,501,846
17846,wsppan,,34,10,9,19
17847,karstens_rage,,19,26,36,62
17848,chronicdisorder,,42,25,38,63
17849,lskkdfjs,,0,4,2,6
17850,meer,,20,4,11,15
17851,roppery,,8,1,2,3
17852,eatingorange,,19,1,3,4
17853,XblackX,,14,2,1,3
17854,glap1922,,13,6,7,13
17855,warner62,,32,20,33,53
17856,rob_dimarco,,34,4,2,6
17857,voldosnort,,31,10,4,14
17858,paradisefound,,13,29,47,76
17859,SpartanJ,,12,2,1,3
17860,dO_ob,,31,6,7,13
17861,cherrios_salad,,43,30,64,94
17862,JamesR,,41,3,3,6
17863,klaengur,,18,39,95,134
17864,cartoon_nate,,0,13,13,26
17865,kss123,,8,4,5,9
17866,TheAFactor22,,13,4,8,12
17867,acid77,,20,3,6,9
17868,killiansman,,1,6,13,19
17869,noahlt,,20,89,47,136
17870,sarehu,,20,5,7,12
17871,motionSymmetry,,19,2,3,5
17872,lauri,,20,42,1,43
17873,rudemaniac,,13,9,9,18
17874,ScrollMaker,,22,4,10,14
17875,bcrossman,,31,2,2,4
17876,evohollywood,,32,5,3,8
17877,Paxalot,,13,50,69,119
17878,superic,,1,1,3,4
17879,jdalkdfjad,,13,20,38,58
17880,ZaoGao,,13,2,8,10
17881,stuartpidd,,39,12,30,42
17882,VibratingClownShit,,19,1,2,3
17883,Awoody87,,42,2,8,10
17884,kpkristy,,13,32,43,75
17885,saxxtreme,,19,4,2,6
17886,marcoporno,,26,25,15,40
17887,NSNick,,22,68,164,232
17888,evan,,20,6,2,8
17889,kanzenryu,,20,32,6,38
17890,sad_panda,,0,111,144,255
17891,lisalove,,43,28,18,46
17892,pytechd,,34,22,40,62
17893,IAmARobot,,20,11,19,30
17894,mrdingdong,,1,31,10,41
17895,devinus,,20,22,15,37
17896,SacrificialGoat,,19,356,586,942
17897,matthewcieplak,,6,83,136,219
17898,akezf,,7,1,2,3
17899,tintub,,20,67,100,167
17900,endtwist,,1,7,2,9
17901,LA-Punk,,13,7,15,22
17902,jcjasmin,,30,44,51,95
17903,re182x,,27,2,9,11
17904,mastercook,,19,18,30,48
17905,reddit528,,1,1,1,2
17906,bsergean,,20,52,98,150
17907,prince373,,34,3,1,4
17908,masaruproject,,32,1,11,12
17909,tetask,,11,1,1,2
17910,fasdfadsf,,18,3,2,5
17911,zakhar,,1,3,5,8
17912,z4r4thustr4,,19,13,23,36
17913,ironfroggy_,,20,4,5,9
17914,ionlion,,19,3,1,4
17915,fibbery,,32,135,148,283
17916,avonbarksdale,,3,23,13,36
17917,johnyaya137,,19,14,14,28
17918,Gamboholic,,18,1,4,5
17919,HolyJuan,,14,467,211,678
17920,DaveUNC,,5,20,2,22
17921,JeremyStein,,42,2,6,8
17922,krh,,20,42,66,108
17923,mortis,,20,1,1,2
17924,stu091,,32,3,5,8
17925,anthonymckay,,20,23,30,53
17926,reborndead,,19,16,21,37
17927,Joseppi,,19,55,152,207
17928,pedroelbee,,3,14,11,25
17929,coldacid,,30,100,110,210
17930,bennymangina,,19,1,1,2
17931,psyonic,,6,44,90,134
17932,Apaulo,,1,106,114,220
17933,catmckinney,,1,1,3,4
17934,apostrophes,,1,5,5,10
17935,docid,,34,186,328,514
17936,clay,,22,2,1,3
17937,shmifaats,,32,1,2,3
17938,theconformyst,,29,2,3,5
17939,cogwheim,,32,6,5,11
17940,Zooph,,1,16,27,43
17941,farkinga,,20,1,1,2
17942,PrinceAuryn,,13,2,2,4
17943,Lameretardant,,18,37,72,109
17944,JohnInMableton,,13,29,58,87
17945,AdamPearlman,,19,6,29,35
17946,SyntaxPolice,,20,9,9,18
17947,seektruth,,19,73,24,97
17948,flakey,,31,2,6,8
17949,assidic,,20,2,2,4
17950,kiru1983,,20,2,3,5
17951,bennthewolfe,,12,2,1,3
17952,borsodas,,18,2,4,6
17953,dpatru,,31,7,12,19
17954,appleb0y,,34,1,4,5
17955,ajrw,,27,260,378,638
17956,vivienashley,,13,7,1,8
17957,jeffus,,20,5,2,7
17958,dying_sphynx,,20,5,1,6
17959,lukeydukey,,31,76,76,152
17960,summersjss,,5,1,1,2
17961,Neoro,,12,4,4,8
17962,Daleeburg,,4,148,157,305
17963,shivax,,3,1,4,5
17964,cypherx,,20,400,491,891
17965,srslyorg,,6,5,3,8
17966,demigod186,,36,11,6,17
17967,AuburnTigers,,0,1,1,2
17968,andrewmin,,20,45,6,51
17969,ksalley,,18,38,43,81
17970,PhiLLyinDaLLaS,,13,1,10,11
17971,bunnies501,,18,39,31,70
17972,homelessvet,,20,1,1,2
17973,richsim,,15,2,2,4
17974,LibertyOne,,13,128,75,203
17975,schneby,,13,128,123,251
17976,Tesladownunder,,34,1,1,2
17977,hattifattener,,22,13,16,29
17978,atom138,,18,6,2,8
17979,votedforwar,,19,30,40,70
17980,blueant1,,0,21,40,61
17981,trollbane,,13,1,1,2
17982,pedahzur,,20,28,28,56
17983,prodeath,,42,278,404,682
17984,itsnotlupus,,33,728,1164,1892
17985,99cent,,18,13,37,50
17986,silverbullet85,,13,18,31,49
17987,barbazul,,5,1,1,2
17988,alman1,,20,2,3,5
17989,dtommf,,18,9,8,17
17990,anonymousperv,,0,14,32,46
17991,Boones,,33,2,2,4
17992,kiwidave,,43,104,113,217
17993,dangauthier,,18,4,2,6
17994,dodgyc,,43,53,65,118
17995,garywiley,,19,27,37,64
17996,MelechRic,,20,182,182,364
17997,mbredditor,,19,69,54,123
17998,absenthanded,,32,1,1,2
17999,Quickdood,,13,3,3,6
18000,bassmrod,,22,41,40,81
18001,knight_47,,1,7,7,14
18002,thezoner,,23,19,1,20
18003,labajada,,19,33,20,53
18004,push40hex,,1,10,11,21
18005,wobzire,,18,16,57,73
18006,Man_or_Monster,,12,1,1,2
18007,barb_s13,,8,1,1,2
18008,physt,,19,3,2,5
18009,jamesshuang,,1,210,244,454
18010,zrail,,20,7,23,30
18011,wagthesam,,0,47,24,71
18012,redwards,,0,2,9,11
18013,seabasss,,31,1,1,2
18014,tvKloDqI,,12,1,2,3
18015,soulajax,,13,284,347,631
18016,Obligatory_Woosh,,22,1,3,4
18017,assfck,,19,16,20,36
18018,jsdvnc,,0,13,13,26
18019,adnam,,20,5,2,7
18020,siekosunfire,,13,9,20,29
18021,broken_heart_11,,42,5,1,6
18022,tikster,,41,1,1,2
18023,Txiasaeia,,30,65,52,117
18024,Caper8888,,13,16,12,28
18025,Illyr,,13,27,38,65
18026,smarker,,18,16,2,18
18027,AbleBaker,,20,9,31,40
18028,GAMEOVER,,13,60,57,117
18029,fRANkENChRiST,,18,1,2,3
18030,thespoon,,31,46,49,95
18031,Tl-lomas,,26,7,15,22
18032,ubergeek42,,19,1,1,2
18033,JamesVII,,20,2,2,4
18034,derekkraan,,31,7,5,12
18035,Glorificus,,32,223,208,431
18036,bywndr,,43,5,5,10
18037,dasch,,20,1,3,4
18038,riverguardian,,20,16,1,17
18039,Number86,,13,62,27,89
18040,sga65,,4,3,1,4
18041,elijahsnow,,10,1,1,2
18042,rhammonsster,,18,10,33,43
18043,hcl4,,13,28,14,42
18044,Toneloak,,18,8,13,21
18045,agvotv,,4,2,1,3
18046,tlogank,,22,1,3,4
18047,trippin113,,34,54,13,67
18048,Valkarie70,,0,7,12,19
18049,Imagineti,,31,166,6,172
18050,guey80,,18,85,25,110
18051,stepasha,,40,1,1,2
18052,2eeaarrgh,,13,8,19,27
18053,andrewcooke,,20,16,29,45
18054,discsid,,19,49,80,129
18055,sushionagrill,,18,1,1,2
18056,syntheticfaith,,1,12,10,22
18057,jxc,,5,6,14,20
18058,MeepZero,,31,1,2,3
18059,smittybacker24,,20,1,1,2
18060,nsfw77,,18,13,2,15
18061,omegian,,8,341,499,840
18062,wonboodoo,,19,15,14,29
18063,genebo,,0,2,1,3
18064,elliot42,,20,2,3,5
18065,macmulberry,,13,17,18,35
18066,bobloblawballs,,30,8,19,27
18067,n-space,,0,23,27,50
18068,catsfive,,6,9,21,30
18069,hiredgoon,,19,744,868,1612
18070,johnwyand,,20,6,8,14
18071,complicious,,5,107,15,122
18072,kishi,,19,113,192,305
18073,yomimashita,,20,1,3,4
18074,knifefighting,,1,1,1,2
18075,Brrr,,39,3,1,4
18076,mcrbids,,10,2,1,3
18077,soopsoopa,,31,4,2,6
18078,rdeml,,12,3,1,4
18079,aberant,,20,21,39,60
18080,crayz,,20,74,46,120
18081,bosse,,42,1,3,4
18082,thandar,,5,23,33,56
18083,aarbojohnson,,32,3,10,13
18084,drsco,,20,20,53,73
18085,tidder8,,1,5,1,6
18086,Emore,,1,12,8,20
18087,RamonaLittle,,43,10,11,21
18088,bobbybrown,,0,6,21,27
18089,erinosmon,,34,160,34,194
18090,debtkid,,19,243,21,264
18091,d166e8,,20,58,15,73
18092,owen454,,43,6,8,14
18093,blue148,,2,4,1,5
18094,spacepro,,8,1,1,2
18095,up234,,1,1,1,2
18096,brivera,,4,1,2,3
18097,kingnothing1,,13,4,9,13
18098,wenk,,20,2,1,3
18099,anon23452,,20,2,1,3
18100,Dudlington,,18,3,7,10
18101,robertbowerman,,13,4,4,8
18102,amore1,,20,4,2,6
18103,namin,,20,22,4,26
18104,thecmgeek,,10,5,4,9
18105,niyazpk,,20,39,5,44
18106,neilplatform1,,31,210,180,390
18107,sd2001,,31,1,2,3
18108,VinnyJents,,28,3,4,7
18109,sheepson_on_rails,,20,1,1,2
18110,mycatguinness,,18,8,2,10
18111,Monster10590,,11,1,10,11
18112,octophant,,13,7,4,11
18113,omnimon_X,,19,117,142,259
18114,explosion101,,18,4,9,13
18115,SaberTail,,42,2,6,8
18116,dcatalyst,,19,1,2,3
18117,Mietta2,,18,1,1,2
18118,flaminp00,,31,6,7,13
18119,ladypenelope,,1,3,1,4
18120,targetOO,,26,4,16,20
18121,PhntmStrke,,3,2,2,4
18122,ziiim,,20,7,9,16
18123,ryan251,,20,8,4,12
18124,bustlinSlug,,31,5,11,16
18125,Junyor,,20,2,1,3
18126,netsql2,,19,2,4,6
18127,gaberdine,,22,96,119,215
18128,Pawn05,,42,1,1,2
18129,Subnormal,,30,12,13,25
18130,MrOptimism,,19,2,7,9
18131,geekologist,,0,21,30,51
18132,recoil,,20,12,17,29
18133,eeeeeeeeeeeeeeeeeeee,,20,95,96,191
18134,donkeytime,,18,38,92,130
18135,jorgeortiz85,,20,4,4,8
18136,every,,19,2,1,3
18137,jebby,,1,8,18,26
18138,sbhansf,,13,13,3,16
18139,disinformationkiller,,19,2,14,16
18140,tweeks_3,,34,2,10,12
18141,Lineageholder,,3,1,1,2
18142,Adapter,,13,12,12,24
18143,xjarchaeologist,,13,16,35,51
18144,rhythmicidea,,1,481,555,1036
18145,n00blulz,,22,12,27,39
18146,IbnReddit,,31,300,180,480
18147,a9bejo,,20,59,3,62
18148,tme001,,18,18,39,57
18149,TheRoach,,18,7,8,15
18150,SgtGeek,,19,16,8,24
18151,sdfbaby,,13,32,16,48
18152,adkk,,19,11,11,22
18153,Skib,,43,23,29,52
18154,ghaitched,,5,322,43,365
18155,joshielevy,,32,2,1,3
18156,dorfsmay,,18,22,44,66
18157,discoraj,,18,1,2,3
18158,totalnutball,,21,1,4,5
18159,kcheng00,,21,1,3,4
18160,fuutott,,22,105,18,123
18161,quaterindie,,13,2,1,3
18162,hibernation9,,19,7,10,17
18163,JohnMichael,,22,1,1,2
18164,egypzee,,20,2,13,15
18165,simonmic,,20,2,2,4
18166,gduffy,,3,1,3,4
18167,Lizard,,1,400,404,804
18168,filterthing,,18,4,6,10
18169,plexxer,,18,10,12,22
18170,SubStack,,1,5,8,13
18171,rujadd,,17,3,6,9
18172,booyahweh,,13,36,2,38
18173,ryon,,19,3,1,4
18174,darktrge,,18,29,2,31
18175,deafmuteandretarded,,34,1,1,2
18176,punit,,20,3,2,5
18177,gekogeko,,17,1,3,4
18178,bball2,,1,7,11,18
18179,EmeraldGirl,,18,84,100,184
18180,venicerocco,,1,45,62,107
18181,Citizenchimp,,18,6,21,27
18182,goingtonycforbagels,,32,4,1,5
18183,dannyrelic,,34,21,1,22
18184,niggytardust2000,,43,151,306,457
18185,psychorabbit,,43,55,9,64
18186,torus,,41,6,9,15
18187,heavyrain,,13,102,149,251
18188,TBoneManBalls,,28,2,1,3
18189,JohnFrum,,32,64,87,151
18190,ereiter,,13,11,29,40
18191,bma,,27,2,5,7
18192,cToyos,,19,5,2,7
18193,frame,,19,4,14,18
18194,dergachev,,20,22,29,51
18195,Count_Fapula,,17,8,1,9
18196,rickysilk,,21,1,1,2
18197,tutash,,29,2,6,8
18198,jimarib,,22,13,27,40
18199,truebosko,,20,130,185,315
18200,bonyicecream,,18,30,34,64
18201,altrego99,,18,4,6,10
18202,tagiam,,19,1,1,2
18203,spilk,,1,545,861,1406
18204,fyl7999,,30,4,4,8
18205,khello,,34,39,38,77
18206,volida,,18,1,1,2
18207,ooooh_pick_me,,20,1,1,2
18208,MasterXen,,8,1,3,4
18209,gvim,,20,5,1,6
18210,karl-marks,,19,125,182,307
18211,savetheclocktower,,19,2,2,4
18212,refto,,20,25,38,63
18213,charlesd,,19,2,1,3
18214,crystalcastles,,18,57,114,171
18215,Smight,,29,984,1542,2526
18216,doomglobe,,0,20,40,60
18217,cyberandroid,,18,3,10,13
18218,gatorcountry,,6,57,60,117
18219,ryanchappell,,26,10,3,13
18220,watto,,18,46,4,50
18221,Captain-Obvious,,13,5,3,8
18222,e-string,,18,18,25,43
18223,sunkid,,13,847,229,1076
18224,spotta,,34,1,2,3
18225,DrK,,1,74,98,172
18226,DustD,,18,97,53,150
18227,NathanDavis,,42,39,6,45
18228,xtimesninety,,20,1,2,3
18229,gerald1,,8,17,3,20
18230,maxhully,,19,3,5,8
18231,anthonyflew,,34,7,7,14
18232,sybesis,,20,206,488,694
18233,norm_,,20,125,178,303
18234,MetroMPG,,5,1,4,5
18235,pagan_angel,,30,1,1,2
18236,gefla,,4,1,2,3
18237,nphinit,,19,35,48,83
18238,apatheticrebel,,18,7,11,18
18239,reddit_title_critic,,26,2,1,3
18240,Thinker10,,19,3,2,5
18241,MoebiusTripp,,32,47,91,138
18242,clemsonrocker,,18,1,3,4
18243,hashbrowncipher,,39,1,3,4
18244,kittyhawk,,8,2,2,4
18245,teddyrux,,1,31,46,77
18246,Notclevr,,6,66,85,151
18247,xsaac,,34,2,2,4
18248,Rothfeller,,19,5,12,17
18249,joe_pacific,,31,15,18,33
18250,zuff,,18,27,61,88
18251,radiosterilize,,6,6,5,11
18252,gordho,,42,16,30,46
18253,awblocker,,29,1,1,2
18254,SkeptiSys,,14,3,8,11
18255,porkrollrocket,,18,4,11,15
18256,technolope,,13,2,3,5
18257,btsdev,,20,1,1,2
18258,gabrielsaldana,,20,9,1,10
18259,Sovoobraznogo,,1,6,5,11
18260,ntlane2004,,18,68,102,170
18261,Vesonos,,43,181,93,274
18262,bl00w,,32,1,2,3
18263,davidpfitz,,18,23,26,49
18264,marlasinger,,19,2,4,6
18265,slapshot24,,42,1,5,6
18266,ri59,,32,64,75,139
18267,UnwashedMeme,,20,86,134,220
18268,BroadcastingBrain,,5,62,29,91
18269,mmoss181,,13,1,2,3
18270,gydhjihdr,,20,32,63,95
18271,MillardFillmore,,43,113,147,260
18272,Propaganja,,13,9,27,36
18273,boblk,,20,1,1,2
18274,volando34,,13,34,45,79
18275,Turd_Ferguson,,0,2,2,4
18276,Spl0it,,32,13,10,23
18277,epistemological,,31,10,5,15
18278,snapdeus,,40,3,5,8
18279,madhollywood,,13,50,17,67
18280,anglefire,,4,1,1,2
18281,sayslulu,,18,2,3,5
18282,atourino,,38,3,7,10
18283,redditors_unite,,6,2,1,3
18284,rogue,,13,8,13,21
18285,Code_Monkey,,20,54,74,128
18286,Drownthem,,18,48,76,124
18287,Jackyyy,,18,2,2,4
18288,gusevx,,19,66,122,188
18289,KimmoS,,18,9,19,28
18290,jenniwren,,14,4,2,6
18291,shark615,,17,163,185,348
18292,pfm,,1,1,1,2
18293,xurbia,,20,7,12,19
18294,figpetus,,1,151,243,394
18295,abillionistoomany,,1,163,150,313
18296,orbital,,19,42,65,107
18297,jkcunningham,,20,5,9,14
18298,janhamm3r,,31,37,78,115
18299,Snarky_Fucker,,19,3,2,5
18300,pertinentwires,,0,16,7,23
18301,ctown121,,43,16,31,47
18302,davidestroy,,31,3,4,7
18303,invisibleskydaddy,,8,1,2,3
18304,CaptainHaris,,33,2,1,3
18305,SnakeJG,,32,39,57,96
18306,clarkest,,18,4,5,9
18307,i_f_pillow_talk,,19,10,12,22
18308,mink78,,18,16,13,29
18309,Arkade,,19,9,18,27
18310,mossplant,,1,5,1,6
18311,vicaya,,20,32,35,67
18312,reverendchubbs,,1,5,3,8
18313,rogerallen,,20,7,8,15
18314,rulsky,,43,7,2,9
18315,percyx,,19,5,3,8
18316,MidKnight,,8,1,1,2
18317,danipen,,18,1,1,2
18318,astrobe,,20,11,28,39
18319,suaz4,,26,2,1,3
18320,wildmitchwalters,,42,5,8,13
18321,MrErr,,31,6,6,12
18322,steelaz,,20,3,4,7
18323,Klass,,18,18,26,44
18324,yozlet,,18,8,6,14
18325,Geraldine_Ferraro,,19,1,1,2
18326,marm0lade,,43,327,393,720
18327,Dallas442,,5,339,742,1081
18328,voilavoila,,18,186,89,275
18329,Vecheeso,,32,84,26,110
18330,Pacer,,5,87,94,181
18331,surfer6,,20,12,12,24
18332,TheCaterpillar,,9,81,117,198
18333,fubuvsfitch,,8,148,264,412
18334,Buck_MalibuLUVSDIK,,13,2,1,3
18335,rbridson,,42,1,1,2
18336,styxwade,,32,40,50,90
18337,AsianBoy,,12,3,1,4
18338,morleydresden,,13,34,38,72
18339,asdem,,13,1,1,2
18340,HyperSpaz,,3,47,75,122
18341,z00rat,,36,1,3,4
18342,gutflopper,,18,1,3,4
18343,Lycurgus,,13,7,16,23
18344,stretchpants,,0,2,2,4
18345,bcain,,20,8,9,17
18346,absurdity,,13,11,10,21
18347,RandomH3r0,,32,303,557,860
18348,earthtomb,,4,3,5,8
18349,tquiring,,43,3,3,6
18350,icechen1,,22,1,1,2
18351,jolpater,,20,1,1,2
18352,fulano,,20,4,3,7
18353,pslatt,,13,29,54,83
18354,skflead,,30,5,4,9
18355,killingthedream,,18,20,27,47
18356,Nurgle,,1,24,13,37
18357,drbrain,,20,27,43,70
18358,pbarmasher1,,0,2,1,3
18359,mike2312,,8,1,4,5
18360,dro0,,19,1,3,4
18361,felton9012,,0,2,1,3
18362,paloduro,,13,22,59,81
18363,VirSaturnA,,34,128,168,296
18364,ChancePhantasmo,,32,34,7,41
18365,2dimages,,17,1,1,2
18366,jda06,,18,2152,11,2163
18367,nraynaud,,22,21,30,51
18368,shivitz,,32,2,5,7
18369,rdunev,,29,2,3,5
18370,keanu-reeves,,32,1,1,2
18371,itail,,34,1,2,3
18372,pavi,,20,4,3,7
18373,pynewman,,5,9,20,29
18374,thematrix307,,18,35,3,38
18375,markreaves,,36,6,2,8
18376,redditer012,,13,2,1,3
18377,transparent,,19,10,14,24
18378,kraln,,13,39,15,54
18379,marcoil,,20,5,4,9
18380,FatPlastic,,42,2,1,3
18381,santo71,,19,80,47,127
18382,GORI_DUNK,,22,12,10,22
18383,Fanda,,39,4,5,9
18384,variods,,20,11,10,21
18385,epadafunk,,13,4,2,6
18386,iamp01,,20,28,42,70
18387,bflogeorge,,13,1,1,2
18388,djkillah,,38,3,3,6
18389,mrmessiah,,20,17,36,53
18390,walt87,,19,4,6,10
18391,bobbymcgee,,1,1,1,2
18392,doorrat,,1,97,26,123
18393,tony28,,43,170,224,394
18394,sammy_the_k,,18,29,57,86
18395,BoeV,,13,3,3,6
18396,zmaniacz,,1,27,43,70
18397,Vorlath,,20,24,42,66
18398,firewaterburns10,,34,1,3,4
18399,BarackOMoslem,,19,26,27,53
18400,bigj,,22,16,5,21
18401,nousplacidus,,20,10,2,12
18402,swinoner,,1,28,15,43
18403,galvana,,13,12,3,15
18404,BushmanBill,,22,2,8,10
18405,givanvliet,,22,2,1,3
18406,apathia,,31,5,7,12
18407,Aegelward,,4,4,6,10
18408,dante50,,19,296,181,477
18409,lumpycat,,18,5,10,15
18410,sir_real,,14,1,2,3
18411,jensbw,,20,7,1,8
18412,buffi,,20,295,321,616
18413,awesomo,,20,1,1,2
18414,javafreakin,,32,6,12,18
18415,mopheus,,13,131,46,177
18416,kvogt,,43,7,1,8
18417,spec209,,18,46,76,122
18418,redtuber420,,18,13,3,16
18419,HereBeDragons,,22,53,124,177
18420,SpiritBreaker,,18,16,9,25
18421,reasonb,,18,1,3,4
18422,pjcsoundsystem,,27,2,3,5
18423,death_egg,,31,44,48,92
18424,conman16x,,18,191,129,320
18425,MidnightTurdBurglar,,1,448,431,879
18426,forbin2k,,21,39,11,50
18427,Jonathan987,,31,2,5,7
18428,Hobart,,20,21,30,51
18429,phaylon,,20,42,101,143
18430,weiyin,,1,2,2,4
18431,j0d,,43,3,4,7
18432,Captanblue,,1,1,3,4
18433,nicesuckoutfish,,33,3,2,5
18434,redfox5,,13,4,5,9
18435,Maledictus,,20,1,1,2
18436,Kirsan,,13,1,1,2
18437,smek2,,32,748,882,1630
18438,JimboJet,,13,5,7,12
18439,jhnhines,,32,1,3,4
18440,evilsnail,,35,1,2,3
18441,ithasfourtoes,,29,11,14,25
18442,cooldude127,,20,11,22,33
18443,Insidium,,5,3,3,6
18444,stormers,,33,1,1,2
18445,eniko,,30,1,1,2
18446,arizona_man,,39,75,85,160
18447,HelpBeatCancer,,1,1,1,2
18448,bonerjams2k3,,32,157,397,554
18449,docforrester,,31,10,10,20
18450,pecunia,,20,1,1,2
18451,itisfritzz,,19,13,28,41
18452,ob_1,,20,2,1,3
18453,cicatrice,,1,2,1,3
18454,LordStrabo,,31,336,461,797
18455,monkeyshines,,18,102,29,131
18456,sfmission2001,,23,1,1,2
18457,zem,,20,1050,1845,2895
18458,masterbih,,18,30,2,32
18459,bodmodsnm,,19,1,10,11
18460,3434889,,20,118,117,235
18461,anthra22,,18,3,2,5
18462,MrsMicah,,16,29,9,38
18463,johnloves,,31,8,1,9
18464,clawoo,,20,364,88,452
18465,Spattie,,18,15,29,44
18466,ayanamifan,,13,13,15,28
18467,asymptotic,,6,21,32,53
18468,broon,,1,14,26,40
18469,masakatsu,,1,2,8,10
18470,Thehumanman,,32,1,2,3
18471,LeThor,,32,13,20,33
18472,Ba-Ba-Boosh,,13,105,28,133
18473,Weezer1223,,5,4,6,10
18474,ChrisHansenNBC,,22,1,1,2
18475,magnus91,,19,11,18,29
18476,arlanTLDR,,18,115,136,251
18477,moonzulu,,32,19,20,39
18478,fasteasyfree,,12,5,6,11
18479,anonymboy,,43,15,12,27
18480,KSpark,,43,90,97,187
18481,dunskwerk,,4,217,273,490
18482,kckman,,23,21,50,71
18483,nelsoncheung,,8,2,1,3
18484,newcows,,32,1,1,2
18485,StarCraft,,34,13,20,33
18486,dooresplat,,34,1,1,2
18487,dudemaster,,18,110,24,134
18488,edwardbc,,21,36,53,89
18489,dwelch91,,35,29,44,73
18490,fusedglass,,34,2,1,3
18491,manthrax,,17,517,1163,1680
18492,Palpz,,32,19,25,44
18493,tjdaybreak,,39,1,1,2
18494,ObamaRevolution,,0,2,1,3
18495,jedidave810,,13,1,2,3
18496,n4s33r,,20,22,15,37
18497,dradik,,39,3,2,5
18498,leevancleef,,32,122,182,304
18499,mrsample,,43,5,5,10
18500,koolkao,,20,36,45,81
18501,manila,,17,2,1,3
18502,truedoughca,,19,6,9,15
18503,Mindslide,,31,3,1,4
18504,newsfeed,,5,1,1,2
18505,pyoobs,,19,33,41,74
18506,alw111,,20,4,6,10
18507,grizdout,,18,24,2,26
18508,caramello623,,1,2,4,6
18509,ossworks,,27,1,1,2
18510,georgewashingtonblog,,19,4055,384,4439
18511,bj00rn,,42,18,34,52
18512,olivebeard,,5,5,2,7
18513,zephris,,20,22,34,56
18514,laffen,,0,4,3,7
18515,osipov,,31,450,189,639
18516,ThoughtNinja,,16,2,4,6
18517,homoiconic,,20,171,39,210
18518,ruined,,11,1,1,2
18519,twentyseventy,,34,10,14,24
18520,ghidra,,19,18,35,53
18521,olemissreb,,1,2,2,4
18522,mobiusrenoire,,43,1,3,4
18523,rocman9,,18,2,4,6
18524,seancanada,,32,1,1,2
18525,slizz,,20,17,4,21
18526,kingsqueen,,0,13,3,16
18527,a_little_perspective,,20,559,666,1225
18528,gaoshan,,3,431,433,864
18529,rhino369,,32,115,181,296
18530,angelessme,,42,29,42,71
18531,scottjames,,5,1,1,2
18532,oldmanHillarysbase,,9,3,1,4
18533,bg370,,13,83,109,192
18534,litosian,,22,1,1,2
18535,ziggyone,,35,3,2,5
18536,gabe_horn,,43,32,29,61
18537,diggapleaze,,1,24,2,26
18538,dimplemonkey,,0,44,88,132
18539,jzimo,,34,2,4,6
18540,integrii,,13,9,9,18
18541,oreonix,,20,2,2,4
18542,aresorli,,20,111,85,196
18543,heroofhyr,,20,4,6,10
18544,Gen_Jack_D_Ripper,,1,11,17,28
18545,braeden,,18,3,4,7
18546,ptarjan,,18,4,2,6
18547,cstew,,1,1,1,2
18548,beer_baron,,1,9,15,24
18549,pirsquared,,32,32,30,62
18550,jh0n,,1,13,12,25
18551,openedground,,6,4,10,14
18552,Thats_What_She_Said_,,18,2,1,3
18553,nononmous,,2,1,1,2
18554,c4g,,18,309,46,355
18555,Coffee2theorems,,20,24,29,53
18556,jjschnei,,32,251,202,453
18557,pbts27,,20,2,8,10
18558,dionidium,,8,13,11,24
18559,iobjectreality,,22,9,17,26
18560,abcdefghijklmn,,14,5,3,8
18561,muffin159,,10,2,1,3
18562,NinjaNine,,29,2,1,3
18563,epochcurrier,,13,6,7,13
18564,ziggity,,18,46,43,89
18565,rye419,,5,119,184,303
18566,jdot,,18,3,9,12
18567,chickensofdoom,,18,18,25,43
18568,treagan,,4,34,47,81
18569,neurad1,,11,27,53,80
18570,Garth28,,1,1,1,2
18571,greenstriper,,18,68,139,207
18572,dan16,,42,2,1,3
18573,Milo_OMalley,,32,62,24,86
18574,shatty56,,13,3,3,6
18575,pianowow,,20,3,5,8
18576,hoppersoft,,20,3,8,11
18577,Kaibot,,18,5,5,10
18578,chingalingaling,,32,4,4,8
18579,theinternet,,0,184,306,490
18580,djnasty,,17,3,2,5
18581,joazito,,43,23,49,72
18582,cnordholm,,32,24,19,43
18583,pcking1,,1,2,2,4
18584,CJBerri,,18,1,2,3
18585,dailyapplecrisp,,0,2,3,5
18586,phenom88,,32,2,4,6
18587,yellowdart,,18,66,58,124
18588,nerdymark,,33,33,33,66
18589,jux589,,32,28,23,51
18590,Kur0,,31,1,1,2
18591,WhiteWorm,,1,14,19,33
18592,ageddyn,,31,11,16,27
18593,TheCookieMonster,,4,55,67,122
18594,unk3mpt,,22,1,1,2
18595,timbur,,34,2,1,3
18596,trek42,,30,6,7,13
18597,norcalgordon,,19,3,6,9
18598,johonn,,43,15,25,40
18599,jeffiet,,19,4,2,6
18600,DEADB33F,,1,131,185,316
18601,goalieca,,20,274,385,659
18602,rtcrooks,,5,12,15,27
18603,Captain_Harlock,,34,51,144,195
18604,lardsink,,0,3,1,4
18605,rottle,,20,4,4,8
18606,velvetsmog,,13,1,4,5
18607,dawnerd,,22,247,440,687
18608,bbw1,,43,367,13,380
18609,munificent,,20,1170,1475,2645
18610,Britslayer,,18,629,1037,1666
18611,fontoon,,13,89,40,129
18612,yruoc,,18,26,39,65
18613,magpiesob,,13,2,10,12
18614,bfischer,,36,3,5,8
18615,goldfaber3012,,20,1,2,3
18616,hilaritydude,,13,3,1,4
18617,irishagua,,19,1,3,4
18618,flowlady,,31,1,1,2
18619,Wannamaker,,1,162,196,358
18620,matth1jd,,16,2,4,6
18621,zecob,,13,3,1,4
18622,DougBolivar,,0,1064,426,1490
18623,wnclittlelady,,31,1,1,2
18624,xxeyes,,1,231,102,333
18625,CaveHusband,,1,4,10,14
18626,anyonehearing,,13,1,1,2
18627,maybeyoushouldwork,,20,3,1,4
18628,djfrey,,32,28,27,55
18629,defska42,,16,1,2,3
18630,dqfriends,,13,4,21,25
18631,chmown,,18,142,98,240
18632,binderben,,0,5,7,12
18633,IAmWillIAm,,18,9,18,27
18634,TrailofDead,,18,28,26,54
18635,gersg,,5,1,1,2
18636,dbl5,,19,23,47,70
18637,NoHandle,,19,159,245,404
18638,alesine,,19,4,3,7
18639,muteh,,19,2,1,3
18640,unik,,13,1,2,3
18641,redvasily,,22,4,2,6
18642,Wizardface,,19,74,86,160
18643,fendale,,20,3,4,7
18644,DrShio,,20,28,4,32
18645,edmonal,,30,1,1,2
18646,Slavichild,,13,2,2,4
18647,syam1224,,20,45,9,54
18648,keystrokes,,5,19,1,20
18649,JZervas,,32,10,6,16
18650,muiknqa,,0,1,3,4
18651,Dwgystyl,,13,8,13,21
18652,boyy,,19,15,31,46
18653,somejan,,20,2,3,5
18654,dmiff,,13,468,703,1171
18655,praetorian42,,20,67,43,110
18656,fubarbaz,,13,105,160,265
18657,nic,,5,1,1,2
18658,BarackHObama,,1,1,1,2
18659,jonstark4,,2,133,202,335
18660,xXTDurdenXx,,13,1,1,2
18661,ddelrio,,8,28,46,74
18662,edpaget,,1,7,18,25
18663,Spike_Lee,,5,2,6,8
18664,ZeppelinJ0,,1,205,212,417
18665,o_0,,19,13,3,16
18666,enderpanda,,1,70,126,196
18667,parodygeek,,19,3,1,4
18668,BigStick,,43,35,18,53
18669,pkrel,,29,1,3,4
18670,rmtew,,20,3,14,17
18671,junkit33,,29,524,556,1080
18672,drdarkxl,,27,2,3,5
18673,Konquest,,20,23,14,37
18674,erik,,36,3,9,12
18675,bebopbalogna,,19,9,18,27
18676,irenedakota,,22,35,58,93
18677,disidentadvisor,,22,31,37,68
18678,Zero_Cool,,43,2,3,5
18679,Sadik,,43,146,271,417
18680,BLACKINFIDEL,,43,104,112,216
18681,Goonbaggins,,18,2,2,4
18682,rossini22,,19,5,4,9
18683,geofffox,,1,17,10,27
18684,witchwatchmom,,18,14,1,15
18685,andr3y,,43,27,66,93
18686,kolia_A,,18,17,16,33
18687,CreepyFootDr,,32,8,9,17
18688,bataggrant,,13,7,3,10
18689,colec,,4,22,19,41
18690,skycalling,,18,3,6,9
18691,I0I0I0I,,18,73,173,246
18692,UltraSlave,,8,5,1,6
18693,talibanjo,,19,36,39,75
18694,wonderworm,,13,55,113,168
18695,Rae-senpai,,18,16,26,42
18696,unknownsoldierx,,22,128,164,292
18697,ntewari,,6,3,1,4
18698,PetLvr,,5,45,5,50
18699,ArmenianBeardBuilder,,1,2,3,5
18700,hprry,,14,8,5,13
18701,0TheArtist,,5,2,2,4
18702,Pemulis,,39,4,3,7
18703,ecocentrik,,1,2,2,4
18704,penlies,,3,78,119,197
18705,jvin248,,0,1,2,3
18706,Hathery,,34,6,2,8
18707,Nefelia,,31,576,1161,1737
18708,MichaelsAMoron,,13,1,1,2
18709,windeva,,19,488,154,642
18710,antyg,,31,7,1,8
18711,DDDavinnn,,1,67,60,127
18712,maenor,,22,9,27,36
18713,secondkeeps,,6,7,1,8
18714,KickinPhresh,,18,4,4,8
18715,boxpop,,20,1,1,2
18716,YoungWise,,20,1,1,2
18717,the_amityville_fap,,1,3,1,4
18718,dudenotbombs,,18,15,14,29
18719,thedarkseid,,41,22,3,25
18720,madeinchina,,0,10,10,20
18721,Whitherby,,4,2,2,4
18722,rockefeller2,,18,155,172,327
18723,gunga,,18,4,10,14
18724,sweetdeals,,43,86,55,141
18725,calmlunatic,,13,2,7,9
18726,sandburn,,22,1,2,3
18727,Science_Rules,,19,6,5,11
18728,malderi,,5,6,4,10
18729,handlit33,,32,83,36,119
18730,MrSafe,,19,5,8,13
18731,michaelwong38,,5,70,75,145
18732,Yankeesfan,,34,15,1,16
18733,Jedit,,31,11,16,27
18734,anandy2,,26,1,1,2
18735,ToddieM,,18,3,2,5
18736,megagoosey,,18,46,56,102
18737,laurasmith76,,19,1,1,2
18738,cum_pussy_tits_ass,,0,46,61,107
18739,stubeloo,,1,17,23,40
18740,spyder99,,1,38,3,41
18741,nsfwalias,,1,1,1,2
18742,tripnik,,43,4,11,15
18743,archimboldo,,31,5,7,12
18744,Pimpwin,,18,4,8,12
18745,laughingboy1,,20,20,14,34
18746,painintheass,,19,4,2,6
18747,LadyLynn,,19,10,12,22
18748,Victor85,,4,3,3,6
18749,Montaz,,6,3,5,8
18750,futurcorerock,,13,10,8,18
18751,apple1nsider,,20,2,15,17
18752,kpanghmc,,20,9,1,10
18753,internet_outrage,,19,5,11,16
18754,flame,,41,6,1,7
18755,crane,,41,1,2,3
18756,brand_x,,17,2,1,3
18757,maddzy,,18,5,11,16
18758,paranox,,21,1,4,5
18759,manellis,,20,1,1,2
18760,andrewy,,20,8,5,13
18761,A_Thinker,,18,1,1,2
18762,SalahalDin,,13,33,64,97
18763,J_Moreau,,13,12,23,35
18764,monkeybomb,,18,44,77,121
18765,Eulogy,,19,74,36,110
18766,FeloniousHam,,18,1,2,3
18767,christianEarth,,19,2,2,4
18768,unearth52,,32,1,1,2
18769,tminionman,,0,16,19,35
18770,ThunderPreacher,,34,130,190,320
18771,MrAtheist,,19,1,1,2
18772,RebelWithoutASauce,,22,1,1,2
18773,gpalm,,22,29,54,83
18774,EGGPLANT12,,8,2,2,4
18775,Scully1981,,5,5,12,17
18776,siractsalot777,,13,4,7,11
18777,Fnerb,,18,21,8,29
18778,Atheist22,,19,80,94,174
18779,NunFur,,20,21,55,76
18780,macdermott,,20,1,1,2
18781,jtorjo,,12,2,1,3
18782,Ryveks,,4,37,36,73
18783,dildil,,32,1,2,3
18784,halcionDaze,,34,1,1,2
18785,justinlilysboss,,20,2,5,7
18786,georgeinwashington,,13,13,2,15
18787,TheWizard,,13,15,30,45
18788,viper565,,17,2,2,4
18789,photostyle,,0,1,1,2
18790,DetroitWonk,,13,3,1,4
18791,zzap,,15,2,5,7
18792,thomasthetanker,,18,86,83,169
18793,tundradesert,,26,1,1,2
18794,nation_nazi,,31,1,1,2
18795,ironman86,,0,5,10,15
18796,froggy000,,19,47,88,135
18797,extracelestial,,19,7,2,9
18798,Mextli,,1,13,28,41
18799,gmason007,,13,6,10,16
18800,ahavemeyer,,20,2,2,4
18801,taxman909,,13,7,1,8
18802,gunnarstaal,,30,1,1,2
18803,formerperson,,36,1,3,4
18804,hockeygoalie,,13,1,1,2
18805,pablosambuco,,1,1,1,2
18806,mommydaddy,,19,2,1,3
18807,anonposter1234,,18,2,2,4
18808,zgailgoodman,,13,1,1,2
18809,andiz,,0,26,27,53
18810,iubdfglisdubg,,20,10,11,21
18811,reveazure,,20,48,31,79
18812,Vincents_pistol,,32,1,1,2
18813,captbobalou,,34,16,22,38
18814,discy,,18,1,2,3
18815,buyutec,,19,10,9,19
18816,cAPTAINdYSLEXIC,,12,2,1,3
18817,natovision,,22,4,21,25
18818,meekamoo,,32,8,8,16
18819,Waterwoo,,20,2,1,3
18820,SellonQ,,5,1,1,2
18821,sarahcotto,,40,13,7,20
18822,TomA,,20,11,25,36
18823,ThatsPopetastic,,18,49,48,97
18824,souk,,20,5,7,12
18825,7805,,31,107,148,255
18826,darkskye,,10,2,1,3
18827,kingarooz,,0,20,48,68
18828,spiff142,,13,5,2,7
18829,mattmcknight,,20,1,1,2
18830,mOdQuArK,,19,376,685,1061
18831,ksan,,31,10,16,26
18832,capobodih,,19,49,7,56
18833,aretinoknows,,19,49,20,69
18834,Sylvyr,,18,3,6,9
18835,Pakars,,3,42,69,111
18836,djxanax,,4,2,3,5
18837,squaredup,,1,1,1,2
18838,stainlessnixon,,19,113,124,237
18839,valintin,,13,3,3,6
18840,dsmith49,,12,9,2,11
18841,heruz,,32,19,26,45
18842,maryummy,,1,17,2,19
18843,jbmigel,,0,10,16,26
18844,fidler,,43,2,7,9
18845,ltpl4y3r,,42,12,13,25
18846,LOLCAT,,43,20,59,79
18847,redalert,,19,264,18,282
18848,infamous,,1,16,33,49
18849,NiceGuyMike,,34,31,36,67
18850,crazedgremlin,,22,116,165,281
18851,benah188,,5,1,3,4
18852,mirkadel,,33,2,1,3
18853,lngshado,,19,1,1,2
18854,tehjarvis,,0,111,114,225
18855,rakeif,,43,8,8,16
18856,cartman81,,19,5,2,7
18857,dgmelski,,19,3,2,5
18858,Your_Boss,,16,1,1,2
18859,niftierthanthou,,15,5,4,9
18860,LegendOfHurleysGold,,18,6,11,17
18861,furyg3,,4,152,157,309
18862,azshade,,32,2,2,4
18863,geekhorde,,0,1,2,3
18864,ajamison,,31,3,3,6
18865,flybrand,,6,1,1,2
18866,stuhacking,,1,6,7,13
18867,shinyplasticbag,,13,17,33,50
18868,mdaconta,,22,5,2,7
18869,jhon2,,22,5,6,11
18870,paulajohnson,,20,47,26,73
18871,prox546,,0,44,65,109
18872,andrewinmelbourne,,15,345,535,880
18873,travis0868,,20,3,2,5
18874,J_McCain,,13,8,4,12
18875,truelements,,3,3,2,5
18876,davidsampson,,1,95,35,130
18877,Montyseven,,14,2,1,3
18878,jonnyhaze,,30,8,23,31
18879,bbmm,,19,11,15,26
18880,TVawser,,13,15,3,18
18881,ZOMG,,18,2,3,5
18882,sleastack,,19,91,150,241
18883,Corenth,,16,3,1,4
18884,Penrif,,20,7,19,26
18885,Invisiblechimp,,19,4,6,10
18886,battletoaster,,22,127,97,224
18887,pavlovs_dong,,5,1,8,9
18888,webtickle,,13,2,1,3
18889,interio,,18,8,4,12
18890,loser_the_user,,19,2,2,4
18891,DAllenJ,,18,27,20,47
18892,maltoodles,,32,3,1,4
18893,tenebrio_molitor,,18,3,8,11
18894,johnsgunn,,22,3,3,6
18895,Id-hit-it,,19,3,9,12
18896,thamiam,,1,7,7,14
18897,LouFigs13,,43,3,9,12
18898,stonelobster,,19,177,310,487
18899,mesjours,,18,36,2,38
18900,andrewl,,20,19,18,37
18901,jimmyikon,,31,1,2,3
18902,madhatter,,31,20,31,51
18903,nhall,,31,1,1,2
18904,jeserac,,20,89,1,90
18905,IntolerantFaith,,13,182,27,209
18906,SimonGray,,31,242,310,552
18907,leshiy,,18,434,590,1024
18908,dr_greenthumb,,13,8,7,15
18909,directrix1,,29,34,45,79
18910,tomatosoup,,17,77,90,167
18911,kevindicks,,19,8,1,9
18912,boothakr,,1,154,22,176
18913,Whig,,6,2,9,11
18914,5DGuy2,,21,3,6,9
18915,dredgedskeleton,,32,137,170,307
18916,nubbles,,20,1,8,9
18917,forumdrasl,,17,2,1,3
18918,RealEstateWiki,,13,9,14,23
18919,lalinoir,,13,7,12,19
18920,bradbrowndotcom,,18,48,90,138
18921,kramer99,,18,4,1,5
18922,periphery,,15,10,18,28
18923,dygital,,6,5,1,6
18924,plan17b1,,20,2,2,4
18925,sodaorseven,,30,8,4,12
18926,tedsan,,13,11,9,20
18927,ironictwist,,30,12,27,39
18928,blueboybob,,1,366,18,384
18929,unloud,,43,175,297,472
18930,daninjapan,,18,46,140,186
18931,Tir,,20,56,59,115
18932,allen3333,,6,18,13,31
18933,powercow,,1,37,57,94
18934,proinsias,,32,1,1,2
18935,Sentinell,,32,53,43,96
18936,achacha,,20,14,21,35
18937,johnnyq,,18,39,64,103
18938,mrdigital,,0,1,1,2
18939,daunas-daunelis,,32,1,2,3
18940,evilhero,,19,9,23,32
18941,vitalysh,,18,21,27,48
18942,zornedge,,10,17,23,40
18943,cescacosta,,29,2,1,3
18944,aname,,20,17,12,29
18945,rpfeynman,,32,4,5,9
18946,gregger101,,6,3,1,4
18947,brancamenta,,1,3,3,6
18948,rawl28,,32,10,5,15
18949,planck,,19,5,7,12
18950,Pixelpaws,,13,276,322,598
18951,Friedrich_Nietzsche,,20,2,6,8
18952,alnayyir,,20,8,15,23
18953,mileshalter,,18,12,7,19
18954,Vlux,,43,1,4,5
18955,FreddyT,,37,1,3,4
18956,zombiewat,,31,642,1169,1811
18957,ffaalzada,,1,29,3,32
18958,gpinn,,13,2,1,3
18959,jaredpar,,43,1,1,2
18960,alaskamiller,,19,1055,994,2049
18961,beatnik307,,18,25,31,56
18962,sam8854,,13,3,5,8
18963,TheArsenal,,13,48,7,55
18964,Le3f,,1,91,155,246
18965,meggersmeg,,17,6,3,9
18966,megerena,,36,1,3,4
18967,tssen,,41,3,10,13
18968,nny76,,18,31,51,82
18969,operatik,,18,1,1,2
18970,bombhand,,22,214,279,493
18971,rmeltg,,13,7,1,8
18972,MailShmail,,12,1,1,2
18973,freshest1,,9,2,1,3
18974,raspberry_bang,,32,1,1,2
18975,flyingcamel,,9,4,6,10
18976,dashx,,20,45,46,91
18977,OpenAlongEdge,,23,64,120,184
18978,RowingBear,,12,25,30,55
18979,digmark,,18,1,2,3
18980,StevoX,,19,4,1,5
18981,eightnine,,43,164,124,288
18982,blasphemonkey,,8,3,3,6
18983,thesinker,,32,38,60,98
18984,liquide820,,18,4,2,6
18985,kahirsch,,29,276,292,568
18986,godspeedandhow,,12,2,4,6
18987,philodox,,5,30,17,47
18988,suckpoppet,,31,42,58,100
18989,raiello,,6,44,70,114
18990,samzklub,,0,24,49,73
18991,diencephalon,,18,4,10,14
18992,Gioware,,31,53,83,136
18993,monkey0,,1,1,1,2
18994,Being_manny,,20,11,1,12
18995,gremlintaco,,41,8,5,13
18996,Anjin30,,30,7,3,10
18997,olivertweest,,18,1,1,2
18998,studioexpress,,6,1,2,3
18999,ndrury,,1,2,4,6
19000,Xig,,43,3,2,5
19001,AustinS,,20,4,8,12
19002,DnaDamage,,4,38,15,53
19003,mukiex,,22,17,27,44
19004,antoinehersen,,20,6,3,9
19005,tehpoopsmith,,13,107,58,165
19006,skigenator,,1,76,78,154
19007,nicliff,,20,1,1,2
19008,neverever,,21,137,211,348
19009,surleigh,,17,2,1,3
19010,thabc,,12,67,69,136
19011,lindsifer,,19,55,77,132
19012,adelosr1,,18,90,62,152
19013,statelypenguin,,12,2,2,4
19014,encryptor,,19,19,32,51
19015,Jonwilks,,32,3,7,10
19016,Trollkiller,,18,68,104,172
19017,daveGravell,,43,4,11,15
19018,LeGrandOiseau,,13,75,206,281
19019,xxrealmsxx,,31,24,38,62
19020,arudolph,,0,8,14,22
19021,thoph,,6,1,1,2
19022,kig0222,,20,5,8,13
19023,widmest,,13,2,4,6
19024,muddylemon,,43,1,13,14
19025,FearOfSuccess,,36,18,21,39
19026,fabiofzero,,20,17,35,52
19027,summerskl2,,31,2,1,3
19028,Samaal,,13,588,50,638
19029,IceAngels,,43,1,5,6
19030,wickermanstudios,,32,1,4,5
19031,SirCrumpet,,0,8,8,16
19032,jayk806,,42,4,3,7
19033,anonymousbiden,,4,53,32,85
19034,Osmondy,,18,15,1,16
19035,chimpo,,11,18,1,19
19036,modus,,18,66,112,178
19037,echeese,,20,15,23,38
19038,yoyoguy2,,17,5,1,6
19039,winmaclinblog,,1,3,1,4
19040,drewlew,,13,8,6,14
19041,newjob,,0,42,58,100
19042,cach-e,,20,23,38,61
19043,ahalenia,,18,2,5,7
19044,newzman,,21,43,1,44
19045,dt_vibe,,18,222,260,482
19046,facenoface,,1,15,1,16
19047,miameetza,,19,2,14,16
19048,eoddc5,,18,1,2,3
19049,hearmeroar,,22,3,10,13
19050,Duodecimal,,31,2,2,4
19051,nightoffire,,36,2,1,3
19052,Jumba,,1,5,15,20
19053,Je-pat,,35,7,1,8
19054,zakj,,38,1,2,3
19055,theQueenOfMelanesia,,32,1,5,6
19056,akalliaridis,,16,1,2,3
19057,CommentMan,,34,277,392,669
19058,dbchappell1,,32,45,25,70
19059,Darkmere,,20,14,17,31
19060,quassum,,43,1,1,2
19061,hpcolombia,,13,4,2,6
19062,magila,,31,38,47,85
19063,wild_magic430,,18,2,9,11
19064,cojerk,,13,5,8,13
19065,dione1200,,18,3,5,8
19066,avichayil,,5,1,4,5
19067,escalation,,13,35,123,158
19068,DrNuke,,32,9,17,26
19069,huntingwhale,,18,12,33,45
19070,ShutYourPieHole,,6,7,9,16
19071,cllewis,,19,3,2,5
19072,IanPower,,34,9,3,12
19073,jimb0,,12,3,2,5
19074,kevingillett,,16,45,4,49
19075,QuantumFTL,,20,2,5,7
19076,maxey,,0,13,36,49
19077,Boreal99,,34,7,8,15
19078,oppenberger,,0,4,1,5
19079,bstichbury,,19,6,6,12
19080,DennisBlazer,,0,4,2,6
19081,jasonskjonsby,,13,285,296,581
19082,unrealious,,9,421,1166,1587
19083,jefuchs,,1,120,104,224
19084,beatskin,,43,11,14,25
19085,noreg,,34,1,2,3
19086,spence2004,,31,1,1,2
19087,JMowery,,19,9,8,17
19088,xipietotec,,1,34,49,83
19089,de-passivator,,19,6,9,15
19090,CuteAlien,,20,139,193,332
19091,andr3,,14,4,4,8
19092,vsuontam,,20,68,54,122
19093,bomfog,,32,1,1,2
19094,miagaille,,17,1,1,2
19095,women_ARE_idiots,,30,1,1,2
19096,AtheistSpirit,,5,1,1,2
19097,kolm,,0,390,636,1026
19098,CydeWeys,,42,64,20,84
19099,Chakat_Sanddancer,,8,157,251,408
19100,lauraegilbert,,5,1,1,2
19101,anoopsaha,,8,66,17,83
19102,jadepanther,,1,40,78,118
19103,ajprax,,13,7,13,20
19104,allhands,,43,738,332,1070
19105,cantsay,,19,555,341,896
19106,privatehuff,,20,37,87,124
19107,azahi,,20,8,8,16
19108,auldnic,,1,66,164,230
19109,mhotel,,22,182,322,504
19110,itayx,,36,7,13,20
19111,granite-state,,5,2,3,5
19112,lawrencekhoo,,19,69,48,117
19113,bellanoelle126,,13,1,1,2
19114,facewarts,,19,64,124,188
19115,Chocobo812,,1,24,42,66
19116,NotTheDude,,29,13,27,40
19117,PrivatePyle,,43,9,6,15
19118,SHEEPL,,1,1,1,2
19119,slightlynew,,20,2,1,3
19120,nosht,,1,122,78,200
19121,chh,,29,21,20,41
19122,sukoi001,,4,2,4,6
19123,privatejoker86,,19,5,4,9
19124,Utopianow,,13,28,35,63
19125,pazzypunk,,19,60,9,69
19126,Bro666,,13,4,7,11
19127,inoeth,,13,11,17,28
19128,lytfyre,,20,13,36,49
19129,tehbored,,32,94,188,282
19130,TheOpenConspiracy,,20,1,1,2
19131,BionicBeefpile,,20,12,24,36
19132,Elethiomel,,20,1,2,3
19133,elabo,,20,143,151,294
19134,chrchr,,20,4,2,6
19135,marcelk72,,16,3,1,4
19136,jegub,,19,8,18,26
19137,ObamaGuy,,13,85,43,128
19138,mainmise,,3,16,33,49
19139,mel17,,18,64,1,65
19140,n3when,,13,322,59,381
19141,somewheregladlybyond,,0,3,4,7
19142,no-handlebars,,13,63,54,117
19143,scoffjaw,,20,11,11,22
19144,bumbleskull,,18,4,3,7
19145,tebeka,,20,1,3,4
19146,green538,,15,2,1,3
19147,billybantha,,13,2,5,7
19148,TL_DR,,1,82,136,218
19149,lil_rag_dolly,,5,8,20,28
19150,pfeester,,1,10,28,38
19151,wingman187,,18,102,27,129
19152,uspatentpending,,39,3,3,6
19153,jakoshako,,34,1,1,2
19154,arazzook,,19,4,5,9
19155,spyderman4g63,,1,20,36,56
19156,Badfaith,,30,14,25,39
19157,fydo,,20,3,2,5
19158,unshift,,20,17,18,35
19159,PennFarmer,,6,4,1,5
19160,gerfboy,,18,1,1,2
19161,grendelt,,27,205,196,401
19162,baltoo,,20,19,39,58
19163,sheepson_apprentice,,20,126,198,324
19164,semishock,,34,107,32,139
19165,smakusdod,,43,154,116,270
19166,HeyWoodJ,,19,3,9,12
19167,ArcoOost,,20,1,1,2
19168,millyuns1,,4,1,2,3
19169,J-Dubbs,,19,10,21,31
19170,shmikshmak,,4,5,4,9
19171,snowboard420,,5,3,2,5
19172,applematt389,,31,22,29,51
19173,derp_derp_derp,,42,34,71,105
19174,teebird150,,38,2,6,8
19175,34_cent_stampede,,33,1,2,3
19176,mpclark,,22,37,58,95
19177,spellboots,,20,5,7,12
19178,ivigurrl,,29,3,5,8
19179,delano,,36,3,1,4
19180,ciurana,,42,2,5,7
19181,simonofsocal,,12,22,16,38
19182,PanglossCalgary,,19,8,10,18
19183,venndiagram,,13,3,2,5
19184,JaneDoe7,,19,1,1,2
19185,misterPhyrePhox,,20,6,11,17
19186,w14,,13,16,3,19
19187,Muffaletta,,2,2,2,4
19188,voeslauer,,20,63,73,136
19189,redclit,,20,9,12,21
19190,Atheistkurd,,14,4,3,7
19191,fxjohn,,1,1,3,4
19192,coldbrook,,19,702,369,1071
19193,6553321,,13,101,193,294
19194,Rudy_Kazootie,,18,2,4,6
19195,just_saying,,23,1,1,2
19196,easytiger,,20,508,696,1204
19197,celebmonkey,,34,7,1,8
19198,skins,,19,3,1,4
19199,soniko,,20,1,1,2
19200,capsteve,,1,5,5,10
19201,Hoek,,36,2,2,4
19202,jlouis8,,20,6,17,23
19203,scbalazs,,13,70,10,80
19204,aunty_american,,19,5,18,23
19205,Monso,,18,57,143,200
19206,afd8856,,20,2,3,5
19207,krazzy4fun,,4,10,1,11
19208,Tombstone0,,18,1,1,2
19209,bagelfish,,18,14,26,40
19210,mufafa,,13,3,2,5
19211,crshngblks,,8,4,9,13
19212,HughDB,,34,10,2,12
19213,LocalScope,,19,11,13,24
19214,dbenbenn,,20,5,7,12
19215,jsprat,,43,7,13,20
19216,jjarvjp,,11,1,1,2
19217,ffrinch,,20,29,46,75
19218,rehwaldt,,13,13,3,16
19219,joshmatthews,,20,25,13,38
19220,aurifex,,22,19,37,56
19221,yortuk,,19,98,138,236
19222,ChairmanWow,,2,7,6,13
19223,dorlov,,6,12,29,41
19224,wekulm,,1,147,230,377
19225,bac9705,,13,32,34,66
19226,potacle,,18,2,5,7
19227,huy666,,31,125,190,315
19228,spiral773,,33,2,2,4
19229,DrCliffHuxtable,,22,3,1,4
19230,fractalman,,13,14,17,31
19231,postmodernist,,19,1,2,3
19232,rogue_1081,,21,12,29,41
19233,MrOrielly,,19,3,2,5
19234,schar,,22,91,32,123
19235,mrfoof82,,0,32,25,57
19236,walonline,,3,12,10,22
19237,alsosf,,1,59,10,69
19238,ButILoveSubmart,,31,1,2,3
19239,the_trve,,22,5,9,14
19240,jondayspring,,0,15,4,19
19241,paintballboi07,,4,6,4,10
19242,lhmerritt,,19,4,18,22
19243,RaduH,,32,1,1,2
19244,kajs,,43,4,1,5
19245,Drasla,,18,113,65,178
19246,tony-28,,31,523,731,1254
19247,wtf204,,14,1,1,2
19248,wellhell,,13,386,386,772
19249,Stomper---,,34,5,5,10
19250,Gontoran,,19,29,73,102
19251,ted_mielczarek,,20,2,3,5
19252,nkad,,4,1,1,2
19253,DotNetster,,20,9,18,27
19254,energyguy,,33,1,1,2
19255,dougbdl,,13,250,272,522
19256,GatesBill,,6,5,4,9
19257,gobrowns1,,31,9,10,19
19258,plat00n,,18,32,13,45
19259,thomasjpaine,,19,3,8,11
19260,yoghurt,,18,16,30,46
19261,onalark,,20,19,6,25
19262,x5315,,11,12,44,56
19263,meatrepeat,,30,1,3,4
19264,Stephy304,,21,13,1,14
19265,Rubbadubbabubba,,19,12,27,39
19266,dashik,,18,3,5,8
19267,exscape,,20,323,413,736
19268,new-frontier,,18,27,33,60
19269,ArtDeco,,18,1,3,4
19270,doubleplus_,,32,3,1,4
19271,socialexpert,,5,317,46,363
19272,random_dude,,30,12,4,16
19273,wilywampa,,0,7,13,20
19274,sbarnabas,,20,59,64,123
19275,f-uckyou,,23,1,3,4
19276,amielb,,18,2,1,3
19277,Lurcho,,18,27,42,69
19278,jasonbourne1,,38,1,4,5
19279,ke4mtg,,42,61,5,66
19280,grantrules,,18,102,117,219
19281,binarylogik,,19,172,283,455
19282,Workingspacepope,,0,27,41,68
19283,Rub3X,,18,3,6,9
19284,clonnus,,13,4,5,9
19285,sounddude,,13,39,41,80
19286,dataman85,,20,1,5,6
19287,badandy80,,18,5,1,6
19288,Notmyrealname,,27,1296,1464,2760
19289,anonymou5,,31,1,2,3
19290,zelladolphia,,32,4,3,7
19291,xing808,,31,33,56,89
19292,IAmGayForJesus,,32,5,7,12
19293,spastichabits,,18,313,21,334
19294,iwantthatpluginnow,,42,3,1,4
19295,fretn,,1,3,15,18
19296,Scabdates,,19,22,1,23
19297,rebug,,0,91,124,215
19298,EclipseGSX,,31,22,19,41
19299,tulita_pepsee,,8,1,4,5
19300,XyzzyYYZ,,42,1,1,2
19301,cyb3rdemon,,20,35,7,42
19302,vanitycrisis,,20,2,2,4
19303,fracatsa,,30,16,13,29
19304,quaju,,22,57,95,152
19305,runn1ng,,31,7,12,19
19306,borodino,,13,250,278,528
19307,DeadPharaoh,,19,22,1,23
19308,Stupid_Idiot,,13,44,130,174
19309,jetskibob,,43,8,6,14
19310,tcardone05,,6,20,8,28
19311,BadAstronomer,,41,3,2,5
19312,panga,,18,3,3,6
19313,Paper_Doll,,18,1,1,2
19314,rascal_the_cat,,13,9,4,13
19315,harshadsharma,,20,1,5,6
19316,swe39,,12,52,92,144
19317,bigred9,,19,24,53,77
19318,natural_smurf,,18,33,52,85
19319,battlebeans33,,13,8,20,28
19320,dackmilliken,,1,3,6,9
19321,georgedonnelly,,31,205,105,310
19322,omelettedufromage,,8,21,25,46
19323,robreact,,20,33,2,35
19324,SKULL_FUCK_HILLARY_C,,19,12,32,44
19325,las3rjock,,20,3,5,8
19326,SpookyPossum,,9,1,2,3
19327,taeth11,,1,2,3,5
19328,shrekie,,13,68,13,81
19329,TOWINGISRUNBYTHEGOVT,,0,3,2,5
19330,Sadist,,42,61,121,182
19331,duwanis,,20,1,2,3
19332,Dr_Teeth,,29,22,37,59
19333,sucinimad,,5,38,60,98
19334,phillyrocks,,13,10,1,11
19335,generic230,,0,40,64,104
19336,sqlrargif,,39,1,1,2
19337,saudade,,20,55,64,119
19338,TheBluesman,,19,131,195,326
19339,theidiot,,32,18,23,41
19340,sheerpanic,,5,2,3,5
19341,montanodiana,,43,2,1,3
19342,Fedorr,,0,39,13,52
19343,cbapel,,14,34,54,88
19344,evilbunny,,19,107,138,245
19345,doctorcurly,,43,4,5,9
19346,kking,,0,591,24,615
19347,mtfmtfmtfmtf,,34,15,26,41
19348,npatu,,20,4,3,7
19349,mbrodge,,1,69,143,212
19350,leon1725,,43,5,15,20
19351,TheIDontGetItGuy,,1,1,1,2
19352,geoff4222,,32,1,1,2
19353,philogb,,20,28,16,44
19354,eugenegamma,,19,1,2,3
19355,cshivers,,30,102,90,192
19356,WillSmits,,32,80,4,84
19357,revella,,13,2,1,3
19358,xachro,,1,90,86,176
19359,mattomatic,,8,1,1,2
19360,jeniferlopaz,,7,1,1,2
19361,rubygeek,,20,115,208,323
19362,Neuroomg,,12,34,49,83
19363,snowmew,,34,14,11,25
19364,joevans,,20,1,2,3
19365,feelsgoodman,,34,1,3,4
19366,itsdrw,,1,4,21,25
19367,john9539,,22,1,1,2
19368,nicholeluvsya,,5,1,1,2
19369,forgetnight,,32,4,8,12
19370,kruz11,,13,3,1,4
19371,dan1980ct,,5,38,61,99
19372,abc2008,,13,29,25,54
19373,breakbeat,,20,26,12,38
19374,formido,,4,297,359,656
19375,blaheeek,,19,1,1,2
19376,BraveSirRobin,,8,1804,2860,4664
19377,tldr,,31,3,6,9
19378,VAMPIRE_BITER,,30,1,1,2
19379,andakawa,,12,5,14,19
19380,zidium,,11,1,1,2
19381,olr,,20,2,3,5
19382,relocopter,,18,125,77,202
19383,kimmh,,1,2,2,4
19384,hm2k,,18,43,82,125
19385,williamsinister,,19,1,4,5
19386,darreld,,42,1,3,4
19387,glui2001,,0,9,18,27
19388,faitswulff,,1,5,8,13
19389,danoo,,1,45,52,97
19390,o_creat,,1,7,18,25
19391,arthurs,,30,1,1,2
19392,ptman,,20,17,41,58
19393,acoustix,,13,71,5,76
19394,anon1984,,1,46,57,103
19395,blacksuit02,,18,15,18,33
19396,theshadow,,18,2,6,8
19397,xMop,,20,1,3,4
19398,Florianr,,20,25,28,53
19399,hugoz,,40,1,1,2
19400,technotronic5678,,18,27,10,37
19401,spetsacdc,,18,11,5,16
19402,senny,,31,2,4,6
19403,juniormints,,13,27,22,49
19404,Codaflow,,13,2,1,3
19405,nicholasblue,,25,2,4,6
19406,BridgeBum,,20,234,398,632
19407,ldbobby,,4,1,2,3
19408,jrmonaghan,,29,34,27,61
19409,LAXTravelGuru,,5,2,2,4
19410,kingofqueenS60,,18,37,2,39
19411,agerbombmsu13,,19,5,5,10
19412,delkes,,18,1,1,2
19413,garryconn,,5,5,6,11
19414,vanekl,,13,286,454,740
19415,LenIV,,29,1,1,2
19416,nonameidea,,17,3,2,5
19417,theironwok,,5,2,1,3
19418,tkhan456,,32,53,79,132
19419,etoncisum,,7,2,1,3
19420,akittenone,,1,4,1,5
19421,rslarkin,,4,1,1,2
19422,rmcrob,,19,61,72,133
19423,tomj,,0,72,33,105
19424,GustoGaiden,,42,110,52,162
19425,soopaflysam,,13,1,2,3
19426,jaxparrothead,,22,11,18,29
19427,cheez,,19,6,8,14
19428,lafayette0508,,43,69,116,185
19429,netghost,,20,25,32,57
19430,FollowSteph,,22,2,1,3
19431,whitesanjuro,,22,5,9,14
19432,jaw896,,42,1,1,2
19433,chetsss2033,,22,1,1,2
19434,TheManInTheMoon,,13,2,7,9
19435,Alphaquark,,13,3,5,8
19436,mehh,,22,18,15,33
19437,uwcsc,,20,1,2,3
19438,jamespatrick82,,15,16,6,22
19439,akjfd,,22,4,5,9
19440,cerealman,,32,6,8,14
19441,onoodle,,16,1,1,2
19442,markbowman,,18,16,36,52
19443,chocolatechunks,,5,83,132,215
19444,reagan_conservative,,13,20,49,69
19445,porti,,19,54,4,58
19446,shinynew,,1,965,1572,2537
19447,earthnative,,13,9,8,17
19448,TinWoodman,,34,12,2,14
19449,ohai,,13,106,230,336
19450,Vesalius,,8,2,2,4
19451,bewo,,20,16,5,21
19452,haakon,,10,125,152,277
19453,roju,,20,19,40,59
19454,easye,,20,1,2,3
19455,augustss,,20,95,136,231
19456,Dooley,,31,28,53,81
19457,prodigal-sunburn,,19,75,105,180
19458,thethreemoths,,18,2,14,16
19459,lovelight,,4,2,2,4
19460,Tampert,,43,91,169,260
19461,gamersdad,,13,22,3,25
19462,nazirene,,10,1,2,3
19463,john_b,,20,202,258,460
19464,watt,,20,4,9,13
19465,ca98am79,,19,13,4,17
19466,Damietta,,13,12,8,20
19467,fuxsit,,18,14,1,15
19468,Demonot,,29,1,1,2
19469,Damanta,,15,1,1,2
19470,briantt,,43,6,4,10
19471,kohlerm,,20,1,1,2
19472,BorockObomo,,20,4,3,7
19473,lazyhaze,,18,1,1,2
19474,Lumiis,,1,7,3,10
19475,911_was_a_coup_detat,,0,1,1,2
19476,darbar13,,43,3,1,4
19477,michaelbrando,,31,2,1,3
19478,gjs278,,20,243,160,403
19479,ozmars,,32,5,10,15
19480,bOOkwurm,,1,8,13,21
19481,bobbox,,1,5,15,20
19482,JGrind,,5,1,1,2
19483,diebold,,19,3,4,7
19484,fyl5000,,36,2,2,4
19485,RobWtzl,,9,1,1,2
19486,FixingConsultant,,31,15,26,41
19487,LRAD,,18,7,10,17
19488,angrytroll,,30,70,113,183
19489,BaronVonMannsechs,,8,285,437,722
19490,Icewind,,13,5,11,16
19491,Maglgooglarf,,13,3,15,18
19492,Naumadd,,29,2,7,9
19493,phillycheesesteak,,13,1,2,3
19494,sociopath,,43,1,1,2
19495,joedog2112,,18,3,1,4
19496,deralaand,,27,1,3,4
19497,ProudRedneck,,20,1,3,4
19498,ztyler90,,43,87,4,91
19499,deskplant,,15,1,1,2
19500,kyt,,43,1,1,2
19501,Edgeworth,,20,1,1,2
19502,lollers,,19,3,5,8
19503,MrHanky,,18,5,3,8
19504,mclovin23,,1,1,1,2
19505,ftard,,34,1,2,3
19506,sheepdays,,32,18,15,33
19507,Jonnny,,18,6,9,15
19508,mattomatica,,20,8,17,25
19509,chaztized,,21,39,68,107
19510,sense,,19,642,251,893
19511,Chetan7,,13,253,58,311
19512,reddit_ro2,,41,46,125,171
19513,public_nme,,3,30,58,88
19514,tHePeOPle,,8,172,244,416
19515,kissthering,,20,3,4,7
19516,JimMarch,,20,50,39,89
19517,Babooboo,,43,1,2,3
19518,redmosquito,,1,65,130,195
19519,villainintheirowneye,,19,3,2,5
19520,sextusempiricus,,31,151,190,341
19521,smokeykongjr,,0,1,1,2
19522,tk423,,39,35,37,72
19523,jlbraun,,17,307,445,752
19524,n3verm0re,,18,12,4,16
19525,Gnillort,,43,4,6,10
19526,analboy,,29,1,2,3
19527,sambo357,,20,45,90,135
19528,zerny,,20,2,4,6
19529,latenightcoder,,20,2,6,8
19530,dwomick,,13,1,2,3
19531,marcg,,35,2,3,5
19532,Ratel,,13,27,50,77
19533,CaraDame,,13,1,1,2
19534,verstohlen,,35,234,357,591
19535,thingie1234,,18,1,1,2
19536,Archz714,,18,15,19,34
19537,byron000,,3,1,3,4
19538,jjzeidner,,31,78,104,182
19539,delicat,,30,45,47,92
19540,grapplerke,,18,18,33,51
19541,lewism101,,0,4,5,9
19542,jrmy,,23,11,20,31
19543,GreenSmith,,34,3,1,4
19544,Excilsploft,,11,1,1,2
19545,Leonard_PriceIsRight,,32,1,1,2
19546,stevedekorte,,20,10,13,23
19547,trashhalo,,18,10,1,11
19548,halcyonw,,19,2,3,5
19549,Alyre,,19,11,16,27
19550,glyph42,,29,69,116,185
19551,Rigd,,18,11,24,35
19552,lemonodor,,20,2,2,4
19553,ivanmt42,,18,2,1,3
19554,redditdna,,18,15,16,31
19555,MrSt1lbak,,20,2,2,4
19556,monkeypizza,,20,3,8,11
19557,heresjohnny,,12,1,1,2
19558,Demosthenes_,,31,50,35,85
19559,MarkWalberg,,1,5,2,7
19560,hektor_rah,,6,1,1,2
19561,tierrie,,12,17,22,39
19562,charlie6,,1,2,4,6
19563,kaudavis,,19,30,62,92
19564,onethumb,,3,2,1,3
19565,joearnold,,34,1,1,2
19566,electric_mouse,,20,4,9,13
19567,steve_holt,,43,2,1,3
19568,veganbikepunk,,29,196,172,368
19569,lambert,,19,7,2,9
19570,braclayrab,,1,59,77,136
19571,treytech,,1,6,8,14
19572,kle,,6,25,29,54
19573,tjkamp,,17,1,1,2
19574,declercq,,13,14,1,15
19575,collintc,,1,1,2,3
19576,imtyler,,34,1,1,2
19577,billisdog,,13,12,4,16
19578,ceramicsbd,,19,4,4,8
19579,terwin,,19,42,65,107
19580,hockeyboss77,,18,11,10,21
19581,joeldevahl,,20,51,69,120
19582,stevekeene,,43,5,13,18
19583,Kennosuke,,4,9,5,14
19584,roven,,20,3,1,4
19585,mctk,,18,5,1,6
19586,Startt,,18,9,1,10
19587,chargeboo,,13,1,4,5
19588,uedauhes,,20,18,27,45
19589,firehazard07,,43,17,29,46
19590,adx,,20,30,14,44
19591,zepolen,,20,112,116,228
19592,BronzeG3,,18,2,4,6
19593,sndtech,,43,14,20,34
19594,staskies,,1,4,6,10
19595,Kaer,,22,564,315,879
19596,iwantonetoo,,1,1,7,8
19597,Sledge420,,11,2,4,6
19598,tsuga,,18,16,7,23
19599,welliamwallace,,18,9,17,26
19600,RayWestWife,,1,1,1,2
19601,somedude0101,,13,1,1,2
19602,implausibleusername,,20,65,109,174
19603,gronkpan,,15,3,9,12
19604,NoComment7,,32,251,161,412
19605,tadmad,,18,17,1,18
19606,frotz,,8,4,4,8
19607,shiftylonghorn,,18,11,39,50
19608,TheHarlequin,,22,1,1,2
19609,residentskitz,,22,72,79,151
19610,brochi11,,32,2,2,4
19611,davids,,14,1,6,7
19612,slidinglight,,43,146,178,324
19613,MrGrover,,12,2,2,4
19614,tikhonov,,1,65,33,98
19615,tribalwaif,,20,1,4,5
19616,Icefox2k,,42,24,20,44
19617,hiddenone51,,4,1,1,2
19618,tehinternetpolicia,,18,8,11,19
19619,trippit,,19,11,1,12
19620,schmigeggyrules,,3,1,1,2
19621,l3v1,,20,1,2,3
19622,friendly_fire29,,20,2,4,6
19623,hamster101,,18,20,41,61
19624,isr,,43,1,1,2
19625,hansahni,,43,4,6,10
19626,CrotchStomper,,13,13,3,16
19627,tommyrxc,,1,26,14,40
19628,barkusmuhl,,19,1,1,2
19629,IsThatLatin,,32,7,1,8
19630,kingkoopa,,32,3,2,5
19631,jamesblonde,,19,68,225,293
19632,Halcyon3,,18,1,1,2
19633,WIR,,13,3,2,5
19634,mattizmyname,,43,1,1,2
19635,Dr_Horrible,,5,1,6,7
19636,Austechnic,,13,101,227,328
19637,chaos5482,,29,1,1,2
19638,brttf3,,32,31,34,65
19639,inotocracy,,18,4,19,23
19640,Darven_Marvin,,1,2,2,4
19641,tincanorange,,8,2,2,4
19642,ntz,,5,1,1,2
19643,kmully,,42,80,36,116
19644,matt_rudo,,43,40,89,129
19645,ramshackle,,32,16,4,20
19646,frukt,,20,795,756,1551
19647,marlow-huxley,,19,4,4,8
19648,stevedclarke,,8,255,686,941
19649,okkoto,,13,359,276,635
19650,exedore,,7,1,2,3
19651,Cat-Hax,,18,1,4,5
19652,jbrendel,,20,12,6,18
19653,shannonGB,,18,2,2,4
19654,happyax,,19,64,69,133
19655,c_dugan,,43,4,8,12
19656,dbeach24,,20,2,3,5
19657,asdfgasf2ds22,,6,3,4,7
19658,meatmcgee,,19,5,2,7
19659,margol,,20,1,1,2
19660,styphan,,38,2,4,6
19661,GINTER,,1,41,103,144
19662,ayuh,,29,2,2,4
19663,rottenchester,,19,5,1,6
19664,joeware,,43,1,4,5
19665,RaulDeLa,,13,1,1,2
19666,wacrover,,1,441,199,640
19667,mthe0ry,,19,162,257,419
19668,teatree,,13,2,4,6
19669,vanostran,,22,368,709,1077
19670,KoldKompress,,43,152,251,403
19671,kmshiva,,20,5,12,17
19672,the4nimal,,18,2,8,10
19673,ryy0,,18,7,13,20
19674,cheesemoose,,18,7,19,26
19675,The_old_rambler,,5,8,11,19
19676,Spik3balloon,,12,8,9,17
19677,super_man_dat_ho,,19,11,11,22
19678,profoundwhatever,,32,1,3,4
19679,snikkerz,,19,16,30,46
19680,Chairboy,,3,182,166,348
19681,wireduse,,30,4,11,15
19682,wurzelg,,20,9,6,15
19683,indigochild,,17,59,135,194
19684,watever,,19,3,2,5
19685,halthouse1,,1,7,1,8
19686,OliveDiPace,,36,2,1,3
19687,DesertTripper,,22,2,2,4
19688,turlian,,18,1,6,7
19689,HoorayForCancer,,32,3,12,15
19690,disposableaccount99,,1,2,1,3
19691,centrx,,19,37,63,100
19692,Timeinvestor,,13,14,6,20
19693,PinBallEffect,,19,26,71,97
19694,mortbort,,12,2,2,4
19695,swblackwood,,19,11,10,21
19696,szza,,19,8,9,17
19697,pierretrudeau,,31,1,2,3
19698,KalalauKind,,13,9,8,17
19699,drunknomad,,18,7,7,14
19700,odstwar,,18,7,2,9
19701,jswoods7,,5,19,2,21
19702,buddhazen,,19,199,124,323
19703,jskulski,,18,8,10,18
19704,wwusnobrdr,,20,3,2,5
19705,alrexx,,34,5,30,35
19706,Philosoraptor,,13,12,14,26
19707,spiltoil,,14,1,1,2
19708,rseymour,,1,39,89,128
19709,Wesa,,22,1,4,5
19710,canyouhearme,,31,307,221,528
19711,bishop1847,,20,20,17,37
19712,ter-kee-ber-gers,,20,1,5,6
19713,CatCatCat,,5,45,34,79
19714,CommentsAboutBlimp,,19,2,17,19
19715,EricTheR3d,,19,3,7,10
19716,Bowinja,,1,2,8,10
19717,vamoose,,19,2,1,3
19718,vianetman,,22,1,1,2
19719,tidderdit,,43,124,59,183
19720,rfugger,,19,209,221,430
19721,beelzebobby,,19,168,331,499
19722,thebeanseller,,43,7,12,19
19723,Charismaticmegafauna,,1,22,17,39
19724,yk_42,,1,5,6,11
19725,mojowind,,1,1,1,2
19726,duvel,,22,28,27,55
19727,mars33,,19,7,18,25
19728,TuringExaminer,,18,42,33,75
19729,octopush,,32,5,8,13
19730,nekron,,20,3,1,4
19731,cDc-Arrakis,,10,10,4,14
19732,balkotn2,,14,2,2,4
19733,pookiesdame,,13,99,19,118
19734,udelstudent,,17,1,1,2
19735,anamanaman,,20,6,5,11
19736,chickenblender,,18,7,16,23
19737,le_cheese,,19,24,108,132
19738,kbrower,,12,79,22,101
19739,TheNorris,,31,19,30,49
19740,optimisticnothopeful,,29,3,5,8
19741,TwoAndOut,,34,1,1,2
19742,beltenebros,,30,57,75,132
19743,i_h8_r3dd1t_3,,30,10,10,20
19744,funtodo1,,18,3,3,6
19745,Derosa6037,,30,106,212,318
19746,flipdagger,,12,3,5,8
19747,Quacks,,1,3,1,4
19748,chumsley,,0,1,2,3
19749,muneeb1k,,4,1,1,2
19750,naptime,,12,1,1,2
19751,fishmonger,,32,61,36,97
19752,suedehead,,0,1,2,3
19753,ph0rque,,20,47,49,96
19754,tvon,,32,59,66,125
19755,LeonidWA,,20,1,5,6
19756,BurningShed,,0,9,18,27
19757,Hank_Hill,,1,16,4,20
19758,bdb,,18,2,4,6
19759,Rhole_1983,,19,9,16,25
19760,brinkly,,27,4,2,6
19761,iamdreamydave,,19,21,24,45
19762,foreignape,,19,5,10,15
19763,pythonpatrol,,5,1,2,3
19764,steerpike404,,20,31,21,52
19765,gregwalker,,18,378,49,427
19766,IsForGrammarNaziThe,,43,1,1,2
19767,jakechance,,13,5,11,16
19768,fragilemachinery,,29,85,137,222
19769,checkonetwo,,1,24,36,60
19770,noxville,,20,1,1,2
19771,goodgord,,18,1,6,7
19772,robotfossil,,16,4,9,13
19773,Husio,,20,2,3,5
19774,Indierocka,,31,29,33,62
19775,user2171828,,23,3,5,8
19776,ITakePostsLiterally,,31,1,1,2
19777,rgelhau,,0,2,1,3
19778,jerohm,,20,1,2,3
19779,hypnopompia,,27,5,6,11
19780,dazb84,,10,3,1,4
19781,tpschi,,13,4,4,8
19782,zoli,,43,49,9,58
19783,sumgai,,18,331,576,907
19784,ryanbooker,,8,3,7,10
19785,lxbruce,,32,3,2,5
19786,tlc,,34,146,34,180
19787,Zenquin,,18,2,2,4
19788,dragonfish,,34,34,3,37
19789,lenst,,20,1,1,2
19790,savestheday,,19,1,2,3
19791,PotatoBasket,,29,56,55,111
19792,MrDubious,,31,106,196,302
19793,perposterone,,32,25,13,38
19794,Izanaki,,18,4,4,8
19795,pomf-studios,,1,9,20,29
19796,1van,,14,2,3,5
19797,xsspider,,43,156,325,481
19798,bigredcat731,,22,42,3,45
19799,vampirical,,20,10,16,26
19800,digeridooo,,19,2,1,3
19801,csimms,,5,9,3,12
19802,pyroguy56011,,18,67,17,84
19803,smoke-n-mirrors,,32,6,6,12
19804,BreastfedQuakeBaby,,36,1,1,2
19805,Paulinker,,34,1,2,3
19806,monamol,,18,10,3,13
19807,obtuse,,19,105,62,167
19808,m4rc,,43,379,50,429
19809,dirckb,,43,7,6,13
19810,ruperp,,20,1,1,2
19811,greefus,,41,1,1,2
19812,kurtseifried,,13,51,64,115
19813,dumper,,18,10,28,38
19814,illuminatedtiger,,20,2,10,12
19815,justinjest,,13,84,173,257
19816,bardak,,30,110,159,269
19817,yaw,,20,18,18,36
19818,jskinner,,20,25,7,32
19819,flaggy,,11,1,2,3
19820,asw66,,13,35,23,58
19821,gnac,,20,3,1,4
19822,yakimushi,,6,3,7,10
19823,FruityRudy,,29,2,2,4
19824,waxpoet,,18,491,124,615
19825,thtroyer,,20,5,2,7
19826,jjsixty6,,18,30,13,43
19827,palindromic,,21,3,1,4
19828,Echospree,,30,163,171,334
19829,fnord23,,20,31,21,52
19830,roulder,,11,7,10,17
19831,joehouse,,32,83,81,164
19832,pokeyman,,13,12,6,18
19833,jjo_chicago,,22,5,4,9
19834,HoneyBaked,,32,4,11,15
19835,ailuromaniac,,2,4,4,8
19836,nickfox,,15,2,2,4
19837,Kry2727,,6,6,9,15
19838,zumbi,,19,32,27,59
19839,spinned,,0,2,3,5
19840,ijontichy,,20,48,109,157
19841,xcsdm,,20,1,1,2
19842,elnefasto,,10,93,86,179
19843,yo-less,,19,1,2,3
19844,icefreez,,18,2,3,5
19845,wexpen,,5,11,9,20
19846,stankaaron,,34,9,8,17
19847,cwhite54,,13,24,39,63
19848,srbrower,,1,1,1,2
19849,pooltable,,18,53,13,66
19850,connerfer,,32,9,10,19
19851,cencio,,20,3,3,6
19852,kuboaa,,5,1,4,5
19853,superdelegate,,18,26,6,32
19854,joeyguerra,,34,3,5,8
19855,flyinglunatic,,20,83,92,175
19856,oomiak,,13,99,15,114
19857,duckfighter,,8,4,5,9
19858,imagif,,43,11,13,24
19859,death2hypocrisy,,32,536,409,945
19860,mikenice1,,43,389,246,635
19861,adansko,,19,11,15,26
19862,Rhonse,,18,1,8,9
19863,iregretnothing,,1,3,1,4
19864,Jezon,,1,1,4,5
19865,raavi,,5,6,7,13
19866,snotmonster,,31,1,1,2
19867,gangstalking,,8,1,1,2
19868,Mashni,,31,6,10,16
19869,garthzares,,34,2,2,4
19870,phmfthacim,,8,176,279,455
19871,ldsgems,,40,526,148,674
19872,ScreamingVeggies,,13,1,6,7
19873,cyn42,,1,2,2,4
19874,hungryhungryhorus,,19,89,153,242
19875,_Mazza_,,22,35,16,51
19876,rwaltz,,17,10,9,19
19877,gnick,,20,45,14,59
19878,yuubi,,31,27,57,84
19879,oilgarch,,31,3,3,6
19880,futsal,,19,9,21,30
19881,108Rats,,13,32,17,49
19882,numballover,,0,1,5,6
19883,gar37bic,,19,24,55,79
19884,ArmandoPenblade,,17,14,18,32
19885,madrone,,31,4,5,9
19886,Bob3333,,31,7,8,15
19887,clslaw,,13,6,1,7
19888,ddigger,,41,97,39,136
19889,LineNoise,,22,33,28,61
19890,technoman,,19,2,4,6
19891,raptorshadow,,1,39,69,108
19892,jcargoo,,20,16,4,20
19893,ToCatchAPredator,,19,9,14,23
19894,cloch,,29,1,1,2
19895,putainsdetoiles,,19,28,37,65
19896,demosthenes226,,19,1,4,5
19897,JStar,,18,29,38,67
19898,gid13,,29,764,779,1543
19899,jhidekim,,42,17,24,41
19900,luminance,,42,26,38,64
19901,shizukanikudasai,,4,8,13,21
19902,sweetjuniper,,20,4,2,6
19903,_omestes_,,22,18,14,32
19904,bouncingsoul,,20,40,12,52
19905,Himbury,,18,11,34,45
19906,ricecake,,3,206,268,474
19907,lizacolby,,43,1,2,3
19908,bmorris,,30,145,52,197
19909,T-Head,,18,1,2,3
19910,C0y0t3,,13,21,22,43
19911,cunning001,,2,1,2,3
19912,moji,,19,35,37,72
19913,brendastarr,,18,5,18,23
19914,Freonce,,12,112,147,259
19915,ekahs,,18,2,2,4
19916,antisvin,,20,1,3,4
19917,average-guy,,31,22,13,35
19918,mielles,,2,115,4,119
19919,nynjagrrl2k8,,19,1,7,8
19920,ecran,,13,16,2,18
19921,moveyourcar1891,,1,2,1,3
19922,major_malfunction,,12,1,1,2
19923,foldl,,20,263,384,647
19924,tellmesomething,,26,8,1,9
19925,leavenisaplace,,17,14,40,54
19926,fullinfinity,,20,2,9,11
19927,purplegrog,,0,12,21,33
19928,DeadRooster,,0,27,7,34
19929,steveketchen,,18,36,72,108
19930,matoto,,19,9,5,14
19931,tripdub,,1,78,126,204
19932,DLWormwood,,20,229,429,658
19933,LeoPanthera,,18,11,7,18
19934,booly3412,,18,47,3,50
19935,rubygirl,,21,6,2,8
19936,netsql,,19,38,74,112
19937,vTwoPoint,,26,1,1,2
19938,gnupate,,20,17,3,20
19939,baxissimo,,20,5,11,16
19940,BeardBeeman,,19,4,9,13
19941,willcodeforfoo,,20,11,5,16
19942,blowcarrot,,26,5,2,7
19943,traphicone,,19,53,40,93
19944,prozackills,,0,2,1,3
19945,volta,,3,85,97,182
19946,emortio,,13,11,6,17
19947,manifestdustiny,,4,14,18,32
19948,harlos,,20,25,37,62
19949,darkbob,,1,102,84,186
19950,ruesdedr,,19,383,702,1085
19951,opethfan,,22,4,1,5
19952,FiredFox,,18,95,112,207
19953,jrifkin,,18,1,10,11
19954,kaioti,,0,24,68,92
19955,forlong,,18,13,4,17
19956,dustyRods,,38,1,1,2
19957,padt,,20,7,7,14
19958,gravity,,20,128,179,307
19959,anshou,,18,41,4,45
19960,catnutter,,13,22,29,51
19961,Ahri,,42,4,17,21
19962,bjtitus,,32,18,34,52
19963,dentz1,,31,1,2,3
19964,TheAbominableDavid,,31,16,15,31
19965,EpaL,,32,2,1,3
19966,r0botluv,,13,13,12,25
19967,neouser99,,20,3,10,13
19968,rpatel10,,18,224,11,235
19969,osoese,,13,22,41,63
19970,GrowSomeBallzz842,,22,1,1,2
19971,Dorkster,,1,1,1,2
19972,aphall,,5,6,12,18
19973,Mitch_Bolling,,9,4,4,8
19974,dshah,,36,7,3,10
19975,exmor,,1,3,8,11
19976,Dafuzz,,1,272,442,714
19977,knockingononions,,43,10,5,15
19978,glbtrottr,,31,15,1,16
19979,ritubpant,,18,433,21,454
19980,Recondite,,20,3,2,5
19981,critsalot,,30,13,25,38
19982,yarriofultramar,,43,1,4,5
19983,rkh,,22,5,8,13
19984,boundlessgravity,,13,5,3,8
19985,ahnold,,20,12,2,14
19986,Griffix01,,13,8,1,9
19987,r3m0t,,8,182,252,434
19988,trackerbishop,,0,561,525,1086
19989,robvert,,19,7,6,13
19990,jarocho,,42,10,22,32
19991,jonathan_rass,,20,1,1,2
19992,salad,,0,3,5,8
19993,cweathers,,13,92,1,93
19994,hobe,,19,46,40,86
19995,aidanpryde18,,18,1,1,2
19996,Slartibartfasst,,31,1,1,2
19997,nicku,,21,1,3,4
19998,Quel,,19,392,454,846
19999,slugsly,,31,7,8,15
20000,ighost,,20,70,96,166
20001,robreim,,20,74,111,185
20002,mattg1138,,11,1,1,2
20003,drcoppersmith,,13,4,11,15
20004,dittoalex,,11,30,38,68
20005,bigmac,,20,124,9,133
20006,jumping_hump,,32,11,16,27
20007,Maxcactus,,19,1208,434,1642
20008,gtod,,41,4,1,5
20009,deshi,,31,3,7,10
20010,IFapThereforeIAm,,32,2,1,3
20011,P_Crow,,18,14,40,54
20012,semanticprecision,,20,86,103,189
20013,chile,,4,1,2,3
20014,BelindaMarie,,17,42,33,75
20015,pawpaw,,18,18,11,29
20016,whereiswooby,,1,9,16,25
20017,onepage,,42,2,1,3
20018,MarcHausman,,34,3,1,4
20019,puserht,,43,4,2,6
20020,jovensdisciple,,13,14,13,27
20021,Dresta,,0,14,9,23
20022,waffleking,,18,11,13,24
20023,B_Cannon,,43,7,6,13
20024,sn76477,,18,7,5,12
20025,sugarandice,,30,15,32,47
20026,apeman32,,4,1,2,3
20027,Jemvolution,,34,16,53,69
20028,McMarthy_was_Liberal,,41,2,1,3
20029,steaprok,,13,139,8,147
20030,Holyhabanero,,13,3,1,4
20031,chaospherezero,,31,20,13,33
20032,antlovesraj,,12,3,2,5
20033,r3al1tych3ck,,0,2,1,3
20034,rustintable,,32,1,1,2
20035,Geek_tank,,18,21,87,108
20036,ryani,,20,6,7,13
20037,RideTheBigWave,,13,36,58,94
20038,noneofthat,,16,1,2,3
20039,slyspred,,13,2,11,13
20040,Waterstraal,,29,4,4,8
20041,paintedshadows,,19,2,1,3
20042,EggplantWizard,,1,82,98,180
20043,gamoholic,,42,142,2,144
20044,cathpah,,35,2,6,8
20045,cavu,,29,1,1,2
20046,wnoise,,20,183,405,588
20047,swinghammer,,19,26,42,68
20048,EvilStreaks,,2,1,2,3
20049,anti-socia,,12,2,1,3
20050,peter_p_s,,17,1,1,2
20051,milkmandan,,6,236,89,325
20052,lingonsylt,,18,1,1,2
20053,gustavo1999,,17,2,3,5
20054,wet_ripper,,40,1,1,2
20055,justbeachy,,13,37,6,43
20056,sosuke,,20,44,32,76
20057,SicTim,,5,103,208,311
20058,fjr1966,,26,2,2,4
20059,blablablablabla78,,31,61,93,154
20060,ElMoog,,33,2,1,3
20061,the_first_rule,,19,225,214,439
20062,ccb0101001,,31,1,2,3
20063,19quest64,,42,1,5,6
20064,sw3t,,15,1,3,4
20065,Marietto,,31,6,11,17
20066,aaronpowell,,32,32,6,38
20067,wangphoebe,,31,1,1,2
20068,amassivetree,,20,35,41,76
20069,HarryWatson00,,5,15,15,30
20070,nanothief,,20,3,6,9
20071,yelsgib,,42,35,39,74
20072,theanswer,,22,9,5,14
20073,chjunior,,20,2,1,3
20074,grendel266,,30,9,1,10
20075,lgc90,,42,29,35,64
20076,charliepark,,1,1,3,4
20077,spinguru,,13,3,16,19
20078,jtmWIEN,,4,26,19,45
20079,havox,,1,8,16,24
20080,mungojelly,,8,25,37,62
20081,savanttm,,31,42,85,127
20082,Boffy31,,22,14,1,15
20083,shanebroue,,34,1,1,2
20084,orbit1979,,41,18,26,44
20085,Pupuluru,,22,1,1,2
20086,rachet,,1,70,26,96
20087,carefulclaire,,43,5,6,11
20088,JakePM,,5,1,1,2
20089,walksonground,,1,508,378,886
20090,remyduvalle,,18,22,49,71
20091,jsrn,,32,28,4,32
20092,cliffy2000,,18,107,6,113
20093,haoest,,11,845,877,1722
20094,ryangreenberg,,20,1,5,6
20095,warnerrr,,18,77,73,150
20096,iigloo,,0,94,134,228
20097,Catchwa,,18,1,1,2
20098,TundraWolf_,,16,42,62,104
20099,watoad,,1,3,8,11
20100,Birdoftruth,,31,66,54,120
20101,tobidope,,27,4,2,6
20102,wlovins,,6,17,8,25
20103,cobras36,,13,1,3,4
20104,sumzup,,18,67,79,146
20105,gjwatersjr,,31,72,111,183
20106,Bobagonoush,,9,6,16,22
20107,markus40,,13,3,9,12
20108,2014,,18,2,1,3
20109,acataleptic,,31,10,8,18
20110,bigbird123,,4,1,1,2
20111,djrubbie,,20,17,28,45
20112,Mother_Nature,,20,1,1,2
20113,aliasmark,,18,2,2,4
20114,pragmattica,,20,2,2,4
20115,badgetbaster,,20,26,1,27
20116,ziyue,,13,7,21,28
20117,Moogy,,13,108,47,155
20118,mark_rogers,,19,1,13,14
20119,pisstoff,,4,1,1,2
20120,Bertez,,18,2,9,11
20121,fricken,,12,47,48,95
20122,pb1x,,19,525,323,848
20123,phath0m,,31,1,4,5
20124,samdude1400,,43,5,6,11
20125,abortions_for_jesus,,0,9,12,21
20126,djr123456,,19,1,3,4
20127,Quibbler,,32,1,5,6
20128,0tehHum4n1ty,,43,20,10,30
20129,casicatracha,,31,311,475,786
20130,yiyus,,32,3,12,15
20131,Spacecow,,18,152,156,308
20132,RoboBama,,1,82,64,146
20133,bpsarch,,43,1,1,2
20134,KurtC,,18,7,1,8
20135,Ozob,,13,162,24,186
20136,DobBobbs,,13,14,17,31
20137,slappyotoole,,31,6,8,14
20138,samamama,,18,3,4,7
20139,serverslayer,,18,17,24,41
20140,trackstr,,18,1,1,2
20141,tvshopceo,,20,396,484,880
20142,mavrc,,1,57,72,129
20143,reeses,,30,15,15,30
20144,irina_ooo,,22,1,1,2
20145,LordGarak,,30,27,43,70
20146,theDavidMartin,,19,3,9,12
20147,engrams187,,34,3,3,6
20148,luiohh,,18,11,10,21
20149,apollo,,18,257,294,551
20150,Smoogy,,18,5,13,18
20151,ShabbyDoo,,27,29,32,61
20152,uncalm,,12,3,2,5
20153,noorits,,0,152,120,272
20154,deflowd,,22,141,199,340
20155,Tblue,,18,30,3,33
20156,rhymantha,,5,5,4,9
20157,venetianbears,,22,5,6,11
20158,violetplanet,,13,381,35,416
20159,johnhutch,,1,199,283,482
20160,zingyo,,19,2,1,3
20161,thirdoffive,,29,248,257,505
20162,hatekillpuke,,18,423,570,993
20163,goldenflaw,,6,1,2,3
20164,4FourtyTwo2,,0,9,10,19
20165,4zimuth,,20,1,3,4
20166,givemesomespamplease,,32,1,4,5
20167,MuckyMuck,,22,12,20,32
20168,mplshawk,,13,1,1,2
20169,corevirus,,42,222,221,443
20170,eerock,,1,9,18,27
20171,ginormous,,16,3,7,10
20172,howardthegeek,,1,1,2,3
20173,ncbutters,,1,2,1,3
20174,phoenix96,,13,8,4,12
20175,context,,19,4,4,8
20176,wantwealth,,13,18,25,43
20177,maniaq,,26,191,428,619
20178,iStoner,,42,146,178,324
20179,Golfo,,13,148,294,442
20180,dpseymour,,6,1,2,3
20181,MrSplashyPants,,29,2,1,3
20182,BenHanby,,11,35,55,90
20183,required2,,13,16,29,45
20184,thespag,,18,69,84,153
20185,martinezgeovani,,43,1,3,4
20186,metroman1,,20,24,28,52
20187,notlem,,31,4,5,9
20188,aadsm,,22,1,1,2
20189,IrvingMorningstar,,1,16,11,27
20190,bamboobay,,13,14,2,16
20191,fenderlespaul,,11,1,3,4
20192,jedberg_future,,43,1,1,2
20193,Shadok,,20,4,7,11
20194,jakefff,,19,5,2,7
20195,sloat,,11,42,52,94
20196,Corazon-Ray,,1,1,5,6
20197,ikegami--,,41,1,1,2
20198,Klonoa,,22,15,2,17
20199,kalamay,,32,6,6,12
20200,chedstone,,13,1,2,3
20201,squiggly,,6,22,22,44
20202,kingbling,,43,1,2,3
20203,CaffiendCA,,42,223,171,394
20204,Shalmanese,,32,84,15,99
20205,moomoocow1,,19,1,4,5
20206,AndreTheMidget,,18,4,8,12
20207,Sventheimpailer,,31,20,31,51
20208,zepp157,,20,1,2,3
20209,Xochipilli,,1,57,13,70
20210,vichyssoise,,1,14,2,16
20211,anotherkeebler,,6,1,1,2
20212,r_dr_r,,19,127,10,137
20213,dylanmcd,,20,21,40,61
20214,fas2,,31,3,4,7
20215,UDub9,,34,512,156,668
20216,ukiro,,13,6,7,13
20217,burmask,,21,79,30,109
20218,trhaynes,,1,70,107,177
20219,probablyoffensive,,42,62,127,189
20220,chicklette,,31,4,4,8
20221,minestrone11,,42,138,110,248
20222,plun9,,22,149,144,293
20223,jacktt,,18,12,16,28
20224,tms,,1,45,46,91
20225,gyronic,,19,11,27,38
20226,Beebe_Gallini,,8,1,2,3
20227,yirush,,13,2,5,7
20228,octordoctopus,,20,23,22,45
20229,pixdamix,,20,1,5,6
20230,Swordsmanus,,1,13,28,41
20231,Kimosabe,,18,5,6,11
20232,pantastitic,,31,1,1,2
20233,joshzilla,,20,39,27,66
20234,freetolio,,14,82,132,214
20235,flak,,19,1,3,4
20236,kanile,,43,4,10,14
20237,cdarwin,,0,27,57,84
20238,nitpickki,,20,3,1,4
20239,AmericanNinja,,13,2,1,3
20240,Wordie,,13,717,436,1153
20241,Powel,,43,41,95,136
20242,4598588,,1,3,5,8
20243,matthewmcvickar,,33,4,1,5
20244,invalid_user_name,,20,370,509,879
20245,99sono,,27,1,2,3
20246,thevaw,,42,4,3,7
20247,bendygirl,,13,1,7,8
20248,PersonX2,,43,2,2,4
20249,AprilFools,,43,1,6,7
20250,tomosaki,,34,1,1,2
20251,krogger,,30,4,13,17
20252,jatwood,,18,1,1,2
20253,kodozoku,,19,2,2,4
20254,pfork,,13,41,24,65
20255,patrickgun,,1,11,28,39
20256,awwaiid,,20,2,5,7
20257,hncnscr,,1,21,15,36
20258,redleader,,18,154,148,302
20259,timbrux,,5,1,2,3
20260,aposter,,19,51,104,155
20261,thrashertm,,10,273,409,682
20262,British_Pride,,19,3,3,6
20263,fofo13,,18,61,6,67
20264,1jb1,,19,53,39,92
20265,samsm,,32,22,33,55
20266,ptcbus,,13,1,1,2
20267,neoabraxas,,29,909,466,1375
20268,spockit,,0,1,1,2
20269,liquidcola,,12,234,297,531
20270,gaygeekdude,,42,2,6,8
20271,Yarbles,,19,148,374,522
20272,DoubleDown,,22,111,177,288
20273,qfe0,,13,16,9,25
20274,mindlessrabble,,13,96,30,126
20275,mhawley,,13,1,1,2
20276,thedeevolution,,1,246,236,482
20277,jlv,,0,7,9,16
20278,keepmathy,,19,3,1,4
20279,doink123,,20,11,3,14
20280,grommit,,19,50,4,54
20281,SecretSnack,,32,47,6,53
20282,sergeo_syd,,18,23,31,54
20283,CaptainHex,,20,3,4,7
20284,Taragine,,18,5,4,9
20285,subtractington,,13,103,106,209
20286,alitanveer,,32,1,1,2
20287,davewashere,,31,83,88,171
20288,AbouBenAdhem,,14,343,450,793
20289,Rokka,,27,3,3,6
20290,greymundo,,0,23,53,76
20291,worst,,20,31,16,47
20292,NAUGHTYJONNY,,18,9,26,35
20293,datacaliber,,20,1,4,5
20294,abc2009,,13,10,17,27
20295,amnichols,,5,2,1,3
20296,yellowking,,14,1499,1669,3168
20297,lifeat24fps,,18,177,61,238
20298,tgilbert328,,39,2,3,5
20299,andrejbauer,,20,1,1,2
20300,notdrinkingtoomuch,,30,12,14,26
20301,pointman,,31,328,271,599
20302,flipflopontop,,5,13,38,51
20303,President_Camacho,,20,4,3,7
20304,smackanickatwice,,19,3,10,13
20305,65ghz,,29,1,1,2
20306,eangel,,31,55,81,136
20307,svott,,35,5,6,11
20308,jmolleru,,0,19,28,47
20309,vtmn,,18,3,4,7
20310,bornarchitect,,0,66,4,70
20311,icandothat,,13,1,3,4
20312,Cashing,,43,3,1,4
20313,Muleburner,,36,81,128,209
20314,JeanneP,,19,18,42,60
20315,ahosni,,35,1,1,2
20316,rylblu59,,5,4,1,5
20317,noisesmith,,20,23,29,52
20318,jbowtie,,20,9,12,21
20319,pestilence,,22,41,48,89
20320,richarddawkins,,32,32,5,37
20321,jnewbern,,34,7,3,10
20322,rjcb,,18,2,2,4
20323,articlab,,1,4,13,17
20324,mommathecat,,0,141,193,334
20325,derfasaurus,,9,99,136,235
20326,ernestkinnison,,13,1,1,2
20327,wilfridcyrus,,1,2,10,12
20328,rheasparrow,,38,1,2,3
20329,lor4x,,20,16,27,43
20330,existentist,,19,73,83,156
20331,Zaskoda,,13,10,1,11
20332,jace319,,22,26,29,55
20333,biv,,0,60,47,107
20334,overhang,,32,3,7,10
20335,galeon,,13,8,7,15
20336,Sinz,,31,7,3,10
20337,joedipilato,,21,1,2,3
20338,Fondateur0426,,34,6,8,14
20339,alach11,,34,3,2,5
20340,angrywhiteboy,,20,1,6,7
20341,royozin,,42,16,8,24
20342,reauxgg,,1,5,3,8
20343,hardtoexplain,,32,8,1,9
20344,kochichka,,41,2,2,4
20345,alphus,,7,1,1,2
20346,yeoman8,,22,1,2,3
20347,drewyates,,18,38,22,60
20348,launchncast,,34,1,1,2
20349,SuperGrade,,20,77,116,193
20350,desquared,,20,12,24,36
20351,tw3k,,13,2,8,10
20352,chwolfe,,5,2,6,8
20353,soegaard,,20,18,16,34
20354,animalaffinity,,5,5,2,7
20355,OomplexBOompound,,13,18,14,32
20356,samolito,,42,2,2,4
20357,zero5549,,13,4,13,17
20358,nonstop87,,1,2,1,3
20359,static_silence,,0,258,44,302
20360,ajslater,,34,6,18,24
20361,j1123r727,,12,3,1,4
20362,sshconnection,,42,2,6,8
20363,hackcess,,3,2,2,4
20364,trickos,,20,29,32,61
20365,ndsprang,,19,1,2,3
20366,rockyfied,,5,3,2,5
20367,wang-bangers_mom,,13,1,1,2
20368,maraino,,1,6,3,9
20369,adelynnsmommy,,18,4,4,8
20370,PockyBum522,,6,25,35,60
20371,DafyddLlyr,,31,8,7,15
20372,ipsofact0,,29,2,1,3
20373,curryloke,,13,3,1,4
20374,mandelbrothel,,20,4,2,6
20375,rexdog,,32,10,17,27
20376,DingleberrySurprise,,13,34,28,62
20377,MashDownBabylon,,1,48,35,83
20378,Sprydoctor,,18,6,3,9
20379,cryptoz,,20,667,368,1035
20380,bigheadarmy,,12,1,2,3
20381,mercyseat,,19,9,3,12
20382,Octoploid,,20,8,2,10
20383,mamarati,,6,2,1,3
20384,steve435,,12,1,1,2
20385,pentium4borg,,22,1,1,2
20386,hinterteile,,42,20,37,57
20387,lordmutt,,19,27,49,76
20388,deinst,,20,27,24,51
20389,DickandSharon,,13,135,14,149
20390,already_reddit,,1,54,51,105
20391,voodookiss,,5,1,2,3
20392,javreddit,,18,100,9,109
20393,ochuuzu1,,20,14,24,38
20394,VectrexGamer,,29,2,1,3
20395,auca9sd8,,16,2,1,3
20396,myusernamewastaken,,18,77,115,192
20397,ColonelFuckface,,0,342,301,643
20398,Nimue,,13,1,4,5
20399,almostagreed,,19,7,4,11
20400,keylogthis,,43,103,190,293
20401,johat,,19,27,27,54
20402,tardibear,,20,19,42,61
20403,skt2k4,,13,74,169,243
20404,mitreddit,,12,10,10,20
20405,Kryz167,,13,26,40,66
20406,mensrea,,13,187,208,395
20407,drawingthesun,,31,7,14,21
20408,huggyprimate,,22,9,15,24
20409,kskulski,,9,1,1,2
20410,ffgff4g3,,5,1,1,2
20411,honodk,,29,162,34,196
20412,richardharrington,,9,8,9,17
20413,dreamer98,,32,9,17,26
20414,chubs,,20,43,22,65
20415,FakeLouDobbs,,1,1,1,2
20416,acro,,22,1,1,2
20417,spacekraken,,1,8,15,23
20418,desman10143,,0,14,24,38
20419,fross,,1,35,24,59
20420,fel,,19,1,2,3
20421,thirtysixbelow,,17,13,5,18
20422,x5400,,20,3,2,5
20423,waylander632,,43,2,4,6
20424,DavidDavidson,,32,10,5,15
20425,NutritionFacts,,22,14,20,34
20426,bstares,,31,3,6,9
20427,millertime83,,1,1,1,2
20428,MikeGravel,,19,2,2,4
20429,UndeadTonySnow,,12,1,1,2
20430,daze99,,13,4,2,6
20431,huinan,,43,4,4,8
20432,filterspam,,18,129,255,384
20433,storysparrow,,12,1,1,2
20434,Boerta,,31,5,13,18
20435,bboychuk,,13,17,7,24
20436,kingwala,,21,202,24,226
20437,syntax,,20,149,163,312
20438,brendaneich,,20,1,1,2
20439,DoctorRonPaul08,,0,1,2,3
20440,clearlynot,,20,46,59,105
20441,calvin43,,13,24,56,80
20442,apdicaprio,,19,19,30,49
20443,icosa,,43,11,19,30
20444,fidmart85,,18,38,67,105
20445,danblanchard,,30,4,3,7
20446,nunb,,41,15,35,50
20447,the6thReplicant,,6,124,168,292
20448,eftresq,,27,17,30,47
20449,taxcheat,,17,5,2,7
20450,ickingfudiot,,22,19,21,40
20451,mtrimpe,,20,17,27,44
20452,tripsuncatchfire,,18,27,68,95
20453,spongy,,8,1,1,2
20454,mezzaluna,,20,9,18,27
20455,grassmunk,,20,12,10,22
20456,koent,,0,17,44,61
20457,TrishaMacmillan,,8,172,225,397
20458,kilomang,,18,2,3,5
20459,JimH10,,20,71,147,218
20460,MrG,,6,367,351,718
20461,michaelnighttime,,29,1,2,3
20462,eserikto,,18,3,1,4
20463,mogwai72,,18,1,3,4
20464,eflouret,,34,27,9,36
20465,mybuddychrist,,32,2,1,3
20466,MechWiredNet,,19,5,1,6
20467,omitraffic,,0,24,21,45
20468,drbunny,,20,4,5,9
20469,Sineeze,,29,2,1,3
20470,soundbyter,,18,2,5,7
20471,deejayqueue,,11,3,3,6
20472,skeesicks,,42,38,54,92
20473,flinchn,,12,8,11,19
20474,a_bad_martini,,1,100,172,272
20475,blackfrances,,13,110,132,242
20476,someNOOB,,22,1,5,6
20477,libertythor,,13,6,1,7
20478,faysy,,22,1,1,2
20479,netsirk,,5,2,5,7
20480,Funkyy,,34,3,2,5
20481,RobSpewack,,0,2,3,5
20482,karlkraus,,19,3,1,4
20483,mlasky,,20,6,9,15
20484,tek-ops,,0,78,111,189
20485,terrymr,,13,36,44,80
20486,cardsfan12,,16,3,4,7
20487,aephoenix,,1,100,166,266
20488,yeziam,,13,6,11,17
20489,fr3ddie,,18,83,141,224
20490,hiS_oWn,,1,1258,1501,2759
20491,umcjdf,,20,3,11,14
20492,talikk,,18,13,21,34
20493,mpredosin,,0,15,30,45
20494,kskolano,,18,1,1,2
20495,psiph,,1,56,26,82
20496,sfanetti,,13,170,230,400
20497,DirtyHerring,,43,309,442,751
20498,banderlog,,19,9,7,16
20499,Semi_Flaccid_State,,19,14,8,22
20500,not_programmer,,20,8,69,77
20501,jayofdoom,,13,14,10,24
20502,SelfIndulging,,1,14,10,24
20503,nykiwi,,18,53,93,146
20504,davesmylie,,20,4,2,6
20505,Kaptain,,42,62,84,146
20506,marlotuck,,39,1,2,3
20507,to-be-exterminated,,20,1,2,3
20508,celoyd,,20,35,53,88
20509,CindyThomas,,18,32,13,45
20510,wiinix,,32,1,1,2
20511,iamgit,,18,2,6,8
20512,saraaaahhhhhh,,31,35,54,89
20513,leftmoon,,20,4,5,9
20514,MattD,,22,60,57,117
20515,jayayeem,,19,202,327,529
20516,Qlassic,,43,14,10,24
20517,hackdaddy,,43,1,8,9
20518,nfulton,,19,652,926,1578
20519,Lendolar,,5,1,2,3
20520,ind3lible,,42,4,3,7
20521,corruptedness,,13,1,2,3
20522,gypsymoon921,,13,18,19,37
20523,richdinatlanta,,5,14,16,30
20524,mizar99,,20,6,4,10
20525,junglist313,,6,186,167,353
20526,Nick4753,,13,72,59,131
20527,jdmx,,0,14,8,22
20528,adrian67,,43,147,4,151
20529,Fabien3,,20,140,204,344
20530,paulieL,,17,1,2,3
20531,FunFact,,19,144,224,368
20532,sunchat,,20,1,2,3
20533,twiztedd,,32,1,1,2
20534,maxwellhill,,19,4683,44,4727
20535,herugrim,,19,5,8,13
20536,dhintze10,,1,6,7,13
20537,MRRoberts,,18,103,167,270
20538,B_C_,,18,117,180,297
20539,scalemodlgiant,,6,22,37,59
20540,deejne,,13,30,4,34
20541,Revoletion,,5,1,3,4
20542,graealex,,20,34,56,90
20543,harlequinSmurf,,22,4,6,10
20544,baantacron,,5,2,1,3
20545,huuhuu,,1,2,4,6
20546,babytrosc,,5,7,1,8
20547,ethelstan,,13,1,1,2
20548,libertynow,,43,1,1,2
20549,B5_til_i_die,,31,1,1,2
20550,monnayage,,6,49,145,194
20551,tommis,,20,103,174,277
20552,criticasartist,,6,2,2,4
20553,Topper_1,,20,12,9,21
20554,myshrm,,32,37,161,198
20555,DougDante,,19,176,164,340
20556,Ceasadh,,8,123,153,276
20557,plong0,,43,213,467,680
20558,Mellany777,,18,4,1,5
20559,Eddih,,22,1,1,2
20560,billturner,,20,8,6,14
20561,ratnakarpagar,,30,1,1,2
20562,sirkit,,1,17,27,44
20563,russianout,,18,22,43,65
20564,joeyslack,,18,274,388,662
20565,phattwizat,,19,4,6,10
20566,fizzbuzz,,20,3,1,4
20567,ubihard,,12,1,1,2
20568,thegravity,,10,1,2,3
20569,Zarutian,,20,231,481,712
20570,mrwizard14,,18,2,2,4
20571,ILikeChickILikeLiver,,18,3,5,8
20572,khir4n0,,13,2,2,4
20573,devpotato,,20,6,4,10
20574,nojoy,,33,1,2,3
20575,KiRyah,,19,52,56,108
20576,penty,,32,9,13,22
20577,golubovsky,,20,1,7,8
20578,shebe,,20,2,1,3
20579,ecg,,1,1,3,4
20580,permeke,,19,49,22,71
20581,freakk123,,36,1,1,2
20582,Willravel,,28,26,35,61
20583,FriedChicken,,19,2,2,4
20584,BiggotHunter,,19,19,2,21
20585,s1m0n,,32,2,7,9
20586,BigGreenSticky,,1,296,221,517
20587,theflightless,,13,4,8,12
20588,quto,,19,14,23,37
20589,Findeton,,31,1,1,2
20590,jrhoward,,18,19,49,68
20591,shuael,,19,36,39,75
20592,Idownmodeveryone,,6,1,1,2
20593,jem71,,0,2,1,3
20594,Bairen,,18,3,3,6
20595,alex90210,,20,18,18,36
20596,katsap,,31,339,435,774
20597,VCGRIFFIN,,13,8,13,21
20598,Pronell,,20,3,3,6
20599,ksondere,,13,3,3,6
20600,steers82,,34,9,6,15
20601,harvesterofsorrow,,34,1,1,2
20602,alphagettijoe,,9,3,3,6
20603,TeamMeh,,20,1,2,3
20604,voyager86,,0,5,6,11
20605,acusticthoughts,,1,40,41,81
20606,medusam,,13,15,56,71
20607,Kirbside,,1,3,12,15
20608,ricklight,,19,6,6,12
20609,Stubb,,27,231,74,305
20610,ak474all,,31,1,4,5
20611,vario,,32,2,1,3
20612,maximusrex,,32,7,8,15
20613,avarus,,20,5,11,16
20614,Gneognosis,,8,2,1,3
20615,isearch,,20,56,37,93
20616,dbrand,,15,68,25,93
20617,The_Seeker,,18,7,17,24
20618,nealibob,,30,13,12,25
20619,Dr_Frankenstein,,35,1,1,2
20620,sanity2u,,36,1,2,3
20621,macoafi,,20,5,7,12
20622,rakusuira,,10,21,3,24
20623,danno18,,34,3,2,5
20624,broman55,,32,22,25,47
20625,mercurysquad,,20,775,739,1514
20626,fantasticjon,,19,47,47,94
20627,paradoxical,,9,4,5,9
20628,jstampf,,3,3,1,4
20629,splim,,42,227,203,430
20630,datawaslost,,13,10,13,23
20631,FDL1,,42,2,5,7
20632,giornalettismo,,13,4,3,7
20633,Oleg1,,34,5,2,7
20634,brotherbob,,13,29,4,33
20635,poptosis,,18,7,11,18
20636,hre,,13,3,2,5
20637,jammyjam,,43,6,5,11
20638,TheDirector,,32,37,58,95
20639,leoinca,,9,112,4,116
20640,fkn_amerikkkans,,31,4,1,5
20641,cooljoebob64,,1,34,59,93
20642,Trainwrek,,43,8,12,20
20643,cwikked,,14,1,1,2
20644,indurain,,20,3,5,8
20645,correspondence,,1,11,1,12
20646,onewing,,5,2,3,5
20647,uberdanky,,3,1,1,2
20648,SpiritThief,,20,5,10,15
20649,Carnage4Life,,20,65,23,88
20650,Blike_Moomberg,,34,1,3,4
20651,kenlubin,,6,269,523,792
20652,Celes69,,43,6,3,9
20653,frice,,13,1,2,3
20654,SilverFox,,16,110,118,228
20655,jkarson88,,13,1,3,4
20656,bobisoft2k5,,32,7,6,13
20657,DoItYourself,,34,3,6,9
20658,skyfex,,32,3,3,6
20659,frankenlinks,,41,4,1,5
20660,PunAndRun,,36,2,2,4
20661,rlynaghshannon,,22,23,31,54
20662,oliware,,18,7,27,34
20663,worldwalker,,38,1,3,4
20664,Kel-lr,,5,4,6,10
20665,eugrl,,31,7,5,12
20666,superfluous,,1,126,221,347
20667,braamlg,,1,3,2,5
20668,hllclmbr,,16,25,13,38
20669,mcgoverp,,13,4,6,10
20670,ihatetomarnold,,23,1,1,2
20671,steakknife,,31,5,2,7
20672,spamfake,,31,20,22,42
20673,h3rald,,20,15,14,29
20674,hansip,,12,4,19,23
20675,ugolino91,,13,1,1,2
20676,DoublePlusMeh,,36,22,60,82
20677,Empact,,1,1,3,4
20678,bootstompingonaface,,19,6,9,15
20679,krik1,,43,1,4,5
20680,novagenesis,,31,7,16,23
20681,dasil003,,20,61,118,179
20682,hawk2119,,1,145,6,151
20683,geegnome,,13,8,5,13
20684,dontmatta,,0,16,11,27
20685,ChefEspeff,,18,97,31,128
20686,krumbs,,33,362,372,734
20687,the_wondering_jew,,19,4,7,11
20688,bSimmons666,,32,605,514,1119
20689,kz00,,1,4,1,5
20690,uberboot,,1,7,16,23
20691,omarciddo,,18,20,28,48
20692,Dustinland,,42,2,1,3
20693,Bean888,,18,19,25,44
20694,dj1200techniques,,13,129,148,277
20695,tlarkin,,30,1,1,2
20696,OldakQuill,,31,145,125,270
20697,f009,,21,2,1,3
20698,Aviator,,20,103,87,190
20699,shelton8706,,19,1,1,2
20700,yourfiredpal,,22,1,3,4
20701,luisrd,,19,89,5,94
20702,aloofschipperke,,20,1,1,2
20703,aletoledo,,19,1762,2561,4323
20704,pretzel,,15,159,99,258
20705,steven_h,,20,57,70,127
20706,melissamelissa,,13,70,55,125
20707,vexu,,0,7,11,18
20708,nonredditor,,22,1,6,7
20709,kappuru,,20,3,3,6
20710,patmac531,,20,3,4,7
20711,jxmitchell,,0,272,83,355
20712,Ivan_A_DMocracy,,19,18,33,51
20713,thisisbullshit,,16,2,1,3
20714,zmcgrew,,20,4,5,9
20715,cjanssen,,18,1,1,2
20716,sensical,,1,193,188,381
20717,kairos,,0,34,62,96
20718,AnteChronos,,11,2145,2095,4240
20719,hsshibley,,13,4,2,6
20720,Ishkabible,,32,2,6,8
20721,Lagavulin,,8,13,8,21
20722,mca592,,36,13,19,32
20723,caffeine314,,31,15,14,29
20724,kevinardo,,34,2,18,20
20725,blame20,,19,2,5,7
20726,psibe,,1,40,72,112
20727,jnfr,,1,27,20,47
20728,phragg,,0,16,11,27
20729,ALoucarch,,1,1,2,3
20730,antikythera,,4,6,4,10
20731,Ocseemorahn,,31,1,1,2
20732,i_only_upmod_idiots,,31,3,2,5
20733,ElRomno,,0,1,1,2
20734,mracer,,31,13,7,20
20735,manu3000,,20,2,11,13
20736,tri000,,20,5,6,11
20737,TheBobMcCormick,,20,34,50,84
20738,andrewq,,1,20,33,53
20739,gotnate,,13,15,23,38
20740,bdifc,,0,6,4,10
20741,angeleus09,,31,10,19,29
20742,oatsy,,34,8,25,33
20743,yggdrasilly,,20,53,39,92
20744,FrankExchangeOfViews,,32,9,18,27
20745,hortont424,,20,38,35,73
20746,penispic,,18,4,2,6
20747,EnigmaCurry,,20,2,5,7
20748,click2803,,19,36,18,54
20749,CWRandall,,16,1,3,4
20750,GrammarBureaucrat,,42,4,4,8
20751,banjeed,,18,1,2,3
20752,newsgirl,,18,5,1,6
20753,exbzurg,,30,12,21,33
20754,damnitdaniel,,2,1,2,3
20755,JesusChristSonOfMan,,36,1,4,5
20756,deMVK,,18,7,13,20
20757,thepensivepoet,,18,659,827,1486
20758,jedileet,,32,26,6,32
20759,spotcatbug,,12,95,139,234
20760,stormandstress,,20,85,79,164
20761,EverybodysAnAsshole,,43,49,61,110
20762,mhoffma,,13,151,63,214
20763,PaladinZ06,,17,4,5,9
20764,dotcam9,,1,4,11,15
20765,aussie151,,22,6,7,13
20766,yakyakyak,,6,88,82,170
20767,duketime,,1,3,4,7
20768,samblesj,,0,213,3,216
20769,JNGilman,,34,50,33,83
20770,mickbuddha,,20,15,26,41
20771,ironclad,,1,40,79,119
20772,Steinburg,,31,23,20,43
20773,HOTORTILLAS,,19,92,88,180
20774,firgnus,,19,5,3,8
20775,cel83,,34,2,1,3
20776,MarkFreedman,,36,1,1,2
20777,tundranerd,,20,11,18,29
20778,traflac,,32,4,15,19
20779,columbian_supreme,,20,32,93,125
20780,berlinbrown,,20,1379,1005,2384
20781,daevlong,,35,3,7,10
20782,DisabledChildrenLive,,13,1,2,3
20783,sardonyx,,6,1,1,2
20784,DedHeD,,13,55,100,155
20785,offtoChile,,1,14,6,20
20786,MenthalMenthos,,30,11,12,23
20787,jroller,,20,27,41,68
20788,danmaitlandsmith,,18,4,8,12
20789,RoboticCoder,,20,14,9,23
20790,Bujanx,,5,249,298,547
20791,dean888,,29,17,18,35
20792,Gatohnegro,,1,151,73,224
20793,musellama,,19,1,1,2
20794,Forrest319,,13,55,103,158
20795,stox,,0,98,161,259
20796,squeaker,,0,138,63,201
20797,bitobaco,,4,42,53,95
20798,woooooooooooooooosh,,42,1,1,2
20799,daisy0808,,30,645,784,1429
20800,fragm,,0,2,1,3
20801,vivvvvic,,32,11,22,33
20802,orcdork,,18,5,4,9
20803,Xyc0,,20,2,1,3
20804,playingreprise,,18,8,6,14
20805,dmaclay,,20,96,98,194
20806,cluck,,13,1,1,2
20807,hondajvx,,1,131,187,318
20808,darth-Tater,,13,12,5,17
20809,oscargang,,22,34,2,36
20810,Paisleyfrog,,22,93,150,243
20811,evaunit517,,3,11,12,23
20812,johnnyh749,,20,9,4,13
20813,nbakshi,,13,4,8,12
20814,DROWE859,,18,17,21,38
20815,cubedweller,,19,54,76,130
20816,shrimpanzee,,1,19,7,26
20817,twitchymart,,18,14,9,23
20818,fishyf,,20,20,44,64
20819,fraying,,20,2,1,3
20820,Orion_FE,,32,1,2,3
20821,Xaboomers,,18,33,2,35
20822,i_think_i_am_crazy,,31,29,26,55
20823,bassman123,,18,30,33,63
20824,rckstdy,,19,12,10,22
20825,nsfmc,,20,17,8,25
20826,Jedravent,,12,382,188,570
20827,JollyJeff,,12,156,266,422
20828,nglynn,,20,283,327,610
20829,peanutbrittle,,13,1,2,3
20830,GodHatesFigs,,19,247,336,583
20831,C8H10N4O2,,15,3,3,6
20832,arkistan,,5,4,4,8
20833,mrken,,1,1,1,2
20834,randyco,,6,3,1,4
20835,trech,,1,7,13,20
20836,lizblue,,25,1,1,2
20837,bnolsen,,20,35,43,78
20838,sickmind,,34,593,53,646
20839,Brain_statiC,,18,16,32,48
20840,bunkre,,5,1,7,8
20841,hustler,,31,13,16,29
20842,hhymcq,,41,1,1,2
20843,guhoya11,,18,1,1,2
20844,yoaliens,,19,25,36,61
20845,Dast,,18,10,12,22
20846,plantro,,13,1,1,2
20847,junpei,,18,4,12,16
20848,dbanerjee,,31,59,61,120
20849,amellor,,22,105,54,159
20850,GimmickAccount,,22,1,1,2
20851,XanXiran,,14,2,5,7
20852,Calm_Pear,,19,2,2,4
20853,timwatly,,18,23,17,40
20854,emgairplay,,13,5,2,7
20855,bstrand,,20,6,10,16
20856,doihaveto,,20,4,4,8
20857,Aka-Ice,,37,3,1,4
20858,eddof13,,20,7,15,22
20859,linkedlist,,31,2246,2090,4336
20860,reginalduk,,31,170,257,427
20861,WebZen,,19,605,624,1229
20862,Shadowhand,,31,15,18,33
20863,doronbc,,18,3,3,6
20864,solitariadolores,,1,1,1,2
20865,avro,,0,24,3,27
20866,InconsideratePrick,,18,24,8,32
20867,Grums,,18,12,22,34
20868,theorpheus,,32,52,7,59
20869,TheSummarizer,,19,11,18,29
20870,plinko92,,20,2,2,4
20871,c3o,,4,6,8,14
20872,ericwong,,20,1,3,4
20873,bakert,,20,24,18,42
20874,humans,,27,3,3,6
20875,ndimos,,5,1,1,2
20876,cynope,,34,94,95,189
20877,hooter523,,5,1,1,2
20878,HomelandSecurity,,19,1,11,12
20879,thebootydontstop,,34,1,2,3
20880,giik,,14,6,5,11
20881,carpenter,,13,30,3,33
20882,edydantes,,18,33,76,109
20883,craineum,,34,8,6,14
20884,testing_timing,,19,1,1,2
20885,thirdworldlover,,43,1,1,2
20886,fakepolitik,,18,138,93,231
20887,TheEvilPenguin,,20,1,1,2
20888,thegoodideaman,,13,2,2,4
20889,Metroid4Life,,42,36,3,39
20890,tangentstorm,,19,61,12,73
20891,onyxdale,,32,11,11,22
20892,bstein80,,13,11,1,12
20893,moarslaw,,13,11,6,17
20894,IHaveCookies,,13,96,79,175
20895,elsombrero,,13,21,36,57
20896,IngeniousTimeTravell,,13,3,2,5
20897,igeldard,,8,2061,108,2169
20898,ia3n,,13,2,1,3
20899,pastymage,,0,64,11,75
20900,hzin,,20,26,1,27
20901,jous,,20,17,5,22
20902,phpkid,,20,4,2,6
20903,mmelton,,14,2,2,4
20904,meatsack80,,20,1,1,2
20905,YoungVoter,,13,29,1,30
20906,brewtalizer,,43,11,16,27
20907,epchris,,0,19,3,22
20908,motorists,,19,164,2,166
20909,JoeIrvine,,20,4,5,9
20910,JohnnyTsunami,,13,1,1,2
20911,kihaji,,10,152,161,313
20912,spamboolimbo,,8,1,1,2
20913,fengshui,,34,2,1,3
20914,nathaner,,27,51,93,144
20915,intrepion,,1,21,55,76
20916,fdb,,19,1,1,2
20917,scruffie,,20,29,15,44
20918,latida,,39,3,1,4
20919,Tacoby,,13,1,1,2
20920,xxdbxx,,31,1,1,2
20921,melink14,,20,21,35,56
20922,Sawta,,18,131,257,388
20923,klauskinski,,1,296,736,1032
20924,chemicalkook,,19,5,2,7
20925,crenbots,,0,19,7,26
20926,madronedorf,,19,323,435,758
20927,anybuzz,,1,49,10,59
20928,helloolleh,,13,1,1,2
20929,smowe,,42,7,1,8
20930,misterFR33ZE,,18,56,108,164
20931,beefanator0,,13,9,18,27
20932,mcbush,,13,766,135,901
20933,garythellama,,20,12,5,17
20934,icychilly,,20,1,1,2
20935,Toppy,,32,1,1,2
20936,allforumer,,1,106,192,298
20937,political-animal,,33,3,6,9
20938,whatfun2,,22,1,7,8
20939,tjl2015,,18,74,8,82
20940,tmh,,11,2,2,4
20941,Beezer,,1,2,1,3
20942,markwebb,,13,1,7,8
20943,hriwo,,1,26,15,41
20944,jungturk,,17,242,351,593
20945,fggfghjjk,,20,3,5,8
20946,cbarge,,18,37,70,107
20947,leno123,,2,2,7,9
20948,Vanhandle,,17,29,36,65
20949,grendel9,,19,39,64,103
20950,4days,,19,1,2,3
20951,Jessegr,,34,1,1,2
20952,robrobrobot,,19,305,172,477
20953,hounddoglgs,,30,4,4,8
20954,dk9000,,13,6,5,11
20955,mosephine,,19,2,2,4
20956,scooterMD,,13,8,22,30
20957,dcxb,,13,1,1,2
20958,spugnugget,,0,20,8,28
20959,iregistered4this,,20,91,92,183
20960,CNBemis,,29,21,9,30
20961,blaze4metal,,19,567,783,1350
20962,icepack,,20,5,9,14
20963,EGKW,,18,3,5,8
20964,dietcocaine,,19,12,27,39
20965,fae4fds,,20,4,1,5
20966,cofol,,18,1,2,3
20967,neilroberts,,20,26,4,30
20968,HoboClownChorus,,29,4,1,5
20969,AntonOlsen,,13,15,12,27
20970,Bahro,,1,86,86,172
20971,mtlea,,6,6,6,12
20972,ukroni,,20,6,3,9
20973,musicphreak252,,19,51,81,132
20974,theuncover,,19,13,18,31
20975,philler,,18,79,24,103
20976,orangecrush,,18,1,3,4
20977,beatnuts96,,13,1,3,4
20978,InspectorJavert,,14,11,20,31
20979,GeeksSpeakFont,,5,161,26,187
20980,mgates,,18,1,1,2
20981,apollinax,,13,2,2,4
20982,goofporter,,19,8,6,14
20983,lexchou,,20,5,8,13
20984,vamonos,,31,59,16,75
20985,wmil,,20,10,16,26
20986,bumblebeecuz,,33,1,3,4
20987,spurion,,4,43,68,111
20988,bardamu2,,23,3,2,5
20989,reapsos,,9,1,2,3
20990,leonardsliver,,20,2,4,6
20991,shakeyjake,,19,15,21,36
20992,danigaswholuvu,,13,89,6,95
20993,trigger0219,,29,162,191,353
20994,cardinalgill,,34,13,10,23
20995,franniemeow07,,20,10,1,11
20996,cutlerchris,,0,15,27,42
20997,justagirl05,,0,2,4,6
20998,ttam,,6,13,11,24
20999,tbwcr,,20,14,6,20
21000,prop74,,32,1,1,2
21001,g_ford,,1,3,4,7
21002,Nomad559,,18,12,8,20
21003,crazysheit,,43,4,2,6
21004,bashamer,,0,2,1,3
21005,slut,,13,3,1,4
21006,mer1,,10,8,12,20
21007,onionose,,34,4,9,13
21008,steeef,,42,11,8,19
21009,acon89,,5,37,5,42
21010,voqk,,18,6,8,14
21011,irsmert,,22,53,99,152
21012,suehuss,,8,1,1,2
21013,solidhayter,,43,59,99,158
21014,johnji,,34,6,19,25
21015,optimalscrew,,40,4,1,5
21016,zby,,20,10,13,23
21017,VapidTeenageGirl,,13,1,1,2
21018,kerklein2,,34,325,358,683
21019,robbyslaughter,,20,12,9,21
21020,ekabanov,,20,47,26,73
21021,no_one,,14,21,37,58
21022,rotterdam,,19,2,4,6
21023,SalParadise,,9,100,27,127
21024,pointerweb,,14,1,1,2
21025,alwaysdeparting,,22,7,1,8
21026,MicrophoneAssassin,,1,1,3,4
21027,catdad,,29,1,2,3
21028,Dr_House,,8,1,2,3
21029,dukeminster,,13,2,4,6
21030,noise-nut,,13,24,9,33
21031,elcheapo,,20,16,13,29
21032,juanclaudius,,39,1,1,2
21033,Johnny_H,,30,10,9,19
21034,bugrit,,20,25,33,58
21035,Slactor,,18,51,56,107
21036,gforce42,,12,1,2,3
21037,girlzero,,13,127,11,138
21038,goonigoogoo,,18,2,3,5
21039,freemorons,,41,42,84,126
21040,zocrates,,32,7,5,12
21041,reedsmomishot,,19,10,13,23
21042,blackandred,,0,527,19,546
21043,sarahelecko,,12,1,1,2
21044,spaceknarf,,18,143,107,250
21045,FutureMajority,,13,11,2,13
21046,hunkydude,,13,1094,45,1139
21047,harlows_monkeys,,20,510,318,828
21048,Align,,22,3,6,9
21049,makeinstall,,32,17,12,29
21050,ekatya,,34,80,85,165
21051,zmann,,1,20,38,58
21052,cyantist,,4,147,291,438
21053,dtweney,,0,8,1,9
21054,redRob,,29,8,3,11
21055,Kaganovich,,19,7,6,13
21056,chipr,,32,1,1,2
21057,ludditte,,30,41,67,108
21058,kjkldsjlksdjlksdjl,,14,1,1,2
21059,hamutaro,,0,4,5,9
21060,codepoet,,8,1134,1457,2591
21061,mm262a1,,4,6,7,13
21062,bogosj,,13,21,2,23
21063,CrimsonSun99,,22,389,626,1015
21064,umilmi81,,34,670,703,1373
21065,jtempleton2006,,31,2,6,8
21066,KingFrek,,43,2,1,3
21067,TKOslam,,32,15,8,23
21068,shazzdeeds,,0,7,18,25
21069,ferality,,19,131,22,153
21070,shujaa,,22,122,156,278
21071,peraspera,,18,46,3,49
21072,JohnSanford,,19,4,8,12
21073,pirana0,,29,1,4,5
21074,tinfrog,,29,17,24,41
21075,lonb,,18,17,5,22
21076,faulkner01,,9,1,3,4
21077,Zak,,20,120,125,245
21078,CDLTO,,30,12,18,30
21079,afton,,20,5,9,14
21080,tracyreed,,20,4,2,6
21081,remix,,13,11,22,33
21082,cityhigh,,18,2,6,8
21083,speeditonline,,18,79,5,84
21084,Eso,,22,62,108,170
21085,mybaseballcardspace,,18,13,11,24
21086,workingmom,,19,5,2,7
21087,m0122,,18,13,22,35
21088,Neuticals,,19,27,50,77
21089,shortbaldman,,13,21,38,59
21090,tehyosh,,18,66,99,165
21091,50-50-Bar,,13,3,5,8
21092,Spazsquatch,,29,589,961,1550
21093,cunt_sneeze,,19,7,15,22
21094,fwinter2,,40,1,3,4
21095,2legit2kwit,,13,95,196,291
21096,koryakm,,1,1,2,3
21097,jt004c,,29,195,323,518
21098,maplecustom,,0,1,3,4
21099,adrienne__g,,43,1,2,3
21100,Diogee,,38,1,3,4
21101,aMomentOfZen,,11,6,6,12
21102,lincolnquirk,,20,17,14,31
21103,akula,,13,7,21,28
21104,mervyn101,,14,3,8,11
21105,miniman,,16,1,3,4
21106,Scriptorius,,20,63,75,138
21107,illuminea,,31,1,1,2
21108,mikeybender,,17,1,3,4
21109,motrbotr,,19,21,38,59
21110,dgridley,,19,79,76,155
21111,vecter,,20,181,163,344
21112,vote_up,,18,59,75,134
21113,antonyr,,5,1,10,11
21114,lzylinepainter,,1,10,11,21
21115,pmussoni,,31,9,6,15
21116,bhmt,,20,1,1,2
21117,revertTS,,20,6,15,21
21118,gtxy20,,6,1,1,2
21119,vardhan,,41,231,258,489
21120,metamorphosis,,1,34,45,79
21121,Erf,,19,7,11,18
21122,spinnelein,,43,3,8,11
21123,maxi_taxi,,31,3,1,4
21124,wrighter_is_n_asshat,,19,4,7,11
21125,maseno,,43,60,65,125
21126,dannykarnage,,32,23,2,25
21127,bstaff1901,,18,2,2,4
21128,AnAppleSnail,,5,22,24,46
21129,dinkinflicka,,31,1,1,2
21130,pito,,43,7,7,14
21131,pstuifzand,,1,2,3,5
21132,Amathaine,,32,51,91,142
21133,Boreal,,31,130,202,332
21134,Snaf,,32,6,12,18
21135,k-bunny,,13,1,2,3
21136,classics,,0,1,1,2
21137,banelos,,19,29,77,106
21138,aperson,,18,454,381,835
21139,ruffi,,18,2,6,8
21140,DrSilverworm,,13,3,6,9
21141,cgb,,17,2,3,5
21142,macournoyer,,20,6,5,11
21143,CMH05,,30,16,21,37
21144,crackcat,,20,2,4,6
21145,paulbunyon956,,9,3,5,8
21146,Zombie-Squirrel,,13,7,3,10
21147,analogtyler,,22,46,68,114
21148,restrik,,18,19,28,47
21149,selectorsam,,0,1,2,3
21150,doyle828,,13,7,7,14
21151,pihkal,,31,7,18,25
21152,zaanpenguin,,20,2,2,4
21153,hopper,,19,135,234,369
21154,ethanator,,18,37,23,60
21155,daniel001,,31,36,23,59
21156,madmarigold,,39,38,72,110
21157,misterorange,,1,5,6,11
21158,grapejuice,,18,2,1,3
21159,quietsolutions,,13,2,2,4
21160,butterbutterbutter,,18,1,1,2
21161,Reg_Spyder,,29,262,432,694
21162,lindb291,,20,2,3,5
21163,gibs,,32,50,46,96
21164,Fedquip,,30,88,23,111
21165,gilgam3sh,,13,16,49,65
21166,trevorpinzon,,1,45,45,90
21167,Guderian,,31,14,6,20
21168,casbboy,,18,32,7,39
21169,me2maam,,31,9,10,19
21170,SenorG,,1,1,3,4
21171,mumbojumbo,,34,1,2,3
21172,Sean_Connery,,19,5,3,8
21173,animalbmx,,15,107,55,162
21174,megamark16,,18,4,4,8
21175,t4stringer,,18,4,15,19
21176,chutzpah,,22,40,41,81
21177,colinsyme,,13,136,335,471
21178,frecklefaerie,,8,8,11,19
21179,Siven,,13,2,1,3
21180,TheDaveBoy,,1,6,3,9
21181,myra_reigns,,6,2,3,5
21182,me2plsthx,,18,54,42,96
21183,martinbrickthrower,,1,41,62,103
21184,adent1066,,8,2,1,3
21185,jccarr,,0,7,27,34
21186,yorgan23,,0,41,10,51
21187,hijimayor,,41,3,1,4
21188,sublemon,,43,19,23,42
21189,bobuser,,20,24,45,69
21190,21uda,,31,3,1,4
21191,aflag,,19,22,47,69
21192,Andys,,20,130,208,338
21193,ionblue,,18,34,30,64
21194,sonnymark,,5,8,19,27
21195,theinklein,,43,155,51,206
21196,dannywoodz,,6,1,2,3
21197,hiccuprates,,6,19,25,44
21198,anonbanon,,10,5,5,10
21199,enculturation,,22,1,4,5
21200,alextr,,13,2,2,4
21201,boby4444,,14,5,5,10
21202,Glamdering,,19,305,214,519
21203,kcoll98,,5,1,2,3
21204,openborder,,21,122,7,129
21205,Gandysampras,,18,11,1,12
21206,mdwyer,,22,138,216,354
21207,vincenz,,20,23,20,43
21208,slyguy183,,0,105,250,355
21209,werdanel,,20,70,77,147
21210,mulletmusketeer,,43,9,7,16
21211,jawa,,42,23,57,80
21212,DrDoctorGivemethenew,,1,1,1,2
21213,Randinn,,19,49,110,159
21214,nosoynadie,,16,2,5,7
21215,a-redneck,,0,1,1,2
21216,thraxil,,20,3,4,7
21217,aphrodite2,,31,2,1,3
21218,olsondc,,6,1,1,2
21219,christielynn,,18,39,27,66
21220,sfg,,0,13,17,30
21221,NyMet,,12,48,2,50
21222,FTroop09,,13,21,13,34
21223,louiedog,,12,69,74,143
21224,MR_Rictus,,18,5,3,8
21225,GeorgeThurogood,,22,1,1,2
21226,cvoid,,13,1,1,2
21227,parafinalia,,18,4,11,15
21228,player101,,19,178,35,213
21229,cynix,,34,1,1,2
21230,Zed,,20,24,20,44
21231,jooes,,18,15,14,29
21232,verbosus,,20,10,10,20
21233,sajal,,34,10,1,11
21234,jchoe,,31,1,1,2
21235,thewaywardson,,18,306,450,756
21236,ehitze,,18,29,47,76
21237,FEED_ME,,19,1,3,4
21238,slaphappy,,13,5,20,25
21239,flailking,,13,38,79,117
21240,womanistmusings,,32,236,91,327
21241,amirk1983,,6,4,2,6
21242,uwc,,31,12,13,25
21243,chalk46,,1,32,86,118
21244,reddan,,32,13,18,31
21245,BuffMom,,13,1,2,3
21246,travmatron86,,6,12,12,24
21247,tomboessel,,19,1,8,9
21248,littleriver1,,34,67,73,140
21249,dudesparo,,43,3,5,8
21250,sfxazure,,1,5,7,12
21251,EggCoroner,,28,182,191,373
21252,gowerski,,12,7,11,18
21253,liesen,,20,1,1,2
21254,alexkehr,,13,498,41,539
21255,jormungandr,,22,1,5,6
21256,justinb,,6,1,1,2
21257,majdeath,,20,5,4,9
21258,gaiusparx,,35,2,1,3
21259,absolutelyamazed,,13,150,124,274
21260,RomneyWhisperer,,19,3,8,11
21261,radialmonster,,43,22,34,56
21262,Squee69777,,18,11,27,38
21263,ssylvan,,20,130,198,328
21264,zorro99,,12,9,14,23
21265,benjaminck,,18,6,7,13
21266,kykid,,12,211,69,280
21267,darlantan,,17,271,408,679
21268,daballer2005,,0,7,5,12
21269,skydivingdutch,,18,157,207,364
21270,tupal,,19,1,3,4
21271,theredkap,,13,43,79,122
21272,Lazymath,,18,25,41,66
21273,gblosser,,34,12,9,21
21274,AN0NYM0US,,18,1,1,2
21275,casualbattery,,30,2,3,5
21276,canadiense,,15,1,1,2
21277,TheProphetMohammed,,43,2,4,6
21278,moadm3,,42,3,2,5
21279,Zeider,,32,2,3,5
21280,miyamotofreak,,19,29,24,53
21281,michaelgburton,,20,1,2,3
21282,mojool,,19,30,78,108
21283,Davo69,,18,12,23,35
21284,doublepow,,20,1,4,5
21285,zenclick,,42,3,2,5
21286,strangerdream,,18,13,5,18
21287,Impudence,,31,17,15,32
21288,StarSirius,,18,15,2,17
21289,anarchman,,1,240,295,535
21290,derrelicte,,18,29,37,66
21291,beammeup,,19,4,1,5
21292,lispism,,20,2,3,5
21293,ctown1,,13,86,16,102
21294,Syltprinsen,,19,2,3,5
21295,willbb,,38,5,5,10
21296,funhouse,,43,107,5,112
21297,dandanielson,,6,51,81,132
21298,underjc,,19,2,6,8
21299,hox,,20,52,89,141
21300,auto98,,18,12,22,34
21301,JohnnieAysgarth,,19,5,8,13
21302,polydorus,,18,41,33,74
21303,imxrq,,32,2,3,5
21304,itsnotabigtruck,,18,14,17,31
21305,meatpiesnorkle,,19,10,4,14
21306,echoes1234,,13,1,1,2
21307,NextQuestion,,3,1,2,3
21308,andrewxhill,,19,5,6,11
21309,SavetheWheel,,32,3,2,5
21310,iamsmrtk,,12,15,8,23
21311,dairyair,,13,3,9,12
21312,dgermain,,29,2,2,4
21313,TwoFourSixOhOne,,18,3,8,11
21314,barnacle999,,13,8,9,17
21315,ajlhahjsdhad,,18,6,7,13
21316,unkle,,18,7,12,19
21317,wafla,,13,4,8,12
21318,lordie,,34,11,1,12
21319,crowe1130,,43,52,18,70
21320,Paperweight,,0,211,203,414
21321,Alexandraf,,18,2,3,5
21322,Haroshia,,22,305,327,632
21323,happygolucky,,18,2,1,3
21324,topderek,,18,3,5,8
21325,rjones2818,,19,93,10,103
21326,5m10y,,1,172,74,246
21327,rplzoom,,31,9,4,13
21328,FreakCERS,,18,29,46,75
21329,jason0802,,32,2,1,3
21330,viewer82,,0,7,5,12
21331,pi_neutrino,,40,2,6,8
21332,rorleth,,20,4,1,5
21333,madhighlandcow,,32,21,43,64
21334,jlabr,,1,87,61,148
21335,phrakture,,12,101,109,210
21336,marshull,,18,144,282,426
21337,Autumnfox,,1,1,1,2
21338,parislemon,,8,127,7,134
21339,infil,,0,515,910,1425
21340,xiaobaitu,,20,1,1,2
21341,anewman11,,19,252,295,547
21342,cornucopia,,43,104,144,248
21343,justech3,,5,1,9,10
21344,chadlerh,,34,1,2,3
21345,bugdozer,,20,2,5,7
21346,MasterMahan,,18,62,46,108
21347,haws,,28,1,2,3
21348,truepatriot2184,,13,1,1,2
21349,brekisback,,18,31,6,37
21350,ajwans,,41,1,2,3
21351,iedroe,,32,4,7,11
21352,cwzwarich,,20,106,137,243
21353,samria,,18,4,15,19
21354,Innogen,,36,1,1,2
21355,erikbra81,,31,368,325,693
21356,Checkit,,20,13,1,14
21357,capn,,13,1,1,2
21358,shanangreen,,25,2,2,4
21359,broken_hand,,0,74,23,97
21360,picred,,19,1,1,2
21361,valdemaximus,,34,27,1,28
21362,miratom,,18,14,26,40
21363,parkedr,,30,23,8,31
21364,hfc,,18,124,5,129
21365,ifnot4u,,20,8,1,9
21366,eVizitei,,31,1,1,2
21367,redditworldtree,,43,3,1,4
21368,ABWORD74,,5,1,1,2
21369,coocha,,34,10,21,31
21370,tungsten3695,,20,1,1,2
21371,lurkinin,,13,28,24,52
21372,yvrview,,30,19,14,33
21373,Coretracker,,18,2,1,3
21374,hickory,,13,22,3,25
21375,bellesole,,13,14,21,35
21376,klaarn,,22,26,7,33
21377,marvik,,18,33,2,35
21378,tripppp,,33,1,3,4
21379,peewinkle,,1,275,200,475
21380,wparsons,,32,88,195,283
21381,jdnx429,,18,5,3,8
21382,getmorepc,,19,5,2,7
21383,egypturnash,,1,83,156,239
21384,adamcar,,18,1,1,2
21385,Borkz,,5,55,93,148
21386,Jimjim201,,38,1,1,2
21387,question_4_seopher,,43,1,1,2
21388,lmdocherty,,43,3,6,9
21389,orangecrushucf,,4,6,9,15
21390,aletornw,,31,2,2,4
21391,Akhkharu,,1,1,1,2
21392,jakefl04,,31,130,114,244
21393,funkydragon2005,,20,6,20,26
21394,mutantediez,,43,3,5,8
21395,benthomasson,,20,2,1,3
21396,carlosh,,13,21,16,37
21397,strangeelement,,13,42,12,54
21398,ThisIsDave,,4,1134,1463,2597
21399,krix,,31,2,3,5
21400,dobaksa,,0,1,1,2
21401,johnjoe,,8,1,1,2
21402,saulhoward,,18,1,2,3
21403,harrisxml,,27,1,1,2
21404,stefanve,,14,1,1,2
21405,ecaradec,,20,1,1,2
21406,justin7,,31,1,1,2
21407,msamericanpie,,16,5,4,9
21408,BurtYoungsters,,30,4,2,6
21409,ftcnt,,30,342,11,353
21410,morigoli28,,0,8,3,11
21411,jjmc123a,,13,24,59,83
21412,inkedmn,,32,11,2,13
21413,jetsetsc,,19,1,4,5
21414,SoysauceMafia,,42,49,82,131
21415,asegura,,20,37,14,51
21416,demian64,,31,74,127,201
21417,Trexdacy,,13,98,90,188
21418,anthrodocZ,,13,96,177,273
21419,TobyDumb,,18,111,262,373
21420,REBELYELLoz,,19,298,238,536
21421,SilverPaladin,,32,16,42,58
21422,xvs,,12,40,60,100
21423,chaopsychochick,,32,1,5,6
21424,combover,,1,86,148,234
21425,FiL-dUbz,,18,171,343,514
21426,argr,,31,3,2,5
21427,BottleRocket,,42,1,1,2
21428,tfm,,20,53,90,143
21429,tito184,,18,11,33,44
21430,javaru,,42,84,139,223
21431,stack_smasher,,20,2,2,4
21432,hitmonval,,31,395,583,978
21433,keithb,,20,125,188,313
21434,jimstr,,18,1,7,8
21435,VirginiaDare,,0,14,4,18
21436,scriggities,,19,166,164,330
21437,SewerHorse,,1,7,3,10
21438,rebelwithacause,,19,1,3,4
21439,ade,,20,15,1,16
21440,digitalmanifesto,,19,3,12,15
21441,cubiccavepearls,,19,28,6,34
21442,johnonly,,0,3,2,5
21443,jmm8,,19,6,3,9
21444,capecodcarl,,35,567,464,1031
21445,JohnSteel,,31,7,11,18
21446,NilObject,,20,68,74,142
21447,patheticfallacy,,13,4,1,5
21448,hagrin,,19,1,2,3
21449,raymondreams,,13,3,14,17
21450,kelaking,,31,4,7,11
21451,bluematter,,31,10,2,12
21452,grs2,,5,2,4,6
21453,WildeIdeas,,29,3,3,6
21454,AndreasBWagner,,20,433,112,545
21455,dt40,,11,7,3,10
21456,nocoolname_tom,,43,1,1,2
21457,infosec,,17,20,2,22
21458,toblotron,,2,14,4,18
21459,deepbrown,,42,29,7,36
21460,bullet19465,,18,19,20,39
21461,knobtwiddler,,35,30,40,70
21462,lonekorean,,22,36,54,90
21463,hubrisjebris,,29,11,10,21
21464,caferrell,,31,83,46,129
21465,aranyx,,42,7,8,15
21466,King_Leonidas,,42,178,420,598
21467,ahtnamas,,19,1,4,5
21468,sprycansht,,18,1,2,3
21469,JackSpratts,,20,5,5,10
21470,cecil4ever2000,,19,26,19,45
21471,AggroBoy,,0,2,1,3
21472,drexo,,43,17,2,19
21473,arebop,,20,53,65,118
21474,jamonterrell,,13,7,8,15
21475,Dice_for_Death_,,19,4,8,12
21476,doubleUsquared,,13,1,1,2
21477,wchogg,,20,3,11,14
21478,tc110407,,31,3,1,4
21479,stetson9,,31,3,2,5
21480,CaptainCranberry,,32,9,2,11
21481,rmosler,,18,125,104,229
21482,pucklermuskau,,20,1,1,2
21483,gcubed,,23,2,2,4
21484,cinnamon_graham,,13,5,5,10
21485,nakejnick,,0,100,5,105
21486,marvinddmartian,,19,33,14,47
21487,ringmod,,1,19,20,39
21488,tundratess,,1,15,31,46
21489,LindaJM,,0,1,1,2
21490,areh,,31,6,5,11
21491,jual,,22,3,10,13
21492,silverstrike,,22,36,11,47
21493,bmdmbphd001,,14,4,10,14
21494,biotmessiah,,12,1,2,3
21495,ruutanansissi,,19,2,1,3
21496,molnatisi,,18,188,3,191
21497,Ferguson1015,,6,35,1,36
21498,Kerrbear,,1,3,1,4
21499,mch,,15,634,1764,2398
21500,tlack,,20,109,173,282
21501,mgodave,,0,1,1,2
21502,Gizmod,,13,1,1,2
21503,cah1277,,13,5,3,8
21504,guyzero,,30,19,31,50
21505,lovegoodisgay,,21,1,1,2
21506,JesseOnReddit,,19,1,1,2
21507,dbcalo,,13,21,59,80
21508,grz,,20,8,12,20
21509,ColdCowboy,,18,4,4,8
21510,satorobamazombie,,13,5,1,6
21511,dfens,,43,18,33,51
21512,cazabam,,20,9,15,24
21513,jng,,20,21,20,41
21514,gilgoomesh,,20,92,101,193
21515,seemsartless,,32,2,1,3
21516,Nedemon,,43,2,1,3
21517,georgeb,,20,256,21,277
21518,clever-username,,12,2,1,3
21519,bdugas,,42,55,17,72
21520,Ermenwyr,,30,65,16,81
21521,sluggg,,0,3,4,7
21522,justincouch,,5,67,122,189
21523,veggiesoup,,18,11,18,29
21524,FleaBittenFreakShow,,19,3,4,7
21525,another_account,,3,1,2,3
21526,threeinthemorning,,19,3,6,9
21527,proudfoot,,8,1,1,2
21528,goldie04,,31,2,1,3
21529,squalk,,42,2,3,5
21530,jonathon1977,,13,82,2,84
21531,waggawagga,,19,823,134,957
21532,klui,,13,7,13,20
21533,benitohoover,,15,21,15,36
21534,koryk,,1,211,116,327
21535,celestialaria,,43,1,1,2
21536,Strauss_ismy_Grandpa,,43,85,30,115
21537,rutiene,,18,3,2,5
21538,reddit0ralpha,,31,4,6,10
21539,jlnotsobad,,43,4,5,9
21540,peterzuni,,13,8,22,30
21541,kinneys,,18,30,52,82
21542,runamok1,,22,111,161,272
21543,max15,,4,6,5,11
21544,buckeyetimmy,,19,24,1,25
21545,danielbuchanan,,16,41,75,116
21546,fredstidston,,43,3,11,14
21547,Entercom,,19,4,6,10
21548,diulv,,1,10,4,14
21549,umarboy,,18,432,58,490
21550,TheDreadedThommo,,31,5,3,8
21551,rnelsonee,,1,139,170,309
21552,yoric,,42,34,25,59
21553,csl110,,19,3,4,7
21554,maxcorp,,43,4,8,12
21555,akfidjeland,,20,1,1,2
21556,dearsomething,,18,70,134,204
21557,flangle1,,43,17,46,63
21558,SkeeterVT,,13,22,1,23
21559,JoshFiles,,20,34,7,41
21560,dilldoe,,22,1,1,2
21561,rhouston,,1,8,10,18
21562,mbouchard,,12,4,5,9
21563,rapidsea,,19,8,2,10
21564,reku,,19,10,17,27
21565,detroitsgoingtowork,,1,5,3,8
21566,hhh333,,20,635,571,1206
21567,dalmuti,,11,1,4,5
21568,goodbandnamefinder,,18,2,3,5
21569,gerbel01,,20,5,1,6
21570,discospank,,10,1,1,2
21571,saveuglyfish,,32,4,2,6
21572,Jodin,,19,175,12,187
21573,gameshot911,,19,301,183,484
21574,donhamon,,22,33,40,73
21575,euicho,,34,1,1,2
21576,vahnsin,,22,173,238,411
21577,paperzinorder,,42,1,3,4
21578,IOU12,,13,15,12,27
21579,ivrydov,,19,66,52,118
21580,SupremeNova,,34,1,1,2
21581,FreeManAndHisDog,,19,9,16,25
21582,kaitos,,17,14,16,30
21583,taptriv,,18,2,1,3
21584,GlueBoy,,22,332,317,649
21585,go_go_creationistas,,29,4,2,6
21586,kittyxiii,,43,42,26,68
21587,kahwee,,32,4,1,5
21588,politicalobserver,,19,10,2,12
21589,agentace,,18,85,189,274
21590,comechao,,20,3,1,4
21591,ashot,,19,29,27,56
21592,crm114,,19,173,56,229
21593,deosone,,31,2,2,4
21594,binarychimera,,13,1,1,2
21595,yourblues,,1,1,1,2
21596,mrsanchez,,20,64,96,160
21597,GuySmilee,,18,15,7,22
21598,nrfinney,,19,4,2,6
21599,BuckBuckBang,,13,1,11,12
21600,asdren,,32,6,6,12
21601,fitzgerald11,,14,1,1,2
21602,lembasbread,,18,200,284,484
21603,rodneykm,,18,38,92,130
21604,bludo,,1,9,13,22
21605,eieio,,13,3,8,11
21606,redmiss,,15,1,1,2
21607,aileana61702,,18,1,1,2
21608,rhlowe,,1,338,281,619
21609,Dunhamzzz,,18,3,4,7
21610,sionar,,18,32,14,46
21611,OVERM1ND,,19,2,5,7
21612,ironylocks,,31,37,40,77
21613,Thundercats_Hooo,,19,1,2,3
21614,OvrLpdIO,,18,5,1,6
21615,ixxy,,22,3,2,5
21616,orangepeel,,19,21,26,47
21617,Jay27,,32,24,32,56
21618,gustavopr,,13,13,19,32
21619,jawknee530,,43,8,16,24
21620,ratdogs,,18,10,2,12
21621,kaythetall,,19,14,15,29
21622,jng855,,13,3,4,7
21623,Summariser,,20,28,45,73
21624,Chrystala,,32,1,1,2
21625,zsombor,,20,7,7,14
21626,betasheep,,31,3,1,4
21627,jeremywc,,20,1,3,4
21628,johnsolo,,42,9,13,22
21629,EntropyG,,5,2,3,5
21630,worldpeacenow,,21,60,12,72
21631,whyamidoingthis,,1,3,1,4
21632,lbiewald,,20,24,1,25
21633,dcradler,,20,1,1,2
21634,mindofgenius,,19,11,3,14
21635,FarmerPete,,34,37,50,87
21636,chryler,,20,8,6,14
21637,moriya,,10,466,448,914
21638,mrtich,,18,1,3,4
21639,commieneko,,6,6,15,21
21640,koolaidman,,18,1,4,5
21641,tomhajdu,,13,85,4,89
21642,acab,,0,1,1,2
21643,anaranjaded,,18,46,34,80
21644,hootdoodie,,22,15,35,50
21645,darknessallaround,,20,18,6,24
21646,pnz,,5,5,5,10
21647,gdshephe88,,1,21,23,44
21648,sheeple-NH507,,32,3,1,4
21649,alsoodani,,18,147,174,321
21650,Zrimmy,,13,31,38,69
21651,feissner,,17,1,3,4
21652,McGruff-the-CrimeDog,,22,1,1,2
21653,mahoua,,18,2,4,6
21654,seddit999,,43,8,6,14
21655,Endura,,18,10,23,33
21656,shru,,34,69,2,71
21657,d_arvind,,32,6,6,12
21658,brother-seamus,,18,118,179,297
21659,hartmoney,,12,5,7,12
21660,rivercheng,,20,8,10,18
21661,Rivensteel,,22,30,15,45
21662,zakalwe,,32,4,1,5
21663,seven5,,1,1,7,8
21664,rabiddachshund,,18,226,361,587
21665,flyingblind,,13,1,3,4
21666,walrus99,,13,202,238,440
21667,unripegreenbanana,,15,216,120,336
21668,mbravenboer,,20,1,2,3
21669,rglullis,,13,5,1,6
21670,kanebosom,,1,5,15,20
21671,mysteri0usdrx,,31,188,233,421
21672,rabidmonkey1,,32,59,28,87
21673,patchwork,,20,307,258,565
21674,svantuss,,43,93,91,184
21675,charrom,,13,1,1,2
21676,White_Sox,,13,12,4,16
21677,krishnamurthy1,,5,11,8,19
21678,silva42,,19,3,4,7
21679,eyal0,,31,2,6,8
21680,effoveks,,18,1,2,3
21681,opkopk,,19,2,3,5
21682,littletamale,,8,29,39,68
21683,Project3,,18,2,6,8
21684,pugh,,38,3,2,5
21685,beeUnit,,18,117,277,394
21686,dognoir,,29,3,4,7
21687,QFever,,19,14,3,17
21688,joemart,,5,64,19,83
21689,clavalle,,20,6,13,19
21690,kadmia,,18,12,15,27
21691,OMGIAMSOANGRY,,18,19,15,34
21692,pwbdecker,,20,14,18,32
21693,giogreen,,25,2,2,4
21694,CletusTSJY,,19,5,13,18
21695,mcrosby,,4,7,3,10
21696,KaizerOumft,,12,2,5,7
21697,hepkat,,30,22,26,48
21698,nelsonjs,,13,2101,125,2226
21699,piranhoiac,,34,11,5,16
21700,Lostinservice,,8,41,56,97
21701,erikgil,,19,2,3,5
21702,gloveworld,,20,2,3,5
21703,Hypx,,18,56,10,66
21704,azitis,,2,5,2,7
21705,flashboy131,,12,9,5,14
21706,sappyheed,,3,1,2,3
21707,Rommel76,,43,1,1,2
21708,reethianaj,,36,11,6,17
21709,dice4death,,19,8,7,15
21710,atticusfinch1970,,1,48,98,146
21711,kaikaifi,,1,1,1,2
21712,jjiggajouncer,,35,3,2,5
21713,whitnone,,20,4,2,6
21714,dwayn3,,35,4,6,10
21715,Pfhreak,,18,2,1,3
21716,sydlab,,43,1,1,2
21717,Imperaclesw,,13,36,13,49
21718,AmazingTechProducts,,10,16,8,24
21719,rgristroph,,15,6,11,17
21720,wack_job,,32,9,6,15
21721,ace_wolfgang,,28,332,886,1218
21722,sigzero,,20,452,598,1050
21723,Pinetrees,,32,1,1,2
21724,jjgames,,5,20,12,32
21725,MeanOldTeacher,,20,2,2,4
21726,mquane,,13,48,8,56
21727,IveBeenEz,,22,13,19,32
21728,PhineusQButterfat,,19,4,2,6
21729,senjin,,31,13,16,29
21730,thelogicalsmoker,,13,26,3,29
21731,caadr,,20,2,2,4
21732,phnx0221,,5,1,2,3
21733,sadiq229,,20,139,7,146
21734,raskalz,,31,495,324,819
21735,mlclau,,0,2,10,12
21736,abstrusegoose,,17,46,3,49
21737,godzawor,,13,13,20,33
21738,adherent,,36,4,5,9
21739,pvg,,18,20,11,31
21740,kelmr2003,,22,162,271,433
21741,bd808,,43,1,1,2
21742,gernika,,19,14,21,35
21743,Huwcol,,20,7,9,16
21744,random_ms_dev,,20,1,1,2
21745,pageonehundredone,,17,3,2,5
21746,kidatheart,,32,16,22,38
21747,jordanst10,,18,1,1,2
21748,schuylercat,,1,1,10,11
21749,yourheadlinesucks,,36,1,1,2
21750,dougmachutta,,22,18,10,28
21751,FizZle,,43,62,53,115
21752,automatedresponse,,19,350,769,1119
21753,bryn,,22,41,108,149
21754,heisenbergs,,34,3,1,4
21755,I-heart-boobs,,36,1,3,4
21756,drewc,,20,101,140,241
21757,raf797,,1,50,30,80
21758,ladyles15,,13,22,30,52
21759,plbogen,,31,566,1071,1637
21760,baru,,20,7,1,8
21761,Mtrain,,13,165,145,310
21762,TheGreenBastard2,,19,2,7,9
21763,Stiltskin,,22,26,37,63
21764,callius,,19,45,84,129
21765,bipolarrogue,,13,21,7,28
21766,Lazrath,,34,58,118,176
21767,rynvndrp,,11,404,516,920
21768,modal,,39,1,3,4
21769,kepik99,,4,2,2,4
21770,CowardiceIsFrench,,30,5,3,8
21771,Disparity,,19,50,67,117
21772,mutantdad,,9,2,1,3
21773,jsheeran,,42,11,7,18
21774,RichardByrd,,3,1,1,2
21775,darkgatherer,,19,575,704,1279
21776,lizard_almighty,,19,1,1,2
21777,chiswede,,18,3,8,11
21778,hilandhall,,1,9,16,25
21779,lagattack,,20,8,7,15
21780,bamobrien,,19,261,515,776
21781,wjv,,20,121,46,167
21782,jlobes,,18,21,28,49
21783,blaaargh,,20,46,36,82
21784,Arctica,,13,103,32,135
21785,akcom,,20,2,2,4
21786,captainabab,,20,9,9,18
21787,kdesu,,18,27,31,58
21788,ShenaniganCannon,,18,22,49,71
21789,iamseb,,31,3,2,5
21790,jczerg68,,1,16,24,40
21791,Latvious,,18,54,51,105
21792,ManiacMunson,,43,50,10,60
21793,edenicholas,,20,4,3,7
21794,ak217,,20,2,3,5
21795,MesaDixon,,13,62,141,203
21796,corvenus,,4,120,232,352
21797,dr_vertigo,,0,53,36,89
21798,jlc,,20,11,15,26
21799,jedcaum,,31,32,58,90
21800,thaworldhaswarpedme,,13,1,1,2
21801,azrolboyz,,43,2,3,5
21802,TheSuperficial,,20,28,47,75
21803,cp1134,,20,14,3,17
21804,apolloandi,,22,8,18,26
21805,dregle,,18,123,108,231
21806,Xenogyst,,13,5,10,15
21807,h-town,,19,672,623,1295
21808,IwillUpmodAnything,,19,29,4,33
21809,toupeira,,20,87,113,200
21810,anais9000,,13,6,11,17
21811,nashy,,7,1,1,2
21812,jaba1337,,18,38,50,88
21813,5cf5e83a,,32,134,158,292
21814,BookWormPride,,34,319,1,320
21815,Pinecone,,43,93,151,244
21816,ddp,,19,9,33,42
21817,fadain,,18,1,1,2
21818,Nouareii,,1,100,17,117
21819,The_Dude,,0,5,8,13
21820,fatmaggot,,11,3,8,11
21821,Whatta,,3,2,1,3
21822,ritteh,,20,20,21,41
21823,hasty_d,,13,5,4,9
21824,Rozen,,43,213,404,617
21825,alex14,,30,15,23,38
21826,COLORED_MAJORITY,,31,3,4,7
21827,JaredTizzle,,1,82,17,99
21828,cico71,,31,1,2,3
21829,NoUnderbites,,1,22,27,49
21830,Lexarius,,20,303,442,745
21831,parkerknoll,,19,116,127,243
21832,Lancose,,13,3,3,6
21833,republicus,,13,68,5,73
21834,Benjaphar,,6,199,200,399
21835,gramie,,10,1,2,3
21836,shutr,,12,45,87,132
21837,antharjalaya,,13,43,4,47
21838,stealthburger,,18,1,5,6
21839,fragmede,,20,21,15,36
21840,trojan7815,,13,152,53,205
21841,allliam,,4,36,47,83
21842,wazzadoin,,39,163,227,390
21843,partysnatcher,,1,3,3,6
21844,onehandhigh,,13,1,6,7
21845,hp0,,10,289,466,755
21846,mickael,,20,15,8,23
21847,eovery,,40,1,4,5
21848,Coriform,,18,49,54,103
21849,kapc,,32,1,2,3
21850,johnrover,,36,6,9,15
21851,johndear3,,0,5,11,16
21852,Blu-Aardvark,,22,1,1,2
21853,FiberOptics,,34,2,21,23
21854,sekritkoad,,0,75,110,185
21855,richtone,,20,1,1,2
21856,dirtracerswife7,,1,1,1,2
21857,sevencorvina,,32,14,24,38
21858,nickstatus,,1,1,5,6
21859,smayland,,19,16,48,64
21860,Gop3588,,22,74,49,123
21861,redherring84,,18,60,121,181
21862,snaps4darienfoo,,29,1,1,2
21863,Metalevel,,14,2,1,3
21864,gwheeler,,31,13,19,32
21865,mccafferty,,20,1,1,2
21866,hwaite,,20,5,8,13
21867,Telekinesis,,8,2,3,5
21868,Penseur85,,13,4,1,5
21869,sickoo,,18,1459,56,1515
21870,ComradeUSA,,13,206,23,229
21871,sonar1,,1,102,129,231
21872,boxofish,,1,1,4,5
21873,darkies,,20,1,1,2
21874,clarion,,32,109,212,321
21875,jelasher,,19,130,75,205
21876,jgodt,,43,46,30,76
21877,billthelizard,,4,1,1,2
21878,frito47,,36,1,4,5
21879,luke_s,,1,4,5,9
21880,tairygreene,,0,8,44,52
21881,tummala,,43,2,1,3
21882,fedy22,,6,9,8,17
21883,ece421,,32,6,21,27
21884,kencam,,18,136,281,417
21885,alanjcfs,,19,1,1,2
21886,skimitar,,18,165,89,254
21887,chimchunk,,13,1,4,5
21888,critik,,5,18,45,63
21889,mughlibuc,,20,27,4,31
21890,dave138h,,13,15,25,40
21891,razaeli,,19,4,14,18
21892,DaylightAtheism,,32,43,2,45
21893,Woody45,,9,1,1,2
21894,HypoLuxa,,0,173,290,463
21895,sixothree,,34,266,543,809
21896,adc,,1,6,5,11
21897,gasjews,,39,2,1,3
21898,Bodhi1,,13,8,3,11
21899,gimiv,,9,7,6,13
21900,herkguy,,4,53,70,123
21901,Notnasiul,,20,5,7,12
21902,horia314,,20,10,9,19
21903,searine,,13,10,14,24
21904,chunjae,,19,191,21,212
21905,Brandbla8,,5,11,1,12
21906,Diffus,,11,3,4,7
21907,zeroclash,,12,6,3,9
21908,Fradgers,,18,19,38,57
21909,boagreus,,14,35,33,68
21910,bishney,,29,73,59,132
21911,petrov76,,20,192,132,324
21912,liquorlunchbox,,43,26,33,59
21913,ryanryguy,,18,1,1,2
21914,danbmil99,,32,1,2,3
21915,RexEast,,20,1,1,2
21916,dicedice,,39,1,1,2
21917,zzzz2008,,13,37,22,59
21918,thunderkat,,20,73,129,202
21919,kb63108,,19,6,14,20
21920,Dasmitch,,13,159,159,318
21921,ollokot,,13,8,14,22
21922,wadet,,43,4,3,7
21923,gregjsmith,,34,1,1,2
21924,bytesmythe,,6,8,11,19
21925,sufo,,19,10,8,18
21926,ThyLabyrinth,,19,235,381,616
21927,niller8p,,34,49,28,77
21928,Janderwastaken,,42,8,19,27
21929,lemz,,19,34,35,69
21930,turmoil,,20,2,1,3
21931,VerbalAbility,,29,1,2,3
21932,susanrae,,18,6,24,30
21933,Blarbo,,13,2,5,7
21934,j0e,,18,1,1,2
21935,ontarioemperor,,29,1,2,3
21936,wormnut,,18,55,170,225
21937,willis3000,,20,43,75,118
21938,jennifer2002,,12,1,1,2
21939,TimMensch,,20,3,6,9
21940,rafishtut,,5,4,7,11
21941,shal0819,,18,108,117,225
21942,egarson,,20,2,6,8
21943,AmenBreak,,29,22,17,39
21944,fredhsu,,32,1,4,5
21945,diogenes,,31,44,38,82
21946,Arcosim,,18,11,7,18
21947,NoSpiderEatBird,,20,2,1,3
21948,Nancy_Pelosi,,19,10,29,39
21949,kidcorporeal,,43,123,160,283
21950,jvcvhs0123,,19,11,5,16
21951,exogen,,20,20,13,33
21952,mrautomatic,,31,1,1,2
21953,stinkyface,,39,3,9,12
21954,9GWQ6bfi,,34,4,9,13
21955,chaconj,,30,1,1,2
21956,wbond,,20,26,4,30
21957,galactic_hitchhiker,,43,1,1,2
21958,sanepsychotic,,13,7,3,10
21959,bigjoe13,,13,26,32,58
21960,voteforamerica,,13,43,1,44
21961,endo,,20,16,21,37
21962,9xX,,42,5,8,13
21963,AriG,,20,9,8,17
21964,nimbl,,42,1,2,3
21965,najcix,,18,40,1,41
21966,busblog,,1,1,2,3
21967,dcontrol,,0,1,1,2
21968,Astronoid,,13,325,382,707
21969,violizard,,10,41,67,108
21970,t_man700,,15,1,2,3
21971,subhub,,5,7,1,8
21972,QuietDestroyer77,,43,23,56,79
21973,toinfinitiandbeyond,,18,11,4,15
21974,softslinger,,36,20,19,39
21975,lkasndfnk,,12,1,1,2
21976,Joneth,,12,112,159,271
21977,bair422,,13,4,6,10
21978,mannytabloid,,31,10,13,23
21979,Astrus,,43,15,5,20
21980,contentoverclarity,,4,4,1,5
21981,cbender35,,13,885,248,1133
21982,jasonm23,,27,1,1,2
21983,vk2sky,,18,7,16,23
21984,darthseb,,14,2,2,4
21985,logus,,20,1,1,2
21986,Dorian_at_Reddit,,42,2,3,5
21987,axiomnow,,0,1,7,8
21988,HybridVigor,,20,1,1,2
21989,lloydxmas,,1,107,243,350
21990,CorporalClegg,,1,2,8,10
21991,queisser,,20,3,8,11
21992,digg1980,,14,7,2,9
21993,lapo3399,,18,134,117,251
21994,sweetlove,,18,136,211,347
21995,glitch13,,22,23,15,38
21996,neokoros,,18,29,81,110
21997,ajoakim,,22,6,7,13
21998,Cyrius,,3,335,633,968
21999,jkustalicious,,33,19,4,23
22000,21jack21,,13,3,1,4
22001,Slick_42,,43,7,9,16
22002,barbieri,,20,3,3,6
22003,feignman,,43,3,2,5
22004,russwbernstein,,19,3,13,16
22005,caulder,,23,4,5,9
22006,mugproject,,5,11,3,14
22007,axonrg,,13,1,1,2
22008,badasslingo,,43,1,1,2
22009,theram4,,10,123,121,244
22010,HextorFreebish,,32,133,230,363
22011,dds,,20,3,5,8
22012,Ben_Ben,,18,9,4,13
22013,homeaccount,,20,5,6,11
22014,CaptainCrunch,,13,340,433,773
22015,soots,,6,1,1,2
22016,Ein2015,,18,32,24,56
22017,sicgamer,,1,180,111,291
22018,b-spline,,18,1,1,2
22019,Comedian,,29,16,22,38
22020,StRophia,,41,3,1,4
22021,foos,,34,9,23,32
22022,MediumRare,,19,9,7,16
22023,nfk,,19,3,2,5
22024,smithysmitherson,,18,46,73,119
22025,sefie,,32,1,2,3
22026,jmsaunders,,20,8,15,23
22027,User_Agreement,,32,94,10,104
22028,lkilcher,,19,1,1,2
22029,JoeHerrick,,36,1,1,2
22030,Helcionelloida,,4,12,2,14
22031,beerwineliquor,,20,17,79,96
22032,ryanpc,,32,3,8,11
22033,mckirsch,,18,37,71,108
22034,Vetsin,,0,27,59,86
22035,qazxsw43,,19,34,1,35
22036,totalof,,19,9,21,30
22037,crazygates,,39,3,2,5
22038,devonRT,,31,1,2,3
22039,chromehorserace,,19,3,5,8
22040,noname99,,12,5791,188,5979
22041,sbender,,5,4,6,10
22042,nadaclue2,,19,3,12,15
22043,JackNobbins,,20,1,2,3
22044,sass-buttes-org,,30,2,1,3
22045,t-dar,,18,3,2,5
22046,Hal9001,,27,6,8,14
22047,sasharocks,,1,17,16,33
22048,kickme444,,18,613,61,674
22049,segfaultxr7,,20,142,136,278
22050,nbloomf,,20,157,266,423
22051,doodlebugger,,19,7,19,26
22052,AverageCanadian,,1,6,3,9
22053,psyllogism,,13,15,4,19
22054,vetinari,,20,15,20,35
22055,000xxx000,,13,171,285,456
22056,europeman,,19,1,3,4
22057,TobascoMan,,20,2,2,4
22058,darrendloux,,13,23,24,47
22059,giovannib,,18,11,13,24
22060,mhmitszach,,19,5,2,7
22061,Mr_Randy_Watson,,18,314,575,889
22062,joandarque,,43,1,2,3
22063,weretheman,,19,8,4,12
22064,pimpampoum,,0,10,17,27
22065,eyekantspel,,18,16,25,41
22066,lerouxb,,20,6,7,13
22067,confidentmeus,,34,1,1,2
22068,brufleth,,31,853,1343,2196
22069,peanutboy,,18,64,142,206
22070,snusmumriken,,1,2,13,15
22071,themullet,,32,4,10,14
22072,gtolson,,20,28,27,55
22073,Violator99,,39,3,2,5
22074,gst,,20,4906,3,4909
22075,flourpour,,12,1,1,2
22076,StopMcCainWhoosit,,13,69,36,105
22077,lisarhianne,,13,7,4,11
22078,wyfflemunky,,26,49,77,126
22079,circusgeek,,0,4,3,7
22080,Red_Wind,,13,3,3,6
22081,stonkin,,18,17,12,29
22082,NoComment,,42,77,13,90
22083,elebrio,,19,36,51,87
22084,JayCTN,,13,19,2,21
22085,rasheemo,,31,40,59,99
22086,ttom,,34,2,4,6
22087,humppapappavaan,,22,59,106,165
22088,frubru,,20,1,3,4
22089,kobs,,20,6,10,16
22090,pbx,,20,127,75,202
22091,zonindehemel,,31,4,2,6
22092,rs85,,22,12,19,31
22093,potyl,,6,3,4,7
22094,smitty13,,21,20,32,52
22095,FlimtotheFlam,,34,30,50,80
22096,getsmartgal,,5,58,32,90
22097,PelonPeloRico,,27,1,2,3
22098,send9,,19,7,9,16
22099,stephencwebster,,13,309,2,311
22100,articleCK,,1,2,1,3
22101,Jedimushroom,,22,26,50,76
22102,ArmedJimmy,,20,15,21,36
22103,deniall,,35,2,3,5
22104,RugerRedhawk,,19,1691,2818,4509
22105,fantagrape,,20,20,19,39
22106,Steve16384,,20,488,609,1097
22107,JessicaLaurie,,0,1349,34,1383
22108,rkstiner,,1,1,2,3
22109,gormer,,34,1,1,2
22110,siliconsnake,,34,1,1,2
22111,uckevin111,,3,6,1,7
22112,fallfornaught,,18,138,107,245
22113,Figs,,20,881,1276,2157
22114,manniac,,31,29,60,89
22115,jarklejam,,22,48,39,87
22116,jollygreengiant,,19,14,28,42
22117,psmith,,42,2,2,4
22118,sarotu,,13,2,3,5
22119,fuzzcat,,42,31,37,68
22120,krammark23,,4,1,1,2
22121,raju1kabir,,13,3,11,14
22122,Pyorrhea,,6,49,77,126
22123,pfairley,,13,22,1,23
22124,Stucco_x,,4,8,10,18
22125,catilac,,4,1,2,3
22126,ransom_phantom,,19,3,4,7
22127,billybobjoe71588,,12,1,3,4
22128,Masonry,,1,2,5,7
22129,Worstcasescenario,,12,134,118,252
22130,queus,,20,262,383,645
22131,sovereignmatt,,13,168,98,266
22132,sadrius,,13,30,49,79
22133,cevven,,20,44,83,127
22134,dalke,,20,2,4,6
22135,Governor00,,19,2,2,4
22136,Neumann347,,5,1,4,5
22137,craigatkinson,,6,2,1,3
22138,demet8,,43,3,5,8
22139,gimme909,,6,1,1,2
22140,NixonsHead,,12,2,1,3
22141,Altazar,,19,14,10,24
22142,eAi,,20,4,1,5
22143,PsychoKiller,,29,1,2,3
22144,shp,,20,2,2,4
22145,aphedox,,19,3,11,14
22146,eoin63,,13,1,3,4
22147,Lagz,,13,27,37,64
22148,lynl,,18,22,27,49
22149,mikegimik,,19,2,6,8
22150,JesseLee,,32,2,2,4
22151,pjenvey,,20,2,1,3
22152,Dummies102,,18,22,44,66
22153,Hawkeye05,,18,138,77,215
22154,beniro,,13,19,24,43
22155,hoxer,,19,6,8,14
22156,asdidi,,1,5,17,22
22157,luke_,,20,1,2,3
22158,rabel,,31,50,68,118
22159,Absolutely_,,0,1,1,2
22160,godeva,,4,1,1,2
22161,innervision,,20,14,30,44
22162,scottmonty,,34,10,2,12
22163,kanon,,4,5,4,9
22164,drupalnub,,17,3,2,5
22165,debney,,19,23,14,37
22166,sosondowah,,31,20,12,32
22167,foogar,,20,3,4,7
22168,justthefacts127,,15,1,1,2
22169,jarhowa,,13,2,1,3
22170,fredzoorzz,,18,1,1,2
22171,kn0thing,,1,649,228,877
22172,suchmann,,18,2,4,6
22173,narwhals,,18,2,3,5
22174,eromitlab,,19,504,959,1463
22175,TheLtOfInishmore,,13,14,30,44
22176,DownedForOverposting,,32,3,12,15
22177,ghflyfk,,42,1,1,2
22178,parboman,,19,9,8,17
22179,voiceofra,,22,12,31,43
22180,signeduptopost-this,,20,4,1,5
22181,dmron,,0,2,6,8
22182,Satanscock,,13,340,669,1009
22183,ryanhughes,,42,16,1,17
22184,somedoody,,31,466,638,1104
22185,Janischambers,,22,1,1,2
22186,eyeshield21,,31,18,11,29
22187,Nysul,,10,40,57,97
22188,bolivarbum,,13,41,62,103
22189,AndruLuvisi,,20,4,1,5
22190,jawz101,,1,53,127,180
22191,xyggyx,,8,3,3,6
22192,redfiretrucker,,20,3,1,4
22193,lost_stranger,,20,9,8,17
22194,tynman,,36,5,1,6
22195,hazardperry,,19,53,64,117
22196,sociallyinept,,1,92,23,115
22197,OrangeTux,,13,22,27,49
22198,seiken,,18,99,139,238
22199,Anon2321,,8,1,1,2
22200,stevengg,,19,64,12,76
22201,skbharman,,18,106,94,200
22202,Doodly,,19,26,28,54
22203,tonfa,,20,82,64,146
22204,pferdestarke,,32,1,2,3
22205,simucal,,39,2,2,4
22206,vthlr,,32,4,7,11
22207,stubbornbelle,,13,218,143,361
22208,spdly,,7,1,2,3
22209,Sasquatchy,,34,1,1,2
22210,Rtbriggs,,1,249,374,623
22211,hillman,,20,1,3,4
22212,angusmcflurry,,20,32,63,95
22213,PPB,,19,7,8,15
22214,amps11,,1,2,5,7
22215,RichMiserable,,32,1,1,2
22216,damvan,,6,15,21,36
22217,mr6275,,32,17,30,47
22218,duskglow,,1,971,789,1760
22219,arvixx,,20,32,13,45
22220,phlyingpenguin,,20,13,38,51
22221,ideaman21,,31,2,1,3
22222,Nokade,,18,50,91,141
22223,gordonlbuchanan,,31,3,1,4
22224,Pepper3333,,31,1,1,2
22225,embretr,,9,92,248,340
22226,cessu,,23,1,4,5
22227,Sabaron,,31,24,41,65
22228,hylje,,20,274,501,775
22229,SilentlyScreaming,,5,2,1,3
22230,thelonegunmen,,1,1,2,3
22231,jonaku,,13,17,1,18
22232,chickens,,20,2,3,5
22233,tfvdw2at,,19,2,3,5
22234,chronicmasturbater,,13,1,1,2
22235,katstar873,,31,48,67,115
22236,pr1m3,,16,7,1,8
22237,TheLegionnaire,,13,50,21,71
22238,blackrockcoast,,13,5,1,6
22239,hexley,,0,5,12,17
22240,Tigereyz,,30,36,21,57
22241,f8ster,,42,3,2,5
22242,EatGreenHumans,,13,5,1,6
22243,toddmfay,,19,18,8,26
22244,Fuk_Boonyalls,,6,3,3,6
22245,Prendeghast,,22,1,2,3
22246,rspeer,,20,10,15,25
22247,broderizdreagan,,18,10,13,23
22248,SpacePirate,,12,21,28,49
22249,few,,1,10,8,18
22250,kevingoodsell,,32,28,41,69
22251,remembercrunchy,,6,2,1,3
22252,anonfornow,,34,1,2,3
22253,jonnybryce,,18,24,35,59
22254,blackrobot,,18,19,7,26
22255,iuferky0,,35,1,3,4
22256,ohuyel,,19,4,3,7
22257,alizaki,,19,69,41,110
22258,mlouie728,,20,3,13,16
22259,OGMO,,20,2,1,3
22260,vapblack,,0,258,246,504
22261,Th3_C0bra,,19,357,340,697
22262,TommyCarcetti,,3,1,1,2
22263,timetofly,,13,7,17,24
22264,ringelingeling,,18,13,8,21
22265,duchesskat,,29,2,1,3
22266,ElectricSol,,10,371,535,906
22267,ryancote,,5,6,1,7
22268,lighthill,,36,7,3,10
22269,wipeout,,5,1,1,2
22270,notloste,,39,1,4,5
22271,Anonymous1234,,13,1,3,4
22272,hashinclude,,20,6,1,7
22273,Dreadgoat,,13,2,1,3
22274,blm126,,43,1,2,3
22275,politalk,,19,13,2,15
22276,chrisporter,,31,4,4,8
22277,acerman99,,15,1,1,2
22278,michelson01,,43,4,1,5
22279,PimpFTRCC,,18,84,3,87
22280,dalbert,,19,234,33,267
22281,trakker,,29,1,3,4
22282,buscuta,,31,4,7,11
22283,fgsdfrtb,,18,23,11,34
22284,UnderwaterJones,,1,165,245,410
22285,sdmx,,41,8,4,12
22286,csonger,,5,1,4,5
22287,woodsier,,22,348,628,976
22288,wushi,,43,70,116,186
22289,JacobB,,20,1,4,5
22290,bahollan,,33,81,120,201
22291,jab-programming,,20,1,8,9
22292,Hobo740,,1,25,69,94
22293,darkesnow,,19,2,7,9
22294,aZoo,,32,2,10,12
22295,dontevenfucwitme,,42,2,3,5
22296,Prom_STar,,30,16,27,43
22297,try_chackson,,34,75,2,77
22298,lukemcr,,1,228,207,435
22299,Krippy,,13,18,41,59
22300,typon,,1,359,381,740
22301,plasticswirl,,19,13,30,43
22302,saadkamal,,42,33,2,35
22303,Skatcho,,30,22,27,49
22304,islandjoe,,4,1,1,2
22305,germ666,,13,42,13,55
22306,ribbiter,,32,31,51,82
22307,swanc,,41,4,3,7
22308,diggum,,34,130,210,340
22309,Gommle,,4,6,6,12
22310,luciferin,,1,1,1,2
22311,mr_visible,,8,2,3,5
22312,oconostota,,13,506,940,1446
22313,linkhunter,,19,7,1,8
22314,miho99,,0,11,19,30
22315,h3st,,20,31,64,95
22316,apdt,,36,1,4,5
22317,xaustinx,,27,2,3,5
22318,GotEmLookin,,12,44,59,103
22319,jgiesinger,,13,7,25,32
22320,rzwitserloot,,20,21,14,35
22321,JManuelD,,31,1,2,3
22322,kd_royal,,22,10,28,38
22323,gx6wxwb,,20,12,21,33
22324,mixx941,,1,2,2,4
22325,bonzinip,,20,414,478,892
22326,aedes,,19,2228,1062,3290
22327,Thelonious_Cube,,32,56,87,143
22328,keebiejeebie,,1,29,69,98
22329,xuttmi,,20,29,29,58
22330,douched,,19,31,69,100
22331,ZuchinniOne,,31,40,35,75
22332,mankin,,34,5,1,6
22333,sacrimony,,18,84,98,182
22334,BlazinEurasian,,18,445,633,1078
22335,bobloco76,,18,2,2,4
22336,tach,,6,243,339,582
22337,cdesignproponentsist,,20,303,591,894
22338,jebreject,,29,1,2,3
22339,0x10,,20,4,9,13
22340,floop,,19,1,3,4
22341,Silentium,,1,5,13,18
22342,Arsthena,,0,5,6,11
22343,R7-D1,,5,32,17,49
22344,drturvy,,29,13,15,28
22345,thatpirategirl,,14,4,3,7
22346,anoraq,,30,67,113,180
22347,zhangsen,,20,2,1,3
22348,hooplow,,20,80,8,88
22349,bigtoga,,20,32,53,85
22350,lenovo,,0,74,136,210
22351,dbenhur,,20,551,373,924
22352,adrian,,42,111,9,120
22353,chunkyks,,1,2,5,7
22354,austinb,,29,2,2,4
22355,Nerdlinger,,18,46,79,125
22356,gfxlonghorn,,3,109,158,267
22357,moocowheff,,39,3,1,4
22358,willem,,22,7,12,19
22359,dcx,,1,5,9,14
22360,Andoo,,13,3,4,7
22361,mibarra,,18,17,4,21
22362,thecapitalc,,30,79,101,180
22363,aussiebb,,13,8,2,10
22364,DarthTater,,19,10,1,11
22365,atothez,,39,2,2,4
22366,PeninsulaGuy,,18,1,11,12
22367,yzerfontein,,43,1,1,2
22368,captainstabb,,19,5,6,11
22369,ajwarren,,1,425,529,954
22370,Reporter,,19,348,631,979
22371,lowenheim,,1,313,271,584
22372,AmyR,,42,1,1,2
22373,paulmalo,,13,2,4,6
22374,dubbleenerd,,22,379,218,597
22375,CorpT,,42,81,70,151
22376,airplane,,22,13,25,38
22377,mcaruso,,20,57,26,83
22378,rywalker,,19,22,10,32
22379,rodle,,17,1,1,2
22380,my_reddit,,18,301,2,303
22381,reddit_ore,,19,20,50,70
22382,meeks,,1,19,29,48
22383,nikopol,,20,2,6,8
22384,marglexx,,31,144,217,361
22385,mintsource,,20,1,1,2
22386,stimples,,19,1,1,2
22387,wiachy,,19,60,63,123
22388,biobio,,8,1,1,2
22389,mineh,,1,1,1,2
22390,IamJoethePlumber,,1,36,22,58
22391,rbsftw,,1,1,2,3
22392,junke_3,,18,30,42,72
22393,mjl5629,,18,10,20,30
22394,goomboss,,12,1,3,4
22395,freshyill,,19,3,7,10
22396,TexasCanuck,,13,63,105,168
22397,bski1776,,31,71,109,180
22398,doctor_subtilis,,20,6,15,21
22399,barnabymeller,,22,1,1,2
22400,cranium,,32,508,57,565
22401,fjhqjv,,22,941,1316,2257
22402,BadBoyNDSU,,32,182,280,462
22403,Willtingle,,19,11,16,27
22404,mushmouph,,1,37,2,39
22405,soulhacker,,20,1,6,7
22406,d3mag0gu3,,19,54,54,108
22407,blender3000,,13,1,2,3
22408,swupuws,,22,14,12,26
22409,zombieaynrand,,6,441,357,798
22410,Geckoman,,26,3,1,4
22411,bulio,,19,16,1,17
22412,grt,,43,1,1,2
22413,nollek,,43,2,2,4
22414,wrngway,,19,3,4,7
22415,mlk,,12,653,547,1200
22416,frozendevil,,20,2,2,4
22417,eldentisto,,18,10,4,14
22418,JimmyJamesMac,,31,18,56,74
22419,nate94gt,,3,1,1,2
22420,joker10687,,18,131,196,327
22421,stormzebastille,,13,18,43,61
22422,barvazim,,0,83,17,100
22423,m-p-3,,32,7,23,30
22424,hphp,,18,14,17,31
22425,raarky,,4,33,49,82
22426,lotu,,1,43,62,105
22427,kpierre,,20,23,14,37
22428,wiseleyb,,34,17,23,40
22429,sirlearnsalot,,6,140,242,382
22430,alexmat,,0,25,24,49
22431,Chamanzan,,13,353,308,661
22432,Arxilca,,18,45,26,71
22433,jamesman,,1,2,1,3
22434,CG10277,,20,74,1,75
22435,otterdam,,22,588,817,1405
22436,squatto,,13,5,3,8
22437,socialguytoy,,20,1,3,4
22438,sunburnt,,1,13,5,18
22439,zacroy,,13,3,4,7
22440,Slashered,,42,123,7,130
22441,DevilsAdv0cate,,13,19,13,32
22442,badmadbob,,4,1,1,2
22443,alekseykorzun,,32,2,1,3
22444,dlew,,22,1,1,2
22445,5thape,,12,8,13,21
22446,PJinAK,,30,1,1,2
22447,tesseract_rider,,22,11,5,16
22448,middayminer,,22,25,42,67
22449,rdpriest,,19,3,1,4
22450,Knapsack,,13,47,75,122
22451,brksy,,30,26,43,69
22452,derkieselgarten,,34,2,1,3
22453,Shananra,,31,6,9,15
22454,professorcreep,,42,4,4,8
22455,punzak,,18,5,12,17
22456,nandolvvlln,,18,2,1,3
22457,kcnchfan,,31,494,232,726
22458,yorian,,1,266,64,330
22459,rasta999,,19,4,5,9
22460,blue_entropy,,20,9,7,16
22461,AlbertGramatico,,13,10,18,28
22462,aboothe726,,20,212,159,371
22463,jimgardner1973,,19,6,4,10
22464,titaniumdecoy,,13,4,11,15
22465,harvester,,34,142,32,174
22466,md5,,19,25,28,53
22467,stantz,,6,12,12,24
22468,tacoswild,,32,6,9,15
22469,dufour,,14,18,24,42
22470,AlexeyMK,,31,185,154,339
22471,hypocondrite,,43,3,4,7
22472,neb,,0,1,1,2
22473,mikepurvis,,20,468,499,967
22474,mhaggag,,20,49,60,109
22475,jimmick,,18,187,145,332
22476,psycho_cat,,13,1,1,2
22477,castanova,,0,328,7,335
22478,andknitting,,22,10,21,31
22479,pragdave,,20,1,1,2
22480,bonerjones,,0,43,105,148
22481,misterpantsz,,13,50,9,59
22482,InWhatRespectCharlie,,32,5,7,12
22483,tflynch,,20,7,11,18
22484,kimmyd,,4,2,2,4
22485,ChinesePropaganda,,40,8,7,15
22486,Ingenium21,,3,25,41,66
22487,burying_luck,,39,4,2,6
22488,sighkobabel,,19,34,59,93
22489,alandy25,,12,2,2,4
22490,setrajonas,,19,3,7,10
22491,majorwtf,,18,437,27,464
22492,piquana,,22,31,3,34
22493,proteinstainedpants,,31,2,1,3
22494,gatey,,14,2,3,5
22495,icecow,,20,7,7,14
22496,estutius,,43,133,118,251
22497,OhioDuran,,42,1,2,3
22498,nrx22,,19,19,3,22
22499,pastr,,34,66,14,80
22500,futz,,16,1,2,3
22501,bobbmalooga,,5,8,5,13
22502,ColeSQ,,13,11,11,22
22503,faultywiring,,19,10,15,25
22504,sassinator,,13,56,11,67
22505,KingNothing,,43,123,169,292
22506,Silver_,,14,119,256,375
22507,inspekt0rgadget,,19,18,19,37
22508,skoll,,20,90,90,180
22509,txstoploss,,13,261,344,605
22510,benjiz,,31,25,14,39
22511,Autodidactic,,43,21,9,30
22512,reddddditer,,31,6,16,22
22513,Armageddon85,,12,3,2,5
22514,cuteman,,19,139,236,375
22515,spondee,,20,14,16,30
22516,mobzoe,,1,3,3,6
22517,Damon29,,43,2,1,3
22518,Entropy_Man,,30,2,3,5
22519,L2182,,19,19,1,20
22520,biskithead,,18,5,1,6
22521,xarcos,,32,10,12,22
22522,estacado,,18,32,34,66
22523,youboozeyoulose,,33,2,4,6
22524,beardedrooster,,1,19,51,70
22525,mbrophy,,22,1,1,2
22526,Greengages,,4,451,803,1254
22527,potemkin,,42,1,2,3
22528,tylermenezes,,1,187,307,494
22529,FCI,,12,6,9,15
22530,bill_o_r,,29,1,1,2
22531,Apple_Dave,,22,95,91,186
22532,jessek,,32,159,180,339
22533,MasterRex,,10,7,10,17
22534,jamesgolick,,20,87,7,94
22535,BeShirtHappy,,18,5,14,19
22536,skepticsglobal,,0,5,12,17
22537,growlypants,,35,2,2,4
22538,rq60,,22,71,128,199
22539,kapetanaki,,32,27,32,59
22540,whdevo,,13,13,12,25
22541,zilx,,18,4,5,9
22542,on_surfaces,,29,1,1,2
22543,supercargo,,43,113,198,311
22544,yeskia,,1,74,70,144
22545,chendoguy,,19,12,12,24
22546,Johnbrad34,,0,93,10,103
22547,djolemcloud,,5,12,1,13
22548,maxwell_smart,,19,29,45,74
22549,pfroo40,,36,1,1,2
22550,SniftyIsATard,,32,1,1,2
22551,errant,,8,19,28,47
22552,firepacket,,13,152,165,317
22553,wiccanflame,,15,13,14,27
22554,Capi77,,18,30,39,69
22555,fann,,19,41,11,52
22556,hybridxdawn,,19,1,2,3
22557,RCA,,19,2,3,5
22558,giancarlo84,,13,18,32,50
22559,chieftechdude,,6,1,1,2
22560,peter1402,,30,13,11,24
22561,defenestrate,,13,110,70,180
22562,adolfojp,,20,169,268,437
22563,magnusjonsson,,20,13,14,27
22564,Krapulator,,0,11,12,23
22565,stick_figure,,20,13,6,19
22566,PaulT23,,34,2,1,3
22567,WomenAreBitches,,5,1,2,3
22568,hugyftdrt,,21,1,1,2
22569,chriscrewdson,,32,5,5,10
22570,pencapchew_3,,1,68,59,127
22571,morkork,,18,19,6,25
22572,bsonk,,18,31,35,66
22573,mattslo,,3,12,19,31
22574,dybber,,20,67,68,135
22575,utnapistim,,34,8,12,20
22576,CAD420,,42,1,1,2
22577,darthabraham,,0,31,45,76
22578,aboutblank,,34,31,66,97
22579,cntzero,,5,14,11,25
22580,rozarsmahkco,,4,2,1,3
22581,KimonoThief,,18,3,9,12
22582,RichG13,,34,1,2,3
22583,Sivart13,,20,3,9,12
22584,jopa666,,19,5,16,21
22585,netactor,,20,59,65,124
22586,kleevr,,31,1,1,2
22587,GeneralVartanian,,19,25,47,72
22588,TRUCK,,39,1,1,2
22589,pegothejerk,,13,11,22,33
22590,OffByPi,,32,1,1,2
22591,twinkie,,13,5,5,10
22592,Odysseus,,20,228,330,558
22593,mriutta,,12,1,1,2
22594,BRizzy80,,29,50,26,76
22595,misho1,,34,70,112,182
22596,geehugo,,12,1,1,2
22597,dobson187,,1,38,55,93
22598,kuratkull,,8,1,3,4
22599,barryfm,,13,139,16,155
22600,evilstickman,,34,9,7,16
22601,hectavex,,3,3,7,10
22602,registerin,,13,1,1,2
22603,taylorham,,32,10,11,21
22604,CallMeZoot,,31,126,179,305
22605,mkayohwell,,15,1,1,2
22606,huda210,,32,10,22,32
22607,trickonion,,4,30,36,66
22608,Fragsworth,,1,343,140,483
22609,joann2,,19,2,5,7
22610,benlan,,22,4,6,10
22611,ecorazzi,,19,53,2,55
22612,sheep1e,,20,404,789,1193
22613,gregsaliva,,3,1,1,2
22614,stephenstephen,,18,1,4,5
22615,lysozyme,,33,2,3,5
22616,CharmQuark,,34,38,1,39
22617,humbleservant56,,19,2,3,5
22618,hanki,,31,17,29,46
22619,albertine,,31,14,1,15
22620,morgid,,4,4,1,5
22621,im_cool_imo,,3,5,4,9
22622,m8ncman,,4,2,3,5
22623,hornlo,,20,1,2,3
22624,OldLifeForm,,31,141,269,410
22625,the_war_won,,34,14,29,43
22626,tehcypress,,17,5,27,32
22627,serivers,,20,1,1,2
22628,Punian,,13,14,2,16
22629,Aikidi,,23,669,993,1662
22630,bdehora,,20,2,2,4
22631,neshel,,21,1,1,2
22632,mcshaken,,43,11,10,21
22633,321fire,,18,3,2,5
22634,BadDreams27,,18,12,2,14
22635,vincit-omnia-amor,,5,1,1,2
22636,woodsmit1,,17,1,1,2
22637,BeeGirl,,43,2,1,3
22638,resiros,,34,1,1,2
22639,STOpandthink,,42,71,92,163
22640,ajw1976,,20,2,1,3
22641,xynxx,,29,19,30,49
22642,bcbcb,,18,55,11,66
22643,FONHoter,,13,2,1,3
22644,Rhettsta,,15,72,108,180
22645,columbine,,29,237,255,492
22646,CptRysdale,,19,2,1,3
22647,stirgeon,,9,2,3,5
22648,fawkesisgay,,20,1,1,2
22649,kerm,,42,38,21,59
22650,davidswayze,,32,1,3,4
22651,corduroy,,22,4,9,13
22652,diot,,18,2,6,8
22653,Animated_effigy,,19,37,77,114
22654,KidBoffo,,8,4,8,12
22655,one2k,,43,118,2,120
22656,DevastatorIIC,,1,28,30,58
22657,unitarder,,13,2,4,6
22658,bobtheplanet,,19,29,66,95
22659,groumph,,20,2,3,5
22660,Woblium,,13,1,1,2
22661,ariacode,,20,15,23,38
22662,dogburp,,7,3,7,10
22663,isandro,,42,1,1,2
22664,Kvindkr,,1,5,1,6
22665,gamefreak6401,,13,1,5,6
22666,guriboysf,,13,1852,750,2602
22667,maina231,,5,3,7,10
22668,dustinbz,,4,5,4,9
22669,xmaspoo,,20,10,7,17
22670,serial_liar,,20,1,1,2
22671,manefraim,,18,3,2,5
22672,tekumse,,31,48,61,109
22673,pseudar,,32,2,7,9
22674,JViz,,32,122,162,284
22675,mmckenna86,,0,11,13,24
22676,ythomas,,13,212,111,323
22677,AdamAtlas,,19,20,23,43
22678,NotAName,,22,52,35,87
22679,DannoHung,,20,286,397,683
22680,cynoclast,,18,48,67,115
22681,ihavenomp,,18,112,86,198
22682,aureve,,19,3,4,7
22683,mrshall08,,19,2,2,4
22684,SanjayM,,3,4,4,8
22685,wpgreenway,,18,29,29,58
22686,accelas,,20,19,10,29
22687,jarrodlb,,20,2,1,3
22688,Watcher1,,13,38,51,89
22689,veritaze,,0,721,1034,1755
22690,Spitfire75,,30,48,73,121
22691,syrisgone,,20,32,45,77
22692,ethyl_mercaptain,,13,4,1,5
22693,1sthealth,,13,8,4,12
22694,peterba,,20,12,4,16
22695,kyokpae,,13,8,6,14
22696,random_indian_dude,,12,1,2,3
22697,reez,,13,45,1,46
22698,gay_defender,,13,1,1,2
22699,ohstrangeone,,1,149,50,199
22700,girlogames,,18,2,2,4
22701,praetorblue,,13,4,1,5
22702,twofrontwar,,18,7,1,8
22703,McBamaFTW,,13,24,35,59
22704,LudoA,,20,596,492,1088
22705,jfowler27,,43,121,200,321
22706,aperturist,,18,42,39,81
22707,klaiere,,27,1,2,3
22708,Modificador,,19,1,1,2
22709,jesus___christ,,31,4,5,9
22710,jguidry,,1,3,2,5
22711,flowtron,,6,1,2,3
22712,newredditsucks,,18,1,4,5
22713,Z_Man,,13,2,3,5
22714,GovBlack,,18,10,18,28
22715,markmuetz,,43,21,8,29
22716,braxley,,43,10,3,13
22717,Nothingatall,,31,27,40,67
22718,davemak,,19,3,9,12
22719,Thinkman,,29,1,1,2
22720,mokki,,18,53,1,54
22721,yumyym,,19,4,6,10
22722,11-26was_aninsidejob,,34,1,1,2
22723,maxxtraxx,,18,7,9,16
22724,dranged,,18,7,4,11
22725,bunz,,20,11,9,20
22726,vinadetta,,19,33,50,83
22727,dkjamez,,19,50,110,160
22728,megoencrzy,,12,1,2,3
22729,sheebz,,0,77,25,102
22730,rydwi,,36,2,6,8
22731,Aldrenean,,4,59,115,174
22732,olsonick,,18,4,22,26
22733,maxthemuss,,31,14,8,22
22734,karakor,,21,172,14,186
22735,orata,,12,2,2,4
22736,fstorino,,29,451,493,944
22737,jm4,,19,3,8,11
22738,victoryisle,,19,1,1,2
22739,deusexnox,,1,6,11,17
22740,fabieen,,19,7,12,19
22741,glothin,,19,1,1,2
22742,SimonS,,20,71,95,166
22743,koreth,,31,162,193,355
22744,shadow2531,,20,33,51,84
22745,bobspirit,,19,4,5,9
22746,jerf,,20,575,738,1313
22747,flatland_skier,,13,1,3,4
22748,Matamua,,42,37,52,89
22749,tjbrace,,13,17,12,29
22750,ellieD,,39,70,148,218
22751,Terentius,,22,3,5,8
22752,medianmode,,9,31,16,47
22753,mark_in_bc,,19,6,9,15
22754,kahureads,,3,2,4,6
22755,whitslack,,13,2,1,3
22756,andra_j,,3,1,2,3
22757,YamiNoSenshi,,13,19,25,44
22758,jdz,,18,13,65,78
22759,angrybrit,,21,7,15,22
22760,CanoeGuru,,5,53,54,107
22761,WhyCause,,42,14,27,41
22762,nemesiscw,,12,17,29,46
22763,ehnus,,20,14,23,37
22764,sais,,32,47,5,52
22765,exersci,,12,2,1,3
22766,iepurilah,,5,281,10,291
22767,triptrap,,35,3,2,5
22768,Raisedshoulder,,18,7,6,13
22769,CharlieSpankface,,18,7,11,18
22770,milkish,,43,1,4,5
22771,xiaoli,,30,1,2,3
22772,explortainment,,13,5,3,8
22773,me_again,,20,5,7,12
22774,cjc155,,13,1,3,4
22775,MaxPayneX,,13,3,2,5
22776,8RANDONBLUE,,25,2,1,3
22777,jwr,,20,17,15,32
22778,katyg,,1,22,23,45
22779,bestbuyslave13,,22,2,6,8
22780,cavtroop,,40,1,2,3
22781,terpmeister,,20,7,8,15
22782,Zahrah,,43,18,26,44
22783,franoso,,13,1,1,2
22784,LoyalRedditUser,,1,7,1,8
22785,stroud,,18,139,168,307
22786,abutchart,,26,33,42,75
22787,alopez,,32,1,1,2
22788,DingBat99999,,20,3,1,4
22789,katana,,20,9,7,16
22790,rickrw26,,1,10,11,21
22791,m4design,,31,14,22,36
22792,boa13,,20,269,311,580
22793,jbrjake,,19,31,23,54
22794,chrisdamato,,18,13,19,32
22795,kensho,,20,2,3,5
22796,OinkersBoinkers,,13,41,33,74
22797,banana_pancakes,,18,1,1,2
22798,TrinityinZion,,13,129,157,286
22799,DBCoopers_Voice,,43,11,13,24
22800,WarEmblem,,6,3,2,5
22801,tatooine,,19,270,358,628
22802,mlurker,,6,1,2,3
22803,JesusXP,,34,18,9,27
22804,i_call_bs,,4,4,10,14
22805,abandonment,,17,4,3,7
22806,IWelsh,,0,51,2,53
22807,jasonebrooks,,0,41,51,92
22808,DavesNotHere,,19,19,25,44
22809,peredecho,,19,1,4,5
22810,kmartburrito,,13,17,16,33
22811,mene,,19,84,159,243
22812,ckwoo,,36,5,2,7
22813,TheCancerofReddit,,19,12,26,38
22814,polymath22,,13,1063,712,1775
22815,zdub,,19,7,13,20
22816,jaredb,,19,295,366,661
22817,yacheritsi,,20,20,19,39
22818,greenw40,,13,126,223,349
22819,blaxter,,20,4,5,9
22820,Destined86,,20,1,1,2
22821,redditnoob,,20,319,405,724
22822,motox004,,34,6,1,7
22823,JulianMorrison,,20,633,869,1502
22824,polyparadigm,,19,441,1165,1606
22825,smeefydeef,,18,4,6,10
22826,leahcimic,,11,1,1,2
22827,azfhkm,,0,2,7,9
22828,tallicast,,1,37,20,57
22829,ss88,,5,2,2,4
22830,commernie,,20,1,2,3
22831,chipwhisperer,,20,221,28,249
22832,briankwest,,8,16,10,26
22833,FatherVic,,43,13,10,23
22834,mkshoox,,42,1,7,8
22835,seeeymour,,1,1,5,6
22836,WintermuteHun,,18,1,1,2
22837,redding44,,12,10,26,36
22838,tojojo,,18,3,1,4
22839,annish33,,32,3,2,5
22840,grando205,,13,3,2,5
22841,oddoddities,,1,1,1,2
22842,rsthiotimoline,,22,6,8,14
22843,sysreq2,,34,15,10,25
22844,579_was_an_odd_job,,5,1,1,2
22845,SharkAttack,,31,6,2,8
22846,rg3design,,13,5,10,15
22847,ewok251,,18,14,30,44
22848,IAmperfectlyCalm,,13,3375,17,3392
22849,Klowner,,22,116,198,314
22850,sydfish,,42,1,1,2
22851,dfplace,,20,1,1,2
22852,goneskiing_42,,18,37,29,66
22853,Alanna,,13,26,12,38
22854,matthewt,,20,5,10,15
22855,flip69,,13,21,39,60
22856,spivey378,,1,97,165,262
22857,umbama,,31,235,331,566
22858,afsd,,0,4,15,19
22859,church-lady,,26,1,1,2
22860,robinbal,,5,380,26,406
22861,factchecker,,19,6,8,14
22862,SteveyDevey,,43,17,22,39
22863,johnny_blaze108,,30,90,66,156
22864,death_to_kittens,,42,2,1,3
22865,vennilapdy,,19,1,1,2
22866,zeej,,43,8,8,16
22867,scottklarr,,32,37,102,139
22868,ispiked,,19,1,1,2
22869,rainx5,,12,1,2,3
22870,davidpbrown,,13,160,295,455
22871,sdmath,,13,9,2,11
22872,Zarathustra,,20,1,5,6
22873,massacre11,,43,2,7,9
22874,mozz85,,23,20,27,47
22875,towelled,,18,7,5,12
22876,wpentland,,34,195,14,209
22877,qengho,,29,28,47,75
22878,kaethre,,31,63,84,147
22879,thepoo,,1,190,184,374
22880,imatalibrary,,31,1,1,2
22881,petrasbut,,29,1,3,4
22882,xutopia,,3,398,481,879
22883,ne0nominator,,13,2,1,3
22884,multi_touch,,43,25,38,63
22885,Pulch,,18,5,10,15
22886,helloandy,,18,3,4,7
22887,alfseegert,,33,5,1,6
22888,jrhanak,,31,4,3,7
22889,AmazingSyco,,20,142,107,249
22890,AgentConundrum,,35,1,7,8
22891,haveacowman,,10,2,3,5
22892,yoshitomi,,18,88,32,120
22893,ToddDavis,,1,1,1,2
22894,ashabot,,34,75,207,282
22895,keg98,,23,2,1,3
22896,admplaceholder,,18,31,42,73
22897,rukubites,,20,108,165,273
22898,TheOldBroad,,34,17,7,24
22899,fps81,,31,2,3,5
22900,solitair,,43,4,11,15
22901,akkartik,,20,30,28,58
22902,musashix90,,18,2,3,5
22903,elcerdoquerie,,20,41,10,51
22904,whatthe2,,19,38,51,89
22905,ziporim,,0,20,6,26
22906,jebiv,,32,143,233,376
22907,cultural_sublimation,,20,12,10,22
22908,powatom,,18,1,2,3
22909,KPMGGGGGGG,,18,3,10,13
22910,turkishrevenge,,31,6,14,20
22911,bocanegra,,12,96,122,218
22912,greg94080,,18,41,106,147
22913,L1ndsay,,32,9,6,15
22914,NonHomogenized,,13,26,58,84
22915,prospero,,20,9,7,16
22916,aardvarkads,,32,1,1,2
22917,sasmccrass,,31,3,3,6
22918,skepticcook,,32,1,1,2
22919,mmmcake,,1,43,14,57
22920,thatgirlismine,,33,45,49,94
22921,goguvasile,,34,3,5,8
22922,rhyso,,20,3,7,10
22923,anonyred,,20,30,32,62
22924,TryingHarder,,19,3,6,9
22925,jamesalexander,,13,1,1,2
22926,SaraFist,,31,5,10,15
22927,mazinlarry,,43,1,2,3
22928,skuk,,1,7,16,23
22929,mernen,,20,148,245,393
22930,pwbringside,,14,4,2,6
22931,treef,,20,20,19,39
22932,chasstor,,19,4,3,7
22933,superdude264,,20,35,52,87
22934,lostdog,,12,12,14,26
22935,i_am_giuliani,,19,2,1,3
22936,ibarrac,,8,6,6,12
22937,mefm247,,12,180,51,231
22938,viper0,,42,1,3,4
22939,kagevf,,20,11,17,28
22940,unbibium,,18,42,68,110
22941,phoebefitz,,32,2,1,3
22942,JasonDJ,,22,1581,2101,3682
22943,rehx,,18,145,89,234
22944,michaelfeathers,,20,56,55,111
22945,ducktyped,,20,7,9,16
22946,helenonfire,,32,109,59,168
22947,niccamarie,,32,8,7,15
22948,bardeen2,,30,1,1,2
22949,samurai_jack,,19,1,1,2
22950,QcUser,,1,2,1,3
22951,fIshstIckfish,,20,2,1,3
22952,kevincolby,,13,136,14,150
22953,sapiophile,,31,18,20,38
22954,Pict,,18,88,100,188
22955,dvdcpu,,1,4,12,16
22956,brfox,,19,67,37,104
22957,julesjules,,1,13,18,31
22958,poxiemuff,,43,3,1,4
22959,Aissen,,5,9,8,17
22960,pakfur,,31,1,1,2
22961,lifeguard1999,,12,20,1,21
22962,MinoMinoMino,,18,27,48,75
22963,kalaine,,29,1,2,3
22964,jcblitz,,5,14,21,35
22965,reddit-mandingo,,13,24,41,65
22966,unidentified_cow,,22,19,25,44
22967,urno,,15,5,5,10
22968,bgroodog,,43,2,7,9
22969,vladd,,12,5,4,9
22970,TimeCube,,33,1,2,3
22971,rick-victor,,18,92,233,325
22972,fuzzybunn,,32,464,648,1112
22973,renegade4ever,,19,4,2,6
22974,Macinposh,,40,47,6,53
22975,somegeekintn,,22,5,5,10
22976,orochidp,,18,132,164,296
22977,clamag,,15,1,1,2
22978,genejockey,,19,3,8,11
22979,goodasyou,,17,2,2,4
22980,mpeppers,,19,149,189,338
22981,gabrielbenjamin,,22,28,58,86
22982,FatHat,,18,28,3,31
22983,skinnys,,19,1,1,2
22984,jterrill,,19,4,1,5
22985,jacl3,,13,6,2,8
22986,mayqueen,,18,12,2,14
22987,Cthulhu_u2,,36,3,4,7
22988,DeliaVelda,,18,2,3,5
22989,jmathai,,20,89,35,124
22990,uleekunkel,,29,4,1,5
22991,alextrafford,,31,2,6,8
22992,geoken,,17,4,6,10
22993,Capnshavahoe,,8,1,1,2
22994,njoubert,,19,16,5,21
22995,wickedsun,,33,7,12,19
22996,cheesegoat,,43,18,1,19
22997,unboring,,18,23,10,33
22998,miamidolfan13,,18,1,1,2
22999,FunnyHat,,18,29,25,54
23000,jkr0sc0,,19,95,69,164
23001,apear,,0,103,23,126
23002,paws,,22,1,2,3
23003,waesrdtf,,13,29,73,102
23004,jighead,,29,16,30,46
23005,Ronald_Reagan,,22,1,1,2
23006,anotheraddict,,5,47,114,161
23007,bradl3y,,22,11,13,24
23008,bazzam,,34,3,1,4
23009,coltafever,,5,8,5,13
23010,budgetsaresexy,,13,2,1,3
23011,bejackson,,12,1,4,5
23012,SpudgeBoy,,13,404,654,1058
23013,RandomChance,,1,5,8,13
23014,RickyRage,,13,30,14,44
23015,imccuaig,,14,2,6,8
23016,draynen,,18,151,130,281
23017,aeschenbach,,39,1,1,2
23018,nik_doof,,12,19,45,64
23019,RagingBigot,,31,1,2,3
23020,kakker,,34,1,1,2
23021,nixonrichard,,31,2789,3142,5931
23022,bloodbrothers,,13,13,1,14
23023,g00sebump,,13,1,1,2
23024,aadvaark,,19,5,2,7
23025,redditcdm,,19,3,8,11
23026,imaclurg,,13,12,8,20
23027,lukey,,29,3,6,9
23028,michaeljmcd,,13,1,1,2
23029,wags83,,42,80,91,171
23030,dmehrtash,,19,145,162,307
23031,wrathofg0d,,18,6,15,21
23032,314159,,20,73,56,129
23033,cannelbrae,,20,44,42,86
23034,caleb555,,43,76,93,169
23035,crosbyface,,34,337,178,515
23036,BrambleQuest,,18,7,8,15
23037,MoogleGunner,,4,38,42,80
23038,ckelso,,32,1,1,2
23039,nedski,,31,2,2,4
23040,cjet79,,6,8,14,22
23041,chrisjoy,,14,1,2,3
23042,megasean,,31,19,16,35
23043,jwhardcastle,,32,24,13,37
23044,xanderdad,,13,33,28,61
23045,Bart__,,20,2,3,5
23046,PStamatiou,,2,2,3,5
23047,tbk123,,34,12,26,38
23048,szer0,,4,10,4,14
23049,tin_the_fatty,,12,1,3,4
23050,knox203,,6,1,1,2
23051,DayVDave,,34,26,22,48
23052,dskoziol,,34,14,16,30
23053,ZorkTheAlmighty,,20,1,2,3
23054,worthlesstrivia,,19,12,20,32
23055,yourereallydumb,,31,1,1,2
23056,Debs68,,1,1,1,2
23057,InvestorGadget,,43,35,38,73
23058,kpflynn,,31,12,3,15
23059,namegoeshere,,19,5,7,12
23060,dsn0wman,,20,13,12,25
23061,delayclose,,13,4,11,15
23062,nebbish,,18,202,460,662
23063,xelfer,,43,751,135,886
23064,FiestaJunction,,34,65,69,134
23065,wil,,13,313,76,389
23066,onfires,,1,2,6,8
23067,AlteredQ,,13,5,4,9
23068,azerkainen,,13,2,6,8
23069,booksnbabies,,5,7,15,22
23070,lobsterGun,,31,1,2,3
23071,ZhongHuaRising,,5,134,19,153
23072,algebra,,22,4,9,13
23073,jackman,,26,6,3,9
23074,mobilexile,,0,4,16,20
23075,SkippyKilamanjaro,,18,1,4,5
23076,papipablo,,13,17,26,43
23077,kalven,,20,67,53,120
23078,deanoplex,,12,438,549,987
23079,twothenthree,,0,1,1,2
23080,steampunks,,29,2,2,4
23081,micklstint,,18,5,9,14
23082,corentin,,19,241,344,585
23083,Wildcard86,,18,16,18,34
23084,BritishEnglishPolice,,18,1700,1195,2895
23085,arewethatstupid,,23,2,1,3
23086,albino1,,20,1,1,2
23087,ali-o,,5,1,1,2
23088,stiggle,,19,8,13,21
23089,encephlavator,,13,82,116,198
23090,SceneScenery,,18,46,88,134
23091,JamieLewisUK,,18,1,1,2
23092,VBS,,18,1,1,2
23093,gt1987,,18,338,30,368
23094,naughtyottsel,,43,29,43,72
23095,Weyland-Yutani,,20,38,45,83
23096,superkash,,42,1,4,5
23097,paulg,,22,4,12,16
23098,puppycrack,,20,30,17,47
23099,sdgsdgsd,,18,50,37,87
23100,podRZA,,34,153,226,379
23101,Anon65536,,30,2,1,3
23102,SkuttleSkuttle,,0,95,193,288
23103,dg172306,,0,23,1,24
23104,Letharis,,13,4,5,9
23105,Ayn_Rand,,19,40,44,84
23106,pnmnl,,39,10,1,11
23107,quitabandita,,5,10,24,34
23108,Raoul_Duke,,18,1,4,5
23109,derby,,20,15,9,24
23110,codybrom,,13,24,40,64
23111,enisoc,,42,2,2,4
23112,victimeofXsyndrome,,40,9,26,35
23113,davidhallstrom,,18,73,10,83
23114,alienfluid,,0,49,4,53
23115,apollo13,,20,1,1,2
23116,ellingtond,,20,7,3,10
23117,pjharvey,,13,68,136,204
23118,levilarrington,,13,112,176,288
23119,chaelosmvoice,,43,71,9,80
23120,Zarouhi,,13,1,2,3
23121,funkomoto,,13,19,6,25
23122,kizzbizz,,15,20,22,42
23123,ominous,,20,193,276,469
23124,mglasspo,,22,16,19,35
23125,habilis,,13,11,1,12
23126,John-McCain,,43,4,3,7
23127,itwontbeeasy,,31,28,37,65
23128,heurrgh,,1,15,23,38
23129,noj,,20,3,6,9
23130,chonny69,,18,6,2,8
23131,Diced,,19,7,7,14
23132,dustbot,,19,5,1,6
23133,AlphaSquad7,,18,19,31,50
23134,Daylight_Again,,18,6,1,7
23135,ElGatoPescado,,19,4,4,8
23136,thestace,,19,2,2,4
23137,jvnburrito,,19,5,2,7
23138,xinship,,12,131,1,132
23139,Titans86,,1,1,1,2
23140,ACoelacanth,,31,3,1,4
23141,livewire-reddit,,21,3,5,8
23142,lowdown,,19,278,400,678
23143,Mad_Gouki,,1,342,497,839
23144,setatakahashi,,43,7,5,12
23145,bobbythebuilder,,18,14,5,19
23146,robpfeifer,,30,3,2,5
23147,ohphuckit,,19,1,2,3
23148,brtw,,43,856,907,1763
23149,doccrow,,0,1,1,2
23150,dowhat,,22,9,14,23
23151,adelutza,,29,19,9,28
23152,obastard,,19,1,2,3
23153,thomash,,5,24,30,54
23154,Federico_AB,,29,2,1,3
23155,johnnyutah97,,0,1,2,3
23156,Wanderer69,,32,7,10,17
23157,killerkarlyle,,32,10,8,18
23158,giosico,,29,7,9,16
23159,L_K,,34,1,2,3
23160,Jacques7,,43,1,7,8
23161,crusader561,,13,29,47,76
23162,dhc23,,4,283,131,414
23163,tluyben2,,20,40,52,92
23164,Monk_NT,,22,1,8,9
23165,danstheman,,13,2,2,4
23166,Mike112233,,29,56,55,111
23167,sid13,,19,1370,9,1379
23168,Kerrminater,,32,6,8,14
23169,andycapp614,,20,1,1,2
23170,ohitsme,,15,1,1,2
23171,kenshi,,20,2,2,4
23172,Ma_chine,,12,72,80,152
23173,aptmunich,,13,7,4,11
23174,rocktopotomus,,13,1,2,3
23175,buffer,,18,19,35,54
23176,runaro,,20,10,17,27
23177,inqurious,,20,23,34,57
23178,abc2010,,13,19,18,37
23179,Toploader,,19,21,7,28
23180,josernanza,,5,4,2,6
23181,m5driver,,13,1,2,3
23182,jnikouy,,18,2,5,7
23183,BenArmston,,20,1,4,5
23184,seraphseven,,18,54,51,105
23185,matkam,,34,2,2,4
23186,Snowboardyn,,1,75,23,98
23187,playback,,13,5,1,6
23188,cydwatts,,32,23,33,56
23189,alanlight,,19,6,4,10
23190,rogerothornhill,,13,66,3,69
23191,scootermcgavin,,5,1,6,7
23192,theshua,,13,53,53,106
23193,dougtheslud,,1,1,1,2
23194,aloch_rye,,32,2,1,3
23195,tirdun,,13,257,340,597
23196,ton210,,18,20,6,26
23197,Mr_False_Facts,,43,5,10,15
23198,sunkencity,,20,2,3,5
23199,WipeHandsOnPants,,19,472,586,1058
23200,blargsoup,,13,4,1,5
23201,trickygrin,,18,1,3,4
23202,hybird607,,43,1,1,2
23203,Dr_Dre,,8,1,2,3
23204,eddiebenton,,16,1,3,4
23205,randybrown,,18,1,1,2
23206,joopndufus,,19,9,17,26
23207,Beltran22,,19,62,62,124
23208,MaxTerry,,0,13,2,15
23209,Redditsleo,,26,7,1,8
23210,garhem,,13,3,2,5
23211,Wynner3,,18,52,120,172
23212,hollaworld,,20,1,2,3
23213,dkol97,,41,1,1,2
23214,Very_Short_Man,,19,1,2,3
23215,Alth,,30,1,2,3
23216,sleet01,,42,19,43,62
23217,caramal,,13,38,38,76
23218,ferdylantz,,0,11,12,23
23219,protaku,,22,57,17,74
23220,N3v3rm0r,,27,3,4,7
23221,thomashauk,,30,135,291,426
23222,Eugi,,34,638,795,1433
23223,Th17kit,,19,10,15,25
23224,test88,,1,1,1,2
23225,mlibby,,18,39,59,98
23226,RockinMoe,,18,13,30,43
23227,lukeman,,20,2,6,8
23228,njaard,,20,36,23,59
23229,dgentry,,20,16,5,21
23230,jazzilliognito,,1,222,186,408
23231,defacto,,19,1,3,4
23232,kovert,,20,36,52,88
23233,sake2me,,5,3,2,5
23234,saxamaphone,,16,2,2,4
23235,qbert555,,20,1,1,2
23236,Nall,,19,188,224,412
23237,ToolBoxes,,34,2,2,4
23238,frothywalrus,,18,9,4,13
23239,hacman,,35,2,4,6
23240,insertclevernamehere,,6,13,5,18
23241,shinybeast,,19,29,6,35
23242,punk27,,1,75,41,116
23243,self,,20,296,42,338
23244,T618,,20,9,4,13
23245,elunico35,,10,4,5,9
23246,Lupus,,20,162,61,223
23247,joecomputer,,36,2,2,4
23248,omiethenull,,15,1,4,5
23249,IkkeDikke,,13,1,2,3
23250,JoeThePlumber,,1,1,1,2
23251,mikejna,,34,11,17,28
23252,bender,,19,4,1,5
23253,choochoose,,13,1,1,2
23254,doskir,,4,4,7,11
23255,blinks,,20,23,18,41
23256,truly_anonymous,,14,1,1,2
23257,ScrewDriver,,2,1098,250,1348
23258,wickedcold,,10,850,796,1646
23259,theCroc,,31,99,178,277
23260,Nonperson,,19,3,1,4
23261,mjagger,,0,3,1,4
23262,ericarlen,,32,122,55,177
23263,fkenned1,,36,4,3,7
23264,achroma,,22,23,39,62
23265,longshot789,,18,28,36,64
23266,charliewoo,,12,2,1,3
23267,TheYank17,,22,21,48,69
23268,socialsocial,,13,3,5,8
23269,bEastie,,19,1,4,5
23270,aweraw,,4,14,19,33
23271,snipe8709,,31,48,76,124
23272,lexicon,,12,3,3,6
23273,currentlyunemployed,,1,1,1,2
23274,snorgsniffer,,13,75,55,130
23275,farnsworth,,22,470,301,771
23276,1812overture,,7,586,900,1486
23277,ItsAConspiracy,,20,388,498,886
23278,hey_suz,,35,8,2,10
23279,weeblewobble,,32,25,18,43
23280,stevegao,,41,1,3,4
23281,sarkera,,22,17,20,37
23282,Akamaru,,31,42,78,120
23283,MorticiaAddams,,1,1,2,3
23284,jokemon,,20,2,3,5
23285,thugok,,13,19,34,53
23286,pkonink,,4,192,313,505
23287,__david__,,20,163,130,293
23288,SgtPsycho,,32,16,36,52
23289,shaen,,42,2,1,3
23290,unsteady21,,31,11,14,25
23291,garryknight,,17,1,4,5
23292,GaboonViper,,20,1,1,2
23293,Vortex851,,0,2,1,3
23294,csman,,13,1,4,5
23295,dtrav001,,1,53,109,162
23296,dailyfill,,15,1,3,4
23297,willikins_bear,,18,9,11,20
23298,nagual,,20,1,2,3
23299,leftist,,20,11,1,12
23300,unrealtrip,,19,21,19,40
23301,sadforamerica,,4,2,2,4
23302,mpreda,,20,1,1,2
23303,y0uth,,22,2,2,4
23304,whererush,,20,1,1,2
23305,kranse,,18,8,15,23
23306,splaspood,,14,3,11,14
23307,andreasvc,,20,139,258,397
23308,u233,,20,2,2,4
23309,Datrio,,1,12,8,20
23310,reinaldomunoz,,18,27,2,29
23311,jcbolduc,,20,3,3,6
23312,Mooo1,,18,7,8,15
23313,lostcheshire,,33,1,1,2
23314,aprz43,,13,15,7,22
23315,yahol,,34,1,2,3
23316,TheGr8Revealing,,38,2,2,4
23317,sjbaue,,31,6,5,11
23318,hnyakwai,,19,26,20,46
23319,HomelandInsecurity,,0,42,56,98
23320,thbb,,20,3,5,8
23321,beardedroman,,19,2,1,3
23322,madmonky1,,20,1,2,3
23323,Truthiness88,,31,5,19,24
23324,craigory,,30,10,7,17
23325,mrcheezy503,,1,2,7,9
23326,sheephead,,8,1,1,2
23327,logician2,,6,10,11,21
23328,petedmeat,,22,1,2,3
23329,craigckc,,12,3,5,8
23330,rob45742,,14,2,2,4
23331,babaghanoush,,18,1,4,5
23332,rooseve,,32,4,1,5
23333,KyndCulture,,42,1,3,4
23334,borlak,,20,125,157,282
23335,wellstone,,7,16,14,30
23336,menwithoutoil,,19,1,1,2
23337,stuckpixel,,18,18,25,43
23338,Godthealmighty,,18,1,1,2
23339,jfarquhar,,32,9,7,16
23340,oh_bruddah,,5,34,44,78
23341,radcopter2,,6,18,9,27
23342,yazik,,29,39,18,57
23343,pizmooz,,0,1,1,2
23344,litelity,,0,1,1,2
23345,tevi,,19,420,200,620
23346,EternalNY1,,20,242,271,513
23347,lpetrazickis,,34,84,137,221
23348,gmarceau,,20,68,16,84
23349,ranautricularia,,4,8,3,11
23350,braeden0613,,32,9,10,19
23351,rosho,,18,3,7,10
23352,anticitizen_1,,0,8,11,19
23353,rothsbane,,22,22,46,68
23354,amandoo,,23,1,1,2
23355,fiskekjorke,,20,6,8,14
23356,Ackeron,,12,1,1,2
23357,bantam,,1,128,196,324
23358,peadar,,14,2,2,4
23359,mvferrer,,43,63,50,113
23360,severianx,,19,1,1,2
23361,Trimbak,,4,2,1,3
23362,gayjustice,,32,9,6,15
23363,precursive,,32,24,37,61
23364,TheDevilChicken,,42,1,1,2
23365,luizlizard,,15,1,1,2
23366,rramdin,,43,2,1,3
23367,strangerthanfiction,,34,5,18,23
23368,hvidgaard,,20,2,5,7
23369,kcnickerson,,34,2,2,4
23370,mtarascio,,1,2,1,3
23371,pirratez,,9,1,1,2
23372,ohdeargod,,35,240,280,520
23373,smearypixels,,36,1,1,2
23374,kyledance,,22,9,4,13
23375,dictum,,13,380,384,764
23376,toomuchsnow,,22,1,1,2
23377,eleitl,,34,1150,2349,3499
23378,lojt,,20,7,3,10
23379,noseeme,,18,709,1209,1918
23380,King_Midas,,18,7,8,15
23381,duncman,,3,3,3,6
23382,nrg13,,8,32,56,88
23383,thedeiningers,,20,1,4,5
23384,Charybdis,,20,23,24,47
23385,weemadarthur2,,20,58,35,93
23386,elevendog,,16,5,7,12
23387,40ozphil,,18,9,32,41
23388,TiredoftheWhining,,13,9,12,21
23389,mojitz,,19,4,3,7
23390,kschrader,,22,3,3,6
23391,thebigslide,,18,3,5,8
23392,pbwhiteskies,,38,1,1,2
23393,Rubythursday,,5,4,3,7
23394,mr-ron,,20,49,40,89
23395,detestrian,,22,119,121,240
23396,jphofmann,,20,13,8,21
23397,pastanoose,,13,605,1013,1618
23398,rfreytag,,20,54,79,133
23399,Condoleezza_Rice,,19,68,102,170
23400,laughingboy,,42,311,281,592
23401,pompanobeach,,13,2,2,4
23402,rambo3060,,28,9,9,18
23403,FierceWords,,1,1,1,2
23404,followthesinner,,1,46,61,107
23405,jhnewt,,12,15,22,37
23406,justleaveme,,22,10,8,18
23407,Boab1917,,13,34,113,147
23408,domer,,19,28,8,36
23409,baddox,,29,167,256,423
23410,magicalsamurai,,20,1,1,2
23411,jedediah,,43,10,13,23
23412,who_the_fuck,,20,1,2,3
23413,hifidigitalboy,,1,1,3,4
23414,raygomer,,13,2,3,5
23415,journeymaan,,13,3,1,4
23416,ultralame,,32,139,191,330
23417,saw2239,,42,14,18,32
23418,beatlawrence,,43,64,5,69
23419,brox,,20,1,1,2
23420,itstriz,,3,5,8,13
23421,louiebaur,,5,392,64,456
23422,Dreamerr,,19,1,1,2
23423,thisisgraffiti,,13,93,62,155
23424,stesch,,20,2086,1438,3524
23425,dcsterlin,,34,9,2,11
23426,ragnarock,,18,13,33,46
23427,mustamike,,42,25,33,58
23428,Engineer1973,,20,2,2,4
23429,opinion_not_fact,,0,14,18,32
23430,joshuatree,,19,21,20,41
23431,drmomentum,,19,3,7,10
23432,drkevorkian,,12,4,12,16
23433,jwmida,,19,5,8,13
23434,Frobozz,,13,35,16,51
23435,panfist,,32,82,91,173
23436,daydreamdrunk,,30,1,2,3
23437,zedstream,,6,81,193,274
23438,counterpup2,,18,1,1,2
23439,rigun,,18,7,9,16
23440,subzer0fun,,1,1,9,10
23441,adamd84,,15,6,21,27
23442,trimalchio,,1,79,181,260
23443,rojaz,,18,1,1,2
23444,ruxxell,,18,19,30,49
23445,azureice,,31,27,35,62
23446,roguehunter,,18,2,7,9
23447,sivadwnitsuj,,12,1,1,2
23448,Rasheeke,,6,179,214,393
23449,deeter,,43,12,14,26
23450,degustiairforceone,,22,37,39,76
23451,marishaLOVESTHECOCK,,18,1,1,2
23452,sephcast,,31,5,4,9
23453,seedy,,30,35,35,70
23454,ConnorSmith,,14,3,6,9
23455,Fantasysage,,18,70,82,152
23456,emailingRob,,13,11,9,20
23457,Andrew_Z,,20,2,8,10
23458,blergh-,,6,12,16,28
23459,bobsaget06,,5,11,5,16
23460,stealthboy,,19,9,4,13
23461,jrazavian,,34,20,13,33
23462,archemedes_rex,,43,172,352,524
23463,mooocow,,0,35,28,63
23464,sonotme,,32,12,12,24
23465,ssmoot,,31,1,3,4
23466,alpha7158,,42,1,2,3
23467,dropshadow,,13,6,4,10
23468,sethew,,3,1,2,3
23469,theguardian512,,35,1,2,3
23470,nikdahl,,1,297,573,870
23471,Vivaa,,15,15,12,27
23472,simosameh,,19,1,1,2
23473,Sec_Henry_Paulson,,18,9,13,22
23474,skink,,29,6,5,11
23475,internauta,,18,16,1,17
23476,Sheamus,,0,252,262,514
23477,billbose,,20,6,8,14
23478,maxs,,27,2,1,3
23479,immymwa,,31,2,2,4
23480,bbulkow,,19,4,7,11
23481,richards1052,,19,27,4,31
23482,Explained,,19,3,1,4
23483,Jafari,,1,1,3,4
23484,ewen,,29,15,26,41
23485,madderhatter,,7,1,2,3
23486,rydudero,,32,1,1,2
23487,hukedonfonix,,1,227,344,571
23488,kooberdeath,,13,1,1,2
23489,ermine,,1,208,394,602
23490,porniac,,19,159,334,493
23491,motophiliac,,1,35,37,72
23492,tyjk9,,19,2,7,9
23493,jjasmine,,0,1,2,3
23494,kkolish,,13,6,8,14
23495,erydo,,20,55,96,151
23496,monks7ue,,13,4,2,6
23497,TehMuffinMan,,18,284,386,670
23498,ASKlein,,13,1,4,5
23499,lylia,,16,1315,102,1417
23500,mrsheep,,20,7,5,12
23501,jstlerce,,13,24,39,63
23502,tievape,,34,7,7,14
23503,dutty_d,,19,33,1,34
23504,jwilson1891,,1,2,7,9
23505,reverend_paco,,20,2,3,5
23506,w00zy33,,20,4,2,6
23507,savannahsavannah,,8,1,5,6
23508,aeacides,,18,5,14,19
23509,skypie888,,18,2,1,3
23510,screeeam,,1,1,1,2
23511,warbiscuit,,20,28,33,61
23512,kaketoe,,20,11,11,22
23513,wojtekk,,31,1,1,2
23514,falconsprint,,19,5,4,9
23515,jivebotic,,18,85,26,111
23516,1esproc,,22,554,524,1078
23517,buzzkelly,,22,1,2,3
23518,cdvallee,,18,20,34,54
23519,rtperson,,6,23,29,52
23520,tien10,,26,2,2,4
23521,reddibama,,18,15,3,18
23522,Trolloholic,,39,9,10,19
23523,JasonWi,,15,1,1,2
23524,Less_fewer_police,,43,1,1,2
23525,Ringdingcoder,,20,6,4,10
23526,kryptn,,20,56,15,71
23527,cal3b,,33,2,4,6
23528,kungfooey,,20,107,26,133
23529,WillToHave2,,5,3,5,8
23530,devbalt,,43,3,3,6
23531,pattyyoung,,1,1,1,2
23532,Dinosars,,4,4,5,9
23533,tomlu709,,20,60,67,127
23534,StOnge,,19,5,13,18
23535,kinglupid,,18,25,48,73
23536,megafan,,13,1,1,2
23537,andymatic,,19,15,8,23
23538,hoosabrat,,1,2,3,5
23539,mohawk,,20,7,10,17
23540,EwanG,,18,29,41,70
23541,H8r,,31,37,38,75
23542,ubiquitous,,3,1,3,4
23543,speling_nazi,,13,2,2,4
23544,Drakia,,18,15,16,31
23545,rozbryzg,,13,1,5,6
23546,officemonkey,,14,1620,1957,3577
23547,charun,,22,88,119,207
23548,idogcow,,0,1,2,3
23549,megaman369,,39,2,11,13
23550,fanboisrule,,18,7,17,24
23551,digitaldavegordon,,18,11,12,23
23552,Trace,,19,248,368,616
23553,AdolfHitler45,,22,3,2,5
23554,xleighx,,1,1,4,5
23555,corevette,,43,217,73,290
23556,Ognad,,11,1,5,6
23557,theclamps,,13,14,24,38
23558,rahearn,,4,1,1,2
23559,skobie7,,13,4,7,11
23560,vare2,,18,14,2,16
23561,Nicholai,,19,8,13,21
23562,acidburner,,22,2,5,7
23563,themightylime,,18,38,23,61
23564,nzgizmoguy,,15,4,2,6
23565,Jive_q,,0,5,4,9
23566,noideareally,,13,9,8,17
23567,mmmf,,1,7,8,15
23568,GtownResider,,16,1,3,4
23569,Fyodor007,,0,70,7,77
23570,RedditGuy24,,18,6,6,12
23571,wolfier,,19,161,284,445
23572,get_over_it,,13,6,1,7
23573,flungdung,,22,4,5,9
23574,blacksquare,,22,10,2,12
23575,Kieslar,,12,3,1,4
23576,spaceflunky,,42,13,23,36
23577,anbeh,,19,48,21,69
23578,technex,,18,31,1,32
23579,Colbert22,,0,34,3,37
23580,fuhgeddaboutit,,31,16,39,55
23581,DropkickM16,,31,10,20,30
23582,arthur_dent,,20,14,10,24
23583,KombatKat,,22,1,1,2
23584,hypntize,,12,4,5,9
23585,AnTyx,,20,3,5,8
23586,ReapingWildOats,,18,209,362,571
23587,anteater_sa,,20,74,48,122
23588,WinterAyars,,14,590,1208,1798
23589,asdflksajdflkasjdfl,,4,1,1,2
23590,MrTJC,,30,4,3,7
23591,beefgun,,20,186,188,374
23592,ANTIHUMORBOT,,41,3,4,7
23593,twism242,,1,1,2,3
23594,kraftwerk2020,,1,1,2,3
23595,tastyrerun,,4,2,1,3
23596,_will,,19,8,3,11
23597,thewishfulwriterblog,,26,15,11,26
23598,ubae,,16,1,1,2
23599,jonathont22,,1,19,17,36
23600,broadbean,,0,21,31,52
23601,Gud84,,12,27,76,103
23602,frumiousb,,1,7,9,16
23603,arcims,,42,6,4,10
23604,pintachio,,21,82,122,204
23605,leaves4chonies,,34,17,43,60
23606,cookie__monster,,20,2,1,3
23607,Enzondio,,4,19,13,32
23608,decker,,43,18,48,66
23609,seang,,20,7,9,16
23610,doctorsound,,18,72,51,123
23611,goodnevilguy,,18,14,14,28
23612,jamt9000,,1,20,16,36
23613,kudu,,43,7,14,21
23614,crayola3,,19,19,13,32
23615,insomniak,,5,9,34,43
23616,Ass4ssinX,,14,4,6,10
23617,fuqdub,,19,15,18,33
23618,DocXango2,,42,1,1,2
23619,itworks,,30,1,6,7
23620,repunctuator,,0,5,8,13
23621,IMJGalt,,13,311,395,706
23622,checkstep,,13,54,8,62
23623,risingasia,,5,16,1,17
23624,Phil_Sebben,,20,2,3,5
23625,speedwank,,26,6,32,38
23626,environment_dollars,,13,1,1,2
23627,nsummy,,18,16,7,23
23628,servilla,,13,9,17,26
23629,RAISEStheQuestion,,13,15,21,36
23630,moriki,,18,51,75,126
23631,TwoMinutesToMidnight,,42,14,6,20
23632,SimpleAnswer,,1,30,38,68
23633,1776patriot,,10,3,3,6
23634,KingSky,,12,1,1,2
23635,asthomps,,19,14,8,22
23636,jetteroheller,,18,1,1,2
23637,idiocracy,,9,3,3,6
23638,momzilla54,,32,1,1,2
23639,neon_eddy,,13,6,10,16
23640,michelemarie,,26,2,1,3
23641,DeathPenalty,,30,4,11,15
23642,Liebot1,,43,4,7,11
23643,nlbctim,,5,1,3,4
23644,trilokjyu,,20,12,2,14
23645,TreatInfamy,,42,1,1,2
23646,curiouscat,,19,18,18,36
23647,scottbre,,30,5,4,9
23648,lobrien,,20,1,1,2
23649,3dom,,31,90,70,160
23650,dirk_funk,,14,77,157,234
23651,Analblazzer,,42,2,4,6
23652,metacircular,,20,3,2,5
23653,rcglinsk,,29,466,820,1286
23654,liberalj23,,0,1,4,5
23655,Inverter,,20,30,32,62
23656,borez,,33,2,2,4
23657,Acewrap,,19,118,203,321
23658,JaneBriefcase,,23,43,8,51
23659,partyonaisle7,,19,73,13,86
23660,aenea,,30,2234,1167,3401
23661,soands0,,13,15,7,22
23662,Robert_Bork,,13,2,4,6
23663,murder,,42,5,16,21
23664,beef2k,,20,45,16,61
23665,SventheWonderDog,,10,6,8,14
23666,Tank-Man,,19,2,2,4
23667,roxyoresox,,31,7,9,16
23668,abisurd,,19,3,8,11
23669,Dr_Jekyll,,18,41,15,56
23670,keopskeops,,19,11,20,31
23671,iNNeRKaoS,,18,115,276,391
23672,rubikscubefreak,,1,78,60,138
23673,SnattoGarro,,12,3,12,15
23674,zundra,,0,41,59,100
23675,wabber,,1,15,10,25
23676,Mitchellonfire,,30,4,3,7
23677,deasmi,,20,87,4,91
23678,bolshovv,,36,1,2,3
23679,RMessmann,,39,1,2,3
23680,wootobama,,20,3,3,6
23681,gamzehyaavor,,15,38,50,88
23682,stolid_agnostic,,13,2,4,6
23683,pzone,,34,5,7,12
23684,SeanClarity,,19,6,4,10
23685,schwartzwithyou,,12,1,1,2
23686,bazzoola,,32,2,2,4
23687,chiggers,,18,7,9,16
23688,fuzzy_one,,13,32,93,125
23689,jshen,,20,151,172,323
23690,Tiarlynn,,43,67,83,150
23691,fishyfishy,,18,3,5,8
23692,volume11,,42,1,1,2
23693,dort,,29,7,5,12
23694,smasm,,1,74,101,175
23695,dylanbob,,13,10,13,23
23696,gilesdudgeon,,34,77,185,262
23697,andrew80,,19,3,5,8
23698,epukinsk,,32,7,2,9
23699,fokov,,31,161,196,357
23700,qred,,19,3,1,4
23701,mee_k,,20,68,91,159
23702,CarlH,,13,360,493,853
23703,workinghard9,,18,2,4,6
23704,hilesb,,13,6,1,7
23705,flaflashr,,43,30,22,52
23706,Sabe,,20,2,7,9
23707,masterlink43,,32,80,123,203
23708,xxxander,,19,1,1,2
23709,msummers,,20,1,4,5
23710,CookieDuster,,19,5,5,10
23711,2leftnutz,,13,81,60,141
23712,josh6499,,18,9,18,27
23713,no1joel,,12,17,35,52
23714,sapphosyne,,17,2,5,7
23715,johnny5ive,,1,82,9,91
23716,themetricsystem,,19,15,30,45
23717,jgot,,20,1,1,2
23718,jpmax,,13,7,1,8
23719,miri_sweety,,43,1,1,2
23720,mrfabbri,,20,9,8,17
23721,shallah,,13,377,32,409
23722,mash4,,13,95,28,123
23723,ejackman,,11,2,2,4
23724,N0CTURN3,,19,42,35,77
23725,nomoremermaids,,32,27,66,93
23726,CaptainTightPants,,13,1,1,2
23727,somekindazombie,,43,1,1,2
23728,kivimaki,,1,1,2,3
23729,Mr_Pessimist,,19,6,12,18
23730,oaklandgrown,,1,1,2,3
23731,pmbuko,,5,44,49,93
23732,anniemelon,,18,1,1,2
23733,palsh7,,18,70,38,108
23734,TimeistheDiamond,,43,4,4,8
23735,hewn,,5,1,2,3
23736,inua,,15,5,2,7
23737,jbz,,14,43,67,110
23738,imsomeonesangel,,32,19,31,50
23739,malik,,20,4,16,20
23740,krushgroove,,11,1,2,3
23741,spacedebris,,32,6,20,26
23742,rinnip,,13,2,2,4
23743,plytheman,,1,186,236,422
23744,lolcats,,19,176,292,468
23745,frodcore,,18,4,8,12
23746,BonzoMadrid,,31,10,13,23
23747,robbansworld,,20,1,1,2
23748,nuprana,,34,25,1,26
23749,Isuck,,19,1,4,5
23750,siddboots,,1,49,67,116
23751,Kamicolo,,13,145,32,177
23752,electronicdream,,18,8,16,24
23753,nattress,,19,14,20,34
23754,bry512,,12,5,3,8
23755,mkrueger,,6,1,2,3
23756,CollinT65,,18,5,2,7
23757,thatdamncat,,8,1,2,3
23758,hippyup,,20,56,52,108
23759,runT1ME,,20,26,34,60
23760,bratterscain,,0,7,25,32
23761,RSquared,,22,206,311,517
23762,moneypej,,32,35,69,104
23763,ParanoidPete,,0,49,25,74
23764,NurseGirl,,30,215,328,543
23765,mucky,,4,3,1,4
23766,epic_thread,,22,2,1,3
23767,samwise99,,20,1,2,3
23768,benreeper,,13,26,26,52
23769,KOOL-AIDMan,,40,6,5,11
23770,xbmodder,,20,66,93,159
23771,steelpitt,,13,6,6,12
23772,halfsleepy,,18,2,1,3
23773,lokizero,,43,4,4,8
23774,oxen88,,0,21,2,23
23775,InfomercialDoctor,,23,1,1,2
23776,seanodonnell,,20,42,53,95
23777,GeekPatrol,,20,40,63,103
23778,ralphie_wiggam,,22,8,20,28
23779,sunsurfin,,43,1,2,3
23780,GeoAtreides,,14,512,484,996
23781,GeorgeWBush,,38,594,1300,1894
23782,exaakax,,18,3,5,8
23783,hmaugans,,18,256,20,276
23784,xiyi,,32,1,1,2
23785,konakevin,,18,5,7,12
23786,eldigg,,12,281,394,675
23787,mintman,,39,1,4,5
23788,jonaizen,,31,24,15,39
23789,Section_9,,18,3,7,10
23790,codyg1985,,34,90,43,133
23791,fecklicious,,13,1,1,2
23792,Derringer2k8,,18,11,12,23
23793,insertAlias,,31,3,3,6
23794,glassware,,0,33,53,86
23795,jackasspenguin,,43,4,10,14
23796,nickf,,20,4,7,11
23797,Wobbly-Dave,,5,9,12,21
23798,fredred,,0,4,10,14
23799,elburto,,18,55,83,138
23800,djsteveoid,,20,2,3,5
23801,jrray,,14,1,4,5
23802,jamesmyname,,18,5,1,6
23803,PrecociousChild,,19,33,55,88
23804,shutupjoey,,30,85,175,260
23805,ajduncan,,20,1,3,4
23806,abeceda,,18,278,2,280
23807,AvvocatoDiabolico,,0,2,7,9
23808,racist_troll,,13,11,36,47
23809,lowgas,,30,2,2,4
23810,joltage,,20,1,4,5
23811,infernon,,1,7,2,9
23812,gigamonkey,,8,4,2,6
23813,Slapstick,,43,13,3,16
23814,900910,,20,2,3,5
23815,gcmjsmkr,,19,3,5,8
23816,erinseale,,19,26,3,29
23817,MrFlowers,,6,27,34,61
23818,snayan,,18,65,12,77
23819,neilk,,35,93,85,178
23820,localeyes,,13,222,1,223
23821,beforeseven,,18,6,7,13
23822,dansmeek,,43,10,9,19
23823,samcrut,,22,7,13,20
23824,Tommstein,,20,350,718,1068
23825,steelflames,,1,34,19,53
23826,beamin2,,13,1,2,3
23827,SniperXPX,,1,10,4,14
23828,NastyGash,,10,1,1,2
23829,musiquedame,,0,2,2,4
23830,hitler_rape_abortion,,0,31,23,54
23831,CaptainOptimist,,14,3,4,7
23832,mattme,,43,1,1,2
23833,godzilka,,32,1,1,2
23834,JClibane,,0,89,17,106
23835,9fZZ776O,,13,86,16,102
23836,allboyshatebras,,42,23,18,41
23837,dcooper,,13,2,6,8
23838,tajitj,,13,2,8,10
23839,lemurc,,5,2,10,12
23840,TheMidwest,,18,10,3,13
23841,dgbarnett,,19,3,2,5
23842,modernguy,,5,1,2,3
23843,elguercoterco,,19,240,23,263
23844,jpdaigle,,20,4,1,5
23845,sili,,20,3,8,11
23846,toyboat,,32,180,234,414
23847,johnsonmx,,31,1,1,2
23848,gobias,,1,3,5,8
23849,Eymapoophace,,32,1,1,2
23850,kieranbenton,,20,3,3,6
23851,Slowlearner,,18,8,11,19
23852,adecruza,,34,7,6,13
23853,vw63,,14,1,1,2
23854,shibumi,,31,119,171,290
23855,ronaldm201,,19,10,14,24
23856,Yakalam,,31,1,2,3
23857,oasisinet,,19,168,4,172
23858,pepparkaka,,34,156,452,608
23859,utunga,,34,19,46,65
23860,hollywoodcole,,18,4,2,6
23861,harda,,6,6,10,16
23862,autodidacticus,,4,1,1,2
23863,alexeyr,,20,73,70,143
23864,bubonic311,,19,7,3,10
23865,norinme,,0,82,9,91
23866,jugz,,43,12,21,33
23867,ahmedbilal,,5,150,6,156
23868,buddhainabucket,,18,33,7,40
23869,shnubert,,17,212,401,613
23870,serge_the_coder,,20,11,2,13
23871,WorkingDead,,0,37,54,91
23872,MimiK,,1,2,7,9
23873,alexandreracine,,34,150,140,290
23874,ethbone,,18,27,24,51
23875,RiffRandle,,18,1,2,3
23876,micheshi,,5,48,71,119
23877,indgosky,,17,16,13,29
23878,leavingharvard,,1,10,26,36
23879,darksofa,,30,14,24,38
23880,fishbert,,13,273,379,652
23881,bdy99,,30,1,2,3
23882,freakball,,18,228,276,504
23883,opti,,8,1,1,2
23884,whiteghetto,,18,5,17,22
23885,eightiesguy,,18,29,33,62
23886,balidad,,34,4,1,5
23887,jpfromjp,,5,1,1,2
23888,Skandrannon21,,19,5,5,10
23889,dudecthar,,22,3,1,4
23890,boomba111,,2,7,1,8
23891,limprichard,,19,94,194,288
23892,fantasyfinch,,20,24,1,25
23893,TheTonkaTruck,,20,80,89,169
23894,atolley,,19,4,1,5
23895,jadecristal,,17,99,200,299
23896,SlugFight,,19,102,216,318
23897,tirpse77,,31,111,5,116
23898,kolia,,18,8,4,12
23899,WestStreetWalker,,19,66,25,91
23900,phobophobia,,1,49,144,193
23901,stbby,,18,18,1,19
23902,dbzer0,,29,340,293,633
23903,graphsuck,,20,1,1,2
23904,kbilling,,19,1,4,5
23905,jackshit,,2,5,2,7
23906,nutron,,34,17,29,46
23907,thegadfly,,18,5,14,19
23908,ilostmypassword,,31,22,3,25
23909,lunchboxg4,,16,3,5,8
23910,anshulk,,20,9,5,14
23911,LittleBaby,,22,2,3,5
23912,cyclopsface,,20,19,20,39
23913,noone187,,13,5,1,6
23914,freddunkle,,22,49,49,98
23915,theodorictheamal,,6,3,2,5
23916,dwi,,22,63,80,143
23917,woosh,,42,5,13,18
23918,Encore65651,,18,1,1,2
23919,armbo,,19,1,1,2
23920,monger00,,20,69,12,81
23921,jeremedia,,18,1,4,5
23922,lost_in_space,,1,1,3,4
23923,kalemba,,19,43,59,102
23924,j3wmanji,,13,6,16,22
23925,NightGolfer,,18,404,417,821
23926,bambino_tostare,,43,1,1,2
23927,professorShrike,,22,1,2,3
23928,mikelevins,,16,4,2,6
23929,ribbit76,,19,1,1,2
23930,xoai,,19,3,3,6
23931,vininim,,20,5,6,11
23932,tanvach,,43,13,6,19
23933,dinasec,,19,2,2,4
23934,greenlantern33,,0,31,37,68
23935,polarizer,,32,2,5,7
23936,m0m0,,18,29,54,83
23937,fiestylilkim,,8,2,2,4
23938,capnmariam,,18,6,7,13
23939,Fairytaleguy,,1,1,1,2
23940,Raeapteek,,18,35,1,36
23941,ratebeer,,19,887,96,983
23942,jleard,,34,2,3,5
23943,masterleep,,20,5,2,7
23944,masseyis,,31,25,36,61
23945,k3n0b1,,19,83,143,226
23946,fart-man,,43,129,20,149
23947,chejrw21,,18,1,1,2
23948,fdksjahfdsa,,18,20,40,60
23949,ibangpots,,4,1,2,3
23950,pentupentropy,,13,60,30,90
23951,alfinoba,,20,2,1,3
23952,biatx,,1,1,1,2
23953,necroturd,,31,33,55,88
23954,liberatedword,,34,294,598,892
23955,scornflake,,13,10,6,16
23956,sagev_efil,,12,4,9,13
23957,zappepcs,,32,18,42,60
23958,doublestodtington,,18,5,8,13
23959,Rosco7,,22,25,20,45
23960,kupopo1,,20,6,5,11
23961,saxmaster,,13,1,1,2
23962,MithrasLives,,1,4,2,6
23963,jcanfield,,18,3,1,4
23964,bandwagon,,0,97,104,201
23965,Mansn,,18,52,63,115
23966,ZanThrax,,31,291,487,778
23967,think3737,,20,1,1,2
23968,p1234,,15,95,6,101
23969,Boreas74,,32,9,1,10
23970,hoijarvi,,20,81,120,201
23971,iSteve,,19,5,17,22
23972,stillwaters,,19,73,128,201
23973,chompsky,,20,53,56,109
23974,labgeek,,13,18,52,70
23975,jesusabdullah,,1,30,88,118
23976,fionbio,,20,31,40,71
23977,b34ch3r,,3,1,2,3
23978,lava444,,1,1,3,4
23979,AllenHarkleroad,,32,9,13,22
23980,SteJules,,5,94,11,105
23981,PoodleSmuggler,,18,6,5,11
23982,mattthetalker,,19,8,4,12
23983,4shane76,,30,22,56,78
23984,freddic,,19,2,3,5
23985,w2d,,20,8,8,16
23986,djbuzzkill,,20,9,4,13
23987,mr_chromatic,,20,257,328,585
23988,Orbitaldecay,,40,22,6,28
23989,tinfoilhat911,,3,1,2,3
23990,thecrazyD,,31,44,49,93
23991,schonchin,,35,3,4,7
23992,trowserwowser,,31,37,74,111
23993,sleen,,13,5,5,10
23994,wepto,,31,1,2,3
23995,ivorjawa,,18,94,68,162
23996,greenjenny,,20,6,5,11
23997,imposs,,0,5,8,13
23998,pemboa,,20,310,430,740
23999,jacker,,0,1,1,2
24000,JordanF98765,,19,100,90,190
24001,mypetrobot,,30,4,1,5
24002,siliconglen,,13,24,5,29
24003,jack_nz,,1,8,7,15
24004,egzthunder1,,22,162,194,356
24005,nevarforget,,29,1,5,6
24006,hain,,22,101,106,207
24007,ccharles,,20,260,193,453
24008,wanpage,,20,1,3,4
24009,boldbonvivant,,31,12,13,25
24010,Bigred,,40,13,18,31
24011,mastery,,20,1,1,2
24012,MaybeTomorrow,,1,15,36,51
24013,anonymous410,,41,1,1,2
24014,PoopsMcG,,1,78,79,157
24015,nfkiller,,13,11,10,21
24016,hokeypokey,,31,1,1,2
24017,Selmerboy,,19,1,6,7
24018,pretzelcuatl,,34,31,7,38
24019,skysee,,19,3,1,4
24020,SittingBull,,1,102,50,152
24021,rotten777,,29,22,38,60
24022,linus_rules,,3,13,18,31
24023,sn0re,,8,1249,1849,3098
24024,confuc,,18,106,4,110
24025,InternetOfficer,,43,1,2,3
24026,nefariousninja,,1,49,50,99
24027,Widget05,,18,9,17,26
24028,bboomslang,,11,3,4,7
24029,cvos,,0,1,1,2
24030,Flyen,,4,174,202,376
24031,DanAndJenn,,5,4,1,5
24032,skyekilaen,,34,2,7,9
24033,Metasheep,,1,60,57,117
24034,se7en,,32,13,6,19
24035,ansgenius,,35,7,13,20
24036,jeh506,,19,56,23,79
24037,up_the_irons,,20,6,1,7
24038,nautimike,,18,12,6,18
24039,jayw,,32,35,72,107
24040,nobodyrp,,18,43,54,97
24041,da_bears_rule,,32,1,1,2
24042,phredtheterrorist,,32,6,7,13
24043,Joose,,22,2,2,4
24044,zzzeek,,20,77,98,175
24045,br1,,20,5,4,9
24046,mgslol,,22,15,10,25
24047,alextp,,20,16,17,33
24048,retidder,,34,33,33,66
24049,GeorgeDubyaBush,,19,4,4,8
24050,cefcm,,31,1,1,2
24051,jgwong,,20,1,1,2
24052,Tolaria,,32,4,6,10
24053,lgastako,,20,1,5,6
24054,UCB,,0,5,3,8
24055,jmijor,,31,3,1,4
24056,Rawrawr,,4,1,1,2
24057,haagmm,,19,13,21,34
24058,quillian,,19,6,5,11
24059,kiku,,22,1,1,2
24060,SesseSekko,,42,4,5,9
24061,lepoulet,,16,3,2,5
24062,goodcopbadcop,,0,2,2,4
24063,majoogybobber,,1,145,69,214
24064,fringsphysiclwrld,,31,18,35,53
24065,edeninchains,,32,17,4,21
24066,sirdonut,,18,6,4,10
24067,zakcroy,,19,1,1,2
24068,praveenpious,,18,43,7,50
24069,good_doctor,,22,8,14,22
24070,infosnax,,32,277,276,553
24071,mdickw,,18,204,108,312
24072,neatorama,,42,1,1,2
24073,klocksib,,20,9,28,37
24074,mistera,,43,40,32,72
24075,cush,,16,139,124,263
24076,MagicGate,,19,9,6,15
24077,gilf,,19,13,8,21
24078,nanbot,,19,9,7,16
24079,dwillington,,0,31,42,73
24080,tolworthy,,31,2,1,3
24081,keyrat,,6,130,122,252
24082,tihp,,34,1,1,2
24083,DvorakUser,,1,2,3,5
24084,opk,,13,35,17,52
24085,chrisbaskind,,5,1,10,11
24086,Zunger,,20,1,2,3
24087,delecti,,14,1,2,3
24088,dberis,,31,196,256,452
24089,thxi1xa,,16,1,1,2
24090,Moxie1,,18,2,2,4
24091,ralmeida,,32,5,6,11
24092,RICKARD5,,19,103,209,312
24093,sumeetjain,,0,8,6,14
24094,OldGreyTroll,,19,1,2,3
24095,quattrofan,,18,71,140,211
24096,derupert,,38,47,74,121
24097,bradtgmurray,,20,4,3,7
24098,downgoesfrazier,,18,155,4,159
24099,sniggity,,1,57,153,210
24100,smift,,34,2,14,16
24101,laurarachel,,12,45,30,75
24102,kay63,,31,1,2,3
24103,dning,,1,17,3,20
24104,Tigaj,,13,7,1,8
24105,mejlkungen,,31,14,24,38
24106,timealterer,,20,42,4,46
24107,timster,,30,21,26,47
24108,beppu,,20,6,27,33
24109,bunfunbun,,18,21,34,55
24110,gasfggjj,,20,1,1,2
24111,YoavShapira,,36,1,1,2
24112,Lifted,,13,14,35,49
24113,roll3r,,13,20,26,46
24114,allanmac00,,0,11,15,26
24115,wikk3d,,18,13,27,40
24116,Akhel,,22,79,76,155
24117,andycarlson,,20,1,1,2
24118,swac,,20,40,14,54
24119,finisterra,,19,242,387,629
24120,veridatis,,17,2,4,6
24121,jangchoe,,20,95,14,109
24122,RicoX9,,31,32,27,59
24123,Eizz,,19,16,22,38
24124,paul_mendoza,,13,47,89,136
24125,dotancohen,,43,40,22,62
24126,mrpickleby,,12,29,50,79
24127,asdf1341,,20,10,14,24
24128,apos,,20,1,2,3
24129,Mkcornick,,20,32,17,49
24130,bambin0,,13,52,64,116
24131,BlackStrain,,19,4,2,6
24132,Tsukuyomi,,1,1,3,4
24133,2solitudes,,19,3,3,6
24134,crimius,,19,3,12,15
24135,ProfessorM,,19,70,100,170
24136,jjray7,,13,98,57,155
24137,tclark,,29,42,79,121
24138,dsk,,31,528,575,1103
24139,cute_kiddo_fury,,20,4,5,9
24140,DzGuy,,20,2,1,3
24141,rrusilowicz,,22,5,10,15
24142,PostingPolice,,18,11,24,35
24143,tampink,,25,1,1,2
24144,quantumamy,,43,1,1,2
24145,oq2,,20,16,39,55
24146,gibsiin,,18,2,2,4
24147,CafeAss,,29,1,4,5
24148,actionboy,,18,19,34,53
24149,emTel,,43,22,12,34
24150,OuchLOLcom,,18,75,3,78
24151,Garbo,,22,22,42,64
24152,joblessjunkie,,20,89,74,163
24153,j1mcamp,,20,6,13,19
24154,fnazeeri,,13,2,1,3
24155,elmer_thudd,,20,1,1,2
24156,Reive,,13,9,23,32
24157,Oz-Batty,,18,5,5,10
24158,ratsbane,,32,7,10,17
24159,dominicc,,6,1,1,2
24160,isthisdigg,,18,9,4,13
24161,alvaai,,3,1,4,5
24162,whiteyfresh,,19,360,510,870
24163,brasso,,12,17,33,50
24164,uglyluvr,,18,2,5,7
24165,hohums,,20,1,1,2
24166,Confinium,,22,9,9,18
24167,jordancaleb,,43,143,190,333
24168,omtw,,1,22,32,54
24169,nightofgrim,,0,49,94,143
24170,shawna_m,,43,45,44,89
24171,eloop,,42,13,2,15
24172,protossss,,43,2,2,4
24173,Chx,,12,91,157,248
24174,workerdaemon,,4,256,407,663
24175,mayonesa,,13,944,352,1296
24176,King_Lem,,40,2,5,7
24177,slgalt,,34,1,1,2
24178,magikid,,29,4,7,11
24179,mightyfin,,29,16,23,39
24180,staxbrix,,13,15,2,17
24181,idiotsmile,,6,2,3,5
24182,12StepAgnostic,,13,1,1,2
24183,ThinkItOver,,19,139,76,215
24184,schnook,,31,1,3,4
24185,complex,,20,4,8,12
24186,DaemonR,,42,16,37,53
24187,djdefekt,,4,9,7,16
24188,O_Gruesome_One,,20,3,1,4
24189,Romandante,,34,1,2,3
24190,OUPrice08,,19,2,2,4
24191,nictiwn,,31,1,1,2
24192,haskellist,,20,48,56,104
24193,hkyoda,,26,1,1,2
24194,middleperson,,20,1,1,2
24195,arcoma,,19,1,4,5
24196,Yaker,,0,19,19,38
24197,Independent24,,13,11,2,13
24198,betrothtypist,,20,3,3,6
24199,gpww,,13,6,3,9
24200,argarararar,,0,6,4,10
24201,Palquito,,31,5,5,10
24202,honc,,20,2,1,3
24203,tmw1488,,18,93,269,362
24204,LesbianHan,,18,1,1,2
24205,cycnus,,32,2,3,5
24206,bigjoe699,,20,1,1,2
24207,HowlingWolf,,19,17,21,38
24208,RedneckForObama,,16,3,2,5
24209,hueristic,,19,24,23,47
24210,thetrivialsublime,,32,2,1,3
24211,darmog,,19,4,7,11
24212,Wisco,,13,378,223,601
24213,mathgeek,,19,48,31,79
24214,kingjames128,,4,27,6,33
24215,Gentle_Ben,,29,2,3,5
24216,junkmale,,1,1043,700,1743
24217,HalleBerry,,12,3,1,4
24218,ChunkyLaFunga,,4,880,1230,2110
24219,eridius,,20,366,415,781
24220,brandnewredditor,,18,6,8,14
24221,pcflet01,,18,38,14,52
24222,GOjeff,,34,116,34,150
24223,rockwellian,,31,5,7,12
24224,raginole,,5,1,1,2
24225,looklookatme,,18,2,4,6
24226,bwells78,,13,1,2,3
24227,hehdot,,18,24,21,45
24228,rue,,18,4,2,6
24229,gjbloom,,32,3,2,5
24230,lawrencetureaud,,19,5,22,27
24231,veritech,,20,27,43,70
24232,thefnord,,27,2,3,5
24233,mizunoX,,18,1,1,2
24234,radical,,29,60,60,120
24235,freedomwv,,19,6,16,22
24236,havocist,,13,111,94,205
24237,zilentbob,,20,3,5,8
24238,thunderballfists,,1,13,35,48
24239,jaalin,,22,167,261,428
24240,wadfasdfaw,,32,2,1,3
24241,eldridgea,,43,20,29,49
24242,TheLastUsername,,21,2,1,3
24243,urso,,29,2,4,6
24244,An_Sheeple,,19,1,1,2
24245,mxyzptlk,,20,45,96,141
24246,qmx,,5,1,3,4
24247,IOIOOIIOIO,,17,349,771,1120
24248,workaholic23,,20,4,6,10
24249,hattmoward,,32,32,56,88
24250,theunixgeek,,34,2,1,3
24251,7952,,31,32,43,75
24252,jimjohn,,19,2,3,5
24253,clownshoes,,20,89,83,172
24254,12Iceman,,1,143,117,260
24255,abc2011,,13,10,8,18
24256,dailyn,,15,766,193,959
24257,sock_muppetis,,39,1,1,2
24258,pmr,,32,5,7,12
24259,notle,,13,4,3,7
24260,spikeparker,,18,11,33,44
24261,snowhite12,,18,204,2,206
24262,bingcognito,,34,28,41,69
24263,randomafk,,18,6,11,17
24264,rjn945,,26,2,4,6
24265,lexpython,,34,31,33,64
24266,weaselonfire,,1,850,361,1211
24267,bena_dc,,19,26,2,28
24268,neurot,,18,56,65,121
24269,VAPerson,,34,79,132,211
24270,happywaffle,,43,300,326,626
24271,thebillmac3,,18,470,894,1364
24272,kidfay,,32,29,31,60
24273,cthibaut,,32,6,11,17
24274,d1257,,18,19,35,54
24275,tinha,,1,14,26,40
24276,modusop,,31,1,1,2
24277,grelphy,,20,723,863,1586
24278,didimaumusic,,13,4,2,6
24279,little_mei,,15,13,18,31
24280,Kapitalism,,31,7,10,17
24281,exportgoldman,,18,1,1,2
24282,rudolfschmidt,,32,1,1,2
24283,Agret,,22,11,13,24
24284,Cthonic,,32,7,17,24
24285,Johio,,13,51,15,66
24286,phil_g,,20,105,86,191
24287,crushd62497,,41,1,1,2
24288,Weeperblast,,32,11,10,21
24289,scrby,,20,37,5,42
24290,bikini_bible,,11,13,20,33
24291,huangyi,,20,1,2,3
24292,gardengnomic,,19,21,37,58
24293,gabtinha,,1,67,29,96
24294,moe_va,,6,1,1,2
24295,osborned,,32,2,1,3
24296,moses1400,,5,3,6,9
24297,hiphopmusiq,,6,138,109,247
24298,jayskew,,13,8,12,20
24299,chaosZombie,,20,2,3,5
24300,brilliance,,1,22,37,59
24301,bobappleyard,,20,74,145,219
24302,fnork77,,18,30,52,82
24303,twisted2253,,5,1,2,3
24304,leslieb310,,34,3,2,5
24305,Etab,,1,624,900,1524
24306,thebandit87,,34,10,30,40
24307,cowdogk,,41,55,37,92
24308,rabidstoat,,32,14,30,44
24309,killerkadoogan,,20,11,19,30
24310,ginaav,,18,132,1,133
24311,cirquelar,,15,63,143,206
24312,JonathanBlow,,8,4,1,5
24313,gebruikersnaam,,31,4,2,6
24314,joonix,,13,1088,684,1772
24315,doone,,13,23,2,25
24316,socratesocks,,32,16,20,36
24317,TopRamen713,,1,728,872,1600
24318,34o1055,,22,2,2,4
24319,kristinsj,,5,2,1,3
24320,orgadam,,22,23,28,51
24321,aandronov,,20,3,3,6
24322,akise,,43,5,15,20
24323,effedup,,33,4,8,12
24324,exegesisClique,,6,49,80,129
24325,reticulatedspline,,22,45,63,108
24326,barfolomew,,12,207,309,516
24327,swiftest,,43,4,2,6
24328,Drakooola,,0,7,9,16
24329,CanadianTire,,6,2,1,3
24330,capital_idea,,31,8,12,20
24331,oldredditor,,1,2,5,7
24332,Fara17,,32,39,52,91
24333,ddavev,,1,70,61,131
24334,the_seanald,,30,105,158,263
24335,alaris,,19,1,2,3
24336,papillon24,,1,163,177,340
24337,tjasond,,32,3,2,5
24338,Trauma,,20,2,3,5
24339,Axius,,18,2,5,7
24340,write_in,,43,3,2,5
24341,numlok,,15,407,239,646
24342,foobazco,,18,4,4,8
24343,foofightrs777,,10,18,22,40
24344,tessfeb01,,13,36,44,80
24345,tapesmith,,22,1,1,2
24346,mrl215,,0,24,31,55
24347,lfcgoreds,,20,1,1,2
24348,RealFriendlyGuy,,1,2,4,6
24349,drgori,,20,18,10,28
24350,coolchickk,,30,8,1,9
24351,garytehs,,31,8,1,9
24352,gakman,,20,12,1,13
24353,joforedditin,,31,22,23,45
24354,cag_ii,,20,307,73,380
24355,earthinaword,,19,3,2,5
24356,dhaggerfin,,22,80,135,215
24357,arohner,,20,27,14,41
24358,hindesky,,13,92,184,276
24359,bigscott0026,,11,1,2,3
24360,FlorenceW,,0,301,1,302
24361,cruijff,,43,4,1,5
24362,jips,,19,819,1,820
24363,racerx52,,13,7,26,33
24364,wgl,,13,10,34,44
24365,putgirl,,43,1,2,3
24366,Fountaine,,1,3,10,13
24367,hassanibraheem,,20,29,2,31
24368,Garbagio,,13,219,411,630
24369,HXC_SHMARDCORE,,30,1,2,3
24370,phillapier,,18,33,2,35
24371,chrisskinr,,1,50,112,162
24372,smacktoward,,16,3,3,6
24373,gratsonbad,,18,13,15,28
24374,Borkachev,,19,182,162,344
24375,Y2Cajun,,34,5,22,27
24376,specmiata,,31,5,3,8
24377,dorock,,18,6,12,18
24378,eshop600,,43,5,9,14
24379,kensingtonvictoria,,15,1,1,2
24380,AhmedF,,31,22,31,53
24381,ctffmike,,22,2,2,4
24382,wafflesrevenge,,30,1,1,2
24383,cashcow,,13,17,6,23
24384,romanoke,,32,2,3,5
24385,nextpage,,34,5,1,6
24386,isnthatheway,,43,8,27,35
24387,juliawise,,18,2,2,4
24388,ironypolice,,34,68,94,162
24389,xflhbs,,4,5,4,9
24390,mooli,,3,302,370,672
24391,tsfrankie,,13,43,14,57
24392,leopoldo,,13,464,18,482
24393,stormopen,,18,2,4,6
24394,jgood2709,,43,1,1,2
24395,zenzizi,,18,104,165,269
24396,wayno007,,32,4,8,12
24397,notahippie76,,1,368,372,740
24398,PipsDayOut,,0,90,58,148
24399,Vash265,,4,700,772,1472
24400,natrius,,19,726,713,1439
24401,bs0101,,34,14,30,44
24402,saucier23,,1,48,55,103
24403,iceix,,7,22,19,41
24404,blunted,,13,43,92,135
24405,CaptainDubious,,13,1,4,5
24406,feckoffcup,,42,2,3,5
24407,kingjafee,,0,400,20,420
24408,michaeb,,13,6,2,8
24409,kmoore,,19,5,14,19
24410,mattso,,17,4,8,12
24411,leftthebox,,18,13,2,15
24412,rad_thundercat,,1,62,63,125
24413,CAPSLOCKBIGCOCK,,31,2,1,3
24414,YourTechSupport,,12,44,80,124
24415,SHEEPLE__,,1,8,8,16
24416,jnana,,1,35,68,103
24417,juliusseizure,,13,99,147,246
24418,buckrogers,,12,1,4,5
24419,bundublog,,43,1,1,2
24420,TheMindFlayer,,5,7,2,9
24421,sensen411,,19,34,55,89
24422,monkeybreath,,30,295,436,731
24423,DavidinBoston,,34,1,1,2
24424,duckrogers,,31,13,18,31
24425,serenecloud,,12,1,3,4
24426,AusIV,,20,251,368,619
24427,Them,,18,1,4,5
24428,House_Playa,,0,4,3,7
24429,intellectual,,19,608,736,1344
24430,Angel1379,,0,165,14,179
24431,elysiand,,1,28,30,58
24432,mully,,20,1,1,2
24433,translucent,,18,9,9,18
24434,weblypistol,,8,2,1,3
24435,jinglebells,,20,168,163,331
24436,channyboy,,43,17,27,44
24437,crankybadger,,32,2,4,6
24438,Wyatt22,,13,124,62,186
24439,turungan,,20,3,7,10
24440,thedarkhaze,,5,9,10,19
24441,surrenderyourduck,,1,5,3,8
24442,rams,,20,71,7,78
24443,Snyper718,,1,1,7,8
24444,usernameispassword,,13,4,1,5
24445,Thursty,,27,18,27,45
24446,ilude,,42,3,2,5
24447,gururickri,,0,21,4,25
24448,duopixel,,34,8,4,12
24449,lamaraju,,5,2,2,4
24450,arrival77,,30,44,50,94
24451,CosmicBard,,18,31,93,124
24452,europeiscrowded,,20,3,3,6
24453,masterJ,,1,60,52,112
24454,Kcar,,34,1,1,2
24455,BTV,,0,26,39,65
24456,pepethecow,,20,1,1,2
24457,tienlex,,20,2,2,4
24458,collegedropout,,22,14,24,38
24459,tndal,,34,12,13,25
24460,mylastbreath,,30,6,10,16
24461,Anon23,,41,1,1,2
24462,madkitty,,34,2,1,3
24463,RonPaul_is_Taleban,,19,1,1,2
24464,BinaryShadow,,13,510,696,1206
24465,benbetso,,1,3,4,7
24466,komacan,,5,1,2,3
24467,thorax,,20,58,91,149
24468,quickie,,42,14,15,29
24469,ramius,,20,1,1,2
24470,El_Guapo,,22,349,505,854
24471,AllenVarney,,19,3,2,5
24472,Shindig,,26,4,5,9
24473,crescentfresh,,20,42,56,98
24474,ride,,43,153,218,371
24475,mw44118,,20,41,7,48
24476,metalmutt,,42,1,2,3
24477,rollingdivision,,19,20,20,40
24478,api,,20,722,674,1396
24479,spoogle,,12,1,2,3
24480,gavinhudson1,,34,37,26,63
24481,dumis,,5,34,12,46
24482,richard_stone,,13,8,10,18
24483,psrivats,,34,1,7,8
24484,donaldrobertsoniii,,31,356,192,548
24485,CoffeeJones,,20,1,2,3
24486,pordante,,18,4,14,18
24487,spaceddaisy,,29,1,2,3
24488,y2k_propaganda,,30,22,10,32
24489,starfocus,,5,64,18,82
24490,turtlesallthewaydown,,1,84,65,149
24491,comob74,,16,1,1,2
24492,anotherDocObVious,,22,24,73,97
24493,thepdxbikerboy,,19,4,11,15
24494,johanneskepler,,20,11,13,24
24495,hinterlander,,1,1,1,2
24496,CapitalIdea,,22,23,31,54
24497,mttprrish,,43,10,12,22
24498,pinano,,20,2,2,4
24499,evergreenamerica,,19,5,7,12
24500,andsmi,,22,46,1,47
24501,deepscene,,19,2,2,4
24502,yes2134sdfsg,,30,6,3,9
24503,presoblu,,18,94,85,179
24504,cysun,,18,112,97,209
24505,sirvesa,,13,6,5,11
24506,antisoshal,,22,9,6,15
24507,lazer,,19,5,11,16
24508,jessta,,20,9,10,19
24509,marquinhocb,,26,6,1,7
24510,LaZerguy,,1,43,88,131
24511,joharilanng,,32,31,30,61
24512,jailbird4444,,13,5,2,7
24513,mattdhorstman,,19,2,2,4
24514,safety_otter,,22,2,6,8
24515,bkmrkr2,,19,5,7,12
24516,PocketWatched,,1,5,9,14
24517,Evilsoup,,28,4,2,6
24518,hotcakes,,13,180,58,238
24519,miGlanz,,20,8,9,17
24520,THE_RIAA,,1,1,1,2
24521,bazzatuk,,1,1,1,2
24522,apuent,,18,10,16,26
24523,mrpony,,32,2,5,7
24524,rook2pawn,,19,620,595,1215
24525,jenhsun,,7,2,1,3
24526,yuckatan,,19,9,42,51
24527,jayc,,20,34,34,68
24528,okhelo,,36,1,1,2
24529,mike689,,1,3,4,7
24530,jcarr,,19,75,52,127
24531,rollerbob,,12,58,46,104
24532,orbiscerbus,,20,13,19,32
24533,citydweller,,43,22,13,35
24534,drexhex,,5,24,16,40
24535,cactusthesaint,,22,5,7,12
24536,renani07,,19,7,11,18
24537,ARDComics,,12,1,2,3
24538,nexus2xl,,7,298,478,776
24539,wisamc,,13,6,11,17
24540,jeff0,,32,74,94,168
24541,maxharris,,19,12,14,26
24542,ktusznio,,18,36,46,82
24543,fredscereal,,13,1,11,12
24544,toekk,,20,2,3,5
24545,PhirePhly,,13,6,5,11
24546,dry_green_tea,,20,255,47,302
24547,af_fox,,18,4,2,6
24548,carmen2007,,5,17,2,19
24549,kukhuvudet,,1,5,5,10
24550,michaelok,,22,10,17,27
24551,raleighwhite,,42,2,2,4
24552,scyrius,,43,1,1,2
24553,some_dude,,9,6,2,8
24554,a0t0f,,18,76,85,161
24555,stevewmn,,43,15,7,22
24556,twiglatte,,27,20,16,36
24557,sgorf,,20,40,38,78
24558,nontheist,,19,10,10,20
24559,jimbo345,,13,1,7,8
24560,spam_rocket,,6,19,11,30
24561,neondemon,,29,2,1,3
24562,satorusan,,18,3,17,20
24563,jaxxon,,18,5,7,12
24564,VerticalEvent,,22,2,1,3
24565,ImmigratingToCanada,,1,1,1,2
24566,sukirnii,,18,5,3,8
24567,adelman890,,32,5,5,10
24568,HolyHandGrenade,,14,2,1,3
24569,calbach,,32,5,3,8
24570,boss1345,,13,13,2,15
24571,MonoApe,,31,192,346,538
24572,djfanon,,13,4,1,5
24573,mmmdelishus,,8,1,2,3
24574,scaevolus,,33,1,2,3
24575,noormuhammad,,5,1,5,6
24576,hbweb500,,31,106,84,190
24577,StachesnMullets,,18,15,2,17
24578,tugboatking,,34,4,9,13
24579,ingle,,13,2,2,4
24580,Captain_Cunning,,18,3,8,11
24581,tjones_2005a,,19,65,142,207
24582,substrate,,6,29,42,71
24583,panzerfinder15,,13,13,12,25
24584,lstorie1971,,13,1,1,2
24585,taylorcomm,,21,5,2,7
24586,pudquick,,34,48,61,109
24587,rhcpds7,,19,40,13,53
24588,zheisey,,5,8,15,23
24589,Bloodtrocuter,,13,8,28,36
24590,mauriceroman,,20,2,2,4
24591,Skee,,22,89,44,133
24592,marydaze,,1,82,131,213
24593,czul1,,19,1,3,4
24594,Srsly666,,19,21,52,73
24595,condensate17,,20,11,8,19
24596,markashton,,19,1,1,2
24597,eco_was_taken,,18,146,182,328
24598,triggler,,32,2,5,7
24599,frazer2669,,20,2,2,4
24600,TheHarvester,,43,15,6,21
24601,skizza,,19,4,4,8
24602,superfreak7,,22,2,1,3
24603,vlad_tepes,,31,250,369,619
24604,tj9582,,20,3,2,5
24605,polaralex,,43,1,3,4
24606,GoldUser,,31,14,7,21
24607,baseball83,,19,1,2,3
24608,LOL_CAT,,22,28,21,49
24609,wreelp,,29,14,17,31
24610,opentruth,,20,195,30,225
24611,Phylodome,,18,9,8,17
24612,avdi,,20,75,14,89
24613,alan_dulles,,6,2,1,3
24614,ruodo,,1,150,218,368
24615,Reporting,,19,41,1,42
24616,bkdelong,,3,1,1,2
24617,zoo3000,,20,3,5,8
24618,zyclonis,,13,118,215,333
24619,ogercaveman,,18,1,1,2
24620,MEME-KILLER,,4,1,1,2
24621,jambarama,,10,91,155,246
24622,Shellack,,13,2,1,3
24623,trancertong,,18,229,91,320
24624,cthielen,,1,143,113,256
24625,plagues,,32,1,1,2
24626,sarotara,,31,43,46,89
24627,jotux,,18,25,34,59
24628,libfree,,29,205,59,264
24629,Percara,,13,3,13,16
24630,stalcottsmith,,42,143,193,336
24631,mushpot_net,,20,5,3,8
24632,cliff_bisch,,18,17,15,32
24633,Mongoloid,,14,1,1,2
24634,CounterBreak,,19,1,3,4
24635,nursewithprostate,,32,44,73,117
24636,lepton3,,20,24,16,40
24637,NicNicNic,,0,72,196,268
24638,phybere,,19,25,34,59
24639,Brokebackcasket,,5,1,9,10
24640,GoateusMaximus,,13,17,20,37
24641,blendo,,18,9,13,22
24642,theframeproblem,,0,6,1,7
24643,kirby9,,20,12,4,16
24644,BrianBoyko,,42,522,559,1081
24645,aturley,,20,6,6,12
24646,csmillichap,,18,144,175,319
24647,Dontgotocollege,,18,4,1,5
24648,martyville,,13,25,25,50
24649,shyneclinton,,18,1,1,2
24650,brushbox,,20,78,118,196
24651,wegin,,10,2,1,3
24652,NotlufNorserp,,0,4,4,8
24653,goshorty,,18,1,1,2
24654,deadparrot28,,34,12,2,14
24655,snoobie,,18,2,4,6
24656,blarney_77,,13,3,2,5
24657,SemanticStallion,,34,1,1,2
24658,tobrien,,13,235,74,309
24659,bassomatic,,13,414,237,651
24660,qulic1968,,22,9,8,17
24661,atlasbound,,28,3,3,6
24662,qyasogk,,0,6,6,12
24663,EggbertPraetorius,,22,6,6,12
24664,firelight,,13,24,32,56
24665,richmcl,,5,4,10,14
24666,wmaustin5,,7,1,1,2
24667,Decoy9,,1,37,4,41
24668,Help_Im_A_Rock,,11,1,3,4
24669,ahhoosha,,18,12,25,37
24670,commonkey,,42,2,1,3
24671,tuan,,3,2,4,6
24672,shazbotter,,12,29,29,58
24673,drugstorecowboy,,5,2,1,3
24674,DrCheezburger,,12,42,64,106
24675,bennythekid1,,1,4,11,15
24676,postertorn,,20,2,1,3
24677,jaunti,,30,6,2,8
24678,El_Forko,,23,3,9,12
24679,hacksoncode,,20,11,12,23
24680,samuek,,22,24,32,56
24681,VerteDinde,,19,61,86,147
24682,deezeejoey,,17,1,1,2
24683,angch,,20,19,46,65
24684,funkadelik,,42,3,1,4
24685,kat,,13,1,2,3
24686,dsacks,,18,1,1,2
24687,Kjjkh_Jkhjkk,,9,1,1,2
24688,csandb,,5,1,1,2
24689,davejohncole,,39,2,1,3
24690,InterrobangProponent,,4,2,2,4
24691,aleutian,,13,6,6,12
24692,alampros,,8,1,2,3
24693,kruegs,,1,1,2,3
24694,joshtempte,,13,3,2,5
24695,stassats,,20,8,12,20
24696,Rick-Astley,,22,12,16,28
24697,robert644,,13,19,41,60
24698,razorhack,,14,4,16,20
24699,Brolee,,18,17,67,84
24700,jclassracer,,18,3,21,24
24701,HarryTruman,,32,20,27,47
24702,daigoba66,,20,10,5,15
24703,m_erik_mason,,13,2,1,3
24704,theguffer,,30,23,21,44
24705,hashmalum,,43,4,7,11
24706,noel,,34,1,1,2
24707,mathgladiator,,11,1,2,3
24708,mojonixon,,22,1,4,5
24709,pandamander,,1,1,1,2
24710,wnose,,18,43,37,80
24711,excession,,1,14,8,22
24712,jncraton,,32,7,4,11
24713,tehjess,,4,8,10,18
24714,verveonica,,0,3,16,19
24715,georgiabiker,,22,9,26,35
24716,foxymoron,,18,28,78,106
24717,directionzero,,34,28,19,47
24718,jonw,,20,108,23,131
24719,smkyle1,,13,55,6,61
24720,SwankyJ,,2,16,1,17
24721,iwata,,41,13,6,19
24722,unanimus,,3,1,2,3
24723,TheirOwnMedicine,,21,5,1,6
24724,MoralHazard,,13,12,10,22
24725,jibbybonk,,14,2,1,3
24726,fffangold,,18,28,4,32
24727,roblef,,42,2,1,3
24728,pkkid,,1,7,7,14
24729,buleball,,29,1,1,2
24730,sternenator,,31,16,8,24
24731,kimberann,,18,73,9,82
24732,opseudo,,18,5,4,9
24733,sagerage,,19,4,1,5
24734,kpezkpez,,13,1,2,3
24735,colinnwn,,19,75,117,192
24736,agentbad,,0,106,381,487
24737,danger_tank,,18,11,10,21
24738,moosehockey23,,34,65,19,84
24739,nerftoe,,18,65,98,163
24740,CaptainInaccurate,,42,15,11,26
24741,404NameNotFound,,0,2,3,5
24742,TheBigRedDog,,20,54,11,65
24743,new_england,,13,16,9,25
24744,sparko,,5,3,2,5
24745,superwhateverman,,5,1,1,2
24746,adamvarga,,19,111,9,120
24747,cha12ly,,22,2,1,3
24748,escartist,,13,21,9,30
24749,Chroko,,3,197,184,381
24750,jursun,,17,4,4,8
24751,LoopHead,,32,259,331,590
24752,zataang,,20,1,5,6
24753,sebso,,0,6,2,8
24754,ensvensk,,27,2,1,3
24755,JinMarui,,32,232,533,765
24756,Ceph,,18,4,8,12
24757,gehlen,,4,6,9,15
24758,okcmaniac2,,19,1,1,2
24759,danny291,,32,9,19,28
24760,sn3098,,1,1,1,2
24761,taigaV,,31,6,12,18
24762,rossalgondamer,,13,30,84,114
24763,jade1yn,,22,3,6,9
24764,RMB123,,32,11,1,12
24765,eventhough,,17,42,14,56
24766,t-shirt-in-a-can,,19,3,16,19
24767,mattmentecky,,29,182,149,331
24768,meatpie,,43,3,4,7
24769,TexDen,,13,37,102,139
24770,zaretina,,22,91,69,160
24771,biggav,,34,18,10,28
24772,AOCsense,,3,4,1,5
24773,pageonenewsfan,,13,1,1,2
24774,Laconicus,,31,2,1,3
24775,pastyface,,6,1,1,2
24776,Thee_Internet,,0,5,3,8
24777,youngtomorrow,,12,1,1,2
24778,ngngboone,,0,452,604,1056
24779,CheeseSandwich,,18,1,2,3
24780,rusty_trombone,,18,8,16,24
24781,chivalry,,7,6,2,8
24782,mindspread,,11,117,43,160
24783,sbhdawn,,19,123,91,214
24784,meistergrado,,1,72,170,242
24785,BestServedCold,,4,281,337,618
24786,Automaton-o-mation,,18,2,1,3
24787,parl,,4,2,8,10
24788,dmarinescu,,20,2,4,6
24789,zaha,,31,1,2,3
24790,queenofspainsbeard,,20,6,2,8
24791,reddragon,,32,4,6,10
24792,dimonolog,,18,2,6,8
24793,GoHealthyGoFit,,1,4,2,6
24794,ddjango,,32,7,9,16
24795,deadliftpookie,,13,7,14,21
24796,umjames,,20,2,10,12
24797,bigtoe416,,6,40,30,70
24798,crazyfingers3,,12,1,1,2
24799,ihadanidea,,1,141,264,405
24800,X-Wes,,20,5,5,10
24801,_greg,,31,34,21,55
24802,Lilis78,,34,1,1,2
24803,WarzoneOfDefecation,,30,49,77,126
24804,AK1RA07,,13,31,36,67
24805,sethspeaks,,29,17,15,32
24806,BradLeclerc,,5,7,5,12
24807,explorer1972,,43,64,106,170
24808,3fingers,,40,14,28,42
24809,BenBaril,,20,2,4,6
24810,nootopian,,18,11,2,13
24811,barcuda,,43,1,1,2
24812,notfromphilly,,20,1,1,2
24813,cpruitt,,0,98,14,112
24814,samiamtoo,,42,8,2,10
24815,2880,,1,1,5,6
24816,mokerrr,,19,3,1,4
24817,cldellow,,15,2,3,5
24818,illymcflow,,30,1,2,3
24819,jaobrien6,,4,7,11,18
24820,moreminimal,,5,27,9,36
24821,cgod,,20,14,19,33
24822,heavyal,,19,1,1,2
24823,LibertyBoy,,20,1,3,4
24824,off8eat,,29,1,1,2
24825,ProgrammingAce,,12,10,1,11
24826,sidianmsjones,,32,15,5,20
24827,CIA_Guy,,1,1,3,4
24828,rebeccahutton,,32,3,5,8
24829,vvpan,,6,101,99,200
24830,milnivek,,34,3,1,4
24831,jasonthemason,,8,22,42,64
24832,halfjoking,,1,21,8,29
24833,RandomName321,,1,3,5,8
24834,squirrels_are_cool,,12,2,1,3
24835,rolmos,,0,91,96,187
24836,mattiast,,20,4,5,9
24837,TwoBit,,20,1,1,2
24838,jperras,,20,24,23,47
24839,darthmiho,,22,29,85,114
24840,tomg555,,18,49,65,114
24841,tedtedted,,16,1,3,4
24842,tetrachromatic,,31,12,15,27
24843,Salsa_Carlion,,43,1,1,2
24844,lasenorita,,32,44,87,131
24845,bsingle,,43,1,1,2
24846,pumo,,20,74,50,124
24847,rytis,,31,80,16,96
24848,oopsla,,8,6,6,12
24849,piroplex,,1,48,70,118
24850,mustpax,,20,2,3,5
24851,spongebob,,36,5,7,12
24852,MrPig,,31,13,10,23
24853,jmuintx,,19,1,1,2
24854,magicmario,,16,1,2,3
24855,kounavi,,22,175,286,461
24856,ableman,,29,3,2,5
24857,dher405,,36,2,1,3
24858,frodo77,,6,13,11,24
24859,dakine100,,13,4,4,8
24860,LiveLucid,,1,27,29,56
24861,pirate_reddit_arrrr,,4,5,2,7
24862,webology,,20,3,2,5
24863,propel,,18,140,93,233
24864,chonger,,42,14,34,48
24865,46and2,,20,1,1,2
24866,norxh,,30,5,2,7
24867,fireberts,,23,3,5,8
24868,Carpfish,,0,7,13,20
24869,quickpost,,1,226,87,313
24870,CaptMandrake,,31,14,19,33
24871,lliw,,36,2,3,5
24872,grotbot,,4,1,5,6
24873,respite,,22,45,75,120
24874,teratomato,,13,51,45,96
24875,BrucePlayne,,13,23,13,36
24876,shellfish,,13,28,31,59
24877,anvilchor,,4,13,14,27
24878,mooksas,,18,5,3,8
24879,democritus2,,1,69,106,175
24880,aerextraho,,19,346,540,886
24881,powerpants,,6,487,565,1052
24882,mortiferous,,20,1,3,4
24883,DigitAl56K,,8,1,3,4
24884,fawkinay,,1,7,8,15
24885,bradentucky941,,5,3,13,16
24886,0xDEADBEEF,,22,1,1,2
24887,Aarmed,,13,11,4,15
24888,melby901,,10,28,1,29
24889,SuperFrankie,,1,58,42,100
24890,johnmudd,,6,400,381,781
24891,sanders5x,,18,5,9,14
24892,mgsloan,,20,37,52,89
24893,rtfm,,19,3,1,4
24894,leph,,22,6,2,8
24895,ninja-wage-slave,,18,28,36,64
24896,pop345,,19,5,5,10
24897,josher565,,20,2,5,7
24898,sea_wall,,12,1260,6,1266
24899,ScurvyDawg,,42,6,13,19
24900,Porpus,,20,5,1,6
24901,pstnotpd,,20,4,2,6
24902,JennyCide,,20,2,3,5
24903,thabman,,18,34,37,71
24904,janxspirit,,19,2,7,9
24905,_pixie,,12,1,2,3
24906,oppenheimerschmidt,,23,1,1,2
24907,ihasreddit,,20,22,11,33
24908,mobiuszero,,19,1,4,5
24909,pfo,,20,6,2,8
24910,thecreativeblog,,19,60,33,93
24911,grillcover,,32,6,13,19
24912,NightNightly,,0,5,1,6
24913,xlacdn,,8,3,6,9
24914,DaBritishRCuming,,18,3,1,4
24915,toooooooobs,,20,136,142,278
24916,violettestar,,16,2,4,6
24917,comiksguy,,20,1,2,3
24918,ibetom,,32,4,2,6
24919,ibbyD,,36,2,1,3
24920,nm1000,,20,1,4,5
24921,pTymN,,20,125,144,269
24922,agnoster,,19,73,82,155
24923,tingrin87,,23,1,5,6
24924,jennybant,,34,1,1,2
24925,kuranda,,20,2,2,4
24926,tubelight,,15,20,4,24
24927,paul_harrison,,32,25,39,64
24928,10poundBrizown,,12,1,1,2
24929,grecka,,22,9,17,26
24930,acwegner,,22,88,6,94
24931,qualiarunner,,42,2,3,5
24932,sammyQc,,5,3,8,11
24933,agent_uno,,19,4,4,8
24934,elsaturnino,,34,29,39,68
24935,d0kd0k,,19,10,13,23
24936,samerh,,15,1,4,5
24937,plexi,,12,227,250,477
24938,zwily,,20,1,3,4
24939,bobiam,,43,4,24,28
24940,SidRoberts,,22,3,1,4
24941,CartilageHead,,22,9,15,24
24942,chechex,,0,6,4,10
24943,ShezFrando,,20,1,2,3
24944,DLX,,31,35,29,64
24945,lukins,,30,1,3,4
24946,jhvoodooss,,18,2,1,3
24947,TheLastFreeMan,,18,96,142,238
24948,jbsibley,,13,4,3,7
24949,Socialism,,13,59,78,137
24950,kavalier,,13,67,8,75
24951,phoenixtx,,0,1,1,2
24952,AnneDorte,,32,1,7,8
24953,blangopolis,,36,2,2,4
24954,reachamanda,,20,7,7,14
24955,baryon,,20,6,5,11
24956,AngryPurpleMushroom,,0,5,7,12
24957,intrinsicchaos,,13,61,13,74
24958,Angry_Activist,,19,22,2,24
24959,Tankdoc,,29,8,6,14
24960,intersection,,13,2,7,9
24961,misternuge,,18,303,140,443
24962,Suppafly,,13,4,10,14
24963,jlakely,,13,67,2,69
24964,puckthecat,,19,68,82,150
24965,bongole,,41,12,3,15
24966,Yukos,,18,4,6,10
24967,RossMasters,,20,18,43,61
24968,grasspo,,1,2,1,3
24969,McCourt,,30,191,241,432
24970,hitmonval_is_a_dick,,31,1,1,2
24971,diroussel,,20,5,13,18
24972,ewdurbin,,1,31,21,52
24973,theglassishalf,,31,61,52,113
24974,Captain_Obvius,,14,2,1,3
24975,your_momma,,40,5,2,7
24976,arcele,,32,3,14,17
24977,pansypatrol,,19,29,3,32
24978,SaysWho,,14,1,2,3
24979,blatant_user,,13,11,25,36
24980,lepton,,18,16,7,23
24981,arunvr,,20,20,21,41
24982,m30000,,22,48,20,68
24983,tatofoo,,20,3,3,6
24984,i_did_it,,43,3,3,6
24985,futuresenator83,,1,1,1,2
24986,kiranhk,,19,2,3,5
24987,Bellhsst,,4,8,16,24
24988,The_Milkman,,43,6,2,8
24989,richie_ny,,32,6,2,8
24990,rightontime13,,2,4,2,6
24991,bakstuh,,17,23,25,48
24992,flaregun,,13,5,1,6
24993,Jabronious,,35,1,1,2
24994,amit78,,22,4,5,9
24995,sblue7,,13,10,2,12
24996,cmotdibbler,,32,53,103,156
24997,flatland,,4,2,2,4
24998,Eatingdogs,,20,19,18,37
24999,teamyamahablue,,6,2,1,3
25000,techiesouls,,5,1,1,2
25001,lvovsky,,13,85,9,94
25002,maximuszen,,19,7,13,20
25003,Combat_Deity,,13,10,1,11
25004,swaroopb,,13,15,21,36
25005,what3v3r,,19,141,33,174
25006,weixiyen,,20,25,64,89
25007,phedre,,30,258,284,542
25008,Impact0115,,34,2,1,3
25009,dillikibilli,,16,436,383,819
25010,James,,20,29,19,48
25011,kinbote,,32,2,5,7
25012,jyewnidt,,30,1,2,3
25013,uwiger,,20,1,3,4
25014,fenderjazz,,14,1,1,2
25015,trenobus,,6,3,6,9
25016,braindrane,,13,810,2352,3162
25017,jgotts,,18,2,8,10
25018,cmaxim,,18,3,3,6
25019,GibZilla,,34,6,8,14
25020,barbosa,,13,31,54,85
25021,mrjast,,20,21,14,35
25022,ddavis101,,13,12,1,13
25023,Antidote,,18,133,167,300
25024,see0red,,32,273,525,798
25025,karmadillo,,1,1236,558,1794
25026,agent_langley,,18,66,1,67
25027,grandczar,,18,22,33,55
25028,ozh,,18,101,46,147
25029,opi,,0,59,75,134
25030,d0wnward_spiral,,13,1,1,2
25031,Lerc,,20,152,156,308
25032,steveyu85,,11,6,2,8
25033,runeh,,42,4,8,12
25034,lasthemy,,13,1,1,2
25035,gsg_,,20,7,10,17
25036,FedUpWithYouIdiots,,10,2,1,3
25037,mx_reddit,,20,12,16,28
25038,MondoHawkins,,0,8,11,19
25039,gregrittchen,,32,3,2,5
25040,alyx,,18,15,10,25
25041,smarmygit,,0,2,5,7
25042,pound,,20,1,1,2
25043,maverick777,,29,1,1,2
25044,Deadend,,32,26,2,28
25045,Robertrc,,43,1,1,2
25046,Interzone_sheriff,,1,17,22,39
25047,masgrada,,12,2,1,3
25048,Comkeen,,31,8,9,17
25049,insyte,,18,1,3,4
25050,uoykcuf,,18,9,9,18
25051,dambo29,,14,2,3,5
25052,phillydawg68,,20,50,72,122
25053,bg_,,32,44,31,75
25054,Battlefieldjack,,12,3,5,8
25055,mmmpld,,26,1,4,5
25056,perciva,,20,58,18,76
25057,buckyrower,,18,7,12,19
25058,EveW,,1,179,25,204
25059,pheel_more,,20,2,4,6
25060,dman636,,18,4,7,11
25061,Ilyanep,,0,29,30,59
25062,jrich013,,18,2,6,8
25063,rizkyw,,32,1,1,2
25064,frontdesk,,13,8,5,13
25065,timmy334,,32,16,30,46
25066,Officer_Hard-On,,10,1,1,2
25067,NickGe,,20,7,11,18
25068,karmakat,,30,5,12,17
25069,niwde,,20,25,28,53
25070,typesblkura,,20,1,4,5
25071,changewecanbelievein,,26,30,62,92
25072,ramunasg,,20,21,20,41
25073,WhammyBar,,19,23,27,50
25074,stone2020,,13,4,6,10
25075,simscitizen,,20,18,27,45
25076,fancytalk,,18,8,18,26
25077,cthulahoops,,20,3,2,5
25078,sarngiber,,43,5,4,9
25079,Grimoire,,20,9,8,17
25080,eshap,,34,13,19,32
25081,jheylin,,2,1,3,4
25082,chimaera102,,18,6,13,19
25083,hauer,,20,2,1,3
25084,arhuaco,,20,11,24,35
25085,andrewrocks,,1,14,17,31
25086,jtp8736,,31,12,14,26
25087,HoodCrowd,,13,20,15,35
25088,sclv,,20,123,154,277
25089,newyawkah,,13,1,2,3
25090,fernandofmarte,,13,4,4,8
25091,dustyd63,,18,9,12,21
25092,Chronicss,,31,117,125,242
25093,bstudio,,17,1,1,2
25094,NastyConde,,20,327,233,560
25095,sourc3,,31,1,1,2
25096,195531,,19,2,1,3
25097,fabian17,,1,116,83,199
25098,anonlawstudent,,19,91,44,135
25099,jagbot,,20,5,4,9
25100,blefescu,,19,33,42,75
25101,mexicangoat,,6,3,2,5
25102,xerus,,18,86,62,148
25103,Galted,,1,7,13,20
25104,cathcacr,,29,57,105,162
25105,realdoozy,,36,2,2,4
25106,akh,,20,3,5,8
25107,jesuswilkinson,,1,4,1,5
25108,WhatDidntDiddyDo,,22,48,43,91
25109,kopophex,,20,15,9,24
25110,sfoulkes,,13,8,5,13
25111,adamdavid85,,32,47,63,110
25112,jch24,,42,27,20,47
25113,chakalakasp,,41,1264,210,1474
25114,otherwhitemeat,,13,1,1,2
25115,russbus,,1,7,2,9
25116,pseudoesque,,1,3,5,8
25117,qazcde,,19,17,2,19
25118,ndoz,,19,6,1,7
25119,JavaLavaJoe,,13,2,5,7
25120,Fecal_Vision,,13,2,2,4
25121,krsjuan,,10,7,2,9
25122,moted,,18,38,30,68
25123,3L1T3,,18,53,54,107
25124,gtalias,,19,8,3,11
25125,shovelingtom,,22,42,96,138
25126,claye,,34,4,4,8
25127,wyomandi,,13,4,22,26
25128,PostHumanBibliophile,,4,3,3,6
25129,sniloc,,18,8,9,17
25130,Giblaz,,1,33,23,56
25131,superrcat,,13,31,11,42
25132,sheafification,,20,15,28,43
25133,lbruno,,20,50,145,195
25134,5r4r3r2r1r,,32,3,4,7
25135,sensate,,19,13,2,15
25136,roxxe,,1,106,101,207
25137,BambooToo,,19,13,16,29
25138,zzleeper,,20,61,112,173
25139,glueandglitter,,13,1,1,2
25140,Jakkers,,18,114,71,185
25141,niels_olson,,1,114,66,180
25142,chaze007,,5,1,5,6
25143,relic91,,32,1,1,2
25144,vayk,,19,4,2,6
25145,TetraCW,,3,2,4,6
25146,thesmartlife,,19,2,5,7
25147,lajaw,,3,1,2,3
25148,danielrhodes,,19,14,13,27
25149,allocate,,10,17,35,52
25150,_bram_,,1,5,9,14
25151,smalldu,,19,33,22,55
25152,sickr,,4,4,4,8
25153,bhamfree,,30,3,5,8
25154,depthomesec,,32,3,5,8
25155,laughattheleader,,13,170,240,410
25156,krisssy,,3,1,2,3
25157,latortuga,,20,85,118,203
25158,idclev,,13,3,3,6
25159,turbov21,,20,19,32,51
25160,andme,,32,1,3,4
25161,hampus,,1,2,3,5
25162,rationalmind,,19,2,1,3
25163,substr,,18,2,9,11
25164,infectoid,,15,7,15,22
25165,stii,,12,8,1,9
25166,SgtSausage,,31,400,562,962
25167,BingoJ,,20,10,9,19
25168,nick_danger,,31,2,2,4
25169,drigz,,20,89,113,202
25170,jjduke,,18,23,20,43
25171,jiznakefoo,,13,5,1,6
25172,garywang,,20,13,21,34
25173,tempest135,,31,5,8,13
25174,LiamHP,,29,1,1,2
25175,r0bw,,18,39,68,107
25176,dafrimp,,20,48,61,109
25177,jongaynor,,18,2,4,6
25178,TheMulletBurden,,18,513,150,663
25179,hatecoach,,1,6,6,12
25180,Snorelock,,21,2,1,3
25181,TheEnigma1313,,13,8,7,15
25182,solquin,,38,1,2,3
25183,arsehelmet,,11,2,4,6
25184,unsurmountable,,6,2,4,6
25185,SwedginWuHangDai,,13,3,1,4
25186,isalpha,,32,281,274,555
25187,turiya,,0,6,2,8
25188,HunterBriley,,14,1,2,3
25189,pipedings,,20,6,14,20
25190,semperviren75,,30,1,3,4
25191,CowWithBeef,,10,53,58,111
25192,oakland94618,,13,1,1,2
25193,fernandomaximus,,1,1,1,2
25194,bplud,,20,1,1,2
25195,redfirewolf,,13,16,19,35
25196,markco,,29,2,1,3
25197,knullare,,1,151,208,359
25198,c4sh,,1,13,22,35
25199,baloghblog,,3,24,2,26
25200,tiklik,,31,2,2,4
25201,skripture,,18,12,5,17
25202,scorpan,,6,9,21,30
25203,tooldvn,,0,3,7,10
25204,leafjumper,,35,45,12,57
25205,sahilamin,,18,57,65,122
25206,charmhaste,,14,4,2,6
25207,gauharjk,,13,2,1,3
25208,fluxdrip,,22,3,1,4
25209,postmodern,,20,2,8,10
25210,soupnatzi,,10,157,225,382
25211,TheWama,,6,205,285,490
25212,Rollic,,18,23,25,48
25213,evilmatt535,,42,1,2,3
25214,scrove,,18,1,7,8
25215,rexxar,,20,35,31,66
25216,Kfresh34,,19,5,9,14
25217,mrmworth,,32,7,5,12
25218,_tweaks,,1,15,21,36
25219,manageMyRights,,18,2,4,6
25220,Head,,13,41,18,59
25221,jaafit,,31,88,72,160
25222,mrallen86,,1,191,226,417
25223,CanPuck,,8,5,8,13
25224,scooby111,,31,77,72,149
25225,rezo,,0,2,5,7
25226,colione,,1,14,4,18
25227,glengyron,,31,1588,2255,3843
25228,spacepope,,20,42,43,85
25229,MichaelJN2008,,31,19,20,39
25230,wrighter,,19,89,91,180
25231,toomuchbtchn,,34,2,2,4
25232,angryvigilante,,10,32,52,84
25233,unchow,,36,447,571,1018
25234,binek86,,19,2,1,3
25235,abbot,,20,17,17,34
25236,ilushkin,,13,19,2,21
25237,safaci2000,,22,2,1,3
25238,pottery59,,19,7,11,18
25239,Apie,,22,2,2,4
25240,Peter_j_r,,31,4,1,5
25241,taikotiger,,11,168,228,396
25242,chillbeast,,1,11,16,27
25243,raevnos,,20,1,1,2
25244,jackthecoiner,,34,30,27,57
25245,bbrueggemeyer,,13,13,2,15
25246,reiichiroh,,22,2,1,3
25247,randomtask,,5,24,38,62
25248,tinshed,,1,1,2,3
25249,a_mused,,13,1,2,3
25250,BlunderTwins,,12,1,1,2
25251,vermontbobcat,,3,44,24,68
25252,Adman65,,20,171,262,433
25253,BenedictKenny,,43,14,39,53
25254,tpk5010,,18,2,9,11
25255,aureliano_babilonia,,0,22,40,62
25256,crystalmethbreakfast,,31,9,12,21
25257,edknaves,,13,2,11,13
25258,stfu_ymf,,13,1,1,2
25259,daniga,,26,3,1,4
25260,Inquisitr,,32,2,1,3
25261,tomsdiggname,,29,1,3,4
25262,maryelen,,19,2,3,5
25263,w3weasel,,19,193,284,477
25264,whit98c,,18,8,18,26
25265,mbatterham,,30,1,1,2
25266,blaablaa,,20,8,3,11
25267,antihero,,18,5,11,16
25268,moongorf,,18,47,2,49
25269,INTPLibrarian,,13,259,207,466
25270,miikE,,13,14,60,74
25271,dnifdoog,,18,56,51,107
25272,arseiam,,33,11,20,31
25273,xaos11,,1,10,28,38
25274,ij00mini,,22,11,17,28
25275,HaMMeReD,,20,337,529,866
25276,brienf,,6,1,2,3
25277,mookeddit,,18,78,65,143
25278,lambofdog,,19,10,16,26
25279,Sanctimonious,,13,83,96,179
25280,C4RLO5,,10,2,1,3
25281,gaviaimmer,,18,2,4,6
25282,soundacious,,32,161,214,375
25283,lbft,,22,174,188,362
25284,mattiasl,,20,31,35,66
25285,tenfive,,19,5,2,7
25286,niksko,,34,5,9,14
25287,shmaelius,,14,1,1,2
25288,Yasas,,19,1,1,2
25289,travelingman74,,43,68,2,70
25290,lijamez,,20,3,8,11
25291,MrThunderRolls,,1,1,7,8
25292,lovestosploodge,,32,1,1,2
25293,johnskiddles,,18,9,2,11
25294,linchiwo,,29,2,3,5
25295,flwombat,,13,2,3,5
25296,manvsbear,,31,154,229,383
25297,photosahni,,18,77,1,78
25298,ignatious,,13,6,5,11
25299,wicked,,20,237,303,540
25300,mikey2600,,19,38,66,104
25301,QuestionBoy,,32,3,1,4
25302,JustDroppingBy,,19,102,129,231
25303,dabdiputs,,19,12,13,25
25304,EndTimer,,13,18,23,41
25305,peterwemm,,1,1,1,2
25306,isitmoi,,18,106,20,126
25307,CognitiveAssonance,,19,4,6,10
25308,Joe_Clark,,18,13,15,28
25309,zvikara,,20,224,138,362
25310,bluess,,1,14,16,30
25311,Nekrahm,,29,1,1,2
25312,jasonhaley,,30,13,11,24
25313,zith,,13,3,4,7
25314,ileftreddit,,43,16,32,48
25315,Hatred,,31,4,5,9
25316,derekaw,,18,30,64,94
25317,BaronBic,,19,69,121,190
25318,jblifestyles,,19,2,6,8
25319,adamhayek,,20,2,3,5
25320,dbhaley,,22,43,44,87
25321,ralphiebacch,,13,7,17,24
25322,iamonadiet,,22,2,1,3
25323,DeafScribe,,19,3,3,6
25324,happycustomer,,43,5,9,14
25325,Ekipstonmai,,1,12,8,20
25326,vadikunc,,16,2,1,3
25327,trumpcard,,0,1,3,4
25328,ElephantRider,,42,142,251,393
25329,czarj,,35,2,2,4
25330,worldestroyer,,22,3,3,6
25331,squiddyphotog,,7,1,1,2
25332,Facepuncher,,42,742,392,1134
25333,Oolong111,,42,1,2,3
25334,13billy,,3,9,8,17
25335,elwood731,,22,112,6,118
25336,cro_mag_non,,31,28,48,76
25337,perrygeo,,20,45,34,79
25338,d2kd3k,,19,393,69,462
25339,bearncze,,18,3,11,14
25340,RST100,,29,1,2,3
25341,ndmitchell,,20,9,19,28
25342,LeBrad,,1,23,19,42
25343,mlambir,,20,1,8,9
25344,gordito,,5,1,2,3
25345,morrisom,,33,5,6,11
25346,nellonoma,,18,5,4,9
25347,hsim3,,0,7,7,14
25348,fatcobra7,,31,9,12,21
25349,hifigi,,43,16,30,46
25350,randombit,,20,20,12,32
25351,wellington_grey,,1,15,4,19
25352,btnheazy03,,18,68,148,216
25353,qazqaz7k,,1,42,57,99
25354,floydianslip,,27,1,2,3
25355,kenij,,22,19,25,44
25356,vasyl83,,18,5,14,19
25357,mrkipling,,22,194,193,387
25358,infinityis,,43,13,15,28
25359,FotoMatt,,17,1,4,5
25360,didntyouhear,,22,2,1,3
25361,jmzook,,19,13,23,36
25362,HYPEractive,,19,58,95,153
25363,dfa,,32,32,48,80
25364,Marsharks,,13,3,8,11
25365,nooffense,,19,2,2,4
25366,mornel,,12,55,57,112
25367,Marlzzz,,19,96,45,141
25368,TimStewart,,20,2,4,6
25369,Jaland,,1,4,3,7
25370,linuxpunk81,,22,64,65,129
25371,jjme,,32,235,187,422
25372,PrincessCake,,31,339,363,702
25373,gibb,,32,1,2,3
25374,haak,,43,1,2,3
25375,pwkk,,1,7,17,24
25376,escher2008,,20,6,4,10
25377,kristakahashi,,19,23,44,67
25378,hash_oil,,12,57,73,130
25379,teff,,17,3,6,9
25380,shadyrudy,,29,12,18,30
25381,Astroboy14,,1,1,5,6
25382,irate314rate,,1,111,45,156
25383,NinetiesGuy,,13,9,5,14
25384,JUDGE_DREDD,,19,7,8,15
25385,pot_o_gold,,19,77,74,151
25386,commandos,,17,2,2,4
25387,otisnixon,,43,44,68,112
25388,neilc,,20,18,31,49
25389,kerosenehalo,,43,3,4,7
25390,fusama,,13,22,6,28
25391,Johny_Cash,,19,523,601,1124
25392,ellisr29,,34,26,18,44
25393,Wolfbagger,,23,5,13,18
25394,Antisthenes,,19,3,2,5
25395,jimmulligan,,13,1,1,2
25396,Tonb,,32,13,9,22
25397,captain_abstinence,,31,37,18,55
25398,keit_shifter,,20,4,1,5
25399,peepsalot,,5,219,297,516
25400,sammyf,,1,4,6,10
25401,tom101,,20,62,74,136
25402,truenorth,,7,3,15,18
25403,richjm,,19,63,2,65
25404,scribbles,,18,91,123,214
25405,merper,,1,469,596,1065
25406,lofi76,,19,289,366,655
25407,blacktarjeta,,20,1,2,3
25408,kingofarts,,18,10,13,23
25409,ActionAuto,,18,29,23,52
25410,lugfish,,20,188,82,270
25411,thomble,,18,20,22,42
25412,LostFloyd,,32,1,3,4
25413,pixelgrunt,,31,4,8,12
25414,ImAReasonableMan,,13,13,13,26
25415,milo3600,,22,73,66,139
25416,mattyrules,,18,590,48,638
25417,Hengist,,6,14,9,23
25418,AprilEthereal,,19,29,6,35
25419,Cajun,,32,62,82,144
25420,Baconfat,,30,3,9,12
25421,danbillings,,4,13,18,31
25422,thehypnotoad,,29,3,3,6
25423,saoretone,,20,6,2,8
25424,crimeariver,,4,52,95,147
25425,micahfk,,34,1,1,2
25426,loz618,,4,11,27,38
25427,SilverEagle,,19,4,9,13
25428,spartag00se,,1,26,30,56
25429,sparkytime,,38,175,10,185
25430,Dashd,,31,84,91,175
25431,DSchmitt,,13,10,13,23
25432,c-ray,,30,18,20,38
25433,chaosrabbit,,42,1,4,5
25434,ObamaamaMMuslim,,19,67,52,119
25435,djkaos,,36,1,1,2
25436,socket0,,32,57,9,66
25437,jordanonorth,,30,41,93,134
25438,port,,18,2,2,4
25439,pragmatist,,20,1,2,3
25440,jimmcjim,,31,2,1,3
25441,lindgree,,13,30,12,42
25442,vozzer,,20,17,4,21
25443,catlebrity,,32,776,1022,1798
25444,Aiwanei,,13,4,10,14
25445,q-_-b,,22,4,2,6
25446,creator100,,18,251,3,254
25447,endperform,,1,10,20,30
25448,subnubus,,0,7,4,11
25449,lyrae,,20,18,2,20
25450,stupidfpp,,31,7,5,12
25451,asciident,,21,2,4,6
25452,bogdon6,,19,17,14,31
25453,Vomit_Sandwich,,13,253,299,552
25454,whiteligthing,,18,3,3,6
25455,clicky,,31,9,16,25
25456,birkenfeld,,20,2,1,3
25457,kakboy,,20,2,2,4
25458,i_h8_r3dd1t_5,,19,2,1,3
25459,kbk,,20,3,10,13
25460,nomdeplume123,,13,13,33,46
25461,AmericaLover,,17,2,3,5
25462,Ardentfrost,,18,32,51,83
25463,uxjackson,,18,30,73,103
25464,chinachina,,42,3,1,4
25465,interbeing,,6,3,5,8
25466,cod68,,39,2,2,4
25467,omgpro,,10,13,14,27
25468,iwasdj,,0,2,2,4
25469,suomipoika,,20,2,2,4
25470,dokumentamarble,,22,99,101,200
25471,kahotep,,13,3,2,5
25472,toconnor,,13,5,4,9
25473,IndeXinn,,5,5,3,8
25474,xkillx,,1,111,78,189
25475,rpd9803,,14,7,12,19
25476,cassman,,13,4,4,8
25477,zvarnell,,31,2,2,4
25478,teessidedazza,,6,5,5,10
25479,ratbastid,,22,10,6,16
25480,impious,,22,2,1,3
25481,anomalous,,32,19,17,36
25482,trollingisfun,,29,4,8,12
25483,fuzzna,,5,1,9,10
25484,utore,,18,81,50,131
25485,jhl,,43,3,6,9
25486,saratogacv60,,31,1,1,2
25487,celastrus,,19,21,31,52
25488,frane,,42,1,1,2
25489,karmos,,11,1,3,4
25490,Chillee,,27,6,26,32
25491,ebzlo,,1,27,37,64
25492,v13,,19,1,12,13
25493,afscott,,42,44,7,51
25494,jonessodaholic,,9,4,1,5
25495,pete_m,,18,126,139,265
25496,chreekat,,20,9,8,17
25497,St_Anky,,18,82,177,259
25498,ergotine,,1,1,2,3
25499,corradoslc,,1,1,2,3
25500,LExaLu,,3,1,1,2
25501,vader101,,18,9,13,22
25502,miklernout,,20,7,1,8
25503,zippy,,32,1,2,3
25504,mcamaj,,13,11,12,23
25505,DustinR,,18,10,8,18
25506,matthew,,1,19,9,28
25507,monkeyman1140,,19,29,66,95
25508,dm3,,43,1,1,2
25509,temjrpgh,,29,151,275,426
25510,modderphucker,,18,5,7,12
25511,nuncanada,,20,12,11,23
25512,shaolinpunks,,32,3,8,11
25513,Randall_Flagg,,19,3,3,6
25514,initforthewaffles,,1,16,13,29
25515,bripod,,31,2,6,8
25516,Jay180,,31,4,4,8
25517,purplenat,,18,2,3,5
25518,shermange,,20,6,3,9
25519,sudentas,,0,2,1,3
25520,lordlawler,,18,2,7,9
25521,chiliu78,,32,1,2,3
25522,zuloon,,18,36,47,83
25523,DontRapeMeInTehButt,,4,3,4,7
25524,tendrils666,,41,3,4,7
25525,gwern,,20,364,630,994
25526,eduffy,,19,78,63,141
25527,Troopr420,,19,3,1,4
25528,jp2,,13,174,31,205
25529,wildleaf,,13,5,10,15
25530,chungmaster,,1,3,1,4
25531,busfahrer,,18,152,217,369
25532,superboyblue,,13,18,23,41
25533,bajsejohannes,,20,70,96,166
25534,Sadie,,0,293,8,301
25535,rj7jr37,,19,1,1,2
25536,pitchblende,,19,2,5,7
25537,badfish401,,13,23,12,35
25538,Owlie,,43,9,6,15
25539,thr3ddy,,20,2,1,3
25540,heybro,,13,15,17,32
25541,vice69,,39,1,2,3
25542,mdfcdr,,8,3,1,4
25543,svinoski,,20,1,2,3
25544,ctshaf02,,18,32,48,80
25545,DeathByDiagnosis,,30,21,33,54
25546,erfi,,1,70,68,138
25547,dinggus,,34,10,18,28
25548,thekenzidelx,,20,4,4,8
25549,aeon2012,,18,606,895,1501
25550,danbot,,18,11,17,28
25551,Captain_Irrelevant,,43,1,1,2
25552,scsibug,,20,2,3,5
25553,veskpk,,19,3,1,4
25554,fairtrialforw,,0,155,134,289
25555,wensing,,19,1,3,4
25556,pwiedel,,13,24,8,32
25557,ufris,,8,16,20,36
25558,138,,22,185,238,423
25559,gloom,,19,2,4,6
25560,kylejennings,,13,9,8,17
25561,amigo7,,19,8,6,14
25562,OniKudaki,,1,8,18,26
25563,jayhawk2008,,0,1,1,2
25564,Popper252,,1,31,30,61
25565,helly1223,,13,2,3,5
25566,k_vladimirov,,18,17,42,59
25567,microfish,,5,1,2,3
25568,YUL89YYZ,,18,2,2,4
25569,SnrBlkCorrespondent,,38,1,2,3
25570,outsider,,31,254,394,648
25571,editor3638,,5,1,1,2
25572,chestyle,,43,10,2,12
25573,defireman,,2,2,4,6
25574,EmpiresCrumble,,13,419,504,923
25575,jtsod73,,5,3,1,4
25576,yesimahuman,,20,91,109,200
25577,letsbelogical,,31,2,2,4
25578,realgenius,,13,34,18,52
25579,tds70,,31,26,22,48
25580,ilikesteak,,18,1,2,3
25581,wonglik,,29,134,79,213
25582,Earsucker,,0,5,1,6
25583,BobHHowell,,13,16,37,53
25584,cLFlaVA,,7,1054,507,1561
25585,moskie,,19,201,165,366
25586,wbdowns,,18,1,1,2
25587,jempina,,5,8,2,10
25588,SpikeSpiegal22,,9,3,4,7
25589,Dr_Mic,,13,7,13,20
25590,boryas,,31,20,25,45
25591,tamoneya,,20,60,14,74
25592,myrtlebeachbums,,10,2,2,4
25593,gjcarew,,32,2,1,3
25594,imagenda,,20,6,8,14
25595,FlyingAvatar,,20,17,21,38
25596,greendigit,,19,61,32,93
25597,MambooMama,,0,17,10,27
25598,mercurialohearn,,32,324,677,1001
25599,lance_,,30,29,24,53
25600,mightycontest,,22,84,25,109
25601,IMSargon,,19,1,1,2
25602,jscimeca715,,42,11,10,21
25603,go-ahead-downvote,,31,199,359,558
25604,sam19435,,13,6,2,8
25605,topherdavis,,18,220,27,247
25606,deller85,,13,21,7,28
25607,mitcharoni,,17,27,32,59
25608,yallizfunny,,22,1,1,2
25609,artvark,,19,8,28,36
25610,johnlunney,,20,1,1,2
25611,randomjackass,,20,13,30,43
25612,bill_tampa,,30,1,6,7
25613,whiteskwirl2,,13,158,196,354
25614,cludwin,,20,8,8,16
25615,Crockadile,,12,1,1,2
25616,tomatopaste,,18,142,224,366
25617,riorage,,1,1,4,5
25618,testudo2002,,12,4,8,12
25619,kremonte,,22,6,12,18
25620,benzu,,8,1,2,3
25621,ghazwozza,,13,5,16,21
25622,soomprimal,,18,8,20,28
25623,20081115,,1,24,3,27
25624,cc22022cc,,26,3,3,6
25625,Ado42,,28,1,1,2
25626,monkeygod,,0,1,2,3
25627,obchase,,18,13,17,30
25628,bottomquark,,43,6,4,10
25629,adm1,,20,6,2,8
25630,duffy100,,20,1,1,2
25631,kbennett73,,5,15,11,26
25632,TruthinessHurts,,13,300,363,663
25633,tinker123,,43,2,6,8
25634,-scout-,,18,15,7,22
25635,hollyblue,,19,3,9,12
25636,sysstemlord,,42,18,21,39
25637,NothingIsReal74,,13,80,241,321
25638,jhdwg,,20,7,3,10
25639,yogachef,,34,7,8,15
25640,coronai1,,25,1,1,2
25641,ahl0003,,4,4,2,6
25642,kalmar,,20,4,3,7
25643,vodkafuel,,32,11,16,27
25644,devisional,,19,75,90,165
25645,mandel_macaque,,20,6,13,19
25646,jppuerta,,19,1,6,7
25647,rexsilex,,20,1,1,2
25648,kenliu,,28,1,2,3
25649,Ognian,,15,14,32,46
25650,bennybuckethead,,1,4,5,9
25651,darknut,,17,7,2,9
25652,HillaryClintonFan,,19,81,28,109
25653,CaptainNSFW,,22,6,4,10
25654,benedict101,,30,2,1,3
25655,lizardqueen,,6,1,1,2
25656,AnotherCanadian,,19,4,7,11
25657,So1618e,,18,8,6,14
25658,khperkins,,29,48,22,70
25659,cryptonium,,34,130,18,148
25660,Buzzard,,20,10,18,28
25661,matlesiouxx,,28,2,2,4
25662,robertgentel,,18,9,5,14
25663,secretdark,,35,12,26,38
25664,FrancoisTremblay,,29,2,3,5
25665,rotatedline,,36,2,3,5
25666,downen,,8,10,6,16
25667,rredit,,19,1,2,3
25668,hawaii,,18,2,1,3
25669,imdwalrus,,32,5,4,9
25670,aheno,,20,12,7,19
25671,Cbeck527,,12,5,4,9
25672,teh_Rabbit,,31,33,69,102
25673,wonkifier,,32,465,744,1209
25674,FataL,,20,15,5,20
25675,sergiomenezes,,31,5,3,8
25676,pestario,,38,203,44,247
25677,tendimensions,,32,66,100,166
25678,zorak8me,,43,107,71,178
25679,thekrone,,16,760,1089,1849
25680,MissCarlaPauline,,19,33,73,106
25681,mumblemumble,,42,2,1,3
25682,tvu,,18,30,63,93
25683,superpowers,,19,2,2,4
25684,gregK,,20,514,670,1184
25685,Kthulu,,18,4,13,17
25686,dash101,,19,409,363,772
25687,carllerche,,20,13,1,14
25688,metapede,,34,1,5,6
25689,Antiuniverse,,12,176,106,282
25690,john_butts,,20,28,13,41
25691,ElanVital,,32,1,7,8
25692,afschmidt,,32,6,18,24
25693,kspec1212,,13,22,1,23
25694,t35t0r,,43,142,165,307
25695,crypticfortune,,35,96,113,209
25696,dotnet4ever,,20,1,6,7
25697,gronx,,32,1,3,4
25698,andrewcatton,,31,1,1,2
25699,goldcup,,7,1,2,3
25700,HolmesSPH,,42,20,16,36
25701,mak12,,5,106,79,185
25702,bwkeller,,22,1,1,2
25703,anonymvs,,13,2,3,5
25704,anthonyhong,,1,3,3,6
25705,countonlosing,,1,12,2,14
25706,llamakoolaid,,18,28,82,110
25707,erasedeny,,18,183,110,293
25708,jasdonle,,12,54,80,134
25709,datn,,34,4,6,10
25710,viscerathighs,,13,2,1,3
25711,gld13,,29,3,5,8
25712,jacada885,,1,2,2,4
25713,stevePallmer,,20,12,7,19
25714,mingdamirthless,,19,115,172,287
25715,mikevalstar,,8,4,9,13
25716,argongas2006,,20,99,73,172
25717,snoopfrog,,19,1,4,5
25718,greim,,32,126,111,237
25719,hazilla,,1,26,8,34
25720,mestguy182,,18,9,5,14
25721,jenred,,14,1,1,2
25722,pizzatime,,1,992,683,1675
25723,allak,,43,2,9,11
25724,dufff,,27,1,2,3
25725,redditers_untie,,0,10,28,38
25726,tristan211,,13,3,5,8
25727,prototype_,,31,2,1,3
25728,Russkie177,,34,12,27,39
25729,diclemad,,13,20,23,43
25730,fap3,,20,2,1,3
25731,kisscool321,,13,1,1,2
25732,cpthw,,1,1,1,2
25733,peterdangit,,22,3,1,4
25734,dean_shan,,20,2,2,4
25735,goober537,,34,2,1,3
25736,alkamist,,19,1,2,3
25737,aoeufx,,18,6,2,8
25738,safeness,,18,44,56,100
25739,mrigor,,32,90,12,102
25740,Raphae1,,13,9,7,16
25741,hopefulsane,,18,2,4,6
25742,orbat,,13,1,1,2
25743,tcervl,,41,1,1,2
25744,grrtt_green,,19,1,1,2
25745,Hippi3,,11,1,3,4
25746,cyberianpan,,32,6,2,8
25747,_______,,19,10,16,26
25748,jedi_aka,,13,123,69,192
25749,jonnyvice,,19,7,23,30
25750,coyasun,,18,19,6,25
25751,wowmir,,42,1,8,9
25752,datagrok,,20,5,8,13
25753,telemachuszero,,20,2,4,6
25754,Reverberant,,9,50,40,90
25755,ben51959,,12,1,2,3
25756,ilcylic,,20,4,2,6
25757,Mask_of_Destiny,,20,44,52,96
25758,mprovost,,20,17,6,23
25759,goerz,,18,15,10,25
25760,qopqo7,,0,1,2,3
25761,hashishi,,32,19,25,44
25762,Subacious,,31,258,252,510
25763,cohbra,,32,1,1,2
25764,BenjaminBunny,,19,39,69,108
25765,SlowOnTheUptake,,8,4,6,10
25766,annon2001,,19,27,2,29
25767,wowrob,,19,16,30,46
25768,peeryeri,,1,8,4,12
25769,modernhero,,18,8,9,17
25770,NJerseyGuy,,22,2,2,4
25771,Mantorok,,4,2,3,5
25772,Subway,,5,113,198,311
25773,jeremygin,,42,4,1,5
25774,Sysiphuslove,,13,85,118,203
25775,BeanTownKid,,19,82,89,171
25776,Jimmerz,,18,1,2,3
25777,freakon,,18,2,1,3
25778,bug_mama_G,,1,229,158,387
25779,SoHereIAm,,32,2,2,4
25780,tsuyoshi,,34,3,3,6
25781,TerrorByte,,30,1,1,2
25782,paddy_m,,20,4,8,12
25783,discuit,,20,2,1,3
25784,Sardonapalus,,43,51,36,87
25785,MobyDobie,,20,27,15,42
25786,grilled_ch33z,,6,264,292,556
25787,mascarenhas,,20,21,16,37
25788,koanman,,1,2,13,15
25789,eeePPP,,18,1,8,9
25790,rootbitch,,18,4,3,7
25791,Democrat08,,13,82,67,149
25792,ghettobob,,13,46,14,60
25793,MUSTBEBOBBY,,6,1,1,2
25794,kremfjes,,1,39,34,73
25795,abrahamsen,,20,401,532,933
25796,Doozer,,20,40,62,102
25797,Gorthal,,12,1,1,2
25798,lucasvb,,32,18,3,21
25799,jchrismac,,31,1,2,3
25800,Jade456,,19,1,1,2
25801,Phreno,,12,9,19,28
25802,ChingChangCharlie,,14,128,220,348
25803,borocks,,29,1,1,2
25804,bloops,,36,2,1,3
25805,Kisil,,34,26,35,61
25806,RussellSprout,,43,6,2,8
25807,gamezor,,42,38,15,53
25808,pressuretobear,,34,36,43,79
25809,Mop,,20,4,7,11
25810,Truthbot,,0,12,30,42
25811,Yohnstoppable,,42,196,292,488
25812,johnHF,,6,5,3,8
25813,poetspirit,,13,4,1,5
25814,tubbycow,,22,4,3,7
25815,TheRedditPolice,,36,1,1,2
25816,seaseme,,18,52,69,121
25817,musturbatingmonkey,,4,1,1,2
25818,vidude,,19,124,197,321
25819,daehrednud,,12,3,3,6
25820,jdeeth,,0,6,40,46
25821,zimzallabim,,42,1,2,3
25822,osirisx11,,20,225,276,501
25823,Happy_Man,,31,13,18,31
25824,Davezter,,13,2,3,5
25825,illu45,,1,32,65,97
25826,new_zealander,,19,1,1,2
25827,somekindofride,,1,33,60,93
25828,PoopDoctor,,22,1,1,2
25829,schm00,,19,31,12,43
25830,david_bv,,1,11,3,14
25831,wabut,,42,1,1,2
25832,dramamoose,,18,51,48,99
25833,ansible,,20,140,152,292
25834,tinkerbellcottontoes,,13,1,3,4
25835,artofstarving,,19,33,70,103
25836,zef,,30,2,3,5
25837,tranceboy81,,13,15,3,18
25838,nbblk33,,39,7,9,16
25839,mugshoot,,19,50,6,56
25840,non-sequitur,,13,1,4,5
25841,pjohns24,,42,70,61,131
25842,erikbryan,,36,1,4,5
25843,DamnLogins,,43,6,1,7
25844,stephy_buttons,,18,175,256,431
25845,rabidgnat,,20,58,52,110
25846,GhostCow,,3,1,1,2
25847,rickyisawesome,,10,1,1,2
25848,Temporary00111,,18,3,1,4
25849,rsynnott,,20,11,15,26
25850,muskymaxmax,,22,13,8,21
25851,Harrygldfarb,,9,41,48,89
25852,breeLimeGreen,,25,1,3,4
25853,savedetroit,,13,6,1,7
25854,wanted_nz,,18,7,9,16
25855,james428,,20,4,1,5
25856,lameth,,13,194,346,540
25857,Michelle-Hayes,,1,2,1,3
25858,saconnel,,42,174,20,194
25859,slumslum,,18,60,4,64
25860,nicoletta123,,8,5,2,7
25861,alinpopa,,20,1,1,2
25862,melanthius,,18,48,110,158
25863,iheartbeer,,32,131,157,288
25864,omik,,22,1,1,2
25865,soyjaguar,,13,4,7,11
25866,TruthOasis,,0,31,25,56
25867,Acrinimiril,,6,2,1,3
25868,Riovanes,,42,77,107,184
25869,Loverman,,32,1,1,2
25870,kr1sp,,13,11,6,17
25871,sheeves,,13,17,25,42
25872,ubuntuguy,,20,164,128,292
25873,woodieuk,,18,4,4,8
25874,cbower01,,18,2,1,3
25875,FURBjr,,20,1,1,2
25876,slydee,,14,170,188,358
25877,dmcorp,,5,1,1,2
25878,jeremysiron,,8,2,1,3
25879,akbars,,18,1,1,2
25880,intercityfirm,,18,1,1,2
25881,themagikarp,,35,5,2,7
25882,pws1970,,5,4,4,8
25883,backelie,,20,43,67,110
25884,flox232,,18,41,39,80
25885,thefngoon,,13,28,5,33
25886,blindeye0,,22,61,62,123
25887,ProspectorJoe,,43,3,3,6
25888,ryanmickle,,34,1,5,6
25889,passwordispassword3,,13,4,2,6
25890,mrzubi,,1,79,53,132
25891,monsterflake,,43,3,2,5
25892,pzang,,31,7,16,23
25893,drdewm,,31,156,282,438
25894,bairy,,11,19,17,36
25895,Tsalagi,,21,2,9,11
25896,hwestbrook,,14,2,2,4
25897,andyxyxy,,13,25,59,84
25898,carrotderek,,18,20,23,43
25899,schwickies,,18,3,7,10
25900,glockops,,42,10,5,15
25901,fcplm,,18,1,6,7
25902,frolib,,32,104,142,246
25903,riggsninja,,18,2,3,5
25904,funkpucker,,14,307,493,800
25905,Detry,,13,161,85,246
25906,RoryQ,,22,122,134,256
25907,xenya,,34,212,300,512
25908,blossom14,,17,5,5,10
25909,Basse82,,13,4,3,7
25910,dsokol,,20,26,49,75
25911,jamie939,,19,48,11,59
25912,AlterNate,,6,14,17,31
25913,the_deprecaterer,,14,3,5,8
25914,cheezebubba,,20,2,1,3
25915,chazburgr,,32,9,8,17
25916,mikepence,,0,10,6,16
25917,MichaelScott,,12,2,1,3
25918,2stupid,,31,23,62,85
25919,KaCzach,,13,7,2,9
25920,chungfuduck,,20,22,36,58
25921,likeahurricane,,29,34,34,68
25922,imediabox,,19,4,3,7
25923,threeseed,,4,9,6,15
25924,warmfuzzykitten,,13,163,362,525
25925,chrishuch,,18,11,5,16
25926,rainmannn,,20,1,1,2
25927,netgeek06,,5,162,15,177
25928,catcher6250,,31,7,17,24
25929,EarPlugs,,19,2,1,3
25930,risomt,,20,5,3,8
25931,madwormer2,,18,8,16,24
25932,lojomofo,,43,32,58,90
25933,lushootseed,,4,7,10,17
25934,dorait,,20,6,6,12
25935,wejash,,9,550,1506,2056
25936,clickcookplay,,0,94,167,261
25937,uddincomm,,13,19,9,28
25938,swtsuthrngurl,,13,2,4,6
25939,zphobic,,19,58,88,146
25940,whatsrequired,,5,27,17,44
25941,sheridbm,,42,18,28,46
25942,CannedResponse,,31,22,35,57
25943,Tynado,,13,9,26,35
25944,ubermonkey,,1,5,6,11
25945,mer-mer-mer-mer-mer,,1,36,50,86
25946,bryan_wheelock,,31,28,36,64
25947,seaniep,,17,1,1,2
25948,askthetrainer,,13,103,13,116
25949,eipipuz,,20,72,82,154
25950,mavrevMatt,,5,2,6,8
25951,anddisaid,,1,36,29,65
25952,demoss,,20,5,9,14
25953,ungage,,1,5,11,16
25954,ladon86,,4,18,31,49
25955,avantol,,1,1,3,4
25956,slayersa,,18,16,25,41
25957,trenchfever,,41,713,988,1701
25958,floatnsink,,10,83,146,229
25959,andrew311,,20,5,3,8
25960,joe90210,,20,281,292,573
25961,bernardi,,19,6,2,8
25962,kzeon,,18,17,10,27
25963,wileyc,,39,1,1,2
25964,circular230,,19,169,180,349
25965,mediapl0y,,32,69,127,196
25966,jansuza,,1,43,85,128
25967,mrcriminy,,4,1,1,2
25968,ccamp,,42,4,6,10
25969,Eratosthenes,,32,25,45,70
25970,testermctest,,13,2,1,3
25971,rob411,,35,3,1,4
25972,ShiftSurfer,,13,73,116,189
25973,obeseeurotrash,,13,13,14,27
25974,pjdoland,,19,14,15,29
25975,metaman,,6,5,8,13
25976,opus13i,,11,5,8,13
25977,gmcg,,19,275,368,643
25978,bloodqc,,42,30,43,73
25979,alexjc,,20,12,13,25
25980,johsgrd,,7,1,1,2
25981,knifebucket,,13,81,230,311
25982,theprince,,19,8,14,22
25983,dhertz666,,33,1,2,3
25984,kral2,,20,27,23,50
25985,pazz,,18,1,4,5
25986,JacobHey,,13,286,18,304
25987,paraedolia,,13,347,488,835
25988,karl_hungus,,30,7,9,16
25989,dontyoutellme,,4,1,1,2
25990,quetzalwing,,32,116,158,274
25991,gematt,,19,56,73,129
25992,modawg,,5,5,8,13
25993,monsieurk,,5,1,1,2
25994,iordi,,22,7,9,16
25995,jonp,,0,41,2,43
25996,blipblop123,,35,4,1,5
25997,individualathome,,5,69,22,91
25998,zzbigalzz,,0,4,18,22
25999,smhinsey,,20,61,101,162
26000,bennig,,32,428,505,933
26001,SquirrelOnFire,,13,308,166,474
26002,0wnagetime,,1,76,131,207
26003,davidevosti,,32,1,2,3
26004,stocksy,,22,130,167,297
26005,akshayr,,19,60,45,105
26006,mccain2016,,20,1,1,2
26007,Kavika,,18,36,75,111
26008,DevilPliers,,1,9,20,29
26009,dazzlindonna,,5,2,5,7
26010,sensi313,,32,1,1,2
26011,chicklets,,18,2,1,3
26012,adam-nude,,22,5,9,14
26013,TheChicEcologist,,3,3,3,6
26014,nrbartman,,13,923,872,1795
26015,God-the-Almighty,,22,3,4,7
26016,brojangles,,13,5,5,10
26017,samandiriel,,20,2,2,4
26018,trickmil,,32,1,2,3
26019,rlleung,,29,3,3,6
26020,pkuriakose,,20,6,7,13
26021,Zefend,,39,3,3,6
26022,puppyman10,,18,6,10,16
26023,NothingbutRage,,41,5,1,6
26024,meatbites,,20,3,6,9
26025,woodlandsfonz,,13,58,5,63
26026,zedlander,,42,11,10,21
26027,zephyrfalcon,,20,6,5,11
26028,kopkaas2000,,20,44,54,98
26029,Patriciefan,,18,62,25,87
26030,s0ckpuppet,,13,111,212,323
26031,chal88,,31,1,3,4
26032,cfis,,31,2,1,3
26033,mckatze,,1,27,22,49
26034,bluerat,,42,3,4,7
26035,rabidgoldfish,,4,221,419,640
26036,raycosm,,43,4,4,8
26037,zornfett,,20,1,1,2
26038,MachFour,,19,1,3,4
26039,GayMeansHappy,,20,1,2,3
26040,jmunsin,,20,2,1,3
26041,FirstDivision,,19,1,7,8
26042,uc0qremp,,20,43,84,127
26043,Prodon,,18,9,4,13
26044,NENEUNMSM,,18,1,2,3
26045,WigginLSU,,18,5,15,20
26046,luckyvanessa,,18,10,24,34
26047,olbeefy,,43,9,8,17
26048,Huuuuuuuge_Asshole,,19,58,84,142
26049,spiralbinder,,43,2,8,10
26050,yappery,,34,5,1,6
26051,bingaman,,13,43,60,103
26052,chris_71767,,13,1,1,2
26053,Gully_Foyle,,18,12,9,21
26054,Albatron,,12,18,24,42
26055,MrDobalina,,0,168,5,173
26056,bigt,,19,84,52,136
26057,greatblackowl,,13,4,7,11
26058,Hortong,,19,37,69,106
26059,awergfawe,,18,84,84,168
26060,Ma8e,,20,98,161,259
26061,broadbeacher,,34,7,3,10
26062,plasmaflux,,1,4,6,10
26063,me_spiek,,1,1,2,3
26064,jdlshore,,20,8,9,17
26065,grumpy3039,,20,41,3,44
26066,burtonboarder,,5,6,3,9
26067,toastednut,,1,1,1,2
26068,cuppajoe,,12,142,291,433
26069,mrabear,,8,1,1,2
26070,SLG52,,43,2,2,4
26071,gsadamb,,13,30,27,57
26072,sezzme,,13,6,1,7
26073,vafada,,20,66,61,127
26074,sadz79,,22,25,21,46
26075,heffa,,3,39,37,76
26076,Captain-Offtopic,,4,7,2,9
26077,Ls3,,6,1,1,2
26078,VulturE,,1,280,180,460
26079,FooBarWidget,,20,52,59,111
26080,tyler_durden,,19,230,187,417
26081,MightyCicero,,18,2,5,7
26082,thecentaur,,32,85,68,153
26083,Autoeroticrat,,29,7,17,24
26084,nocturbulous,,5,39,10,49
26085,mzzarh,,22,1,2,3
26086,zipperhead,,32,8,6,14
26087,freekill,,39,190,87,277
26088,rocketslot,,18,44,2,46
26089,ajg,,21,5,9,14
26090,herbcharles,,13,256,1,257
26091,torrent1337,,32,111,136,247
26092,mads91,,8,20,29,49
26093,JamesChase,,5,1,2,3
26094,justinreeck,,18,12,43,55
26095,tvmute,,18,58,116,174
26096,usamom,,19,1,4,5
26097,ComicSansMS,,6,3,2,5
26098,ddevil63,,1,203,347,550
26099,lhaas,,5,1,3,4
26100,genica,,43,2,1,3
26101,eluberoff,,20,2,1,3
26102,arrix,,20,1,1,2
26103,Demaroth,,0,7,16,23
26104,cualcrees,,18,280,89,369
26105,liber8US,,0,713,1441,2154
26106,djmeds,,13,3,4,7
26107,wolfbrand,,31,4,3,7
26108,eranshor,,5,1,1,2
26109,mmilenko,,20,5,8,13
26110,sifiblog,,13,8,2,10
26111,jimbecile,,13,785,201,986
26112,Timmih,,18,20,3,23
26113,sararose244,,1,2,1,3
26114,strktwo,,36,5,5,10
26115,didi5679,,31,5,10,15
26116,boola19,,1,83,95,178
26117,mizaya,,18,171,277,448
26118,Jesus0fNazareth,,22,1,1,2
26119,meowfaceman,,42,23,43,66
26120,lankakitten,,0,17,32,49
26121,Ironphp,,13,41,4,45
26122,hrumphgrumble,,19,117,170,287
26123,kiwijim,,19,39,13,52
26124,madelino,,19,7,3,10
26125,Misery90,,42,1,1,2
26126,caex,,18,3,13,16
26127,saddor,,36,1,1,2
26128,Talky,,20,3,5,8
26129,jenniemic,,13,8,19,27
26130,schwa23,,20,1,1,2
26131,Adieu1,,5,2,1,3
26132,alpine01,,32,7,5,12
26133,dmix,,18,25,33,58
26134,DogBotherer,,8,364,617,981
26135,notsoonenough,,26,1,3,4
26136,qazujm,,14,11,9,20
26137,oyok2112,,43,103,143,246
26138,carpespasm,,32,390,686,1076
26139,jtablerd,,1,124,51,175
26140,benjo8,,28,11,12,23
26141,verisimilitude,,18,21,38,59
26142,discord,,1,52,63,115
26143,loerneas,,1,9,13,22
26144,cyklopps,,34,21,14,35
26145,tekgnosis,,15,30,75,105
26146,isejfosffdsfs,,13,5,5,10
26147,BlahblahName,,1,37,42,79
26148,steveo23349,,13,55,55,110
26149,drewr,,20,43,11,54
26150,belovely,,18,13,52,65
26151,fab13n,,20,39,53,92
26152,polakmark,,0,3,5,8
26153,denzuko,,14,3,7,10
26154,CUBICcube,,13,6,1,7
26155,TNCLR,,19,7,19,26
26156,jbw31415,,32,44,4,48
26157,YellowTruck,,18,2,1,3
26158,thaahg,,17,1,2,3
26159,dextroz,,34,123,209,332
26160,patrix,,11,1,3,4
26161,mice_power,,32,7,4,11
26162,kobayashi,,18,24,40,64
26163,zeekiller,,13,30,3,33
26164,yaruki_zero,,32,64,93,157
26165,iamagainststupid,,13,1,5,6
26166,campaignmrozek,,11,6,1,7
26167,lemkenski,,1,6,6,12
26168,thisisnotmyname,,20,21,10,31
26169,WolfgangAmadeus,,9,1,1,2
26170,McHoff,,20,112,131,243
26171,minutemantm,,43,71,157,228
26172,baros,,22,4,5,9
26173,gemineyes,,18,1,2,3
26174,mkrfctr,,22,778,1171,1949
26175,peter411,,43,11,21,32
26176,canonymous,,18,31,56,87
26177,zvikico,,20,5,1,6
26178,scarletrouble,,32,2,1,3
26179,mdiokwe,,6,14,1,15
26180,koomapotilas,,31,4,4,8
26181,javes,,20,1,1,2
26182,factotvm,,14,3,2,5
26183,charlatan,,18,2963,662,3625
26184,afghanwhiggle,,22,5,2,7
26185,an0el,,43,8,6,14
26186,depa,,20,3,2,5
26187,zac79,,34,295,411,706
26188,shimitsm,,13,112,3,115
26189,ericksoa,,30,2,2,4
26190,timmothhead,,14,1,3,4
26191,familynight,,13,1,1,2
26192,speachless,,13,1,2,3
26193,ramijames,,34,363,319,682
26194,stoops,,12,2,3,5
26195,sveinhal,,31,42,39,81
26196,Kommy,,19,8,15,23
26197,zergatheart,,13,5,4,9
26198,debng,,5,69,4,73
26199,Sitamama,,18,17,59,76
26200,kylethegreat,,11,3,6,9
26201,nannerla,,22,5,6,11
26202,xMetalDetectorx,,18,2,14,16
26203,jamoes,,20,51,61,112
26204,chu,,20,208,244,452
26205,dirtyp,,13,739,12,751
26206,cudegra,,5,3,8,11
26207,Rlittle66,,13,5,34,39
26208,s7uckinreality,,26,42,41,83
26209,Foo7,,31,189,170,359
26210,Smeed,,32,2,8,10
26211,Strayphoenix6,,19,81,4,85
26212,paramage,,30,2,1,3
26213,dezmodium,,29,318,431,749
26214,toshok,,20,3,9,12
26215,smoots,,22,4,3,7
26216,Vulpyne,,18,4,9,13
26217,rotinski,,13,5,4,9
26218,nm00ph,,18,59,146,205
26219,5wen,,19,4,2,6
26220,brainflow,,13,61,29,90
26221,steveg,,12,23,27,50
26222,dstcruz,,20,4,5,9
26223,wyyyrm,,20,5,7,12
26224,churchdog,,13,169,54,223
26225,atduskgreg,,1,3,1,4
26226,eskimomatt,,4,2,7,9
26227,crystallyn,,30,1,1,2
26228,snwbrdr464,,36,1,1,2
26229,habitus,,1,7,11,18
26230,xoomani,,0,16,3,19
26231,ab9003,,0,2,2,4
26232,ghiuryy,,18,33,12,45
26233,nenoload,,19,4,4,8
26234,macroman,,8,2,1,3
26235,lmclapp68,,20,20,38,58
26236,otrov77,,18,393,22,415
26237,superjerk,,19,158,256,414
26238,rehevkor5,,8,4,3,7
26239,darlyn,,18,275,527,802
26240,jamieoli,,18,4,3,7
26241,racarr,,20,27,7,34
26242,WhyNotToday,,13,10,13,23
26243,striker69,,19,23,14,37
26244,Danthekilla,,15,6,4,10
26245,greenskin,,0,29,31,60
26246,bentronic,,13,11,29,40
26247,avalenci,,18,48,20,68
26248,bikko,,13,8,15,23
26249,nighttrain,,20,2,2,4
26250,earthman19,,18,88,102,190
26251,anemptygun,,43,4,17,21
26252,xGreatRomances0x,,32,12,1,13
26253,magiclava,,5,6,11,17
26254,anonnymouse,,18,6,5,11
26255,younggrammy,,36,1,2,3
26256,hoopmastaflex,,20,5,14,19
26257,ragehot,,19,11,2,13
26258,garyg1322424,,0,4,7,11
26259,symphony,,20,6,4,10
26260,Thelema,,5,1,2,3
26261,jessbo,,9,1,3,4
26262,ReneeAshley,,10,1,1,2
26263,RegMcF,,3,1,1,2
26264,Baphomet,,13,16,39,55
26265,KenC411,,32,15,12,27
26266,janeylicious,,20,16,33,49
26267,da4,,42,2,2,4
26268,porphyria,,22,1,4,5
26269,currentlocation,,39,2,5,7
26270,pchristensen,,20,20,13,33
26271,Prospagnosia,,13,3,3,6
26272,daveeff,,18,1,1,2
26273,jaldrich,,13,4,5,9
26274,cinemafest,,13,46,13,59
26275,noclips,,22,2,2,4
26276,bejitto101,,1,25,14,39
26277,bobcat_08,,13,1,3,4
26278,knylok,,22,1511,2486,3997
26279,gardnert2,,19,1,1,2
26280,jeffvangrumpy,,20,6,4,10
26281,anon_john,,43,2,1,3
26282,ffej,,22,30,44,74
26283,Fenrisulfr,,20,4,4,8
26284,mallusyr,,20,1,3,4
26285,loki969,,31,14,9,23
26286,No-Shit-Sherlock,,34,1,1,2
26287,esilverberg,,41,7,1,8
26288,CorvusPDX,,32,5,15,20
26289,Mr_Splashy_Pants,,15,23,31,54
26290,Nimbus2000,,13,57,102,159
26291,xor,,32,2,2,4
26292,powerjg,,20,6,6,12
26293,8string,,20,18,20,38
26294,petercasier,,34,149,2,151
26295,Caeremonia,,31,22,26,48
26296,UncleOxidant,,20,933,1103,2036
26297,letharus,,18,57,92,149
26298,chzplz,,30,70,81,151
26299,dreddor,,13,10,12,22
26300,vancouve,,13,33,14,47
26301,MTCicero,,31,42,15,57
26302,codyc,,1,83,45,128
26303,DRUGSISRUNBYTHEGOVT,,1,2,1,3
26304,livefood,,34,1,1,2
26305,gatsby137,,10,171,168,339
26306,jcmoscon,,31,1,1,2
26307,tuple,,34,89,84,173
26308,Jredrum,,18,962,124,1086
26309,jacekplacek,,13,214,416,630
26310,viborg,,19,5,6,11
26311,Elizabelle,,20,1,1,2
26312,ajd17case,,20,56,16,72
26313,paultantk,,14,4,1,5
26314,robotnick,,18,82,10,92
26315,planteo,,21,13,1,14
26316,imarobot,,1,17,32,49
26317,cerpntaxt,,19,40,15,55
26318,advancednano,,39,2,5,7
26319,pandaro,,18,5,21,26
26320,chrisarndt,,19,13,18,31
26321,demosthenes247,,19,2,2,4
26322,jo-cisco,,31,2,4,6
26323,diligentdogs,,19,192,64,256
26324,subtleanddangerous,,18,14,34,48
26325,jadedfox,,30,1,2,3
26326,attractivetb,,0,635,108,743
26327,dfsw,,2,2,10,12
26328,sixdoublefive321,,31,10,21,31
26329,angledluffa2,,30,9,5,14
26330,bozho,,20,3,1,4
26331,wheezl,,17,32,44,76
26332,uf9878,,43,2,1,3
26333,simonjp,,1,183,207,390
26334,madRomanian,,34,91,30,121
26335,wanax,,19,25,1,26
26336,randrews,,20,28,38,66
26337,cmdln_,,20,1,1,2
26338,dailite,,19,3,5,8
26339,2oonhed,,18,135,421,556
26340,indrax,,43,3,11,14
26341,bigfatphony,,31,23,18,41
26342,traffle,,0,7,10,17
26343,joeyjoejoe,,13,33,1,34
26344,i0n,,1,3,8,11
26345,Squidmore,,19,1,2,3
26346,ghztew,,9,2,1,3
26347,johnnyk,,18,34,54,88
26348,nicereddit,,19,20,1,21
26349,full_throttle,,12,1,1,2
26350,Erudecorp,,32,637,1387,2024
26351,Mollow,,43,1,2,3
26352,drusam,,19,12,17,29
26353,acrodizer,,19,1,2,3
26354,sil3nce,,31,1,1,2
26355,niwinski,,42,1,1,2
26356,dayvan,,18,155,59,214
26357,stereomind,,14,2,2,4
26358,Railboy,,18,4,4,8
26359,zabaduba,,32,23,21,44
26360,corbs,,1,9,13,22
26361,Omarosa,,31,5,3,8
26362,NotMarkus,,1,584,580,1164
26363,MrBobBarker,,8,2,4,6
26364,doneddat,,8,1,6,7
26365,crfergus,,18,1,3,4
26366,The1337,,9,83,2,85
26367,5rgb79,,0,17,40,57
26368,chriseidhof,,20,6,5,11
26369,thehumungus,,13,173,175,348
26370,Qingy,,1,35,41,76
26371,outsyder,,20,1,4,5
26372,RgbyTgr24,,19,71,60,131
26373,poliscimajor,,31,4,1,5
26374,xuoG_1988,,0,51,39,90
26375,fyl9000,,22,7,4,11
26376,Korian,,18,13,29,42
26377,9brandon,,19,137,2,139
26378,zirconium,,31,24,13,37
26379,Mathiasdm,,20,11,11,22
26380,terato,,20,174,167,341
26381,mutz,,23,1,5,6
26382,mythealias,,20,2,2,4
26383,tobeyswain,,31,2,1,3
26384,Zebby,,8,309,213,522
26385,tri_wine,,18,1,9,10
26386,bowermr,,18,244,9,253
26387,TITS-or-GTFO,,43,1,1,2
26388,Shantaram,,20,2,1,3
26389,JewishPropaganda,,31,651,456,1107
26390,albar129,,12,24,16,40
26391,moocat,,20,9,5,14
26392,yellowhelly,,19,2,2,4
26393,biotech9,,22,144,76,220
26394,NobleCommerce,,11,40,30,70
26395,beebers,,0,2,2,4
26396,shapechanger,,32,28,11,39
26397,farre,,20,3,1,4
26398,SleepingSheeple,,1,302,139,441
26399,patroclus,,20,2,1,3
26400,pb_zeppelin,,20,33,53,86
26401,ivorylineslead30,,34,3,9,12
26402,kank84,,32,70,83,153
26403,crei0,,8,1,2,3
26404,SourcesPlease,,18,10,4,14
26405,digitaldevil,,32,1,2,3
26406,Frazzydee,,18,88,97,185
26407,stmiller,,20,54,72,126
26408,alex_gregor,,11,1,1,2
26409,jaemccall,,1,18,20,38
26410,ba33eg,,18,14,2,16
26411,flukes2,,30,9,15,24
26412,hojomonkey,,18,14,16,30
26413,degustisnuffleupagus,,19,39,54,93
26414,charliedouglas,,1,4,5,9
26415,spacelincoln,,1,297,347,644
26416,Ttaxchristine,,14,4,4,8
26417,DiscordantJellyfish,,20,75,95,170
26418,lukaskaiser,,5,1,4,5
26419,soyabstemio,,18,307,623,930
26420,briandunning,,32,6,5,11
26421,JackAzzz,,13,38,113,151
26422,Mastrmind,,12,1321,449,1770
26423,brooks19,,0,1,1,2
26424,xamdam,,34,66,114,180
26425,calbear81,,19,84,70,154
26426,punkypine,,31,40,28,68
26427,HeirToPendragon,,18,864,1341,2205
26428,tabigail,,13,1,5,6
26429,Mitchacho,,15,74,87,161
26430,mo0nrider,,5,11,6,17
26431,klapaucius,,30,6,10,16
26432,freehat704,,1,35,2,37
26433,tclbuzz,,13,20,57,77
26434,mizuhana,,0,3,7,10
26435,SomewhatDisturbed,,1,76,147,223
26436,brewtalized,,19,1,1,2
26437,TooCloseToCall,,19,1,5,6
26438,mpstevens_uk,,20,2,5,7
26439,silence7,,34,400,297,697
26440,maggiesguy,,36,2,2,4
26441,jeffbarr,,22,1,1,2
26442,lyontamer,,10,72,163,235
26443,webomatica,,8,3,10,13
26444,tommia,,20,3,4,7
26445,e-socrates,,13,126,200,326
26446,ux-guy,,13,2,4,6
26447,newpatriots,,13,269,486,755
26448,whatthedeuce,,22,36,77,113
26449,geoCorpse,,42,17,14,31
26450,so_very_wrong,,20,1,1,2
26451,meox,,31,3,1,4
26452,SyphilisBoy,,34,17,43,60
26453,Halcyone1024,,3,1,2,3
26454,LibertyKnight,,13,2,4,6
26455,rock217,,1,56,74,130
26456,PossumTucker,,18,386,446,832
26457,hugsandnugs,,0,1,4,5
26458,fiam,,20,17,22,39
26459,theycallmemorty,,16,475,404,879
26460,cyah,,16,1,1,2
26461,Stripper,,10,1,3,4
26462,Die-Bold,,19,124,76,200
26463,bleachedanus,,13,279,100,379
26464,Vorgus,,18,4,1,5
26465,Canyon1951,,20,1,1,2
26466,macj321,,10,1,1,2
26467,sgarissta,,20,1,3,4
26468,CraigUma,,19,92,113,205
26469,peabody,,20,11,12,23
26470,execute85,,0,388,409,797
26471,jsb123,,13,5,6,11
26472,Luis_R,,13,1,6,7
26473,greeneggsnam,,18,53,59,112
26474,Dolphinwolf,,31,12,4,16
26475,ATLG,,34,2,3,5
26476,BobFromAccounting,,43,8,10,18
26477,qwerty42,,0,181,291,472
26478,oxigen,,43,1,2,3
26479,xsql,,13,7,3,10
26480,RFKresearcher,,20,1,3,4
26481,RantyDave,,20,60,94,154
26482,mohammy,,1,18,2,20
26483,onmach,,20,102,104,206
26484,Magjua,,31,2,6,8
26485,dejavont,,15,5,11,16
26486,ThesisAnti,,13,4,1,5
26487,FatAlbert,,22,68,111,179
26488,lordxenu74,,19,1,1,2
26489,PLanPLan,,11,33,56,89
26490,Scorpion1011,,34,51,77,128
26491,solinent,,20,51,106,157
26492,sigurmyrkur,,43,2,1,3
26493,hocktwoie,,22,8,3,11
26494,zraelian,,18,63,125,188
26495,IhateEverything,,42,26,33,59
26496,durzagott,,22,21,17,38
26497,Bukz68,,13,205,230,435
26498,duncan80,,43,42,57,99
26499,scatgreen2,,13,844,180,1024
26500,MissingNo,,22,1,1,2
26501,tbak,,34,1,2,3
26502,bumped,,13,405,723,1128
26503,Scrutable,,20,6,2,8
26504,ApontePR,,26,6,1,7
26505,vovcheg,,13,2,1,3
26506,xDeToXx,,36,1,1,2
26507,yhodda,,43,4,4,8
26508,skooty,,30,12,14,26
26509,Spaceomega,,1,21,6,27
26510,rb545331,,13,2,2,4
26511,avengingturnip,,13,2,2,4
26512,Jonex,,20,2,2,4
26513,teuobk,,32,49,43,92
26514,tlankow,,5,5,3,8
26515,1point21Gigawatts,,19,5,11,16
26516,toadst00l,,3,7,8,15
26517,abhinay99,,1,3,5,8
26518,vikadin,,20,15,10,25
26519,KarateRobot,,12,24,31,55
26520,timbrell,,13,1,2,3
26521,highspeedbee,,18,64,7,71
26522,fr00ty,,32,1,1,2
26523,ltorvalds,,3,4,1,5
26524,AJLobo,,18,5,16,21
26525,kuda,,19,2,3,5
26526,vindos,,30,11,1,12
26527,euroamerican,,19,110,11,121
26528,driftersgold,,26,3,5,8
26529,DrEvil,,23,19,36,55
26530,Johnny_5_alive,,43,48,22,70
26531,psrobert,,20,4,1,5
26532,scoobiashi,,1,4,2,6
26533,yellowcakewalk,,18,1,2,3
26534,ko773,,13,2,7,9
26535,nyclass,,11,4,6,10
26536,343409890,,22,1,1,2
26537,BXRWXR,,6,1,4,5
26538,themanchild,,5,32,50,82
26539,aarontaylor5000,,43,173,86,259
26540,joethebob,,13,49,70,119
26541,ReadilyApparentBoy,,19,5,14,19
26542,don221955,,31,1,1,2
26543,lookagain,,42,41,55,96
26544,jcurtis65,,11,6,18,24
26545,jaymunger,,13,1,3,4
26546,longbow7,,22,89,156,245
26547,shoutwire2007,,19,63,68,131
26548,Coalesce,,43,50,82,132
26549,Kaashar,,13,20,7,27
26550,schudder,,18,102,75,177
26551,mudslag,,13,265,161,426
26552,grammarian,,22,9,7,16
26553,matthasaproblem,,32,17,14,31
26554,monicel,,5,2,1,3
26555,rhmcisafaggot,,18,5,4,9
26556,krizo,,13,509,621,1130
26557,jacksonhewitt,,22,2,2,4
26558,dudley14144,,19,2,14,16
26559,sleazyb,,0,138,2,140
26560,efxeditor,,20,1,2,3
26561,poub,,20,1,1,2
26562,task,,8,2,3,5
26563,vodkat,,1,28,45,73
26564,misphit,,11,2,2,4
26565,TheRonMan,,18,20,22,42
26566,coodie,,31,1,2,3
26567,chip33550336,,19,270,560,830
26568,Stormwatch36,,32,12,39,51
26569,gernwood,,10,3,3,6
26570,embee,,19,8,3,11
26571,winstonsmith,,19,85,15,100
26572,silverman66,,29,1,1,2
26573,otto_s,,20,12,25,37
26574,lkozma,,20,57,9,66
26575,justinlillich,,13,3,19,22
26576,hiegel,,5,20,2,22
26577,nitran,,20,29,40,69
26578,gnufrra,,20,7,12,19
26579,prider,,20,439,403,842
26580,ben321,,31,6,4,10
26581,clytle374,,17,408,671,1079
26582,doubleginntonic,,19,486,487,973
26583,jungans,,20,2,3,5
26584,zombiefresh,,18,7,14,21
26585,rosshettel,,0,61,80,141
26586,ltriant,,15,81,34,115
26587,DanielLee50,,13,16,41,57
26588,steveissuperman,,34,40,32,72
26589,refugeewc,,17,4,4,8
26590,awetawef,,1,36,10,46
26591,mivsek,,20,93,4,97
26592,rlmowry,,0,31,1,32
26593,syristi,,32,2,3,5
26594,BAKEDpotatoe,,19,3,6,9
26595,jeanlucpikachu,,20,510,370,880
26596,paganmonkeyboy,,13,152,184,336
26597,patio11,,20,16,11,27
26598,mevodig,,20,1,2,3
26599,TheAnomaly,,20,2,5,7
26600,jdale27,,20,11,7,18
26601,zerokey,,43,111,173,284
26602,mikemorley,,7,7,13,20
26603,alandunne,,1,9,8,17
26604,mastema_ro,,32,25,49,74
26605,I_own_what_you_think,,10,12,8,20
26606,monjorob,,13,12,13,25
26607,thatsapaddlin,,13,4,5,9
26608,pastrytroll,,31,1,1,2
26609,doublejay1999,,18,159,266,425
26610,314159265358979,,13,3,4,7
26611,cryptic,,20,71,74,145
26612,missye,,43,92,3,95
26613,abstractnonsense,,12,1,2,3
26614,billjohns2,,19,105,5,110
26615,Kphaup,,32,18,11,29
26616,nimita,,3,1,2,3
26617,organic,,26,274,395,669
26618,bbcoburn,,5,10,8,18
26619,r0b0_m4tt,,32,4,2,6
26620,liamQ,,20,32,23,55
26621,Tw0Bit,,30,1,3,4
26622,Skorrogan,,19,3,1,4
26623,fingers,,39,1676,3118,4794
26624,Solomatrix,,1,2,2,4
26625,sigil,,20,1,2,3
26626,MamGu,,18,4,1,5
26627,Kitsunemisao,,36,1,8,9
26628,waynemr,,22,45,13,58
26629,stressinsh,,8,2,4,6
26630,Moseste,,12,2,2,4
26631,Cubedesigner2,,18,5,4,9
26632,solidworksalkan,,18,194,2,196
26633,chemrat,,19,1,7,8
26634,ringkichard,,13,5,2,7
26635,mcescherwhat,,1,3,8,11
26636,nonguy,,18,1,1,2
26637,eighteyes,,1,10,6,16
26638,hermes369,,6,21,41,62
26639,hamhed,,34,4,9,13
26640,ftzine,,5,8,11,19
26641,poopshootjohnson,,19,1,1,2
26642,michaeljsouth,,13,13,7,20
26643,mikeplugh,,35,3,3,6
26644,Ritchie_13,,42,1,2,3
26645,lefty33,,1,2,4,6
26646,unitas,,22,72,77,149
26647,vemrion,,0,606,395,1001
26648,Dr_Egon_Spengler,,22,2,5,7
26649,jellofiend84,,5,31,19,50
26650,23450982304958,,38,1,2,3
26651,peterpincus,,20,247,63,310
26652,edwardnh,,42,8,3,11
26653,manBEARpigBEARman,,1,19,16,35
26654,awaazbandh,,19,94,89,183
26655,Greta_B,,43,1,1,2
26656,thundersnow,,13,4,6,10
26657,abfa00,,1,1,6,7
26658,AchtungAchtung,,34,1,2,3
26659,onions,,26,3,4,7
26660,Paulaner,,13,126,296,422
26661,johndavis730,,13,25,12,37
26662,ssunder,,14,2,5,7
26663,mcarlint,,5,23,48,71
26664,stumps,,14,1,3,4
26665,theozoph,,31,48,92,140
26666,dieselmachine,,0,109,172,281
26667,voip,,43,125,125,250
26668,freakonthefiddle,,13,14,26,40
26669,vdoma,,1,21,5,26
26670,almost,,20,11,20,31
26671,rwallen,,12,8,4,12
26672,polyrhythmic,,34,144,264,408
26673,timbofield,,20,17,15,32
26674,touchthesky,,13,26,85,111
26675,darrint,,20,21,9,30
26676,hohs20,,19,11,1,12
26677,shadow_cloak,,11,2,1,3
26678,JenniferMX,,13,22,31,53
26679,Tekkoist,,18,4,1,5
26680,uniplexer,,20,31,24,55
26681,skillzphd,,13,16,11,27
26682,kekko,,0,287,142,429
26683,batsheba,,19,1,7,8
26684,thetheroo,,18,10,11,21
26685,mat05e,,18,12,14,26
26686,windsmith,,6,4,1,5
26687,proee,,5,19,20,39
26688,nailz1000,,18,263,392,655
26689,jennywine,,1,1,1,2
26690,alextryie,,0,36,6,42
26691,b00ks,,17,234,334,568
26692,dodga,,18,2,1,3
26693,fakeaccount12345,,1,24,6,30
26694,Apotheosis,,0,14,17,31
26695,w1r3r4t,,13,15,14,29
26696,mangalamraj,,19,3,1,4
26697,caolo,,13,5,8,13
26698,ddeano,,18,2,1,3
26699,touchpadonbackon,,42,15,15,30
26700,retard_applejuice,,0,5,4,9
26701,timperry42,,32,5,5,10
26702,manbitesdog,,18,4,18,22
26703,conradparker,,20,20,1,21
26704,thephilwhite,,19,51,32,83
26705,arsenix,,13,1,1,2
26706,blerg,,42,5,4,9
26707,beatnixxx,,39,3,1,4
26708,beer_stein,,19,20,10,30
26709,edman007,,27,4,5,9
26710,theclaw,,20,81,106,187
26711,yafsho,,42,8,14,22
26712,BurritoFrenzy,,4,13,26,39
26713,bonerobo,,13,37,66,103
26714,salzstangen,,31,2,3,5
26715,deadbob,,19,2,4,6
26716,frankparker,,43,6,9,15
26717,vep,,34,13,28,41
26718,JokeRuiner,,39,1,2,3
26719,JordanZakarin,,13,1,1,2
26720,tacitblue,,18,8,4,12
26721,littlerobothead,,30,2,5,7
26722,asenz,,20,26,75,101
26723,MrCrud,,13,7,4,11
26724,Mathematics411,,5,1,3,4
26725,masticate,,10,6,1,7
26726,bigcynic,,13,1036,841,1877
26727,insect_song,,31,110,128,238
26728,anndrewd,,19,1,1,2
26729,Xptql,,29,13,9,22
26730,donkeymon,,17,3,8,11
26731,lbt,,18,1,3,4
26732,asciilifeform,,20,842,238,1080
26733,odddrums,,1,28,8,36
26734,Steveb08,,19,6,11,17
26735,socialbanner,,5,92,5,97
26736,mavelikara,,20,20,21,41
26737,andy4443,,19,78,85,163
26738,sommer,,16,1,5,6
26739,onlinehero,,18,45,9,54
26740,f-_-_-_-_r,,18,2,6,8
26741,Originate,,1,1092,780,1872
26742,issem,,13,8,10,18
26743,Nois3,,22,19,21,40
26744,GkDragon,,31,2,14,16
26745,timmaxw,,20,144,189,333
26746,buccia,,20,135,33,168
26747,bogg,,1,1,3,4
26748,tomrees,,32,10,1,11
26749,madratz,,34,31,103,134
26750,nolander,,32,7,20,27
26751,faloose,,34,3,3,6
26752,buzzer,,0,12,5,17
26753,Rhysaff,,31,25,33,58
26754,LeCollectif,,18,60,95,155
26755,drewbic,,34,340,155,495
26756,jackruby43,,22,1,1,2
26757,_red,,29,297,344,641
26758,jaymunee80,,4,2,1,3
26759,kRabbit,,22,26,6,32
26760,krod4,,0,83,147,230
26761,slickrick327,,19,8,6,14
26762,lowspeed,,31,72,117,189
26763,Ronik,,42,2,2,4
26764,frorocker,,13,1,1,2
26765,uint32,,20,20,45,65
26766,stonecold,,19,76,23,99
26767,fijidaddy,,34,1,5,6
26768,VonTurbo,,8,2,1,3
26769,jasonlushable,,19,2,1,3
26770,dirtychic,,21,5,3,8
26771,wasthedavecollins,,32,13,4,17
26772,jamessun,,13,5,2,7
26773,jmusselwhite,,5,3,1,4
26774,lovelythr,,0,10,2,12
26775,mr_luc,,20,86,122,208
26776,HarDeFuckingHar,,18,2,2,4
26777,kumpera,,16,2,2,4
26778,indigotree,,18,9,24,33
26779,yoojin,,4,1,4,5
26780,hottoddy,,1,1,5,6
26781,alpha486,,20,5,3,8
26782,sumdeus,,20,26,22,48
26783,davidryal,,34,1,8,9
26784,random12345,,42,19,23,42
26785,Anthaneezy,,1,5,7,12
26786,Brndn,,18,32,47,79
26787,jjacobs2,,32,1,1,2
26788,traemccombs,,15,2,5,7
26789,tehgeekmeister,,20,33,5,38
26790,priapusmaximus,,0,7,8,15
26791,smadley,,22,3,13,16
26792,Lambboy,,1,88,74,162
26793,monogoose,,36,1,1,2
26794,motherrussia,,36,2,2,4
26795,peteybear,,5,1,1,2
26796,inoshiro,,1,3,3,6
26797,kzhi,,42,1,4,5
26798,sunbright2,,13,4,4,8
26799,jimithng33,,19,2,3,5
26800,thewileyone,,4,48,113,161
26801,mycivicsi2006,,19,139,191,330
26802,mdaniel,,20,5,13,18
26803,piranha,,20,123,197,320
26804,myaltalt,,17,4,3,7
26805,timmertc,,13,4,4,8
26806,lordofthejungle,,30,4,2,6
26807,brad08,,19,5,23,28
26808,Estha,,32,12,3,15
26809,Jesus_Faction,,18,8,9,17
26810,cbraga,,18,33,39,72
26811,azngunsmoke,,43,7,8,15
26812,samurai123,,5,1,1,2
26813,kernelhappy,,33,286,448,734
26814,jsjkim,,0,47,3,50
26815,sci901,,31,12,20,32
26816,Sodaware,,1,4,1,5
26817,kirby12,,16,3,5,8
26818,rgaginol,,4,94,128,222
26819,bchociej,,26,1,5,6
26820,wenzelr2,,17,1,1,2
26821,dcr42,,16,4,6,10
26822,dcooper8,,31,2,1,3
26823,rzn1987,,42,38,3,41
26824,laughtears,,5,2,7,9
26825,mikebrowne,,43,4,5,9
26826,nickeldimedime,,8,1,1,2
26827,IAmUrMum,,32,1,2,3
26828,bellamix,,19,6,2,8
26829,eigenvector,,34,4,7,11
26830,koosisking,,34,1,4,5
26831,Agrippa,,43,8,4,12
26832,Seeders,,18,77,155,232
26833,itan,,19,5,1,6
26834,SharewareFun,,20,2,1,3
26835,Zyrkon,,43,1,1,2
26836,shrednivashtar,,0,46,38,84
26837,buffinator,,17,25,16,41
26838,mascot,,19,1,1,2
26839,repercussion,,13,57,19,76
26840,rongenre,,20,24,24,48
26841,dubalom,,13,4,5,9
26842,tmp1,,20,2,2,4
26843,anaxerzia,,22,88,93,181
26844,keeish,,32,1,1,2
26845,Sollus2,,18,2,2,4
26846,Severious,,29,4,1,5
26847,kenmo,,19,7,8,15
26848,bakosdelowang,,19,53,96,149
26849,SpinDoctor,,43,1,1,2
26850,tinghao76,,15,1,1,2
26851,angularvision,,4,1,2,3
26852,serenadingfool,,16,1,4,5
26853,kopikat,,20,2,2,4
26854,dewey2100,,6,2,1,3
26855,Fauxbama,,35,1,1,2
26856,gimmickaccountrating,,23,1,4,5
26857,quakank,,19,238,268,506
26858,askjigga,,34,23,23,46
26859,s7r1k3r,,43,4,6,10
26860,Erobern,,43,36,49,85
26861,cptmarginal,,8,2,4,6
26862,felixgolden,,34,1,3,4
26863,chadmyers,,20,3,2,5
26864,PartySlug,,1,32,15,47
26865,Stagnantdwarves,,18,8,28,36
26866,foca,,20,14,22,36
26867,boredidiot,,15,76,86,162
26868,esteroth12,,14,1,1,2
26869,thephotoman,,20,282,474,756
26870,soco,,13,2,1,3
26871,determined1,,1,2,5,7
26872,could_be_paranoia,,23,3,2,5
26873,digitalmemory,,18,1,9,10
26874,Kevin-Roses-Left-Nut,,12,422,402,824
26875,Skitzie,,19,37,53,90
26876,toastedzergling,,4,50,72,122
26877,goanalog,,1,40,2,42
26878,tricksterspirit,,18,1,5,6
26879,rubyaeyes,,31,16,45,61
26880,elf631,,18,2,4,6
26881,Emelius,,42,1,1,2
26882,HeywoodJablowme,,42,28,50,78
26883,joinordie,,13,2,4,6
26884,GregHouse,,33,2,1,3
26885,bbbrain,,31,1,4,5
26886,jamminpotato,,20,1,1,2
26887,ninjamurf,,19,5,6,11
26888,daeron,,31,2,2,4
26889,Jalford,,0,43,7,50
26890,angeltari,,18,5,22,27
26891,extinct,,14,1,1,2
26892,thisismyanonymousnic,,20,2,3,5
26893,chuckwho,,5,1,1,2
26894,mosesconspiracy,,18,174,322,496
26895,ajay,,29,1,2,3
26896,tgdvw,,18,1,2,3
26897,acmercer,,30,3,3,6
26898,235rtgsgdsfg,,39,2,1,3
26899,mistermick,,42,147,203,350
26900,PENIX,,20,61,85,146
26901,Uresu,,8,5,4,9
26902,unwittingaccomplice,,22,4,4,8
26903,epicrule34,,0,64,124,188
26904,keeperofkeys,,20,21,43,64
26905,dpa62,,12,5,5,10
26906,superpredditor,,19,3,4,7
26907,hiq_boy,,43,2,1,3
26908,jessegberg,,1,21,23,44
26909,Ancho,,21,3,2,5
26910,hex4def6,,8,2,2,4
26911,flashpimp,,20,10,3,13
26912,dairem,,43,40,13,53
26913,wwosik,,20,1,2,3
26914,joeskunk,,2,9,22,31
26915,abas,,31,5,8,13
26916,Lukassus,,18,1,3,4
26917,Icanhazreddit,,22,411,541,952
26918,ErikMuskrat,,17,1,4,5
26919,jacktheripper,,4,56,45,101
26920,koksiboks,,27,2,2,4
26921,elmuchoprez,,4,180,90,270
26922,Tryke,,20,56,59,115
26923,Greenpointer,,5,13,3,16
26924,Itkovan,,1,41,84,125
26925,viagrakamagra,,9,2,8,10
26926,dg10050,,18,73,132,205
26927,nobody1234,,2,36,53,89
26928,zaggynl,,32,12,17,29
26929,d_b,,13,6,12,18
26930,jqueryit,,20,1,1,2
26931,bushel,,20,75,96,171
26932,bgcialis,,1,3,2,5
26933,Slick424,,42,46,71,117
26934,mcornett94,,13,3,6,9
26935,ErinER,,5,1,1,2
26936,Mashulace,,29,89,143,232
26937,pandering,,18,10,1,11
26938,luvthenet,,19,26,2,28
26939,bostonsoxfan,,12,3,7,10
26940,balkotn,,11,14,8,22
26941,Rusty99Arabian,,5,7,7,14
26942,mbruns,,36,2,1,3
26943,ehabkost,,22,4,7,11
26944,BigMikeYork,,15,61,52,113
26945,sotonohito,,32,301,286,587
26946,draustus,,42,4,4,8
26947,mercid,,19,16,10,26
26948,muffdyvr,,32,7,20,27
26949,exactamentos,,19,2,10,12
26950,InsincereDave,,19,104,10,114
26951,usdysk,,20,2,3,5
26952,Snazzy42,,13,21,15,36
26953,namlas,,30,65,33,98
26954,diamondjim,,18,47,100,147
26955,jdeneut,,13,1,1,2
26956,GeneralTsosChicken,,43,23,44,67
26957,doidydoidy,,20,85,198,283
26958,jcopling,,34,1,2,3
26959,onlineinspirations,,11,1,1,2
26960,CavMan,,32,32,36,68
26961,vreyes84,,18,18,9,27
26962,mdorn,,20,2,1,3
26963,grandpa,,30,51,38,89
26964,Bep,,9,5,5,10
26965,LxRogue,,31,45,51,96
26966,zhiliang,,13,3,11,14
26967,gabeiscoding,,20,16,16,32
26968,RickAHyatt,,26,2,3,5
26969,New_Hampshire,,19,14,16,30
26970,arthurni65,,13,1,4,5
26971,callingallcops,,27,6,1,7
26972,cezary,,13,2,1,3
26973,cojoco,,15,371,378,749
26974,JuiceBox,,23,1,5,6
26975,je255j,,26,954,1158,2112
26976,musicscoutjustin,,42,3,2,5
26977,WarPigs,,29,6,12,18
26978,lvtrance,,31,1,2,3
26979,codazzo,,18,16,12,28
26980,jcdreads,,20,1,1,2
26981,atnnn,,20,9,2,11
26982,ribald_jester,,31,69,112,181
26983,thereddust,,13,19,22,41
26984,blamecheney,,43,44,42,86
26985,jimgordon,,8,1,1,2
26986,bhrgunatha,,20,94,159,253
26987,sychadelicamania,,19,7,5,12
26988,smoofra,,19,100,148,248
26989,MJDiAmore,,19,4,6,10
26990,lavozatidebida,,13,5,11,16
26991,turkmenistan,,0,1,1,2
26992,kutya,,31,129,128,257
26993,Cxan,,1,17,28,45
26994,mycall,,20,860,726,1586
26995,DeadlyBrad42,,32,2,6,8
26996,jazzillion,,19,6,10,16
26997,TheKnightsWhoSayNi,,18,862,94,956
26998,TheUberDork,,17,190,384,574
26999,dr_qwertz,,22,86,149,235
27000,geekagent,,20,1,4,5
27001,moofive,,19,2,6,8
27002,desp,,14,54,74,128
27003,746f6d,,1,11,17,28
27004,charlestheoaf,,1,129,216,345
27005,SPna15,,18,2,4,6
27006,milki_,,20,6,4,10
27007,187lennon,,0,55,60,115
27008,jango_broughty,,13,1,1,2
27009,spoonito,,13,25,7,32
27010,xian24,,15,1,3,4
27011,rjonesx,,19,1624,364,1988
27012,Spudders,,22,548,778,1326
27013,human_giant,,22,71,91,162
27014,estone,,1,18,34,52
27015,hornetjockey,,13,12,19,31
27016,efbee,,20,4,9,13
27017,Stick,,18,148,311,459
27018,tienshiao,,20,9,13,22
27019,elint,,13,4,13,17
27020,greasyspoon,,1,1,2,3
27021,nickw,,32,14,7,21
27022,HillarysEyeSockets,,43,1,1,2
27023,gosh,,20,4,5,9
27024,lightether,,13,103,174,277
27025,ty8l8er,,18,95,24,119
27026,BigRedDSP,,18,3,2,5
27027,roug,,43,4,6,10
27028,Kim_Jong_Il,,19,23,42,65
27029,madrigael,,29,3,2,5
27030,sewellcm,,18,19,25,44
27031,slavus,,20,50,5,55
27032,chad206548,,34,1,2,3
27033,nanofiggis,,18,95,60,155
27034,gthing,,30,6,7,13
27035,moneeskyblue,,25,1,2,3
27036,desrever,,20,3,2,5
27037,ambyrhodes,,18,6,4,10
27038,bobjane,,18,11,9,20
27039,aflury,,17,1,1,2
27040,jimblackler,,43,1,2,3
27041,kk_090,,19,22,22,44
27042,thorndike,,43,37,42,79
27043,Tomstateler111,,18,58,3,61
27044,shirov,,32,2,3,5
27045,unrealredditaccount,,1,1,1,2
27046,ohwhytheresnoopenid,,0,2,1,3
27047,tagger22,,18,1,2,3
27048,heydude008,,42,1,4,5
27049,glen_scott,,20,8,3,11
27050,kvncortez,,13,4,15,19
27051,redditorin2006,,19,1,1,2
27052,mike-switch,,1,9,2,11
27053,JohnKerry,,43,2,2,4
27054,jngrow,,20,1,1,2
27055,alexsott,,20,2,2,4
27056,jasonmanley,,0,11,6,17
27057,bmusic,,6,2,2,4
27058,ApostrophePosse,,13,944,345,1289
27059,sayswhat,,4,1,1,2
27060,Marijuana_Enthusiast,,43,124,180,304
27061,dr_vertigo2,,34,17,29,46
27062,squizzled,,19,8,2,10
27063,reddiquettePolice,,19,43,82,125
27064,cnull,,43,69,59,128
27065,crowds,,31,71,3,74
27066,JCOrion,,19,15,24,39
27067,losethos,,20,71,19,90
27068,threetoed,,18,3,3,6
27069,msweeney,,10,1,1,2
27070,Bagel,,1,1122,1542,2664
27071,JonAtkinson,,20,5,5,10
27072,jmghollywood,,0,1,6,7
27073,theanarcrist,,19,144,15,159
27074,ethylhexyl,,0,8,8,16
27075,criminyjicket,,19,1,1,2
27076,aceinthehole,,0,58,177,235
27077,PurpleSfinx,,18,30,63,93
27078,sungod23,,14,2,3,5
27079,halfjew,,17,2,2,4
27080,chrisryland,,10,1,1,2
27081,tomtt,,20,49,11,60
27082,lip,,13,27,31,58
27083,russdot,,18,45,49,94
27084,MihaiC,,22,25,50,75
27085,dagit,,20,6,4,10
27086,leladax,,18,80,186,266
27087,dugdig,,14,8,7,15
27088,ThickGreenPuke,,13,388,439,827
27089,gusbustafunk,,18,106,134,240
27090,Droviin,,34,16,37,53
27091,jayesanctus,,43,7,17,24
27092,abc2020,,13,1,1,2
27093,burnninator,,16,2,2,4
27094,drdcuddy,,1,2,1,3
27095,zmonk2,,43,41,85,126
27096,erranttv,,19,116,12,128
27097,simplybrenty,,1,12,1,13
27098,unlearned,,42,2,2,4
27099,nicksauce,,32,114,112,226
27100,Shaelen,,19,1,1,2
27101,lllaaauuurrraaa,,43,15,32,47
27102,irenamak,,19,1,1,2
27103,shoneys,,18,66,104,170
27104,CockeyedPete,,12,21,27,48
27105,spammishking,,36,11,10,21
27106,tehgreek,,18,97,219,316
27107,jellobot,,1,1,2,3
27108,supermeerkat,,32,80,126,206
27109,jkennedy27,,13,69,1,70
27110,textfiles,,20,1,6,7
27111,markbres,,22,1,1,2
27112,bobb100,,5,9,1,10
27113,snot_rocket,,18,3,3,6
27114,GooZshooZ,,18,219,344,563
27115,thomas2431,,5,2,1,3
27116,jugabee,,38,2,1,3
27117,majorneo,,19,340,368,708
27118,ranma,,5,209,282,491
27119,lyon,,20,5,18,23
27120,kevlarcupid,,18,221,237,458
27121,911was_a_outside_job,,19,3,10,13
27122,CheBuzz,,22,1,1,2
27123,dcrall,,14,1,1,2
27124,thomas533,,30,23,13,36
27125,23_98,,43,1,1,2
27126,eatgrass,,18,7,3,10
27127,hetero_genius,,43,4,12,16
27128,belasco99,,6,1,1,2
27129,misohonie,,18,13,11,24
27130,joesapo,,18,2,5,7
27131,JazzJayZee,,21,64,4,68
27132,wallywoot,,23,1,2,3
27133,wingie,,18,16,37,53
27134,milomilo,,0,17,31,48
27135,DjFeltTip,,0,1,1,2
27136,lrm242,,20,9,2,11
27137,yelnatz,,20,3,3,6
27138,jchimney,,32,6,8,14
27139,leebones,,14,1,2,3
27140,NoiseBOX,,18,6,9,15
27141,Muziking,,12,5,2,7
27142,obrienj,,19,4,1,5
27143,nickfil,,42,22,14,36
27144,zeekstah,,18,17,16,33
27145,michaeljruscito,,19,1,4,5
27146,innocentbystander,,42,1758,2314,4072
27147,gojibot,,12,3,9,12
27148,kokok,,13,22,46,68
27149,bizquisite,,1,17,41,58
27150,schtarb,,20,24,30,54
27151,aalmiray,,20,1,1,2
27152,The_FBI,,13,6,14,20
27153,givas,,20,2,3,5
27154,Sophisticatedd,,10,4,4,8
27155,verrius,,20,6,7,13
27156,premiumdude,,18,3,3,6
27157,carsonbiz,,30,2318,108,2426
27158,squigs,,10,631,892,1523
27159,ine8181,,31,544,613,1157
27160,robosatan,,42,282,414,696
27161,gruehunter,,20,3,4,7
27162,pdewacht,,20,15,25,40
27163,BG5954729,,42,1,1,2
27164,ExpatSarah,,0,7,3,10
27165,saskboy,,30,2,4,6
27166,yogthos,,20,4,5,9
27167,MrDanger,,13,1161,1307,2468
27168,GoPolitics,,29,1,1,2
27169,nathanclay,,14,3,7,10
27170,joshyelon,,31,8,8,16
27171,JKillaII,,18,8,14,22
27172,duuude,,13,2,2,4
27173,fnot,,18,3,12,15
27174,Wilkerson,,13,1,1,2
27175,bauhous,,13,1,1,2
27176,blcline,,20,2,3,5
27177,CasualT,,34,2,14,16
27178,lamestuff,,13,57,1,58
27179,frankster,,18,21,38,59
27180,lilmiss2,,19,47,18,65
27181,mkuehn,,14,1,2,3
27182,gadamer,,31,3,1,4
27183,leper99,,0,1,1,2
27184,mdanuser,,2,8,1,9
27185,TheSOB88,,43,460,760,1220
27186,mvcornelius,,19,23,50,73
27187,pistolntulip,,18,122,5,127
27188,RainmadeMan,,0,641,542,1183
27189,brosephius,,20,265,389,654
27190,BingMcGhandi,,32,20,4,24
27191,argonlightray1,,31,2,1,3
27192,wtf_ever,,6,95,109,204
27193,mme_deviance,,30,20,27,47
27194,dylan7,,19,11,21,32
27195,cowsgonemadd3,,18,13,4,17
27196,floodedcodeboy,,12,7,10,17
27197,arichi,,18,86,153,239
27198,Magma42,,32,50,29,79
27199,0boy,,34,1232,34,1266
27200,tempreddit,,29,486,435,921
27201,longwalker,,29,1,1,2
27202,user69,,12,1,3,4
27203,pwner,,0,1,2,3
27204,noodles12,,18,3,5,8
27205,kip50,,19,7,13,20
27206,Ranugad,,18,7,10,17
27207,Daishiman,,20,20,18,38
27208,VC2217,,43,2,1,3
27209,ThreeT,,31,5,9,14
27210,Hodan,,43,11,10,21
27211,rarrrrrr,,20,10,4,14
27212,rems,,18,223,551,774
27213,grassyknolluk,,19,113,26,139
27214,zaach,,20,12,8,20
27215,tahawus,,18,5,7,12
27216,DropTableUsers,,20,131,56,187
27217,valadil,,20,33,53,86
27218,thudbang,,39,5,5,10
27219,callmecharlie,,12,4,10,14
27220,amiramir,,19,3,1,4
27221,speciousfool,,20,445,55,500
27222,mattOmynameO,,22,31,41,72
27223,deeceeo,,13,27,15,42
27224,abcxyz1234,,18,6,8,14
27225,alchemeron,,18,428,625,1053
27226,SmellyRaghead,,18,1,6,7
27227,Telluride12,,43,74,121,195
27228,amylynne321,,13,9,1,10
27229,hermanlo,,32,66,105,171
27230,GNUGeist,,26,1,2,3
27231,coz23,,18,1,1,2
27232,noobprodigy,,1,219,237,456
27233,stonyandcher,,26,1,1,2
27234,ddade,,38,1,1,2
27235,c0da,,2,66,89,155
27236,ach3030,,11,3,4,7
27237,dadRabbit,,18,79,15,94
27238,mrbill,,13,7,12,19
27239,d0nkeh,,20,1,3,4
27240,TomK,,1,7,3,10
27241,geoscopic,,43,4,7,11
27242,soakratikmethod,,32,3,1,4
27243,sunboy798,,13,1,5,6
27244,IMONMETH,,6,2,1,3
27245,dissdigg,,6,8,23,31
27246,rwg,,20,14,13,27
27247,aythun,,20,57,83,140
27248,long_story_teller,,1,3,1,4
27249,spoids,,19,93,90,183
27250,el_donovano,,1,3,9,12
27251,Whatsthatsound,,1,3,1,4
27252,resolva,,18,124,4,128
27253,NickG,,19,22,32,54
27254,frostyknees,,18,5,22,27
27255,notathrowawayaccount,,6,9,22,31
27256,a_trotskyite,,13,17,46,63
27257,Mustapha_Monds,,32,9,16,25
27258,pivotal,,20,91,123,214
27259,pipian,,23,3,1,4
27260,Sanguine,,13,33,62,95
27261,lolinyerface,,22,155,319,474
27262,gk8679,,18,7,8,15
27263,myplacedk,,20,11,14,25
27264,kfine,,18,10,4,14
27265,strax,,19,47,49,96
27266,deong,,20,160,183,343
27267,luigis_girlfriend,,18,17,13,30
27268,tanside,,10,9,15,24
27269,poohpoohpandah,,19,10,9,19
27270,KarateKid,,18,9,8,17
27271,Wwoody123,,18,4,2,6
27272,spotter,,20,23,61,84
27273,netburnr,,13,1,5,6
27274,pzn,,13,1,1,2
27275,phoenixfireball,,5,35,3,38
27276,toru,,20,33,37,70
27277,boredgeorge,,19,6,5,11
27278,sirgerg2,,13,1,10,11
27279,TheNational22,,43,3,3,6
27280,supremepbsk,,18,5,8,13
27281,bobrocks,,43,13,12,25
27282,ortsed,,13,3,4,7
27283,nnunley,,20,17,14,31
27284,ilikebikes,,19,16,14,30
27285,gamblekat,,20,44,69,113
27286,vokrus,,13,9,14,23
27287,dangph,,20,174,219,393
27288,efree58,,18,5,10,15
27289,Aluhut,,29,31,71,102
27290,charlesgoodall,,43,1,8,9
27291,mikefiction,,18,54,61,115
27292,dcormann,,30,8,4,12
27293,tom94115,,8,1,1,2
27294,inanytime,,1,27,26,53
27295,silentbobsc,,42,339,392,731
27296,ianbanks,,20,1,2,3
27297,userd,,20,43,80,123
27298,Bensch,,19,1033,1712,2745
27299,wallish,,42,305,544,849
27300,WarResistor,,22,8,7,15
27301,jennynyc,,1,1,5,6
27302,yanomamoman,,18,8,6,14
27303,JWarder,,1,7,6,13
27304,travisg,,13,1,1,2
27305,int3,,22,1,1,2
27306,SKROOB,,14,1,2,3
27307,rthomas6,,43,459,571,1030
27308,voxorg5,,4,2,2,4
27309,spiceweasel,,14,87,75,162
27310,shamelessPRhack,,1,188,92,280
27311,sudoko,,30,1,1,2
27312,devinedj,,18,166,104,270
27313,har3,,20,10,9,19
27314,KrisJordan,,20,16,4,20
27315,visarga,,32,439,430,869
27316,raglandpark,,13,57,109,166
27317,kerray,,22,8,16,24
27318,bhunterr,,18,2,3,5
27319,scarlin,,32,2,3,5
27320,LeeJunFan,,13,171,241,412
27321,daddyrief,,31,1,2,3
27322,joecarst,,1,15,30,45
27323,orthros,,0,4,6,10
27324,tallwookie,,20,3,14,17
27325,suedad,,6,12,18,30
27326,Kimura,,9,2122,15,2137
27327,lejoq,,43,14,34,48
27328,tashi-d,,34,5,10,15
27329,iggit,,43,4,2,6
27330,ajadoniz,,5,6,6,12
27331,Shoegaze99,,13,321,317,638
27332,fuckinhell,,18,34,82,116
27333,Prosit,,0,1,5,6
27334,element112,,1,6,5,11
27335,decklap,,19,36,46,82
27336,zoltron2,,13,2,1,3
27337,brettgian,,32,1,2,3
27338,traianus,,32,1,1,2
27339,pera001,,19,4,17,21
27340,FBernadotte,,13,6,6,12
27341,flxstr,,8,1,1,2
27342,TheOpossum,,1,147,211,358
27343,LameRedditCommenter,,19,1,1,2
27344,fattybob,,4,1,8,9
27345,merdely,,9,4,8,12
27346,quinnsa,,13,105,93,198
27347,axonblue,,18,230,202,432
27348,beastlycarnivore,,13,14,13,27
27349,ZACK_DE_LA_ROCHA,,19,19,41,60
27350,lowtone94,,43,228,29,257
27351,exgrafix,,5,1,1,2
27352,dafook,,13,10,5,15
27353,jimbo00000,,22,3,7,10
27354,icancheckyourhead,,1,2,2,4
27355,dudutch,,29,5,9,14
27356,hlvoorhees,,19,5,2,7
27357,Atomsk3,,19,11,13,24
27358,toban,,29,2,2,4
27359,eyeheartyou,,0,199,3,202
27360,toanoma,,19,3,1,4
27361,Sarah_Silverman,,19,9,9,18
27362,robinhoode,,20,6,10,16
27363,throwaway1,,19,1,1,2
27364,bahmak2003,,20,1,3,4
27365,jackastro,,6,6,2,8
27366,jumpstart,,0,1,1,2
27367,HoratioMcMoney1,,13,29,7,36
27368,demige10,,23,1,1,2
27369,spainexpat,,0,2,1,3
27370,iklnob,,19,4,2,6
27371,uberrandom,,18,5,3,8
27372,hailstone,,20,42,54,96
27373,lobofanina,,22,9,20,29
27374,shanemx,,22,3,8,11
27375,RandomOddNumbers,,36,2,1,3
27376,shaze,,1,186,235,421
27377,holysun,,43,1,1,2
27378,zackks,,0,267,529,796
27379,phobs,,0,113,175,288
27380,rizoh,,18,227,31,258
27381,Tekfrog,,18,8,6,14
27382,heston,,22,1,2,3
27383,HonestGuy,,42,6,5,11
27384,canuck-farmer,,35,4,6,10
27385,FuZ3,,43,15,18,33
27386,frikativ54,,30,14,10,24
27387,unknown_lamer,,20,63,130,193
27388,lickmydesktopmonit0r,,36,1,1,2
27389,andjjru,,6,11,28,39
27390,seavan,,0,1,1,2
27391,lanaer,,20,102,179,281
27392,gclaramunt,,20,27,53,80
27393,uzzaruby,,20,11,2,13
27394,leandroc76,,18,34,92,126
27395,AndrewStephens,,20,16,11,27
27396,starlifter71,,13,5,4,9
27397,RadiantBlueLight,,12,84,22,106
27398,JPathis,,22,6,8,14
27399,halobender,,18,30,45,75
27400,Null_State,,20,103,31,134
27401,degustihydrofoil,,3,1,1,2
27402,xitdedragon,,18,41,64,105
27403,cinemascope,,5,1,2,3
27404,smalltalk,,20,3,1,4
27405,bamanation,,13,5,7,12
27406,Fangsinmybeard,,31,19,41,60
27407,bruster,,13,1,2,3
27408,superscooter,,18,1,2,3
27409,rickk,,20,84,116,200
27410,darkchild82,,5,786,36,822
27411,ladyshelly,,34,39,2,41
27412,jericho,,43,120,209,329
27413,Gills131,,31,1,2,3
27414,placeholder,,1,199,118,317
27415,Viamin,,18,3,2,5
27416,fnog,,5,2,2,4
27417,smokkeyy,,42,1,3,4
27418,fala2000,,20,1,2,3
27419,bascule,,20,118,39,157
27420,cosmofraek,,18,29,94,123
27421,batkin,,19,2,4,6
27422,golansm,,13,21,1,22
27423,spicypiss,,18,14,12,26
27424,funkstick,,19,37,5,42
27425,right_to_arm_bears,,19,99,153,252
27426,mjayb,,10,5,10,15
27427,AssignMeARole,,31,8,8,16
27428,lickmydesktopmonitor,,27,3,1,4
27429,doctorgonzo,,13,424,100,524
27430,cport1,,32,8,1,9
27431,usr211211212,,20,18,38,56
27432,rsavage,,43,19,36,55
27433,jbb3rd,,13,6,4,10
27434,drfishy520,,18,4,3,7
27435,ssalmine,,20,4,4,8
27436,alidin,,22,1,5,6
27437,Ulyss3s,,8,45,4,49
27438,paulie1313,,5,1,6,7
27439,isunixthekey,,34,3,2,5
27440,ccmarsig,,13,1,2,3
27441,jnet,,32,1,2,3
27442,jayz28,,16,1,3,4
27443,chuck001,,19,46,14,60
27444,RayNbow,,20,28,35,63
27445,tevslin,,19,2,2,4
27446,shr1n1,,39,11,12,23
27447,unsubscribe,,18,21,41,62
27448,r12sxiqau,,43,1,1,2
27449,archaeopteryx,,29,42,21,63
27450,SteveRawx,,18,110,66,176
27451,okidokegirl,,18,14,23,37
27452,ToxicSox,,1,1,2,3
27453,raghurao,,13,1,1,2
27454,KevMike,,43,58,93,151
27455,narph,,18,3,5,8
27456,gravityboard,,32,6,12,18
27457,greut,,20,200,26,226
27458,mtbhucker,,0,6,18,24
27459,cabcaraway,,18,3,3,6
27460,BigKahunaBurger,,1,62,86,148
27461,novocaine21,,17,6,12,18
27462,anewaccount,,43,52,31,83
27463,timmenzies,,20,1,1,2
27464,rob_b,,20,1,1,2
27465,laprice,,20,187,127,314
27466,jooj1313,,1,2,1,3
27467,jables,,19,1,3,4
27468,delirial00,,20,2,5,7
27469,JigoroKano,,16,8,11,19
27470,SVKinAZ,,13,2,1,3
27471,jsghetto,,20,1,1,2
27472,Derge,,43,20,29,49
27473,Larry_Fishburn,,3,1,7,8
27474,TheLoneHoot,,31,121,199,320
27475,pokemans,,32,5,1,6
27476,meunierd,,18,3,4,7
27477,Randy_Marsh,,30,2,1,3
27478,pahanaama,,34,1,6,7
27479,loginname,,34,2,10,12
27480,jlowry,,13,86,45,131
27481,Blargh12345,,19,1,1,2
27482,lanzkron,,20,55,15,70
27483,sango0711,,5,37,104,141
27484,triggersix,,22,36,51,87
27485,MyCn18,,13,19,24,43
27486,aslan_ia,,18,1,2,3
27487,Facelessjoe,,1,149,112,261
27488,paulquinn00,,19,39,43,82
27489,No0n3,,9,25,29,54
27490,EmperorPalpatine,,19,2,1,3
27491,jbogli,,18,1,2,3
27492,voracity,,18,59,100,159
27493,matsalleh,,1,12,4,16
27494,TH322,,0,32,17,49
27495,redog,,17,424,739,1163
27496,Booie,,21,4,14,18
27497,greenmeatmonster,,20,2,2,4
27498,BusStation16,,13,11,18,29
27499,kitomo,,13,2,1,3
27500,isaacs,,1,7,17,24
27501,EthanPDX,,14,4,13,17
27502,Scientitian,,19,10,20,30
27503,malefactor1,,41,4,2,6
27504,shinobikins,,20,2,3,5
27505,danny_,,0,184,176,360
27506,geoserv,,5,1,1,2
27507,OtherOne,,34,71,8,79
27508,Tonnynocks,,13,2,3,5
27509,zeroooooooooooo,,1,69,75,144
27510,mope,,11,1,2,3
27511,Aixelsyd720,,19,3,7,10
27512,synt4x,,18,4,11,15
27513,mrfletcher,,9,1,1,2
27514,shinya666,,20,91,29,120
27515,singnyc,,13,5,2,7
27516,sixsidepentagon,,11,1,1,2
27517,MajorObvious,,22,1,2,3
27518,nirjhari,,20,2,4,6
27519,bonniemuffin,,34,8,14,22
27520,Homestar,,18,14,21,35
27521,stoneyb,,30,1,1,2
27522,nelag,,13,6,3,9
27523,micahglasser,,36,6,4,10
27524,321,,1,1,2,3
27525,lightedgiraffe,,19,15,14,29
27526,cryptlib,,19,2,1,3
27527,dude111,,0,1,2,3
27528,darkswarm,,18,40,11,51
27529,conal,,20,14,13,27
27530,zach,,20,55,43,98
27531,Ruckus,,18,26,32,58
27532,adamtsai,,19,21,28,49
27533,sofiseymor,,31,82,117,199
27534,Cobalt-Spike,,13,7,14,21
27535,kharriss,,20,1,1,2
27536,tackle,,43,149,201,350
27537,superman9,,13,1,1,2
27538,EvilGeniusCartier,,18,3,10,13
27539,NMSpaz,,42,13,14,27
27540,blankspaceseattle,,19,3,3,6
27541,aladi,,18,3,1,4
27542,HiddenTalents99,,0,9,1,10
27543,naughty,,20,21,47,68
27544,5to10,,1,2,1,3
27545,redditking,,19,312,33,345
27546,shoeninja,,18,35,31,66
27547,rightchoiceamerica,,13,2,5,7
27548,3rdFunkyBot,,13,144,55,199
27549,vaibhavsagar,,20,28,15,43
27550,newagenda,,32,1,1,2
27551,Gdupandout,,21,2,2,4
27552,timjay,,31,4,3,7
27553,deitrich_reitrich,,34,14,7,21
27554,khafra,,6,615,1082,1697
27555,DavidHausen,,18,48,92,140
27556,Jasper1984,,31,134,264,398
27557,christierney,,20,3,5,8
27558,Rhiannon,,13,680,19,699
27559,I_LOVE_ANAL_SEX,,1,37,31,68
27560,Tarn,,32,2,4,6
27561,simple_solution,,12,1,1,2
27562,Li17,,32,17,26,43
27563,nosuperstitions,,1,1,1,2
27564,gpowell,,31,17,3,20
27565,TruthSerum44,,3,35,40,75
27566,elsagacious,,18,220,295,515
27567,G325C9,,31,16,17,33
27568,scientologyrulez,,34,1,1,2
27569,lilacsandlolita0513,,13,1,1,2
27570,ondal,,0,68,82,150
27571,mov,,20,1,2,3
27572,will_itblend,,34,352,595,947
27573,OldeBill,,12,1,5,6
27574,yoink15,,32,21,20,41
27575,potatochipthief13,,13,7,4,11
27576,nipps85,,19,268,257,525
27577,treefrog55,,34,1,4,5
27578,phoneguy,,0,12,1,13
27579,col-pepper,,19,1,1,2
27580,ToastAndJam,,19,18,27,45
27581,Gaylord_Focker,,8,1,1,2
27582,blinkkk,,20,1,4,5
27583,tomek77,,0,51,80,131
27584,Palin2012,,13,10,8,18
27585,silentp,,32,7,7,14
27586,brokenburrito,,17,1,1,2
27587,hashbangperl,,20,26,27,53
27588,jacobiconstant,,5,13,19,32
27589,fatterangrywiccan,,0,22,58,80
27590,namsu971,,18,38,5,43
27591,i_am_the_best,,13,1,1,2
27592,locqlemur,,22,9,12,21
27593,denisedwitmer,,26,2,1,3
27594,MrSurly,,5,73,140,213
27595,projectshave,,20,186,186,372
27596,WaterboardWetbackLOL,,22,27,49,76
27597,Observant_Servant,,18,13,25,38
27598,fluffle,,20,16,24,40
27599,adma1,,22,64,72,136
27600,sogroig,,10,19,16,35
27601,burnblue,,6,259,433,692
27602,nick31,,12,11,4,15
27603,carny666,,0,351,241,592
27604,bcompton,,19,10,11,21
27605,puffypants123,,1,423,274,697
27606,hkstar,,38,2,1,3
27607,purefx,,34,7,19,26
27608,desultorypawn,,10,48,54,102
27609,the_trout,,3,179,193,372
27610,polnikes,,30,2,8,10
27611,maxm,,1,15,15,30
27612,yougene,,8,12,11,23
27613,skraemate,,19,3,2,5
27614,myth1n,,18,27,12,39
27615,Minim4c,,18,14,19,33
27616,mcsethanon,,32,31,49,80
27617,trjordan,,20,47,59,106
27618,chopp3r,,0,1,1,2
27619,newacct,,18,15,5,20
27620,jfb3,,20,3,3,6
27621,sprash,,20,35,44,79
27622,dadvocate,,32,4,10,14
27623,ScottMaximus23,,22,5,8,13
27624,moogs,,22,261,329,590
27625,shables2222,,19,7,25,32
27626,phathippo,,31,4,1,5
27627,Brian975,,18,8,16,24
27628,kilowatt,,20,102,87,189
27629,vicgolgo13,,39,2,2,4
27630,GrantShoe,,1,3,2,5
27631,user_1,,28,1,1,2
27632,Herge,,20,5,3,8
27633,cinta5,,34,13,1,14
27634,melindia,,22,31,1,32
27635,carving_a_giant,,20,2,2,4
27636,steelio,,19,123,185,308
27637,troymg,,13,2,5,7
27638,ataricult,,5,19,30,49
27639,dancerobots,,31,5,8,13
27640,o2pb,,18,22,26,48
27641,cconger,,20,1,8,9
27642,pornleak,,18,11,1,12
27643,gliscameria,,18,334,315,649
27644,jpclex,,13,3,8,11
27645,letthemswim,,22,6,7,13
27646,keito,,42,83,138,221
27647,rabidw,,20,38,49,87
27648,fredinbed,,5,1,4,5
27649,godofpumpkins,,20,4,3,7
27650,jbindel,,20,18,35,53
27651,macousin,,18,1,5,6
27652,vinblackham,,18,116,29,145
27653,alakra,,8,2,4,6
27654,liarliarpantsonfire,,18,10,10,20
27655,spindoc,,42,1,1,2
27656,marshray,,20,19,25,44
27657,morn,,22,2,1,3
27658,ziquapix,,18,5,3,8
27659,dreamlandburns,,32,2,2,4
27660,Spankypoo,,34,14,19,33
27661,climbinkid,,18,2,9,11
27662,mkultra123,,13,4,12,16
27663,gtani7,,20,17,14,31
27664,adutzu,,13,13,3,16
27665,thekingoflapland,,32,51,51,102
27666,okeefe,,20,37,70,107
27667,delliott64,,22,6,1,7
27668,black44166,,17,1,1,2
27669,bravetoaster,,19,18,2,20
27670,petersenman21,,13,7,3,10
27671,prpldrgnfly,,43,1,2,3
27672,totalspaceship,,36,1,1,2
27673,SUNY_Boy,,23,1,1,2
27674,lAmInLoveWithJesus,,18,4,2,6
27675,employeeno5,,1,230,262,492
27676,wfarr,,20,23,57,80
27677,GenevaConventionsFTW,,4,1,1,2
27678,godLESS1,,19,29,47,76
27679,TheCanadian,,43,3,4,7
27680,hidiloper,,29,3,2,5
27681,suexian,,19,324,662,986
27682,cloverT,,19,5,4,9
27683,wmv248,,1,2,1,3
27684,mike23bz,,13,4,3,7
27685,jkr,,18,1,2,3
27686,MyrddinE,,20,333,525,858
27687,codeodor,,20,285,254,539
27688,suprthug8d,,42,6,1,7
27689,tryx,,20,505,392,897
27690,FearlessDreams,,5,7,1,8
27691,ondrah,,19,15,17,32
27692,Apple_dev,,22,1,1,2
27693,morehush,,1,2,9,11
27694,eadinad,,1,108,55,163
27695,rapist,,19,104,95,199
27696,Larakin,,13,2,6,8
27697,WhoRadley,,31,1,1,2
27698,drunk2much,,36,1,2,3
27699,Cherry5oda,,43,2,3,5
27700,angryostrich,,1,225,218,443
27701,jennaon,,4,4,5,9
27702,errantKnave,,22,30,52,82
27703,politicssuck1,,19,2,3,5
27704,ckasper,,43,5,5,10
27705,Willop23,,32,1,2,3
27706,adambeta,,1,15,13,28
27707,anmar,,13,7,10,17
27708,redleif,,1,1,1,2
27709,venificusd,,1,15,12,27
27710,Kaws,,1,12,20,32
27711,Sonicus,,18,1,2,3
27712,Foone,,20,194,228,422
27713,adenium,,5,1,2,3
27714,klancaster1957,,20,12,16,28
27715,kanuk876,,32,374,461,835
27716,6f6,,19,61,28,89
27717,BBK2008,,13,13,24,37
27718,drJamesKamm,,23,2,1,3
27719,ganelo,,34,1,1,2
27720,alexfarran,,20,114,38,152
27721,dmwit,,20,163,217,380
27722,RobotLordofTokyo,,18,28,75,103
27723,teKniepo,,36,2,1,3
27724,amade,,20,11,12,23
27725,blogmeister,,13,17,4,21
27726,jdweeks,,1,2,1,3
27727,undauntedspirit,,19,17,21,38
27728,jmkogut,,20,52,67,119
27729,thesqlguy,,20,155,67,222
27730,kaoblues,,13,5,1,6
27731,mrlawlsome,,20,30,59,89
27732,jschau2,,13,87,1,88
27733,MorganQuinn,,19,12,34,46
27734,redditboy23,,18,2,1,3
27735,thenationalgadfly,,13,7,1,8
27736,glaucon,,19,2,2,4
27737,syobosyobo,,41,17,6,23
27738,rhialto,,9,2,1,3
27739,locster,,20,24,43,67
27740,vstas,,31,21,17,38
27741,Purpledrank,,1,44,114,158
27742,grimboy,,20,154,290,444
27743,huybee,,19,62,1,63
27744,EmoticonMan,,19,1,5,6
27745,raoul,,14,2,1,3
27746,Ginseng,,0,1,1,2
27747,onezerozeroone,,10,133,139,272
27748,ryth,,34,6,3,9
27749,skatanic,,18,13,23,36
27750,jodythebad,,1,128,120,248
27751,SovereignZ,,18,69,55,124
27752,doctapeppa,,12,91,122,213
27753,momeb,,12,6,12,18
27754,akvj1n,,31,8,7,15
27755,robahu,,20,18,18,36
27756,gulp35,,22,25,23,48
27757,MisterBill,,12,8,11,19
27758,zeroelixis,,12,21,34,55
27759,esc125,,0,10,9,19
27760,mot_choker,,31,1,1,2
27761,daedstars,,14,7,4,11
27762,procrasturbate,,20,3,4,7
27763,amichai,,6,1,2,3
27764,TheManWithNoName,,20,128,88,216
27765,fourthie,,34,89,51,140
27766,gmnotyet,,36,7,9,16
27767,emperor_of_fun,,19,77,81,158
27768,PeterBraden,,20,8,1,9
27769,contentmanager,,0,1,4,5
27770,epyon9283,,30,2,2,4
27771,Cebus,,1,80,39,119
27772,Cowbellz,,13,4,3,7
27773,apower,,5,7,17,24
27774,scornedpatriot,,8,22,27,49
27775,slypheed,,7,1,1,2
27776,Prosody,,22,35,40,75
27777,bwarbiany,,19,62,5,67
27778,easedowntheroad,,18,4,7,11
27779,dimitrynewyork,,31,2,2,4
27780,Johnny_Guitar,,13,38,57,95
27781,pat965,,18,62,134,196
27782,pbh101,,42,2,5,7
27783,Elmira_Green_Gulch,,32,17,2,19
27784,Fishyfishy44,,31,1,2,3
27785,alextraynor,,22,2,1,3
27786,DisConform,,13,307,53,360
27787,CygnusXII,,3,2,4,6
27788,ass2mouth,,18,11,18,29
27789,pogothemonkey81,,21,261,24,285
27790,andrewmp,,31,27,23,50
27791,jeffthestripper,,13,2,1,3
27792,sleepingsquirrel,,20,41,44,85
27793,larsivi,,20,4,7,11
27794,waterclock,,19,13,3,16
27795,georgeb48,,13,5,6,11
27796,andrepl,,20,1,2,3
27797,andy_boyd,,5,40,75,115
27798,romcabrera,,20,132,132,264
27799,keupo,,15,3,6,9
27800,Tyler32,,32,3,2,5
27801,chopper77,,31,4,7,11
27802,ramblertwin,,34,7,7,14
27803,imnotanitwit,,0,1,1,2
27804,bakergo,,18,6,7,13
27805,fakenathan,,43,4,9,13
27806,archipodius,,13,1,1,2
27807,japherwocky,,31,3,5,8
27808,PreservedKillick,,4,17,16,33
27809,upnorth1967,,13,18,36,54
27810,quakerorts,,13,573,231,804
27811,ranscot,,13,271,141,412
27812,kickasspodcast,,19,7,8,15
27813,btl,,31,827,994,1821
27814,hermzz,,18,116,92,208
27815,icefox,,20,201,118,319
27816,expedient,,20,2,6,8
27817,retlawmacpro,,18,19,32,51
27818,alrokerjr,,18,1,1,2
27819,snowchaser,,18,2,9,11
27820,wvit1001,,13,2,3,5
27821,Jesusish,,13,423,63,486
27822,alexes,,13,2,2,4
27823,mattsta,,19,7,2,9
27824,por,,19,54,17,71
27825,cometparty,,29,402,436,838
27826,fieldglass,,19,4,2,6
27827,00seven,,34,2,3,5
27828,bababeechums,,13,34,4,38
27829,allpurposecleaning,,13,27,4,31
27830,sdbest,,19,20,2,22
27831,UnknownVariable,,29,58,80,138
27832,zck,,32,183,204,387
27833,_sic,,0,139,190,329
27834,amykate,,43,1,4,5
27835,OrionBlastar,,19,16,10,26
27836,Cloukyo,,34,66,91,157
27837,LAmarODom420,,21,4,8,12
27838,Kardon,,8,4,4,8
27839,drcode,,20,54,22,76
27840,vanimal,,1,6,13,19
27841,surfincolorado,,18,9,7,16
27842,quentinnuk,,43,326,58,384
27843,bobf,,20,2,1,3
27844,ModelConsumer,,19,14,17,31
27845,JordanGreenberg,,32,7,13,20
27846,kunalshah83,,8,1,1,2
27847,pbr,,12,13,31,44
27848,informer100,,29,2,1,3
27849,greedz,,18,24,58,82
27850,fabreeze,,23,2,3,5
27851,nakedpeewee,,13,48,19,67
27852,nevries,,4,7,3,10
27853,fangolo,,19,1061,483,1544
27854,InfernalTempestX,,8,2,1,3
27855,jasondragon,,13,147,119,266
27856,FISHBWOY09,,18,44,99,143
27857,IVIAuric,,43,148,116,264
27858,DaTruth,,19,3,3,6
27859,harrison_the_skater,,22,4,7,11
27860,vyoma999,,5,4,12,16
27861,nestletollhouse,,13,2,3,5
27862,splato,,20,5,1,6
27863,jimmymets,,13,202,24,226
27864,Katsuichi,,34,16,18,34
27865,uprightnetizen,,31,1,1,2
27866,ProfaneDrunk,,18,4,1,5
27867,joefiro,,5,8,8,16
27868,mr_dbr,,20,438,495,933
27869,trehug,,42,1,2,3
27870,g_sus,,12,48,27,75
27871,lifelonglearning,,42,37,44,81
27872,nyamatongwe,,20,2,2,4
27873,BFinuc,,19,50,77,127
27874,myconetyeti,,31,1,1,2
27875,coreyp319,,19,15,36,51
27876,rilo,,18,99,91,190
27877,earthheart,,29,47,67,114
27878,ToughNoogies,,22,108,82,190
27879,jockc,,20,40,55,95
27880,gorvis,,30,2,1,3
27881,xniphobe,,1,53,26,79
27882,jaydoggy,,32,3,5,8
27883,spoondoodle2,,26,4,3,7
27884,polgara04,,11,24,67,91
27885,apsudraconis,,19,4,7,11
27886,payoff,,19,184,274,458
27887,warpzero,,0,11,14,25
27888,bekele2617,,8,45,42,87
27889,krazymelvin,,4,1,3,4
27890,bobolux,,0,8,29,37
27891,Freidenker,,23,1,1,2
27892,junk2006,,18,12,21,33
27893,hal22,,20,53,24,77
27894,callmemrshades,,1,2,6,8
27895,collegesophomore,,39,2,1,3
27896,Knute5,,13,55,106,161
27897,joecam,,5,15,52,67
27898,pmf,,20,89,89,178
27899,Bozodog,,0,2,9,11
27900,acpawlek,,13,137,283,420
27901,pandacity,,34,1,2,3
27902,gimpslayer,,1,1,1,2
27903,prosanity,,12,2,2,4
27904,cdenyikayedu,,31,6,16,22
27905,markfl12,,20,1,1,2
27906,luvthymullet,,19,2,5,7
27907,onehundredmonkeys,,18,15,15,30
27908,CherryInHove,,34,195,188,383
27909,biglook,,20,3,5,8
27910,dirvanDambilo,,30,99,135,234
27911,OneUpper,,20,14,17,31
27912,randomman420,,19,10,14,24
27913,Justinsaccount,,20,79,144,223
27914,fh_,,20,6,5,11
27915,rsanheim,,20,9,5,14
27916,jamin_brook,,13,482,271,753
27917,irregardless,,19,265,225,490
27918,Kushali,,29,2,4,6
27919,seudonymus,,20,8,6,14
27920,finite,,20,83,90,173
27921,willson,,34,16,31,47
27922,cd411,,13,4,2,6
27923,ppot667,,13,5,6,11
27924,rockicon82,,13,313,332,645
27925,sedo1800,,1,29,58,87
27926,Elfman72,,26,2,2,4
27927,ubitendo,,31,249,318,567
27928,xlamplighter,,18,295,413,708
27929,Serious-Cat,,17,2,1,3
27930,Jessica_Henderson,,20,468,345,813
27931,jemjabella,,20,2,8,10
27932,snv3000,,18,4,3,7
27933,userunderscorename,,18,30,38,68
27934,Apfel,,12,1,2,3
27935,13ren,,20,761,1118,1879
27936,arkmtech,,13,2,2,4
27937,splynncryth,,10,2,3,5
27938,tribat,,1,1,3,4
27939,jtmarlin,,0,62,2,64
27940,silverfoxx08,,21,27,40,67
27941,Scheschy,,1,3,4,7
27942,ubito,,13,1,2,3
27943,Bex4Jesus,,32,27,2,29
27944,I_pity_the_fool,,31,41,68,109
27945,rep_movsd,,20,15,6,21
27946,fkn_eh,,28,2,3,5
27947,Hagoroo,,8,2,2,4
27948,HoneyMustardIcing,,18,1,1,2
27949,djwm,,20,9,15,24
27950,Lycoris,,1,16,46,62
27951,pwnies,,18,3,2,5
27952,calantus,,13,379,648,1027
27953,auiris,,13,1,3,4
27954,fritzair,,13,5,11,16
27955,discdigger,,36,5,5,10
27956,g2boojum,,20,1,1,2
27957,RyanGWU82,,20,81,40,121
27958,arkpog,,20,6,5,11
27959,mads-80,,18,30,54,84
27960,khell,,18,7,1,8
27961,jennybold,,19,20,25,45
27962,idiocrat,,31,3,2,5
27963,Suicide_Guy,,22,179,133,312
27964,miketwo1s,,19,22,30,52
27965,l034me,,18,13,13,26
27966,timekillerjay,,32,5,2,7
27967,querulous,,20,16,19,35
27968,trollnick,,14,2,1,3
27969,chegeordievara,,13,63,88,151
27970,critteriste,,13,12,1,13
27971,Lloyd_Christmas,,43,1,1,2
27972,nobodyspecial,,31,216,188,404
27973,kinesis,,18,1,1,2
27974,Esoteria,,8,64,68,132
27975,TheChaosKitty,,13,12,1,13
27976,killerstorm,,20,441,688,1129
27977,coadmunki,,18,1,1,2
27978,mustardgas,,34,2,2,4
27979,Wangus,,0,2,4,6
27980,niccha,,13,324,18,342
27981,cdward,,20,9,14,23
27982,TheQuoteBot,,32,1,9,10
27983,redbike,,31,4,10,14
27984,yorgle,,1,3,14,17
27985,OGLothar,,19,51,57,108
27986,EricArthurBlair,,0,20,29,49
27987,chembro84,,13,1,3,4
27988,stanmartin1952,,19,43,14,57
27989,ttys0,,20,2,4,6
27990,AnotherLameHaiku,,12,12,17,29
27991,aphrodite1,,13,21,38,59
27992,hoaznod,,43,9,3,12
27993,svenjolly,,10,8,5,13
27994,fubuki,,19,47,105,152
27995,ladycrappo,,43,272,184,456
27996,MachinShin2006,,9,260,455,715
27997,dysenteryduke,,13,10,1,11
27998,antillus,,3,1,6,7
27999,martin87654,,43,2,1,3
28000,snotrokit,,13,207,293,500
28001,prof_booty,,20,3,2,5
28002,Cole_Avenue,,34,2,5,7
28003,DaveTheLightingGuy,,34,10,8,18
28004,Badenkin,,19,2,1,3
28005,weeble,,20,1,1,2
28006,iusig,,18,2,6,8
28007,drogian,,31,1,1,2
28008,oditogre,,22,627,856,1483
28009,thylacine222,,41,1,1,2
28010,An_Anteater,,18,1,4,5
28011,lefty100,,13,3,1,4
28012,Guinnessin,,18,10,15,25
28013,dossy,,20,4,1,5
28014,matthooks,,16,5,8,13
28015,jimrooney,,43,16,27,43
28016,fradiavolo,,19,1,2,3
28017,GhostOfRussert,,13,12,9,21
28018,klinegl,,19,3,1,4
28019,francpaul,,30,2,1,3
28020,RedditSuxFuckingAss,,32,1,2,3
28021,EmmDock,,1,2,3,5
28022,paaki,,18,9,12,21
28023,redditards,,6,1,2,3
28024,JohnSmith2008,,13,20,20,40
28025,ivette81,,18,20,27,47
28026,Jrix,,18,8,10,18
28027,patrickinminneapolis,,39,2,2,4
28028,kiddcode,,13,1,2,3
28029,ness0216,,18,23,33,56
28030,whackamole64,,0,1,3,4
28031,Gro-Tsen,,32,23,12,35
28032,headspace,,11,3,6,9
28033,replicacobra,,1,2,6,8
28034,JesusWuta40oz,,11,4,9,13
28035,dwcharn,,34,1,1,2
28036,oddst,,1,139,19,158
28037,user1024,,12,3,1,4
28038,madeofcheese,,18,3,5,8
28039,andrewjs42,,17,3,5,8
28040,Ninjaattack,,22,7,5,12
28041,littleboylost,,20,3,5,8
28042,Denki,,18,3,2,5
28043,gucker,,18,10,4,14
28044,papadoc,,13,1,1,2
28045,cmiller173,,13,112,168,280
28046,spyderiii,,1,40,10,50
28047,Latch,,15,22,54,76
28048,Oswyt3hMihtig,,13,45,50,95
28049,fhauge,,29,6,8,14
28050,sanotaan,,10,7,18,25
28051,tweetums,,29,1,1,2
28052,sutcivni,,18,12,12,24
28053,redditeer,,31,62,93,155
28054,Pendleton1990,,1,3,4,7
28055,ovreucpac,,19,14,16,30
28056,Sherm,,19,115,176,291
28057,portalcakes,,0,2,4,6
28058,justryde,,18,12,37,49
28059,lyrnx,,5,1,1,2
28060,oregoncon,,5,1,3,4
28061,geik,,22,13,13,26
28062,whiterabbitmuse,,2,1,2,3
28063,amabaie,,19,1,1,2
28064,thefieryking,,1,1,1,2
28065,Yabbaba,,20,10,23,33
28066,lachristy,,34,6,1,7
28067,Stinkis,,11,1,2,3
28068,dragonfly_blue,,20,7,5,12
28069,ian-t,,19,5,3,8
28070,jinkies,,42,4,6,10
28071,daversf,,13,14,6,20
28072,HiluxCrux,,34,49,114,163
28073,qwerty123321,,22,35,33,68
28074,visceralflux,,22,1,2,3
28075,arrowaytech,,1,2,5,7
28076,manflesh,,20,5,5,10
28077,RD-Arcadia,,20,4,2,6
28078,azenhi,,19,18,31,49
28079,DonnieMarco,,34,6,9,15
28080,bechus,,1,66,69,135
28081,NAntill,,22,24,8,32
28082,jedsen,,42,8,13,21
28083,jambajews,,23,30,42,72
28084,key95,,15,147,74,221
28085,Stancisco,,13,2,3,5
28086,bgfinkel,,18,15,45,60
28087,logic,,18,4,9,13
28088,theprizefight,,1,7,2,9
28089,gjl321,,18,5,1,6
28090,nicwilliams,,43,1,3,4
28091,Gluverty,,18,40,91,131
28092,Dave222222,,32,22,31,53
28093,opek,,32,3,10,13
28094,minxer,,36,2,4,6
28095,Pharaonic,,32,219,257,476
28096,tedbowman,,19,15,7,22
28097,eggplantoffire,,12,8,24,32
28098,pecet,,18,19,7,26
28099,Jambi,,29,47,49,96
28100,bndr,,19,1,1,2
28101,mdfmk05,,13,63,23,86
28102,gaunilo,,5,40,2,42
28103,Jacob_dp,,32,84,16,100
28104,justarandomguy,,30,1,1,2
28105,jliendo,,0,16,5,21
28106,billbakeracmorg,,34,1,2,3
28107,andersbergh,,20,11,17,28
28108,blackraven36,,6,1,1,2
28109,rottendolls,,32,42,4,46
28110,kristine25,,1,36,18,54
28111,mcroydon,,20,1,1,2
28112,dangerdoug,,18,15,17,32
28113,trakus,,32,2,1,3
28114,bking,,18,8,1,9
28115,TheAutophobe,,30,18,34,52
28116,tprzepiorka,,35,1,1,2
28117,Atomics,,31,879,1102,1981
28118,Azi,,18,3,6,9
28119,materialist,,32,181,226,407
28120,onan,,31,64,78,142
28121,drunksquirrel,,8,1,2,3
28122,ballaa,,20,7,5,12
28123,livingcasper,,34,2,11,13
28124,mrpeabody208,,18,1,8,9
28125,CowboyDan,,13,336,95,431
28126,KCBassCadet,,32,35,36,71
28127,monkmellon,,18,16,25,41
28128,perb123,,1,452,306,758
28129,pauljonas,,20,1,1,2
28130,TutsiPop,,22,2,1,3
28131,antisocialiting,,19,1,6,7
28132,enocenip,,32,85,56,141
28133,calumr,,20,60,25,85
28134,baltman,,13,1,1,2
28135,AngryClarinettist,,29,2,3,5
28136,postalrat,,29,30,37,67
28137,thau,,20,16,3,19
28138,wjg10,,13,139,98,237
28139,leehp83,,14,6,6,12
28140,chickenlittle,,13,3,7,10
28141,cedargrove,,1,455,479,934
28142,avid_reader1986,,30,4,5,9
28143,__hage,,41,1,2,3
28144,DestroyedGenius,,6,1,1,2
28145,joshross,,13,5,13,18
28146,ohxten,,20,580,213,793
28147,jetmark,,13,146,296,442
28148,A_Human_Being,,1,86,73,159
28149,rubbermaid,,19,106,125,231
28150,dutchlad,,13,21,12,33
28151,UntakenUsername,,22,548,1214,1762
28152,jungle_jim,,19,17,26,43
28153,skeez,,10,51,29,80
28154,azron,,19,1505,837,2342
28155,lubricious,,34,132,294,426
28156,angie13,,43,24,5,29
28157,AnnFurthermore,,19,14,31,45
28158,ConsciousPilot,,43,31,19,50
28159,somethingup,,31,9,15,24
28160,eiketsujinketsu,,1,1,1,2
28161,sofa,,0,10,32,42
28162,cappie2000,,12,2,1,3
28163,raj200,,5,102,2,104
28164,bkey23,,19,5,10,15
28165,nocreativityx,,12,17,27,44
28166,arniegrape,,18,2,4,6
28167,tom_at_biketempe,,22,1,2,3
28168,natch,,32,280,371,651
28169,BillyJeansBaby,,13,11,7,18
28170,Infinity_Wasted,,22,266,524,790
28171,iesvs,,8,14,56,70
28172,trot-trot,,0,79,17,96
28173,RandomChu,,20,1,1,2
28174,Torq,,20,2,2,4
28175,burritovision,,19,8,7,15
28176,crego20,,32,9,14,23
28177,richiejp,,22,27,55,82
28178,limabean4,,16,4,2,6
28179,senzen,,18,2,21,23
28180,bart2019,,20,363,644,1007
28181,raindoggie,,5,3,5,8
28182,TwoSweet,,43,17,20,37
28183,JustinKSU,,22,1,1,2
28184,cassius_,,22,13,16,29
28185,jaguar_paw,,20,8,9,17
28186,erwanl,,20,38,42,80
28187,groapacuprosti,,18,5,3,8
28188,jonahan,,29,52,46,98
28189,J2011R,,31,12,7,19
28190,occidental_inkling,,10,52,129,181
28191,fiercelyfriendly,,34,381,601,982
28192,PartyInMyTummy,,32,24,40,64
28193,gte910h,,31,93,143,236
28194,Jacqueline_Hyde,,31,8,11,19
28195,billcube,,20,12,17,29
28196,sighbourbon,,34,347,561,908
28197,Pynchon,,5,4,7,11
28198,patrickcollison,,20,7,5,12
28199,mollylolly88,,18,4,6,10
28200,murphy99,,20,2,1,3
28201,ReanLu,,18,2,6,8
28202,maslachak,,29,2,2,4
28203,deus_pater,,7,2,7,9
28204,MeridianJP,,18,157,229,386
28205,samrobroy,,8,3,1,4
28206,drtyfrnk,,1,170,295,465
28207,SarcasticGuy,,13,83,135,218
28208,qax951,,4,6,3,9
28209,millymilltown,,43,2,7,9
28210,jstills,,19,1316,341,1657
28211,KeyserSosa,,1,99,19,118
28212,xed122333,,19,4,8,12
28213,Lord_Hex,,43,7,13,20
28214,jessebogan,,19,1,1,2
28215,ocicat,,22,86,42,128
28216,kisschicken,,22,21,30,51
28217,redalastor,,20,156,200,356
28218,Harelin,,31,10,12,22
28219,armrest,,18,1,5,6
28220,Nicholie,,13,138,174,312
28221,Dinglefarmer,,19,310,240,550
28222,velocityhead,,22,4,9,13
28223,ryanx435,,19,204,61,265
28224,metaGlass,,14,3,2,5
28225,Sidewinder77,,19,406,10,416
28226,worldking,,0,3,2,5
28227,beardjam,,43,2,2,4
28228,Sheffield_Police,,1,1,1,2
28229,TheTempest,,13,3,1,4
28230,LongTimeFirstTime,,18,40,33,73
28231,Gnascher,,6,21,33,54
28232,judgeschmales,,13,7,5,12
28233,JowSithm,,4,1,1,2
28234,d0odx,,17,19,3,22
28235,Dragon256,,19,71,4,75
28236,jms11235,,0,3,4,7
28237,Digital_Omnivore,,19,6,17,23
28238,mrmaxpowers,,18,2,2,4
28239,deepcleansingguffaw,,20,71,148,219
28240,colmcnamara,,18,4,17,21
28241,ngangishetti,,18,6,17,23
28242,dock2,,18,5,7,12
28243,arnonrgo,,20,2,1,3
28244,sdeken,,1,3,6,9
28245,therustytracks,,0,14,21,35
28246,Xenius,,18,2,4,6
28247,dcormier,,19,31,50,81
28248,ak472u,,19,2,6,8
28249,babaganoosh,,12,19,25,44
28250,grumble_au,,32,24,21,45
28251,brstilson,,19,233,196,429
28252,oldchicolocal,,18,4,1,5
28253,slygreyfox,,1,12,4,16
28254,seven,,20,14,17,31
28255,xendmaker,,34,1,1,2
28256,americanhellyeah,,20,606,538,1144
28257,PhuQ,,32,67,163,230
28258,Morghus,,1,53,89,142
28259,Aiue,,18,5,1,6
28260,lmntal,,31,2,6,8
28261,nofrak,,19,112,300,412
28262,Lunchbox753,,16,1,1,2
28263,sdhjkjhgfdxfgh,,1,1,1,2
28264,videothink,,19,19,23,42
28265,strongox,,19,16,4,20
28266,morthul,,8,1,1,2
28267,uses,,1,185,112,297
28268,kragnax,,29,169,203,372
28269,desertpuke,,18,7,44,51
28270,cumhur,,5,15,13,28
28271,therealtrypto,,0,22,20,42
28272,rox_midge,,20,34,73,107
28273,rzzazzr,,20,22,34,56
28274,Blacks_Are_Retarded,,0,11,12,23
28275,ogleme,,19,250,125,375
28276,dr_mtarver,,20,1,1,2
28277,surfmadpig,,43,39,77,116
28278,kadath32,,10,7,16,23
28279,candyman420,,18,11,15,26
28280,scodav,,13,2,3,5
28281,heldhelm,,20,7,3,10
28282,citation_nazi,,8,2,1,3
28283,siniavine,,13,3,1,4
28284,klax89,,0,45,62,107
28285,chokolad,,31,6,6,12
28286,bigrocco,,1,1,2,3
28287,d0ubleplus,,19,2,2,4
28288,capnjack,,32,10,15,25
28289,ajaycb,,20,5,2,7
28290,juu4,,31,8,19,27
28291,drksolrsing,,1,1,1,2
28292,frank_dux,,12,2,17,19
28293,Dr_Wooosh,,1,1,1,2
28294,acamus,,1,3,9,12
28295,rout39574,,20,2,2,4
28296,phreakz0r,,28,3,1,4
28297,spooonage,,4,3,2,5
28298,epic9x,,31,7,5,12
28299,Zorak,,13,261,257,518
28300,nwalker,,19,2,2,4
28301,noteed,,20,9,8,17
28302,three1oh,,34,1,1,2
28303,worthlesscomment,,43,1,8,9
28304,reddit-man_98_points,,20,6,2,8
28305,suatb,,15,3,12,15
28306,MustacheMan,,6,1,1,2
28307,neverenoughgimmicks,,19,2,3,5
28308,memebot33,,34,8,26,34
28309,HoppyMcScragg,,32,66,117,183
28310,Gairloch,,31,15,23,38
28311,jasno,,18,6,2,8
28312,Khaledk,,22,73,14,87
28313,eibat,,20,2,3,5
28314,cchooper,,20,97,106,203
28315,nicasso,,29,1,2,3
28316,panek,,43,100,81,181
28317,MattyDub,,20,13,10,23
28318,bquinlan,,12,1,1,2
28319,bobobobob,,20,18,18,36
28320,twelvehands,,6,18,3,21
28321,CiXeL,,6,289,345,634
28322,sard,,20,32,31,63
28323,grokcode,,20,15,4,19
28324,Wolydarg,,29,2,3,5
28325,vegittoss15,,1,1,1,2
28326,gislan,,4,1,1,2
28327,dr_fear,,32,14,14,28
28328,Sheber,,4,13,19,32
28329,robotshoelaces,,13,2,14,16
28330,drobilla,,20,22,45,67
28331,J-Less,,0,6,1,7
28332,plontz,,42,4,2,6
28333,robhall,,43,1,1,2
28334,dan360man,,5,534,167,701
28335,xela321,,1,16,19,35
28336,charcourt,,20,3,7,10
28337,LetsGo,,13,4,3,7
28338,proteusguy,,20,57,61,118
28339,AverageCypress,,39,2,8,10
28340,mslaven,,20,4,8,12
28341,maxcarter,,13,36,25,61
28342,jimmyjohns,,5,1,1,2
28343,MrSkov,,0,2,2,4
28344,IAmMe1,,43,8,7,15
28345,lkcl,,31,2,1,3
28346,C_Robinson,,20,7,13,20
28347,edufish,,13,1,2,3
28348,hermana,,13,171,290,461
28349,StinkyZergling,,1,2,7,9
28350,Picsman,,18,11,2,13
28351,Burnsx3,,13,8,25,33
28352,toastspork,,41,555,954,1509
28353,Syngekhoomei,,20,5,2,7
28354,Jorsh,,18,17,9,26
28355,manilagurrl75,,13,25,10,35
28356,Korvar,,31,3,6,9
28357,vej,,22,32,19,51
28358,shaneo83,,34,1,2,3
28359,plankton_gobler,,2,1,4,5
28360,posborne,,20,8,18,26
28361,kicue,,5,2,1,3
28362,large_sandwich,,10,1,1,2
28363,Onsia,,32,4,9,13
28364,FreeManOnTheLand,,19,6,17,23
28365,animatus,,13,8,1,9
28366,Shawm,,19,13,13,26
28367,faster,,6,1,2,3
28368,dysk,,20,66,95,161
28369,dmahbubanijr,,34,2,3,5
28370,sketerpot,,20,321,607,928
28371,bolshov,,43,1,1,2
28372,gerritvb,,19,45,80,125
28373,mrplow,,30,1,4,5
28374,jeff419,,34,66,38,104
28375,gosee,,20,1,1,2
28376,stallmer,,12,23,26,49
28377,LilifyFey,,18,7,13,20
28378,zanwar000,,19,1,6,7
28379,AngryOfMiddlesex,,19,1,1,2
28380,ChocChinder,,18,28,36,64
28381,randiddy,,21,1,1,2
28382,Toucan,,43,1,1,2
28383,robbie,,18,7,5,12
28384,vanstorm,,34,92,259,351
28385,shakenbacon1564,,29,1,2,3
28386,largarfaaa,,0,29,51,80
28387,demlog,,31,2,1,3
28388,jvictor118,,19,3,2,5
28389,TMM,,19,209,58,267
28390,serudla,,20,153,46,199
28391,Joshua_,,43,6,4,10
28392,GnatDog,,32,1,1,2
28393,xof711,,14,1,1,2
28394,peggelegge,,20,3,1,4
28395,markus_b,,20,2,4,6
28396,figurefaster,,13,4,13,17
28397,moyos7,,6,2,1,3
28398,robel,,20,6,7,13
28399,ratedsar,,3,82,143,225
28400,schleg,,1,12,11,23
28401,messup,,22,4,5,9
28402,heavysteve,,1,128,131,259
28403,MileStretch,,29,2,2,4
28404,trii,,20,12,9,21
28405,Csaurus,,0,2,5,7
28406,mackman,,20,2,3,5
28407,bottleneck,,20,4,2,6
28408,youranidiot,,13,19,17,36
28409,ricehead,,22,22,56,78
28410,toosheds,,13,174,51,225
28411,cachrnthry79,,41,90,48,138
28412,upperlittleappletree,,42,19,27,46
28413,viglen,,19,495,828,1323
28414,israphel,,31,1,1,2
28415,drench,,20,17,30,47
28416,nicolele12,,0,10,3,13
28417,chhintz,,13,22,40,62
28418,infekt,,18,143,151,294
28419,drhowarddrfine,,32,3,1,4
28420,kiafaldorius,,13,14,14,28
28421,anon00,,20,5,2,7
28422,20CMC,,31,4,3,7
28423,danry25,,18,1,2,3
28424,chuliomartinez,,20,5,6,11
28425,Honeymaid,,13,18,22,40
28426,wild_eep,,18,12,16,28
28427,mrbogle,,43,43,45,88
28428,cagsmith,,8,2,2,4
28429,guisar,,3,221,381,602
28430,rabuf,,20,2,1,3
28431,mbentley,,13,4,3,7
28432,AaronRowe,,29,472,28,500
28433,kiderdav,,21,4,2,6
28434,ClownSuitCowboy,,11,1,2,3
28435,crudbeans,,43,5,2,7
28436,EmptyPockets,,3,1,4,5
28437,rob90,,18,85,1,86
28438,hardyboy,,22,2,1,3
28439,showbizkid,,13,2,13,15
28440,eevo,,20,2,3,5
28441,dedalus12,,31,16,26,42
28442,daslife,,13,8,1,9
28443,cogitofire,,19,242,331,573
28444,peppapig,,34,222,2,224
28445,ModernRonin,,17,343,622,965
28446,davidjayhawk,,18,17,4,21
28447,covah,,21,2,2,4
28448,StampCollect0r,,9,13,13,26
28449,monadyne,,18,19,18,37
28450,mjolnir18,,12,1,1,2
28451,JUNK0,,43,13,25,38
28452,jesster84,,13,14,31,45
28453,shelbygt33,,42,13,25,38
28454,majinski,,19,3,10,13
28455,Zafner,,1,208,172,380
28456,dbavaria,,8,21,37,58
28457,amacarth,,41,45,7,52
28458,au5lander,,43,143,230,373
28459,Vindicator,,13,9,9,18
28460,eloisius,,34,89,46,135
28461,Double_D,,13,2,1,3
28462,jgranby,,43,1,1,2
28463,bmiljko,,18,11,2,13
28464,RainmansGirl,,1,1,2,3
28465,yourmomis1337,,20,16,11,27
28466,cal_01,,19,261,228,489
28467,gigaquack,,22,782,992,1774
28468,Adam_AD,,13,2,10,12
28469,strike2867,,31,302,463,765
28470,myhandleonreddit,,18,303,603,906
28471,Karzyn,,43,208,299,507
28472,slacks,,34,16,23,39
28473,stone11,,13,415,495,910
28474,denshi,,40,2,4,6
28475,Daemonlee,,19,2,11,13
28476,strat31,,19,263,93,356
28477,timothycutter,,43,1,1,2
28478,lazyslackerblog,,32,7,2,9
28479,Master_Rux,,32,104,138,242
28480,eanoper,,19,56,117,173
28481,joke-explainer,,22,69,38,107
28482,petdance,,20,378,435,813
28483,IAO131,,1,5,10,15
28484,the_nuclear_lobby,,30,2,4,6
28485,azadaisy,,22,4,2,6
28486,nut854,,19,5,6,11
28487,everymn,,8,111,206,317
28488,Dyyne,,19,61,18,79
28489,EternalNite,,13,6,1,7
28490,ruertar,,17,29,13,42
28491,escape_goat,,13,748,643,1391
28492,chadkeck,,20,1,2,3
28493,Flame0001,,1,141,140,281
28494,dwhee,,42,1,5,6
28495,Reddit-Politician,,13,28,1,29
28496,Yarrbles,,18,152,148,300
28497,Bodie1550,,18,32,81,113
28498,drummer9,,11,9,4,13
28499,spoilmenow,,23,1,1,2
28500,kimpira,,12,5,12,17
28501,bernakeisthedevil,,31,3,2,5
28502,StickUpKid,,43,1,1,2
28503,grandmotherfucker,,31,15,21,36
28504,mulciber,,13,2,1,3
28505,OJisGUILTY07,,5,1,2,3
28506,cinder,,1,1,1,2
28507,boozinf,,19,29,53,82
28508,DrBartosz,,20,15,15,30
28509,shadm81,,13,25,10,35
28510,VoodooIdol,,26,666,1178,1844
28511,Grinder_,,1,51,27,78
28512,meeemo,,41,3,5,8
28513,dalittribal,,19,18,47,65
28514,ricket,,31,24,32,56
28515,blorbx,,36,1,1,2
28516,iman2413,,0,2,1,3
28517,MaxCorbetti,,1,28,8,36
28518,numb3rb0y,,29,243,264,507
28519,vapor64,,4,2,1,3
28520,henryprecheur,,20,66,9,75
28521,referee,,19,17,42,59
28522,djsdotcom,,43,128,198,326
28523,lucidilullo,,15,1,1,2
28524,leftenant_wright,,43,2,3,5
28525,baringforge,,20,2,1,3
28526,throwaway1340,,1,2,3,5
28527,videowordflesh,,17,39,51,90
28528,fraudwasteabuse,,19,8,15,23
28529,hnautiyal,,14,90,140,230
28530,cornholio,,32,51,40,91
28531,paxdavid,,13,204,205,409
28532,KesshoRyu,,39,2,1,3
28533,oggelbe2007,,12,36,46,82
28534,pdizz,,13,292,295,587
28535,cvp,,34,11,11,22
28536,OolisKraprin,,20,42,33,75
28537,endtime,,31,398,436,834
28538,AndyOB,,19,7,8,15
28539,phill0,,31,668,444,1112
28540,brovril,,20,3,4,7
28541,raped_gummy_bear,,1,11,15,26
28542,perfectfire,,9,23,39,62
28543,alkaiser142,,42,13,21,34
28544,GutenSlob,,43,1,1,2
28545,seanstickle,,20,6,5,11
28546,asshammer,,20,31,33,64
28547,PhysicsMajor,,31,2,1,3
28548,grokalator,,13,2,4,6
28549,joerick,,1,24,21,45
28550,mattmason,,43,139,18,157
28551,BradC,,34,2,12,14
28552,mumrah,,20,25,33,58
28553,vplatt,,20,312,505,817
28554,voxel,,18,173,176,349
28555,Tetranitrate,,33,2,4,6
28556,ludw,,14,11,9,20
28557,MrsDePoint,,22,20,26,46
28558,Flashhater,,20,6,15,21
28559,Newspapertaxy,,0,1,4,5
28560,lusserreal,,20,1,4,5
28561,railroadmike,,34,6,5,11
28562,patzors,,18,11,10,21
28563,KelbornCmd,,13,7,27,34
28564,kidintheshadows,,18,15,51,66
28565,volvospeed,,19,4,1,5
28566,greenblatt,,7,1,1,2
28567,benjy,,32,13,13,26
28568,Fritter,,32,2,1,3
28569,nunyadambizness,,34,1,14,15
28570,keen75,,19,793,4,797
28571,Illuminarch,,13,7,11,18
28572,ibn4n,,31,2,2,4
28573,keath,,20,7,13,20
28574,chrajohn,,20,76,160,236
28575,paul3720,,8,8,17,25
28576,contextclouds,,43,27,46,73
28577,whigs,,32,12,17,29
28578,ecotraz,,34,1,1,2
28579,honestbleeps,,1,193,200,393
28580,montyalfred,,20,4,13,17
28581,prozacjack,,18,134,235,369
28582,shilkytouch,,18,6,19,25
28583,offcentric,,18,12,7,19
28584,vnast,,31,8,9,17
28585,Mr_Morley,,19,5,13,18
28586,aguyiusedtoknow,,22,4,5,9
28587,wii247,,34,13,7,20
28588,L_diablo,,19,2,1,3
28589,bolhuijo,,20,10,15,25
28590,davidsickmiller,,6,9,15,24
28591,crwper,,20,68,72,140
28592,jomamma2,,13,103,49,152
28593,itsokmom,,22,1,1,2
28594,cvk,,18,1464,424,1888
28595,mycroft61,,18,1,11,12
28596,bhan07,,18,3,2,5
28597,ZooMan,,13,41,13,54
28598,thorie79,,13,4,1,5
28599,StateRadioFan,,29,2,1,3
28600,grandon,,42,593,921,1514
28601,rpowers,,12,98,208,306
28602,bcaff05,,13,1,1,2
28603,labbrat,,1,82,53,135
28604,Arainach,,20,23,12,35
28605,irongeek,,0,1,1,2
28606,silenceofnight,,12,53,38,91
28607,OMG_Ponies,,43,62,72,134
28608,veggieburrito,,34,3,2,5
28609,arithmetic,,18,8,6,14
28610,ropiku,,20,121,26,147
28611,wookiecontrol,,31,3,7,10
28612,wampwamp,,18,3,10,13
28613,megamichan,,32,8,11,19
28614,willhaney,,20,2,7,9
28615,PaperLess,,34,1302,40,1342
28616,Negitivefrags,,1,1,1,2
28617,devinypin,,19,3,5,8
28618,2kymonk,,19,2,1,3
28619,cybercobra,,20,15,14,29
28620,shinratdr,,6,156,253,409
28621,modyoudown,,20,15,1,16
28622,smartbear,,15,12,1,13
28623,bubbleboyz,,13,2,1,3
28624,steveeso,,19,10,18,28
28625,jc_denton,,29,35,8,43
28626,colin8651,,43,24,27,51
28627,devinjay,,22,57,71,128
28628,kordos,,15,42,65,107
28629,RonPaul2012,,19,83,155,238
28630,ignitingtides,,32,1,2,3
28631,theaceoffire,,3,117,131,248
28632,khyberkitsune,,18,61,32,93
28633,IEatBabies,,1,384,685,1069
28634,nutjob,,13,13,6,19
28635,Nienor,,13,6,3,9
28636,toonces,,19,622,554,1176
28637,whathell,,39,6,7,13
28638,ChuckChuck321,,22,2,1,3
28639,omegaman1984,,1,35,22,57
28640,thewiglaf,,18,25,30,55
28641,calebros,,19,107,142,249
28642,cyclic,,20,74,41,115
28643,zeroOne1,,19,1,1,2
28644,oddbob,,10,5,1,6
28645,Diice2,,32,5,9,14
28646,captainslog,,13,7,5,12
28647,SomewhereInTime,,20,2,3,5
28648,roxyrockwell,,32,2,5,7
28649,randomgoogler,,19,1,2,3
28650,karmatjie,,1,4,4,8
28651,g0zer,,43,27,30,57
28652,Crackheadbob,,13,13,28,41
28653,notlearninglatin,,18,5,11,16
28654,haveacigaro,,5,7,9,16
28655,Snafu7,,34,3,13,16
28656,Taciturn,,12,38,46,84
28657,tbartels,,22,1,1,2
28658,rhonersutin,,22,1,1,2
28659,Fergi,,32,21,10,31
28660,shakbhaji,,3,2,4,6
28661,HotSlag,,18,5,10,15
28662,kotten,,12,24,42,66
28663,senojetan08,,5,1,1,2
28664,bedfellow,,10,1,1,2
28665,damebavaralie,,43,2,2,4
28666,charlie222,,21,2,2,4
28667,Pilot7,,13,137,95,232
28668,epsilondelta,,13,11,10,21
28669,Brackhar,,20,3,2,5
28670,joe12321,,10,13,23,36
28671,senfo,,10,1,2,3
28672,GaryX,,43,124,101,225
28673,ninjamike,,18,9,8,17
28674,blueside,,19,13,3,16
28675,jjjjjjb,,5,1,1,2
28676,raasclaat1,,18,1,1,2
28677,treevu,,19,138,59,197
28678,registerundo,,1,2,1,3
28679,MrFunions,,19,36,42,78
28680,Johnny_5,,32,1,6,7
28681,Shafi,,43,3,1,4
28682,inomniaparatus,,19,7,15,22
28683,dougmataconis,,13,1425,278,1703
28684,bringswisdom,,5,25,56,81
28685,zugnush,,0,2,2,4
28686,runxctry,,0,17,19,36
28687,smullaney,,1,22,13,35
28688,spasmdaze,,1,15,1,16
28689,jon_smith_1980,,31,1,2,3
28690,Baseline,,20,87,110,197
28691,bobx11,,3,4,4,8
28692,percypersimmon,,1,25,30,55
28693,mjm1374,,20,33,25,58
28694,beefcake1234,,18,1,1,2
28695,Chrysophrase,,13,134,197,331
28696,blawa,,18,4,10,14
28697,unfocused1,,19,8,8,16
28698,Chirp08,,23,595,858,1453
28699,hutchbunny,,18,23,46,69
28700,TokyoXtreme,,18,9,33,42
28701,bassbin,,43,94,113,207
28702,hourigan,,43,293,2,295
28703,jamiepitts,,19,5,10,15
28704,Freedelivery,,13,25,53,78
28705,BobJobs,,18,36,1,37
28706,dpinh,,13,4,2,6
28707,evtedeschi3,,19,97,33,130
28708,thevza,,31,6,4,10
28709,nurd,,12,1,1,2
28710,TrueTom,,20,74,73,147
28711,mothraStewart,,0,32,33,65
28712,dhain,,32,1,1,2
28713,julirocks,,1,173,139,312
28714,zzcm,,13,9,12,21
28715,dirtysherman,,13,1,1,2
28716,den_of_thieves,,26,1,2,3
28717,taul,,41,7,11,18
28718,tamar,,5,156,9,165
28719,andreyseven,,32,4,11,15
28720,cmessner,,20,2,1,3
28721,zeppelinfromled,,18,253,352,605
28722,youlikethat,,18,16,5,21
28723,rbrt,,22,4,1,5
28724,bensig,,43,2,1,3
28725,tashbarg,,20,80,107,187
28726,AvatarOfErebus,,18,20,33,53
28727,captainpuma,,43,1,4,5
28728,daveb5,,18,1,1,2
28729,carioca76,,18,1,2,3
28730,jining,,0,4,5,9
28731,bradediger,,20,34,64,98
28732,chauss7,,31,160,113,273
28733,RyanSeacrest,,13,40,44,84
28734,Transistor,,32,1,1,2
28735,criis,,20,22,40,62
28736,weeksie,,31,52,59,111
28737,PuppetBoy,,19,10,24,34
28738,vexxor,,20,21,16,37
28739,earlycj5,,23,1,2,3
28740,samuel1411,,32,16,26,42
28741,vilator,,18,8,14,22
28742,aikiai,,31,20,26,46
28743,fretbuzz,,32,99,63,162
28744,demizer,,18,77,98,175
28745,christophe971,,22,1,1,2
28746,iriscoler,,0,78,17,95
28747,toddlb,,18,3,5,8
28748,mcccain,,17,3,1,4
28749,tbmcmullen,,20,13,9,22
28750,tskegel,,16,10,10,20
28751,DrDichotomous,,20,42,90,132
28752,tepas,,20,14,16,30
28753,stsaby,,1,30,29,59
28754,gtc55,,13,10,2,12
28755,cake3412,,1,7,9,16
28756,ioni3000,,0,17,6,23
28757,rkag,,13,38,83,121
28758,Gorgomon,,0,99,23,122
28759,johnw188,,20,91,66,157
28760,Naga,,30,97,114,211
28761,adam75,,20,7,1,8
28762,ramibotros,,20,3,14,17
28763,zz101,,30,21,20,41
28764,ani625,,18,528,114,642
28765,Procrastinator,,20,2,3,5
28766,drplump,,13,3,15,18
28767,mr-datter,,28,2,1,3
28768,ilikeyou,,19,16,16,32
28769,moxiepuff,,1,188,282,470
28770,theDook,,43,1,1,2
28771,LazloHollifeld,,13,13,18,31
28772,SuperSnooper,,1,3,4,7
28773,ws1984,,33,6,3,9
28774,thall,,30,1,7,8
28775,Korova,,18,1,2,3
28776,rbblum,,19,1,4,5
28777,General_Solipsist,,38,128,239,367
28778,bodyheatstarempire,,30,4,3,7
28779,Naedlus,,5,1,4,5
28780,Digeratus,,19,173,193,366
28781,iolokus,,5,5,3,8
28782,Ciserus,,30,678,767,1445
28783,mirach,,32,1,2,3
28784,crikey321,,13,25,4,29
28785,IckPooYuck,,36,1,1,2
28786,mattchambers,,10,1,2,3
28787,jeffehobbs,,18,438,184,622
28788,geekner,,20,78,124,202
28789,sun_tzu,,31,10,16,26
28790,glebd,,20,12,22,34
28791,Chknbone,,18,80,137,217
28792,mtraven,,19,13,17,30
28793,ElectricMoose,,18,19,46,65
28794,DrDystopia,,1,134,268,402
28795,unpossible,,31,6,10,16
28796,rannic,,32,1,1,2
28797,Open_Your_Eyes,,13,169,51,220
28798,tehmatticus,,20,59,75,134
28799,loveline,,12,32,18,50
28800,tulrich,,18,58,57,115
28801,blackmothsuperainbow,,19,1,2,3
28802,ChipotleSalad,,27,4,9,13
28803,Sr_Moreno,,34,161,121,282
28804,Speckles,,23,2,1,3
28805,askalyuk,,20,3,2,5
28806,logicpill,,13,5,13,18
28807,nmcnulty,,1,1,1,2
28808,smooshie,,13,562,9,571
28809,tasharanee,,1,4,9,13
28810,gaso,,42,223,346,569
28811,upside_down,,30,3,2,5
28812,picklefeather,,18,87,4,91
28813,nimm,,6,5,4,9
28814,Gh057h4k,,22,70,40,110
28815,domston,,13,29,20,49
28816,draught,,29,7,5,12
28817,Bossman1086,,1,139,213,352
28818,tdf27,,19,33,20,53
28819,dakboy,,1,357,533,890
28820,rcar,,20,7,10,17
28821,animesh1977,,20,5,3,8
28822,LiviaLive,,13,3,4,7
28823,yourthreecents,,19,184,2,186
28824,noodhoog,,32,12,31,43
28825,essjay2009,,34,45,44,89
28826,clambucket,,4,15,11,26
28827,polarbz,,18,43,74,117
28828,OSUbuckeye,,18,11,18,29
28829,ryanlowe,,43,3,4,7
28830,voteup,,19,2,12,14
28831,welldoitliveFUCKIT,,34,4,2,6
28832,Lone_Wolf,,13,35,57,92
28833,gau_veldt,,0,17,59,76
28834,Wiggin,,1,2,1,3
28835,joshuamckenty,,43,5,5,10
28836,Spytap,,42,7,13,20
28837,alergictomorning,,14,1,1,2
28838,jeremiahrogers,,4,1,3,4
28839,OlympicPirate,,3,1381,1847,3228
28840,craybur,,1,31,68,99
28841,losslessignal,,2,3,4,7
28842,duncanwilde,,19,11,11,22
28843,shen,,20,70,92,162
28844,bagammon,,31,4,6,10
28845,fleetmouse,,0,11,21,32
28846,MaryjaneBrewington,,1,9,44,53
28847,Todes,,1,28,27,55
28848,wengem,,0,1,2,3
28849,zachsandberg,,1,1,1,2
28850,simianrusselli,,5,2,1,3
28851,babaganushka,,43,2,5,7
28852,zergl1ng,,32,62,25,87
28853,hanz,,20,2,4,6
28854,frummidge,,13,23,51,74
28855,watermillvillage,,31,10,21,31
28856,ExplodingBob,,36,242,341,583
28857,gbypass654,,33,2,1,3
28858,JSiobhan,,19,3,6,9
28859,pinxox,,18,187,198,385
28860,elezeta,,18,116,172,288
28861,Greyholme,,12,1,1,2
28862,Doane,,18,368,3,371
28863,BusinessDelivery,,20,2,4,6
28864,headcrabcake,,18,2,3,5
28865,saleop,,18,14,15,29
28866,CalvinR,,22,102,122,224
28867,zaius,,13,2,1,3
28868,jsantos17,,34,62,105,167
28869,markncream,,19,26,19,45
28870,viciousglue,,3,2,6,8
28871,3dimka,,4,61,95,156
28872,Cunstitutionalist,,31,45,90,135
28873,ambulatorybird,,20,1,1,2
28874,jfredett,,32,345,615,960
28875,frayed_knot,,32,2,1,3
28876,mrdelayer,,18,16,2,18
28877,maalyex,,22,2,1,3
28878,osmosisgenius,,13,31,50,81
28879,thinksalot,,13,2,6,8
28880,thecoollamer,,34,59,5,64
28881,KimRae,,2,1,1,2
28882,Mrgalikanookis,,19,1,4,5
28883,erikw,,20,27,54,81
28884,giorgioagamben,,29,10,5,15
28885,Anemonerr,,0,54,5,59
28886,atlacatl,,43,451,740,1191
28887,Miser,,19,7,13,20
28888,redjeb,,13,26,26,52
28889,bigmajor,,31,7,2,9
28890,seamusm,,31,39,2,41
28891,beeff,,18,2,1,3
28892,nicolaslloyd,,32,183,349,532
28893,weegee,,19,1009,1089,2098
28894,aleon010,,12,1,1,2
28895,kukon,,5,462,15,477
28896,cyrano741,,34,3,9,12
28897,mareek,,20,5,2,7
28898,tanstaafl90,,6,152,294,446
28899,defyapathy,,17,1,1,2
28900,mlpnko,,18,5,1,6
28901,zestytaco,,34,1,1,2
28902,neoice,,20,222,332,554
28903,torgeze,,42,3,1,4
28904,Khuldan,,22,26,2,28
28905,shad0w_walker,,19,10,22,32
28906,jespern,,20,52,56,108
28907,EndymionAwake,,22,280,412,692
28908,anodes,,31,310,433,743
28909,krapfi,,22,1,1,2
28910,Wakuko,,20,92,124,216
28911,theothemonkey,,22,2,1,3
28912,aju2,,13,17,12,29
28913,Tanuki0,,18,8,9,17
28914,j4m3z,,13,6,1,7
28915,willfull,,8,5,17,22
28916,dillbilly,,9,21,38,59
28917,ILoveBlowjobs,,27,1,1,2
28918,wormwood_pearl,,0,171,44,215
28919,bofh,,20,71,142,213
28920,mdsvanc,,19,1,1,2
28921,wejorg,,21,3,4,7
28922,Raptor563,,1,121,72,193
28923,Gforce20,,18,6,12,18
28924,jjohnston,,5,11,11,22
28925,hoss-style,,34,491,7,498
28926,changy82,,42,1,1,2
28927,jrichmond,,20,1,1,2
28928,antena,,20,7,13,20
28929,markusmark,,13,17,35,52
28930,pawntokingspawn,,13,4,10,14
28931,Parrot57,,20,1,2,3
28932,tgbyhn,,20,308,2,310
28933,acsync,,19,3,3,6
28934,ksnap,,18,8,13,21
28935,SlvrEagle23,,31,244,239,483
28936,acidfire,,18,9,25,34
28937,jlongster,,20,68,24,92
28938,xxtreem,,18,1,1,2
28939,amurriken,,0,2,2,4
28940,DNME,,18,22,24,46
28941,szetlan,,14,1,1,2
28942,Renshai,,26,1,2,3
28943,mao_neko,,20,213,366,579
28944,elasticsoul,,30,997,1556,2553
28945,dontknowhwattodo,,13,1,1,2
28946,destraynor,,20,2,2,4
28947,mzappitello,,6,1,3,4
28948,partyjess,,5,216,12,228
28949,GoldbachsConjecture,,32,2,1,3
28950,itsgoodya,,19,1,3,4
28951,TopicA1,,13,178,70,248
28952,mwgore,,22,2,2,4
28953,bellboy,,18,66,111,177
28954,redder4322,,16,8,16,24
28955,divbyzero,,20,42,43,85
28956,coob,,20,336,377,713
28957,Maeglom,,3,116,218,334
28958,youropinionisnotfact,,20,1,1,2
28959,greenknight,,6,113,256,369
28960,NekoKaneko,,18,2,3,5
28961,LeonGrey,,18,24,6,30
28962,inversionofhope,,9,22,14,36
28963,frnzy,,42,2,8,10
28964,mangodrunk,,31,528,804,1332
28965,SaidTheShotgun,,19,1,2,3
28966,ustgblerkvusrd,,20,70,96,166
28967,itaborai83,,20,2,3,5
28968,norwegianwood,,20,50,29,79
28969,Pseudoscience,,8,2,2,4
28970,kunalgoel,,1,8,8,16
28971,libertybangor,,13,2,2,4
28972,skinniouschinnious,,3,51,40,91
28973,rhnigl,,19,21,27,48
28974,Pirat,,13,2,5,7
28975,z0gf7,,20,5,2,7
28976,PriestofSyrinx,,19,8,14,22
28977,SitPoMk,,15,1,1,2
28978,roydog11,,19,1,1,2
28979,gfish3000,,8,1,3,4
28980,Overreacting_Old_Man,,43,3,4,7
28981,jwilke,,17,6,4,10
28982,Katarungan,,18,4,10,14
28983,malthusian,,6,11,17,28
28984,2p1s,,20,2,1,3
28985,achiebaba,,18,13,32,45
28986,osfn8,,23,9,72,81
28987,mediaspree,,18,1,1,2
28988,Laodicea,,13,88,7,95
28989,134KS,,13,11,13,24
28990,DiscoWolf,,1,144,220,364
28991,00j,,1,2,2,4
28992,evilwombat,,19,281,467,748
28993,jtune,,4,1,1,2
28994,bgiltner,,19,2,2,4
28995,drif,,1,3,1,4
28996,you_ve,,1,6,12,18
28997,tweiler,,43,1,3,4
28998,gnrfan,,20,10,1,11
28999,dieselcreek2,,23,4,6,10
29000,snair,,18,340,708,1048
29001,greekgeek,,34,1,1,2
29002,jpnkevin,,13,46,19,65
29003,dorkasaurus,,1,1,6,7
29004,glenndo,,8,30,44,74
29005,citizen_j,,18,15,3,18
29006,Thespus,,31,7,12,19
29007,Ebirah,,13,58,88,146
29008,Theisos,,10,1,1,2
29009,judgej2,,8,1538,2743,4281
29010,vansciver,,15,5,5,10
29011,pazoo,,13,1,3,4
29012,tetsuto,,20,1,2,3
29013,zonkzor,,1,88,103,191
29014,zikks,,22,19,33,52
29015,misterme,,32,14,28,42
29016,waz67,,32,6,4,10
29017,starseed42,,42,28,46,74
29018,Daniel_Plainview,,13,16,17,33
29019,donnyg16,,13,6,4,10
29020,Still_Hillary,,3,1,1,2
29021,aricene,,32,7,12,19
29022,spoony,,19,8,12,20
29023,Forgery,,36,4,2,6
29024,IustinusM,,30,4,9,13
29025,smanek,,20,76,12,88
29026,spaceghost0r,,12,35,24,59
29027,tubes,,20,3,3,6
29028,scootertronic,,29,4,3,7
29029,sms4share,,0,1,1,2
29030,jmelesky,,20,189,174,363
29031,cowboytronic,,1,42,74,116
29032,q-bit,,13,3,4,7
29033,DeathWish808,,18,103,22,125
29034,campbellm,,20,31,15,46
29035,dubled,,19,35,27,62
29036,onmytoes,,20,65,11,76
29037,simonhsu,,19,6,6,12
29038,ebendread,,18,8,20,28
29039,Aaronontheweb,,43,9,15,24
29040,sd897,,13,1,1,2
29041,ShawnGupta,,18,208,202,410
29042,jrnewton,,20,8,22,30
29043,SnavenShake,,5,2,5,7
29044,jarwiz1,,13,6,5,11
29045,mythicalbyrd,,19,15,31,46
29046,Astroturfer,,12,2,6,8
29047,siffinleex,,28,2,4,6
29048,gregd,,0,324,68,392
29049,archibaldcox,,31,1,1,2
29050,idiotwithastick,,0,49,45,94
29051,bleedingdark,,3,2,9,11
29052,stealtheair,,19,10,8,18
29053,redbenn,,23,24,55,79
29054,schwindelkonto,,18,2,9,11
29055,rughmanchoo,,1,4,5,9
29056,freeloadr,,26,3,2,5
29057,IHaG0Fw,,30,54,53,107
29058,keptblue,,1,133,127,260
29059,m242,,20,5,3,8
29060,dsch1,,34,10,22,32
29061,lilylauren,,15,66,3,69
29062,fridesntrom,,43,30,44,74
29063,quintios,,18,1,3,4
29064,sirgallium,,18,9,16,25
29065,c7272,,10,42,4,46
29066,mochaboy,,8,6,15,21
29067,pong,,20,1,1,2
29068,ypostelnik,,13,22,1,23
29069,rperk,,13,1,3,4
29070,Captain-Ambivalent,,31,1,2,3
29071,jubalicious,,34,2,3,5
29072,jpgetout,,19,86,50,136
29073,zygy,,42,2,10,12
29074,Silvent,,29,2,2,4
29075,subcultured,,22,4,2,6
29076,gluino,,20,104,117,221
29077,hard2kill,,18,73,12,85
29078,msakas,,13,259,606,865
29079,dominosci,,20,7,10,17
29080,calliopejones,,5,12,5,17
29081,MrUnhappy,,18,12,15,27
29082,Kalimotxo,,6,66,100,166
29083,0in0out,,28,2,1,3
29084,benjidog,,32,1,1,2
29085,mik0r,,13,10,25,35
29086,WreckRoom,,14,12,12,24
29087,BayState,,13,7,5,12
29088,Spunt,,18,4,8,12
29089,wrestle4228,,18,14,36,50
29090,mattymomostl,,32,275,171,446
29091,mudkiller,,19,1,9,10
29092,bigboomer223,,19,335,116,451
29093,FreeThingLostMyWay,,19,41,64,105
29094,dutchmcnubb,,19,3,10,13
29095,redchuck,,20,8,9,17
29096,posthole,,43,13,19,32
29097,Crontab,,31,6,8,14
29098,MegaKN,,13,77,90,167
29099,smackson,,16,99,133,232
29100,mickeymongoose,,6,2,2,4
29101,javajunkie,,42,2,5,7
29102,MotTheBarber,,32,1,4,5
29103,obama2012,,19,5,9,14
29104,eawesome3,,13,35,37,72
29105,nagrom,,31,7,10,17
29106,AdamPan,,43,30,67,97
29107,sameoldmike,,13,9,8,17
29108,LewP,,13,9,8,17
29109,charlesm,,20,4,1,5
29110,timmy6591,,13,125,172,297
29111,johnflynn50,,13,8,6,14
29112,slice,,34,2,8,10
29113,sonyturbo,,42,3,2,5
29114,sknob,,32,2,1,3
29115,huipot24,,18,2,3,5
29116,repster,,20,62,103,165
29117,poplin,,32,4,2,6
29118,Rapidog,,19,1,4,5
29119,HottenTotten,,17,6,2,8
29120,dherve,,19,16,6,22
29121,damncommies27,,23,8,1,9
29122,homerdash,,19,11,17,28
29123,stevanl,,10,4,7,11
29124,alfador,,18,9,11,20
29125,Stupidfish,,42,13,16,29
29126,rbuschur,,18,5,5,10
29127,JeffMo,,31,112,161,273
29128,djninjastar,,43,7,10,17
29129,CecilDL,,22,2,7,9
29130,Specul8,,13,6,7,13
29131,yar18,,13,3,7,10
29132,JoJoMan18,,43,7,10,17
29133,aldhelm,,31,420,477,897
29134,enterthepizza,,0,4,9,13
29135,Gigabyte,,22,5,6,11
29136,Flipp100,,4,2,1,3
29137,TheUsher,,12,62,108,170
29138,liubsgilasdubg,,22,1,1,2
29139,hugolp,,13,35,34,69
29140,fuck_obama,,31,2,5,7
29141,makubex,,1,154,200,354
29142,bunnyfart,,43,34,62,96
29143,PC_LOAD_LETTER,,13,2,2,4
29144,insertamusingmoniker,,18,61,49,110
29145,Parmanoir,,20,3,4,7
29146,voodoochi1d,,18,2,9,11
29147,youcaughtafish,,22,2,5,7
29148,jus10case,,0,1,1,2
29149,nachof,,20,79,102,181
29150,cuil_theoretician,,1,1,1,2
29151,lastmovement,,13,71,3,74
29152,mbreese,,20,18,18,36
29153,redditor55,,31,1,1,2
29154,Crath,,20,14,23,37
29155,melonhedd,,20,24,26,50
29156,tr0y,,20,1,2,3
29157,fr1j0l3,,0,40,27,67
29158,33a,,31,19,13,32
29159,jbonura,,19,2,1,3
29160,chakl,,1,5,3,8
29161,redditHQ,,20,4,5,9
29162,majikmixx,,18,2,3,5
29163,kandicole,,13,1,1,2
29164,adnan278,,5,4,1,5
29165,redberyl,,34,2,2,4
29166,pinkhamster,,5,1,3,4
29167,ascus4,,21,150,282,432
29168,mcnicholl,,13,22,7,29
29169,mredd,,31,52,89,141
29170,esker,,18,1,3,4
29171,obehag,,20,4,9,13
29172,ollie77,,42,4,6,10
29173,Hookstra,,1,87,59,146
29174,sabaidee,,19,107,115,222
29175,bunkmonkee,,22,17,5,22
29176,gregglind,,20,6,8,14
29177,lol_at_haskell,,20,2,1,3
29178,Merendino,,32,8,7,15
29179,wrybabydave,,14,2,3,5
29180,immure,,34,7,10,17
29181,flow207,,18,18,15,33
29182,315was_an_inside_job,,19,455,721,1176
29183,droden,,18,42,101,143
29184,JackBower,,29,1,4,5
29185,cynosargos,,19,1,3,4
29186,tharris7,,11,22,31,53
29187,rmarson,,29,2,1,3
29188,ulissescosta,,20,7,2,9
29189,mkaplan,,43,15,18,33
29190,nknezek,,6,14,15,29
29191,pantaloon,,20,33,46,79
29192,deltawk,,10,1,3,4
29193,arctyr,,14,4,9,13
29194,cottonbuds,,43,9,2,11
29195,spinn,,18,24,68,92
29196,spectorjay,,13,15,41,56
29197,jollynix,,18,2,15,17
29198,eddhillman,,22,24,55,79
29199,whatthehellbro,,43,1,1,2
29200,seanconwell,,42,58,76,134
29201,thegreatgazoo,,0,315,361,676
29202,djwohls,,1,12,19,31
29203,Professor-Subtle,,19,1,1,2
29204,jonopei,,3,1,3,4
29205,jmcstar,,22,9,17,26
29206,DiamondBack,,6,258,471,729
29207,pitapa,,18,115,2,117
29208,hardoncollider,,20,2,4,6
29209,dtuur,,13,2,1,3
29210,tendeuchen,,13,1,5,6
29211,Amythystnights,,34,4,2,6
29212,modulus,,20,80,127,207
29213,Mikle,,42,161,218,379
29214,dufflove,,20,11,15,26
29215,FreedomForever,,43,16,24,40
29216,kissmychrome,,34,1,2,3
29217,Undertoad,,6,50,59,109
29218,seandxi,,20,1,3,4
29219,senright,,17,1,2,3
29220,rcunningham,,43,1,2,3
29221,flyingpostman,,4,11,9,20
29222,gsiener,,20,8,12,20
29223,thepipirate,,43,149,211,360
29224,corellia40,,4,5,3,8
29225,tunedradio,,7,36,4,40
29226,thejesse,,18,4,6,10
29227,spooniep,,4,1,2,3
29228,brettfromtibet,,5,14,11,25
29229,Mark0Pon,,32,2,4,6
29230,nnagflar,,18,18,17,35
29231,teraflop,,20,112,145,257
29232,uncannyvalley,,18,15,27,42
29233,francoMJ,,19,1,19,20
29234,Saxe-Coburg-Gotha,,18,4,24,28
29235,thebeef,,19,40,53,93
29236,rtaito,,43,1,1,2
29237,koskos,,12,27,33,60
29238,El_Colombo10,,17,1,4,5
29239,eggnet,,20,21,31,52
29240,mpn,,18,1,1,2
29241,fludgesickles,,18,9,7,16
29242,Spire,,22,5,2,7
29243,taromsn,,7,1,3,4
29244,gbot,,13,3,2,5
29245,Johnny_Cash,,13,440,623,1063
29246,botbooty,,19,4,2,6
29247,putney,,22,280,162,442
29248,trb122387,,13,1,3,4
29249,quaker1729,,19,57,131,188
29250,polveroj,,20,6,14,20
29251,jjsb64,,18,1,2,3
29252,cvinson86,,18,1,3,4
29253,soonago,,5,1,1,2
29254,ashok,,29,54,37,91
29255,doubleviking,,5,1,5,6
29256,daver,,20,46,25,71
29257,miles_dad,,5,45,55,100
29258,Kleenex1,,13,76,12,88
29259,azazello3,,20,8,4,12
29260,rza,,34,8,4,12
29261,RacistConspiracy,,4,3,1,4
29262,chlamydia,,3,1,1,2
29263,kahoonas,,20,18,28,46
29264,phire,,1,152,203,355
29265,FrothyKillsKittens,,22,23,38,61
29266,ambiversive,,19,161,122,283
29267,jackdot1,,31,2,2,4
29268,lolcatraptorjesus,,43,2,5,7
29269,stiltzor,,11,3,3,6
29270,charlesgrrr,,19,556,455,1011
29271,ActualArticle,,8,7,9,16
29272,Higgs,,13,10,4,14
29273,cocorobot,,18,131,205,336
29274,samurai725,,19,28,54,82
29275,armadalol,,13,4,5,9
29276,bertacus,,20,12,16,28
29277,postlogic,,19,1,2,3
29278,nickadams,,18,15,22,37
29279,soeric,,19,15,11,26
29280,kevin28282,,13,1,4,5
29281,kundera1,,18,7,1,8
29282,simsea,,19,41,58,99
29283,gbouchard,,5,3,8,11
29284,nixcamic,,10,105,176,281
29285,penisbird,,20,6,11,17
29286,Blergh,,20,1,1,2
29287,Midness,,34,6,8,14
29288,BrianRCampbell,,1,11,15,26
29289,podperson,,31,292,337,629
29290,opengovt,,6,2,2,4
29291,Nadia4077,,13,1,1,2
29292,inerte,,20,14,18,32
29293,Reorax,,1,2,7,9
29294,lisper,,22,132,24,156
29295,RovertP,,9,1,1,2
29296,blackhat,,20,15,3,18
29297,ghpoobah,,43,21,25,46
29298,terryducks,,14,1,1,2
29299,whatnowbitch,,19,1,3,4
29300,Agent00funk,,14,11,13,24
29301,americagreedgreed,,13,1,1,2
29302,kharmel,,22,34,28,62
29303,somanybutts,,0,59,112,171
29304,scrubber,,30,2,1,3
29305,arjuan,,1,2,9,11
29306,beefmagnet,,19,7,8,15
29307,celticraven,,34,1,2,3
29308,WhoreChurch,,13,270,338,608
29309,Manuzhai,,20,298,104,402
29310,rbobby,,30,178,272,450
29311,hhhseses,,31,1,1,2
29312,demented_pants,,18,102,76,178
29313,supafupa,,13,1,8,9
29314,ebrunar,,18,2,2,4
29315,aek82,,14,2,9,11
29316,tamrix,,12,15,23,38
29317,bzavadil,,20,2,2,4
29318,cstuart,,20,1,1,2
29319,tgeliot,,15,33,56,89
29320,upnation,,43,18,7,25
29321,pedrobelo,,20,52,24,76
29322,LeRenard,,18,87,210,297
29323,jasonreid,,20,3,4,7
29324,LookWhosHere,,43,27,5,32
29325,JRepin,,20,224,20,244
29326,Urdna,,20,5,7,12
29327,ProphetV,,1,1,1,2
29328,synspark,,10,2,4,6
29329,inkkungfu,,32,4,1,5
29330,rline928,,6,4,4,8
29331,sitq,,20,7,7,14
29332,yellowdwarf,,15,122,2,124
29333,localhost80,,27,2,2,4
29334,Korollary,,20,32,73,105
29335,remiprev,,1,1,1,2
29336,russpinke,,13,4,1,5
29337,fukifino,,32,13,28,41
29338,rivethaus,,4,2,2,4
29339,feizouhema,,41,1,1,2
29340,trocar,,43,107,118,225
29341,damselinadress,,14,3,1,4
29342,skuunk,,13,10,22,32
29343,JOA23,,3,21,33,54
29344,vcyhju7yt,,19,3,1,4
29345,yahaya,,31,168,121,289
29346,enivid,,34,32,1,33
29347,HalCion,,22,292,473,765
29348,qualiaqueen,,32,10,2,12
29349,rvsdrvs,,19,1,3,4
29350,figa,,20,11,11,22
29351,Odog,,38,3,5,8
29352,the-ace,,31,2,4,6
29353,tripartisan,,18,159,26,185
29354,blrbytes,,15,1,3,4
29355,peroyo,,20,217,124,341
29356,robinhd,,43,51,25,76
29357,AlGoretex,,18,4,7,11
29358,grigorescu,,12,43,22,65
29359,nalf38,,19,117,218,335
29360,kiwi90fsu,,43,4,6,10
29361,jondue,,13,6,10,16
29362,TheFeds,,0,1,1,2
29363,radicade,,4,4,3,7
29364,drakino,,42,1,1,2
29365,gjx86,,32,12,9,21
29366,commongiga,,22,160,60,220
29367,naysayer123,,18,11,17,28
29368,flarkenhoffy,,18,11,29,40
29369,poptarts,,20,2,4,6
29370,Thwart,,13,185,579,764
29371,nightchrome,,18,16,21,37
29372,McBushLies,,13,85,67,152
29373,shoy,,22,7,6,13
29374,robic,,20,1,6,7
29375,MechaBlue,,20,104,155,259
29376,Starks,,6,9,14,23
29377,bobbane,,20,43,64,107
29378,wroth,,9,3,6,9
29379,hellomudda,,31,17,26,43
29380,dev-urandom,,20,13,6,19
29381,jimmyr,,21,4,1,5
29382,AerialAdvertising,,31,2,1,3
29383,homar,,40,3,5,8
29384,tatinthehat,,10,6,13,19
29385,ZippyDan,,29,40,50,90
29386,jugimaster,,30,1,1,2
29387,cowpowered,,20,20,14,34
29388,Deacon,,18,1069,2138,3207
29389,htsoulja66,,6,5,9,14
29390,rumrokh,,22,324,161,485
29391,redditer004,,19,2,3,5
29392,lungdart,,32,30,33,63
29393,kortneypayge,,42,1,1,2
29394,eightbithero,,18,4,6,10
29395,oldy,,32,7,5,12
29396,dfgsdja,,1,3,1,4
29397,RJHinton,,20,52,34,86
29398,vulgar,,19,8,4,12
29399,steved3298,,19,3,2,5
29400,noodler,,18,26,38,64
29401,homeathouse2,,34,1,1,2
29402,emindead,,18,2,2,4
29403,MC_Shortbus,,13,12,14,26
29404,tanasinn,,18,4,5,9
29405,whatsreal,,19,3,5,8
29406,crashwhack,,13,4,3,7
29407,optimizeprime,,20,34,23,57
29408,jimfitz,,18,4,1,5
29409,Toggan,,18,3,4,7
29410,jamesmnz,,31,3,7,10
29411,AthlonRob,,1,62,74,136
29412,Creative_User_Name,,43,3,1,4
29413,genida,,0,116,136,252
29414,fios,,0,4,1,5
29415,ricemilk,,18,10,11,21
29416,Uncial,,13,102,163,265
29417,gabort,,19,107,9,116
29418,billycreate,,34,28,33,61
29419,remcoder,,20,3,1,4
29420,megalodon77,,18,1,6,7
29421,loonatic,,20,5,8,13
29422,rumdiary,,18,2,2,4
29423,sweetholymosiah,,13,4,10,14
29424,Mormolyke,,13,9,9,18
29425,remko,,20,9,6,15
29426,bole33mo,,31,1,1,2
29427,ADHD,,19,6,8,14
29428,Ozymandi,,13,88,86,174
29429,nopal,,20,18,5,23
29430,victorcrowns,,29,5,2,7
29431,vava,,19,208,592,800
29432,socksuka,,39,3,1,4
29433,ftothe3,,39,75,61,136
29434,dijxtra,,20,20,9,29
29435,Ksilebo,,12,30,79,109
29436,2343984098,,29,2,5,7
29437,ndt,,34,2,1,3
29438,obamaobama,,19,21,12,33
29439,BIllyHatesYou,,9,1,3,4
29440,poostew,,32,5,3,8
29441,crumbelievable,,1,6,10,16
29442,n1ik,,20,2,3,5
29443,wreckshop,,19,1,2,3
29444,lubjob12,,13,2,8,10
29445,DuncanCV,,43,80,26,106
29446,apok,,19,41,9,50
29447,oliverdaniel,,1,51,7,58
29448,xankriz,,18,29,26,55
29449,CancerLancer,,32,4,1,5
29450,jasonr11,,19,9,4,13
29451,cr0n1c,,22,12,3,15
29452,MsHappyDance,,19,1,1,2
29453,sonyasav,,10,1,2,3
29454,shylockfox,,0,1,1,2
29455,WritersCoin,,16,8,12,20
29456,JackyPaper320,,31,2,3,5
29457,alger82,,19,40,9,49
29458,elemenohpee,,18,251,286,537
29459,stephenactually,,23,7,6,13
29460,DrBone,,43,34,29,63
29461,fkyrnf,,11,4,8,12
29462,dhhlovely,,20,6,2,8
29463,nullpointer0x00,,43,1,3,4
29464,tylerbgood,,34,13,15,28
29465,caribbeing,,17,2,6,8
29466,redshirt67,,18,4,5,9
29467,hotani,,1,1,6,7
29468,MarkZspot,,41,23,46,69
29469,pacifist16,,31,6,2,8
29470,chiguy,,21,25,27,52
29471,funkybjorn,,19,65,9,74
29472,kymar911,,8,2,1,3
29473,themightymouse,,20,12,2,14
29474,bang_wanger,,19,5,11,16
29475,thatsthelawinbritain,,6,1,1,2
29476,DrunkMc,,13,4,5,9
29477,FryDuck,,32,14,19,33
29478,Gentle_Pirate,,42,8,8,16
29479,greenwizard,,13,158,335,493
29480,Theoneisis,,13,4,17,21
29481,kd5bjo,,20,3,1,4
29482,MSWsHusband,,31,2,6,8
29483,g123,,19,61,56,117
29484,lovingkindness,,36,1,4,5
29485,roflburger,,13,138,119,257
29486,imfm,,20,4,7,11
29487,fenris23,,31,2,3,5
29488,Arth-Vader,,1,1,1,2
29489,spedmyster,,19,32,38,70
29490,Scooby0,,33,25,46,71
29491,jhrace2,,19,14,12,26
29492,novous,,19,19,30,49
29493,RockinRoel,,22,330,561,891
29494,MetalPig,,20,2,3,5
29495,lempo,,20,3,7,10
29496,jimmiejaz,,19,119,102,221
29497,JamesM_,,20,2,1,3
29498,statictype,,20,264,318,582
29499,twodayslate,,42,190,173,363
29500,yaniikk78,,43,1,1,2
29501,02021345,,4,5,6,11
29502,backinblack,,15,3,4,7
29503,degustiwagoneer,,18,63,62,125
29504,Tim2thaTom,,32,1,1,2
29505,corybantic,,19,1,8,9
29506,philldiamond,,32,2,1,3
29507,kronholm,,20,25,30,55
29508,blalpha,,18,7,8,15
29509,u2knapp,,19,9,11,20
29510,znsh18,,19,2,3,5
29511,nrmehta,,43,1,1,2
29512,jart,,20,4,4,8
29513,gr4kk3r,,22,5,9,14
29514,krispykrackers,,1,972,859,1831
29515,Max4000,,20,3,4,7
29516,wrathael,,19,2,4,6
29517,rzza,,10,42,25,67
29518,edgarvm,,31,2,6,8
29519,SelahSoItGoes,,19,78,111,189
29520,MrDallreen,,19,5,3,8
29521,syntheticpubes,,18,56,2,58
29522,DeadBent,,18,33,54,87
29523,woowoooo,,13,4,14,18
29524,ilan,,20,9,6,15
29525,taniaderveaux,,0,154,3,157
29526,chromakode,,20,349,260,609
29527,nostrademons,,20,375,473,848
29528,sybersonic,,13,92,40,132
29529,ryansmeets,,43,5,1,6
29530,jweebo,,18,31,46,77
29531,toddmanqa,,22,1,1,2
29532,kellegous,,20,14,1,15
29533,Nexus_Zero,,30,5,4,9
29534,Ohfscott,,34,1,2,3
29535,rmtatum,,19,6,2,8
29536,esdraelon,,13,11,8,19
29537,scarheel,,19,24,41,65
29538,pyramix,,19,3,4,7
29539,cibyr,,18,54,26,80
29540,sterne,,19,29,34,63
29541,jcal,,42,15,24,39
29542,WanderingStars,,19,11,30,41
29543,pja,,20,5,8,13
29544,NoRealHat,,34,8,28,36
29545,SexyItaliaBella,,37,4,1,5
29546,DarkGoosey,,20,121,137,258
29547,stalematedizzy,,1,7,3,10
29548,thehustler,,19,9,31,40
29549,FRABAR,,18,7,13,20
29550,mdasenn,,20,59,24,83
29551,iluvlucyie,,13,1,2,3
29552,holst,,19,1,2,3
29553,dingbatman,,20,3,1,4
29554,justindossey,,10,5,6,11
29555,GreyWalker,,12,20,34,54
29556,willans,,7,1,2,3
29557,wombatsneedlove,,29,2,3,5
29558,meeb,,22,46,73,119
29559,theragu40,,17,3,1,4
29560,dbauchary,,12,3,1,4
29561,linkserf,,5,36,3,39
29562,osiris7,,0,27,39,66
29563,DrOOpieS,,18,18,46,64
29564,dink_,,0,84,17,101
29565,esotericguy,,18,378,283,661
29566,dotseeohdotzedaye,,32,2,6,8
29567,hayabusarider,,14,3,4,7
29568,Xzibit,,18,13,27,40
29569,arowan,,1,466,358,824
29570,doctornick,,20,190,22,212
29571,spdowling,,13,3,2,5
29572,Pinky88,,43,1,2,3
29573,pacbat,,21,2,2,4
29574,TBob,,42,54,86,140
29575,tow2a,,1,1,1,2
29576,andreah,,43,1,1,2
29577,hellz_yeah,,22,15,20,35
29578,GullyF,,41,1,1,2
29579,jk1150,,0,252,324,576
29580,aut0maticdan,,23,1,2,3
29581,monobot2,,13,81,84,165
29582,leolaith,,31,2,1,3
29583,mutable_beast,,13,4,8,12
29584,elcapitanp,,32,4,4,8
29585,richcoder,,13,18,9,27
29586,Futile,,22,1,1,2
29587,dpk,,31,1,1,2
29588,pseudomind,,32,3,5,8
29589,Yanaran,,42,8,6,14
29590,rubarb,,13,2,2,4
29591,ztorgo,,19,7,2,9
29592,snowbbdd,,36,4,3,7
29593,simplezeal,,17,1,1,2
29594,buffyoda,,20,1,3,4
29595,robtotheb,,31,1,1,2
29596,marike,,20,49,61,110
29597,Rolo,,34,18,3,21
29598,jertheripper,,9,1,1,2
29599,weedwhacker,,18,3,16,19
29600,grant0,,43,102,109,211
29601,lamby,,20,43,63,106
29602,apodo,,19,5,5,10
29603,pelirrojo,,1,433,494,927
29604,dancingholly,,5,2,4,6
29605,thunder_rob,,19,602,393,995
29606,alulim,,0,14,28,42
29607,pamiamb,,18,6,4,10
29608,pessimist,,6,4,5,9
29609,thinkpol,,27,3,1,4
29610,ZMANKER,,31,1,1,2
29611,tissle,,43,73,102,175
29612,kindling,,32,21,8,29
29613,EliezerYudkowsky,,29,1,2,3
29614,vbhtngr,,20,8,1,9
29615,jtanniru,,34,1,1,2
29616,laserman92027,,11,2,2,4
29617,gorrepati,,30,11,19,30
29618,sauce71,,0,1,3,4
29619,andre2003s,,19,2,3,5
29620,yabadaba,,39,1,1,2
29621,werdan,,18,5,12,17
29622,wyvern1,,13,2,2,4
29623,contre,,1,3,6,9
29624,rocksmom,,13,28,14,42
29625,JasonHears,,13,153,197,350
29626,smithfield,,20,1,2,3
29627,BoonTobias,,18,82,115,197
29628,felzix,,20,1,3,4
29629,hwillis,,18,16,43,59
29630,spaniardslikelisp,,1,1,2,3
29631,5aculu5,,13,9,16,25
29632,swordsaintzero,,1,36,36,72
29633,Nimish,,20,105,145,250
29634,Vladekk,,20,52,64,116
29635,plix,,4,4,2,6
29636,GayJewishNazi,,8,2,1,3
29637,phlux,,32,64,86,150
29638,carlio,,20,372,86,458
29639,thebandit,,1,1,1,2
29640,pinginfan1,,4,7,21,28
29641,INIT_6,,18,23,26,49
29642,the_confused,,18,138,58,196
29643,biokinetic,,13,21,42,63
29644,justice4all,,13,32,3,35
29645,terazx,,19,9,1,10
29646,mountain19,,13,22,10,32
29647,aardvark1,,43,23,42,65
29648,angliss,,19,32,12,44
29649,gong,,20,2,4,6
29650,logical,,0,131,80,211
29651,squirrelthetic,,32,2,5,7
29652,organised,,22,1,1,2
29653,junk8755,,1,362,261,623
29654,tntnews,,43,78,96,174
29655,AmieN,,13,35,5,40
29656,kngfling,,29,1,1,2
29657,notreallyuser,,12,1,3,4
29658,jamesj,,1,106,104,210
29659,sincewednesday,,19,59,62,121
29660,johnsibly,,32,1,1,2
29661,SamyK,,18,83,46,129
29662,bday_on_august_27,,1,10,1,11
29663,stinkystank,,5,1,1,2
29664,brownkidd,,18,18,2,20
29665,c0ldfusi0n,,5,167,255,422
29666,DODECAHEDRON,,43,1,5,6
29667,goingstuckey,,13,14,3,17
29668,snra786,,5,6,2,8
29669,thernkworks,,34,2,1,3
29670,minigamer1896,,1,34,57,91
29671,helleborus,,18,294,509,803
29672,Erikk,,43,5,3,8
29673,Pillow_Talk,,19,36,71,107
29674,tiredofthis,,19,2,1,3
29675,atientp,,19,1,1,2
29676,PizzaKiller,,14,3,1,4
29677,a_labelle,,1,12,3,15
29678,linuxcod3r,,31,1,1,2
29679,ZaaK433,,3,501,977,1478
29680,zombietwat,,22,1,2,3
29681,bigot,,19,6,3,9
29682,courbabe,,33,5,5,10
29683,2percentright,,18,50,77,127
29684,sh0tzy,,6,2,1,3
29685,jomofo,,0,50,17,67
29686,Captainfidget,,12,118,101,219
29687,Mahmoud_Ahmadinejad,,38,1,7,8
29688,Weebs,,20,15,5,20
29689,nkription,,18,1,4,5
29690,doddi,,18,8,12,20
29691,interg12,,13,825,48,873
29692,laughingboy0,,20,7,5,12
29693,dennern,,14,1,2,3
29694,anatoly,,20,29,39,68
29695,SirRobS,,3,2,1,3
29696,Lykus42,,32,2,7,9
29697,ojiisan,,31,31,35,66
29698,garyes19,,19,8,4,12
29699,arikb,,43,6,15,21
29700,adamld,,32,123,216,339
29701,I_E_Leibowitz,,17,1,1,2
29702,peterb518,,20,2,3,5
29703,Uzah,,31,5,2,7
29704,Klorox,,19,52,91,143
29705,joseacolor,,25,6,8,14
29706,oku,,34,105,103,208
29707,elmer_the_arse,,31,44,114,158
29708,ph8,,14,1,1,2
29709,grampybone,,42,50,82,132
29710,lardo,,18,6,1,7
29711,ragatiki504,,6,1,1,2
29712,Rofl_Waffler,,20,90,188,278
29713,thrax1fy,,19,9,19,28
29714,dooooood,,19,4,9,13
29715,sparhawk1985,,13,6,3,9
29716,Dead1nside,,43,8,20,28
29717,StormCraft,,19,38,6,44
29718,cvolz,,1,41,5,46
29719,followup,,22,24,2,26
29720,Wunderbar,,18,53,119,172
29721,psycko,,1,71,83,154
29722,picmium,,43,257,2,259
29723,playmusic,,13,6,1,7
29724,ansdofuno,,14,18,5,23
29725,plawplew,,20,2,2,4
29726,dreamslaughter,,29,29,16,45
29727,Anal-Limpet,,19,1,1,2
29728,nathanielb,,1,4,5,9
29729,dungar,,0,36,36,72
29730,Moj0,,12,8,14,22
29731,159734682,,31,19,35,54
29732,armhead,,19,54,49,103
29733,getemboys,,19,4,3,7
29734,Alexiares,,6,3,1,4
29735,OlderIgor,,31,20,38,58
29736,davidbgonzalez,,6,2,1,3
29737,s_reed,,0,21,36,57
29738,libertyy,,1,20,8,28
29739,doug11235,,20,21,4,25
29740,thrillhouse,,31,37,30,67
29741,spikedLemur,,31,28,26,54
29742,constellation,,43,8,18,26
29743,toefur,,18,13,16,29
29744,lazylion_ca,,13,33,38,71
29745,NekkedRingworm,,31,2,3,5
29746,quodestveritas,,43,29,18,47
29747,killercanary,,27,4,3,7
29748,Ablerank,,42,14,35,49
29749,gator2112,,13,72,2,74
29750,americanender,,18,2,2,4
29751,recoton007,,18,1,1,2
29752,sanswork,,42,6,10,16
29753,geogaddii,,18,5,9,14
29754,vrangnarr,,18,50,37,87
29755,dfaraci,,13,70,146,216
29756,edderly,,20,3,5,8
29757,vikramhaer,,34,2,3,5
29758,gehenom,,43,117,139,256
29759,haywired,,18,4,10,14
29760,Watanabex,,6,1,2,3
29761,santas_boyfriend,,20,1,2,3
29762,Anarkos,,13,5,26,31
29763,jackattax,,0,1,1,2
29764,So_Cash,,17,5,1,6
29765,YellowSnot,,22,3,9,12
29766,dirkachbar,,1,31,54,85
29767,moonman,,1,489,804,1293
29768,aylarose4,,18,3,5,8
29769,Phallicular,,18,5,6,11
29770,akifbayram,,1,49,41,90
29771,redditbannedmetwice,,31,12,18,30
29772,noworld,,4,2,1,3
29773,just_sayin,,20,3,1,4
29774,dbbob,,13,184,11,195
29775,blufr0g,,19,1214,1126,2340
29776,ididntREADIT,,33,4,2,6
29777,GeorgeForemanGrillz,,18,6,34,40
29778,ninjamongoose,,13,15,34,49
29779,Estoye,,18,22,27,49
29780,karlb103,,19,2,3,5
29781,elvisliveson,,13,495,636,1131
29782,justanother_R0boT,,22,84,84,168
29783,chriscooley,,22,2,1,3
29784,gizmothe1,,5,568,23,591
29785,addsense,,18,20,28,48
29786,Grammer,,36,1,1,2
29787,CygnusX1,,20,23,24,47
29788,piratebroadcast,,0,19,17,36
29789,danprager,,20,3,4,7
29790,mnemonicsloth,,22,1,1,2
29791,blay,,31,1,2,3
29792,gasull,,31,43,70,113
29793,ThePoopsmith,,6,14,9,23
29794,burty89,,20,5,7,12
29795,thetripp,,20,23,24,47
29796,goondocks,,20,115,65,180
29797,nickellis14,,18,2,3,5
29798,ehares,,42,1,2,3
29799,Siksay,,1,3,7,10
29800,shit,,20,228,277,505
29801,TBMonkey,,13,90,151,241
29802,Svenstaro,,20,81,149,230
29803,owen007,,0,21,2,23
29804,drysquid,,20,38,51,89
29805,MAXZOOM,,18,6,14,20
29806,doublejrecords,,13,4,6,10
29807,ampegg,,43,1,2,3
29808,liza,,13,13,7,20
29809,PrawnSolo,,30,91,74,165
29810,isny,,16,4,8,12
29811,mattalexx,,18,1,8,9
29812,Copy_Cat,,13,1,1,2
29813,bosco,,20,40,19,59
29814,whitlock,,19,6,9,15
29815,ohblair,,10,14,17,31
29816,tullypimp,,0,234,316,550
29817,hirak99,,31,1,7,8
29818,coc_ar,,0,47,25,72
29819,Rhadoo1980,,18,24,12,36
29820,silverlight,,22,105,35,140
29821,Anzat,,32,36,55,91
29822,Tobiaswk,,8,33,62,95
29823,jacobmiller,,0,463,249,712
29824,ABentSpoon,,43,23,30,53
29825,cman_04,,20,54,47,101
29826,level255,,6,1,1,2
29827,Ingenium13,,34,73,8,81
29828,TomorrowPlusX,,4,155,130,285
29829,statbit,,32,1,2,3
29830,ephebobear,,1,1,1,2
29831,saisniorp,,8,3,4,7
29832,diamondjo,,29,31,29,60
29833,GaryOak,,16,1,2,3
29834,lordbee,,0,66,2,68
29835,revo86,,31,2,2,4
29836,finerrecliner,,18,293,132,425
29837,CarsonCity314,,13,21,45,66
29838,zooky,,19,4,15,19
29839,lethain,,20,10,5,15
29840,nor-and-or-not,,8,1,3,4
29841,katzmo,,12,1,4,5
29842,slavojzizek,,20,1,1,2
29843,neilgorman,,31,1,1,2
29844,no_dice,,3,67,49,116
29845,SCVirus,,4,83,114,197
29846,bishopbrady,,17,2,1,3
29847,westmini,,6,3,4,7
29848,jswedler,,20,2,1,3
29849,Glassius,,0,3,4,7
29850,steveuk50,,19,50,79,129
29851,mtnkodiak,,43,123,136,259
29852,Howie509,,13,57,100,157
29853,personator,,20,6,3,9
29854,subzerogts,,31,426,541,967
29855,dreish,,29,18,43,61
29856,burdalane,,20,160,320,480
29857,thefedexpope1,,18,11,2,13
29858,HillaryRodhamClinton,,40,1,2,3
29859,keanu_reeves,,18,41,60,101
29860,Doingitwrong,,22,16,18,34
29861,piersicuta,,43,1,1,2
29862,MohamedO,,1,3,5,8
29863,fictionclemens,,43,27,27,54
29864,youcaughtthegay,,7,4,13,17
29865,senecavirus,,18,9,16,25
29866,MrJolly,,1,10,1,11
29867,Arve,,20,2439,498,2937
29868,fastdruid,,20,1,1,2
29869,Arcueid01,,19,52,97,149
29870,gtrmike,,13,55,25,80
29871,indeyets,,20,32,7,39
29872,haberman,,20,3,2,5
29873,WhyOhWhyOhWhy,,13,24,34,58
29874,Untruth,,43,2,5,7
29875,dead_ed,,6,426,989,1415
29876,socialskills,,4,1,1,2
29877,ibanex22,,20,55,6,61
29878,burgermind,,22,64,104,168
29879,abcboy,,13,17,2,19
29880,blindmonk,,22,41,55,96
29881,pznn,,38,1,6,7
29882,steamynachos,,18,131,248,379
29883,jeremymcanally,,20,40,54,94
29884,thatfuckingjerk,,21,2,3,5
29885,almodozo,,32,32,25,57
29886,rask,,22,27,24,51
29887,siovene,,20,47,28,75
29888,Invader_Zim,,43,3,3,6
29889,Ionis,,18,3,3,6
29890,bernypark,,36,1,4,5
29891,wanderingcynic,,34,3,7,10
29892,plasticbuddha,,13,1,2,3
29893,baconn,,42,336,400,736
29894,derekco,,18,68,14,82
29895,crazyfinx,,18,4,3,7
29896,technonotice,,20,8,3,11
29897,yoink,,43,8,7,15
29898,GregTBunny,,13,26,6,32
29899,blue58,,32,1,1,2
29900,obamaman99,,14,1,1,2
29901,Afaflix,,6,35,38,73
29902,somerandommember,,13,12,20,32
29903,McReasonable,,13,5,3,8
29904,quag,,20,9,8,17
29905,soldier4568,,31,1,1,2
29906,NoParents,,18,3,1,4
29907,b21ft,,29,2,3,5
29908,Dexter77,,3,72,69,141
29909,costin,,19,8,4,12
29910,locu,,5,1,6,7
29911,Alpx5,,13,1,1,2
29912,metalchick70,,1,4,1,5
29913,bluecup,,13,10,10,20
29914,KishCom,,30,247,171,418
29915,phoenixshard,,19,2,2,4
29916,BradHAWK,,15,4,4,8
29917,static,,20,10,16,26
29918,dibbler2,,31,57,77,134
29919,denmoff,,42,1,1,2
29920,tqh20178,,9,1,1,2
29921,MIkeR1988,,11,1,4,5
29922,howpeegoo,,22,3,5,8
29923,db2,,19,950,1512,2462
29924,Throwmeabone,,32,43,107,150
29925,jkkramer,,20,12,11,23
29926,msx,,26,1,2,3
29927,FRONTIER_PHARMACIST,,22,2,1,3
29928,diamond,,35,1096,1307,2403
29929,unkb,,1,24,3,27
29930,Eivo,,32,3,1,4
29931,robertglenn,,3,9,9,18
29932,brcleeroy,,15,5,8,13
29933,bethlehem18,,18,29,34,63
29934,RobWW,,13,93,184,277
29935,wallyf11,,18,2,1,3
29936,fillmore,,29,3,1,4
29937,Capitain_Oblivion,,20,17,25,42
29938,WSPCambridge,,20,2,1,3
29939,punny,,19,5,3,8
29940,freemarketmyass,,1,8,1,9
29941,madoublet,,22,10,21,31
29942,SaddleShoe,,6,7,17,24
29943,timepad,,18,2,5,7
29944,necromancer1976,,18,326,11,337
29945,kublakhan1816,,18,220,323,543
29946,aktufe,,31,147,221,368
29947,greeny789,,17,1,3,4
29948,trifecta,,13,628,101,729
29949,SgtCedar,,13,6,3,9
29950,dano85,,29,3,3,6
29951,Trevj,,12,45,61,106
29952,MarcoVincenzo,,0,11,35,46
29953,pedanticdave,,8,3,5,8
29954,zpweeks,,22,1,1,2
29955,psyyduck,,20,1,7,8
29956,sunnyjim,,19,7,28,35
29957,nugan,,29,2,4,6
29958,hootnanny,,19,22,39,61
29959,someuser,,29,1,2,3
29960,jonathanownbey,,11,4,5,9
29961,doremon313,,32,18,39,57
29962,smika,,13,258,192,450
29963,h2gofast,,19,45,124,169
29964,lordgibby0,,18,5,8,13
29965,D2dodder,,1,41,93,134
29966,ScienceSpeakingHere,,22,7,1,8
29967,mafihotz,,31,14,1,15
29968,MarcelleLeahy,,41,4,3,7
29969,redditron,,13,44,45,89
29970,chksixx,,10,1,1,2
29971,fuzzyl0g1c,,8,1,2,3
29972,deviantz,,28,1,1,2
29973,kevxross,,17,1,4,5
29974,woman_on_reddit_omg,,43,2,1,3
29975,arnoldo101,,5,1,1,2
29976,CSharpSauce,,18,40,54,94
29977,SpellNazi,,6,2,2,4
29978,alanpost,,19,18,46,64
29979,player2,,20,133,172,305
29980,mburke6,,13,3,3,6
29981,danth,,36,73,53,126
29982,pjprd,,18,3,3,6
29983,nordo,,34,143,230,373
29984,thant,,31,6,8,14
29985,kidcannuck,,30,1,1,2
29986,pauld,,19,1,1,2
29987,timmox,,42,1,1,2
29988,random-wharfedale,,13,1,6,7
29989,drboyd,,13,14,15,29
29990,malune,,20,2,3,5
29991,dist,,20,1,2,3
29992,cosmokramer,,32,15,1,16
29993,corewarrior,,20,3,1,4
29994,nikils,,1,32,2,34
29995,bryanalves,,20,7,15,22
29996,bishopcheck,,19,9,14,23
29997,conciliatory,,20,74,22,96
29998,turtletail,,19,12,18,30
29999,322,,43,44,3,47
30000,iamnoah,,22,118,159,277
30001,picfan,,21,1,2,3
30002,tico86,,13,40,56,96
30003,thasiet,,4,26,56,82
30004,TooSloJoe,,5,7,12,19
30005,buttz,,18,3,8,11
30006,psilva,,14,5,5,10
30007,klook,,29,1,3,4
30008,Stevey,,19,14,21,35
30009,joshchapstick,,31,2,1,3
30010,Luminaire,,42,1,1,2
30011,Humphrey0,,13,8,4,12
30012,hasiangurl,,32,1,1,2
30013,Reno1,,13,3,7,10
30014,ajaw,,32,53,2,55
30015,WillardMittRomney,,27,2,4,6
30016,StormTheGates,,6,45,21,66
30017,Cole2026,,19,36,47,83
30018,lukeredpath,,20,17,30,47
30019,shitkicker,,18,77,44,121
30020,jawalking,,21,2,2,4
30021,WaterBottle22,,1,1,1,2
30022,ando-xxx,,8,1,1,2
30023,Koniferous,,43,65,94,159
30024,hsenag,,20,14,21,35
30025,pgoetz,,20,17,21,38
30026,ccasey,,19,42,30,72
30027,ajushi,,43,1,2,3
30028,JimRoepcke,,0,1,1,2
30029,chuong1981,,12,1,1,2
30030,ladykaty24,,16,1,1,2
30031,FraterNS,,4,1,2,3
30032,matt88,,34,6,15,21
30033,intuition25,,18,41,63,104
30034,voice_of_civility,,29,1,1,2
30035,masterbaexunn,,19,57,127,184
30036,tkeeley,,13,117,18,135
30037,tinderstix,,34,4,2,6
30038,Borris,,1,1,1,2
30039,uksaunders,,5,9,7,16
30040,Barnesy8,,5,18,9,27
30041,harma,,20,5,7,12
30042,grandpawiggly,,13,106,54,160
30043,yatpay,,1,27,12,39
30044,bazta,,19,5,4,9
30045,possiblyj,,18,1,1,2
30046,stanthebat,,31,44,44,88
30047,c_a_turner,,42,116,54,170
30048,danielsoneg,,19,37,61,98
30049,cpualani,,29,2,1,3
30050,master_rahl,,18,21,19,40
30051,bward76,,19,2,2,4
30052,adelime,,16,1,3,4
30053,sendmoreparamedics,,10,6,1,7
30054,phreakymonkey,,18,382,412,794
30055,the13thzen,,13,12,10,22
30056,Bjoolz,,30,3,1,4
30057,Internets,,5,1,2,3
30058,joka86,,18,301,28,329
30059,zakalwe30,,19,36,99,135
30060,zip99,,32,2,4,6
30061,madmax_br5,,43,913,748,1661
30062,kriegsdrachen,,18,44,71,115
30063,skawaii,,20,2,3,5
30064,Nanobe,,20,6,4,10
30065,ncesare,,6,7,1,8
30066,crgreddit,,29,1,2,3
30067,reverz,,13,17,11,28
30068,jakewolf,,19,2,5,7
30069,Roughy,,18,38,84,122
30070,jchrome,,13,2,4,6
30071,gnotredditor,,34,3,7,10
30072,breadtk,,18,2,9,11
30073,hi123123,,36,1,2,3
30074,dgrant,,30,161,126,287
30075,potatomato,,43,2,1,3
30076,guanxi,,13,6,22,28
30077,yumology,,34,76,74,150
30078,curtistheory,,18,7,1,8
30079,WalterSear,,13,130,142,272
30080,seadaddy,,6,4,2,6
30081,itsdeuce,,18,50,88,138
30082,jondissed,,18,30,41,71
30083,phaedrusalt,,22,2,9,11
30084,tourettedog,,20,8,12,20
30085,loki16,,43,2,5,7
30086,faithnomore,,31,1,1,2
30087,Sobe,,18,44,13,57
30088,sinsyder,,30,59,155,214
30089,addius,,19,34,49,83
30090,bombtrack,,13,26,17,43
30091,Teegro,,34,1,1,2
30092,Scutterbotch,,31,6,3,9
30093,tjarko,,34,18,15,33
30094,hakonlo,,20,35,60,95
30095,QueenZ,,18,20,21,41
30096,queuetue,,1,27,40,67
30097,sombrero66,,20,52,1,53
30098,Zaborix,,13,19,21,40
30099,RipTatermen,,18,3,6,9
30100,freedomISslavery,,19,1,2,3
30101,vokiel,,6,1,1,2
30102,DerelictMan,,20,11,14,25
30103,ecommando,,13,5,6,11
30104,xkageryux,,34,25,55,80
30105,spencerlucas,,11,3,3,6
30106,macmcteague,,5,1,2,3
30107,smart_ass,,22,384,527,911
30108,mikedemarais,,20,1,1,2
30109,pgiani,,19,5,1,6
30110,mikko1111,,13,2,1,3
30111,LoompaOompa,,18,59,75,134
30112,antipathy,,42,9,4,13
30113,U747,,1,30,8,38
30114,blowmage,,20,3,4,7
30115,evolrewsna,,20,2,5,7
30116,defect,,18,1,2,3
30117,systemsengineer,,19,11,42,53
30118,PessimistParty4Life,,19,4,6,10
30119,Tringle,,19,6,4,10
30120,introitus,,43,218,261,479
30121,monoglot,,13,346,304,650
30122,PTPolitics,,19,226,12,238
30123,madthomas,,20,3,2,5
30124,narupo,,18,2,2,4
30125,bwoj,,31,10,26,36
30126,krasn0yarsk,,1,33,39,72
30127,pilotbread,,28,92,132,224
30128,thepeopleseason,,22,1,4,5
30129,Hambone,,0,93,111,204
30130,myth1218,,32,1,1,2
30131,whiskeymango,,31,2,1,3
30132,Ranger_Rick,,22,2,2,4
30133,FLUSHGORDEN,,13,1,1,2
30134,neithernet,,18,72,167,239
30135,Xuyen,,18,4,7,11
30136,dumbass2008,,19,2,3,5
30137,Poplicola,,6,2,2,4
30138,LuckyBdx4,,13,228,505,733
30139,bvlietst,,32,1,5,6
30140,jacktasia,,35,6,7,13
30141,notme93,,1,24,13,37
30142,Grey-Fox,,8,2,2,4
30143,homanh,,31,27,33,60
30144,Surferess,,5,15,4,19
30145,Rotlaus,,20,2,3,5
30146,feelix,,1,57,19,76
30147,pointer2void,,20,428,531,959
30148,bigly,,22,1,1,2
30149,torode,,13,1,2,3
30150,tehmarty,,31,9,11,20
30151,rachet06,,1,8,16,24
30152,abenzenering,,31,2,4,6
30153,dwf,,31,16,23,39
30154,sharpquote,,20,3,4,7
30155,Tesaaa,,43,12,15,27
30156,fearthesheep,,18,4,1,5
30157,zeroone,,1,25,7,32
30158,badfish301,,19,238,178,416
30159,Ridiculer,,36,3,1,4
30160,crushhawk,,1,1,1,2
30161,robplace30,,35,4,7,11
30162,gin7,,20,4,6,10
30163,ieopruwiofu,,19,4,3,7
30164,zebraface,,11,1,2,3
30165,Ofenza,,18,33,30,63
30166,AmishHobo,,18,9,2,11
30167,giantpandachair,,19,26,23,49
30168,cobblehillmartin,,18,8,14,22
30169,9us,,4,75,104,179
30170,ColinStewart,,13,21,3,24
30171,eastlib,,32,18,26,44
30172,ilovemccain,,18,1,1,2
30173,blabla3,,18,6,5,11
30174,fantasma,,29,1,2,3
30175,fdasfew,,13,7,8,15
30176,NeoconDouchebags13,,34,4,10,14
30177,dicesgary,,13,17,7,24
30178,iamyourevilid,,18,2,9,11
30179,pnumb,,18,1,1,2
30180,ChoobaChabba,,18,57,42,99
30181,mrblowhart,,34,5,5,10
30182,Slick135,,18,2,3,5
30183,attackofthetim,,19,3,4,7
30184,serume,,32,39,56,95
30185,TurtleEater,,31,265,184,449
30186,krazykorean,,18,312,15,327
30187,J05H,,5,1,1,2
30188,unintuitive,,13,15,15,30
30189,stirringthepot,,19,1,3,4
30190,fivre,,20,354,482,836
30191,Zorb750,,11,19,26,45
30192,FountainsOfDave,,1,142,116,258
30193,serine,,19,16,38,54
30194,poxy1,,43,9,13,22
30195,Takalth,,19,101,69,170
30196,oniony,,22,193,198,391
30197,magnumix,,19,18,6,24
30198,edmdusty,,1,319,288,607
30199,bluecloud,,21,29,2,31
30200,eatmyshorts,,20,23,34,57
30201,wleahcim,,20,46,35,81
30202,rossovino,,29,2,1,3
30203,krisscofield,,43,6,17,23
30204,martinbishop,,20,392,260,652
30205,crankyliberal,,13,10,4,14
30206,seelen,,22,4,3,7
30207,MaxQ,,5,6,8,14
30208,dsaint,,13,5,5,10
30209,tabbser,,32,3,1,4
30210,Rubin0,,13,94,58,152
30211,itsnothdr,,5,9,2,11
30212,jaunssi,,31,5,2,7
30213,MIlanKundera,,14,1,1,2
30214,benio1804,,0,28,7,35
30215,asb,,20,55,21,76
30216,a-gorilla,,19,29,54,83
30217,mikenick42,,10,181,294,475
30218,AbeEstrada,,20,9,19,28
30219,GautierGiuliani,,18,31,79,110
30220,timeywimey,,42,149,353,502
30221,DrRoboto,,32,1,1,2
30222,DaemonXI,,18,496,325,821
30223,tehjamez,,1,82,192,274
30224,idiotboxbox,,20,1,1,2
30225,taliswolf,,6,24,42,66
30226,audaxxx,,20,1,2,3
30227,astubbs,,20,2,3,5
30228,metricton,,22,19,31,50
30229,jhherren,,20,12,7,19
30230,wajones67,,1,3,2,5
30231,pcx99,,31,121,83,204
30232,mrphillc,,20,40,43,83
30233,BoomptyMcBloog,,6,721,817,1538
30234,commentsaredeleted,,5,1,1,2
30235,Buzzby,,43,5,13,18
30236,memefilter,,1,112,236,348
30237,sea_bass,,20,1,3,4
30238,HollywoodHoes,,18,23,7,30
30239,mcnada54,,19,1,1,2
30240,abc2015,,13,5,7,12
30241,belred,,41,1,2,3
30242,ImaPC_andaNoob,,43,2,1,3
30243,Dundun,,18,23,27,50
30244,mechanon05,,12,8,2,10
30245,milohoss,,13,80,42,122
30246,trabuco007,,43,10,9,19
30247,arman0,,0,28,3,31
30248,mramm,,20,2,5,7
30249,thechitowncubs,,13,23,22,45
30250,futureruins,,36,21,64,85
30251,joetheredditor,,18,6,9,15
30252,aanand,,20,42,17,59
30253,SupaFurry,,13,152,90,242
30254,kevin70,,12,52,96,148
30255,bizplan2,,1,1,1,2
30256,pomo_homo,,18,2,3,5
30257,erisson,,20,24,21,45
30258,workreddit,,39,2,6,8
30259,oneironaut,,20,9,8,17
30260,jaxomlotus,,18,126,30,156
30261,Ethril,,18,2,2,4
30262,sriramalka,,13,25,66,91
30263,TheSecondCommandment,,22,3,7,10
30264,lemnich,,22,4,3,7
30265,carrot57,,20,3,2,5
30266,wenyude,,41,1,3,4
30267,dataset,,5,22,35,57
30268,hooba,,42,1,2,3
30269,gzur,,18,13,32,45
30270,zenon,,20,24,8,32
30271,A-hole,,0,1,1,2
30272,knavillus,,34,23,19,42
30273,opsn,,19,1,2,3
30274,protocol0,,22,5,5,10
30275,S7evyn,,22,487,684,1171
30276,anonymous_troll,,1,6,5,11
30277,quizzical,,12,1,3,4
30278,learn2punctuate,,22,9,13,22
30279,genericshell,,20,52,60,112
30280,rgoslins,,34,25,8,33
30281,HeadfirstForHalos,,18,17,16,33
30282,WiZZLa,,18,32,52,84
30283,appleflaxen,,21,3,2,5
30284,Turandot,,12,6,7,13
30285,showmesomescars,,12,10,26,36
30286,mikecalios,,20,43,3,46
30287,DarthVona,,29,1,1,2
30288,jlenes,,19,18,2,20
30289,rincebrain,,20,1,1,2
30290,franimal61,,16,12,30,42
30291,michaels0620,,8,2,2,4
30292,wieczo,,18,1,4,5
30293,emmster,,1,423,619,1042
30294,DrunkPudge,,4,1,1,2
30295,flamingeyebrows,,32,358,581,939
30296,Akirasan,,14,2,1,3
30297,captain_stubbs,,42,51,61,112
30298,tfp,,20,46,41,87
30299,phjr,,20,18,28,46
30300,ke1y,,13,4,3,7
30301,rs98101,,13,15,5,20
30302,idarling,,7,56,48,104
30303,ifeatu,,30,1,1,2
30304,elurin,,20,20,9,29
30305,chameche,,1,18,39,57
30306,demonic,,42,18,8,26
30307,Psyqlone,,32,23,35,58
30308,mudah,,18,43,4,47
30309,Gravy,,34,239,17,256
30310,J_gault,,19,2,2,4
30311,Sapho,,1,1,2,3
30312,killtherebel,,18,85,25,110
30313,jamesmarshall,,22,17,12,29
30314,Thraxamer,,31,5,6,11
30315,telecaster,,13,747,726,1473
30316,schwarzwald,,20,182,131,313
30317,ruthfull,,19,13,18,31
30318,thingnumber2,,1,132,160,292
30319,bassist789,,1,44,39,83
30320,LaurieCheers,,20,440,605,1045
30321,shutyourmemehole,,20,3,1,4
30322,pickyourking,,29,1,12,13
30323,neilbarnwell,,20,1,1,2
30324,nikhil,,20,11,3,14
30325,skbrne,,22,17,30,47
30326,rboyce,,22,50,68,118
30327,Knossus,,5,4,16,20
30328,synthespian,,20,334,141,475
30329,iamchenny,,1,1,1,2
30330,sondatch,,0,201,7,208
30331,rgautier,,18,7,15,22
30332,adamx,,7,2,2,4
30333,pnsm,,20,3,4,7
30334,bradwheeler,,19,61,24,85
30335,diginux,,20,3,8,11
30336,jeff303,,20,150,279,429
30337,davidarnow,,5,1,1,2
30338,snyderjw,,1,71,106,177
30339,Ron_Paula,,32,1,1,2
30340,WhatMatters,,19,1,3,4
30341,worseneil,,0,4,4,8
30342,slackbp,,29,1,2,3
30343,mujahideenryder,,32,255,96,351
30344,jun2san,,18,196,211,407
30345,Ksero,,20,19,26,45
30346,sheepthief,,18,182,23,205
30347,spinerret,,43,14,12,26
30348,jinks,,20,29,8,37
30349,neito,,43,796,54,850
30350,dokholidae,,4,3,5,8
30351,exile29,,30,8,11,19
30352,taw,,20,334,323,657
30353,pc486,,20,28,25,53
30354,xyzzypoof,,34,41,40,81
30355,blackdeath88012,,1,43,94,137
30356,Lystrodom,,22,361,545,906
30357,Shadow6363,,1,14,6,20
30358,virtual_void,,20,12,20,32
30359,tmsagain,,34,6,10,16
30360,earthgirl1983,,27,1,3,4
30361,briandon,,20,3,2,5
30362,elZaphod,,0,1,5,6
30363,ck0,,18,1,1,2
30364,thuffner,,19,2,1,3
30365,rrihnafmgm,,20,2,2,4
30366,zero01101,,1,62,73,135
30367,PastorDisaster,,22,3,2,5
30368,geekmom2,,19,76,66,142
30369,can_has,,18,21,51,72
30370,ssn,,19,25,12,37
30371,vimau,,20,9,11,20
30372,nanooker,,11,3,2,5
30373,mondokoosh737,,18,16,28,44
30374,jibegod,,8,59,43,102
30375,zebra10,,13,121,55,176
30376,brendhan,,32,27,44,71
30377,tamu,,0,1,1,2
30378,Vovchick2004,,18,5,3,8
30379,MenosElOso,,32,3,11,14
30380,aspenbordr,,0,13,5,18
30381,mallardtheduck,,20,113,119,232
30382,k3871,,39,8,11,19
30383,tombonneau,,18,32,57,89
30384,fingstupider,,1,1,2,3
30385,devon223,,22,6,8,14
30386,Morbot,,19,44,147,191
30387,anthony_barker,,20,9,12,21
30388,jerk1off,,1,1,6,7
30389,Hershon,,13,32,3,35
30390,Heyooooh,,18,7,12,19
30391,hankols,,6,2,1,3
30392,dvorak,,22,108,162,270
30393,redditer033,,18,1,1,2
30394,Headzzot,,31,3,4,7
30395,mpinkeyes,,13,282,2,284
30396,MrUlterior,,20,28,44,72
30397,briagreen,,25,1,1,2
30398,nhinman,,4,1,2,3
30399,fagmotard,,31,5,15,20
30400,jlogelin,,30,14,4,18
30401,tromik,,1,3,10,13
30402,pasat,,18,19,1,20
30403,phouck,,29,26,47,73
30404,p0tent1al,,20,90,161,251
30405,mjw2025,,36,145,198,343
30406,MocToc,,29,1,1,2
30407,alangcarter,,41,11,26,37
30408,topnotch,,43,64,30,94
30409,xzZzZzZzx,,31,14,24,38
30410,datskosdatsko,,1,9,11,20
30411,iizsmart,,13,36,51,87
30412,skilless,,18,48,13,61
30413,badger99,,18,2,5,7
30414,SiPhuYoda,,5,1,1,2
30415,heathen_chemistry,,18,1,1,2
30416,Rufus_2,,20,1,1,2
30417,deadelephant,,18,115,206,321
30418,independentwatcher,,13,19,8,27
30419,chrystofier,,13,29,23,52
30420,MrWoIf,,22,3,15,18
30421,hveiti,,1,9,41,50
30422,JJFO,,19,278,357,635
30423,courttimesinfiniti,,35,88,186,274
30424,malfunctionality,,14,2,2,4
30425,rubikfreak,,0,5,14,19
30426,houligansz,,30,1,2,3
30427,radavasquez,,13,3,5,8
30428,ffualo,,7,1038,616,1654
30429,grusbf5,,19,3,1,4
30430,yonyonjohn,,0,18,21,39
30431,waku2waku,,34,5,4,9
30432,mcash,,13,1,1,2
30433,MyPants,,32,6,12,18
30434,sundance1028,,18,77,35,112
30435,stanleypane,,19,61,52,113
30436,hagbard_celine,,18,28,66,94
30437,intrigued11,,13,1,5,6
30438,mtyoung,,29,2,9,11
30439,mlesniak,,20,1,5,6
30440,senornono,,16,2,6,8
30441,JWF,,13,98,1,99
30442,rnixon,,22,44,10,54
30443,worthless_poster,,32,210,56,266
30444,BlackSunshine,,31,19,30,49
30445,dundas,,6,1,1,2
30446,er_er,,18,23,20,43
30447,seacrop,,22,1,1,2
30448,redditcodephp,,0,1,3,4
30449,njr,,19,56,118,174
30450,meson537,,19,29,32,61
30451,apeman,,43,78,27,105
30452,reuivcuiqowe,,20,2,1,3
30453,NOTstupid,,32,10,19,29
30454,neofuturism,,8,1,4,5
30455,sh0rty,,43,57,23,80
30456,c0d3thug,,20,15,20,35
30457,whatintheworldisthat,,12,30,31,61
30458,sidolin,,18,5,5,10
30459,markonen,,20,2,2,4
30460,ebs,,4,3,3,6
30461,piderman,,20,8,10,18
30462,KorayA,,19,15,23,38
30463,chrisgemignani,,20,2,2,4
30464,thebushdoctrine,,34,4,3,7
30465,discreet2ndaccount,,1,1,2,3
30466,Resum,,22,4,4,8
30467,stupendousman,,31,264,469,733
30468,zsoltika,,20,51,11,62
30469,japolo,,31,5,8,13
30470,riiik,,13,3,6,9
30471,languin,,19,20,19,39
30472,Artcfox,,28,1,1,2
30473,OneEyedJack,,18,10,77,87
30474,thejewishgun,,1,2,5,7
30475,slagpelosi,,31,52,136,188
30476,viclopez,,43,336,53,389
30477,xApple,,1,1,1,2
30478,Yawb,,32,1,1,2
30479,ksidbg,,40,1,1,2
30480,cunnilinguslover,,36,2,7,9
30481,burpit,,34,1,5,6
30482,kochier,,1,117,106,223
30483,Spiffjiggins,,13,59,155,214
30484,haywire,,8,982,1682,2664
30485,oracle2b,,36,2,6,8
30486,uf98787,,22,1,1,2
30487,chimchim123,,34,5,5,10
30488,blakeh,,18,27,27,54
30489,tacodog,,5,15,21,36
30490,DouchesWild,,34,13,25,38
30491,BLIPYOU,,27,1,1,2
30492,rgh,,20,6,20,26
30493,isuckcock,,31,8,15,23
30494,acyclic,,18,46,25,71
30495,NINJAF1,,43,1,1,2
30496,signal9,,34,2,4,6
30497,BoardWalker,,20,43,39,82
30498,zima,,18,23,8,31
30499,infinity,,5,20,37,57
30500,punkinpi,,31,83,135,218
30501,BastiX,,20,29,34,63
30502,eh13,,20,1,1,2
30503,bemmu,,43,1428,310,1738
30504,JokeExplainer,,33,6,1,7
30505,MrDuncan,,19,2,8,10
30506,adlittle,,18,8,25,33
30507,Aqua_lung,,31,70,76,146
30508,cy88,,10,4,1,5
30509,xMadxScientistx,,22,478,841,1319
30510,codekitchen,,20,22,26,48
30511,chrono13,,32,75,95,170
30512,Orange_Crush,,8,5,4,9
30513,kingmonkey,,13,100,6,106
30514,stubray,,34,1,2,3
30515,rasteri,,18,2,4,6
30516,MaxK,,20,14,20,34
30517,luker,,31,4,2,6
30518,armadillo,,20,16,1,17
30519,TorleyX,,18,187,125,312
30520,Cecil077,,6,9,13,22
30521,tieze,,20,2,6,8
30522,virgule,,18,124,273,397
30523,KMKSouthie2001,,1,62,23,85
30524,sirencio,,29,1,1,2
30525,desitexan,,13,285,47,332
30526,talkincat,,35,75,85,160
30527,life_is_beautiful,,20,1,3,4
30528,JonnyQabbala,,32,30,32,62
30529,aqhb11,,30,7,4,11
30530,tef,,20,58,56,114
30531,Marivs,,19,26,40,66
30532,Jaqen,,19,118,165,283
30533,yipyapyipyap,,0,1,1,2
30534,3498349848,,17,1,1,2
30535,Captain0bvious,,42,13,7,20
30536,moose262,,19,2,8,10
30537,RandySammy,,18,3,11,14
30538,angocman,,13,35,4,39
30539,Kirsten,,19,45,61,106
30540,Inigo__Montoya,,18,2,1,3
30541,YogiBerra,,19,1,1,2
30542,bayjubla,,22,7,3,10
30543,cia_plant,,20,87,78,165
30544,ningwut5000,,8,19,37,56
30545,Oogly1,,3,14,6,20
30546,garethm,,0,10,7,17
30547,johndhackensacker,,13,131,43,174
30548,TRBenji,,41,2,4,6
30549,roopp,,40,3,1,4
30550,defrost,,15,58,87,145
30551,Reactivist,,13,28,25,53
30552,mijalis,,4,2,1,3
30553,poppawinst,,18,5,6,11
30554,caldwell04,,13,7,13,20
30555,clade,,15,2,5,7
30556,mordain,,20,3,4,7
30557,isolde,,19,34,53,87
30558,gaffe,,19,8,14,22
30559,Debbie-Downer,,43,1,1,2
30560,eMigo,,13,271,419,690
30561,photo_nazzi,,18,3,1,4
30562,diegoami,,43,4,18,22
30563,Twiek,,43,129,14,143
30564,miql,,15,2,1,3
30565,INTERNET_COP,,10,1,2,3
30566,Aries9,,42,22,52,74
30567,zeroDNT,,31,13,12,25
30568,qazima,,19,32,20,52
30569,that_fun_guy,,31,8,4,12
30570,superluminal23,,18,26,2,28
30571,betab34r,,0,1,1,2
30572,ga16lucino,,19,4,8,12
30573,geekmaster01,,18,1,1,2
30574,vikingshipper,,13,3,6,9
30575,omargard,,6,180,419,599
30576,juliusctw,,18,1,1,2
30577,TheOfficeNewb,,19,44,3,47
30578,appypolly,,20,21,15,36
30579,dylan420,,19,5,16,21
30580,zimbabwe,,0,39,58,97
30581,starfire,,20,2,1,3
30582,limpinandpimpin,,14,1,2,3
30583,senlei23,,5,10,27,37
30584,northstand,,18,304,36,340
30585,flaminggarlic,,1,21,45,66
30586,ragman_43,,14,1,1,2
30587,KemperBoyd,,31,4,11,15
30588,aphroditerules,,29,1,1,2
30589,cnk,,2,144,209,353
30590,nahlol,,18,1,4,5
30591,MineDevin,,19,1,4,5
30592,sweddit,,18,287,379,666
30593,foobark,,20,3,7,10
30594,heyhellohi,,36,2,3,5
30595,sebnukem,,12,79,180,259
30596,artaak,,20,1,1,2
30597,Tranejam,,19,4,11,15
30598,NameTry2468,,13,221,58,279
30599,08orbust,,19,51,30,81
30600,eatcrayons,,13,34,22,56
30601,tensix,,1,6,6,12
30602,Kalyrn,,30,20,37,57
30603,ChevChelios,,5,603,26,629
30604,layinginwait,,19,8,9,17
30605,skopp,,0,22,41,63
30606,wolf3973,,7,11,22,33
30607,wordy,,18,3,4,7
30608,altoloco,,34,2,6,8
30609,barneytoe,,29,17,20,37
30610,Ipipholypse,,40,25,5,30
30611,rolfv,,32,232,302,534
30612,Fitzhume,,0,91,9,100
30613,unknowingjoy,,0,5,3,8
30614,deanwinters,,32,1,2,3
30615,Riddle-,,4,1,1,2
30616,strange-moo,,20,10,7,17
30617,AEA2,,43,21,54,75
30618,geekamongus,,20,21,20,41
30619,notalent,,19,6,12,18
30620,anonymoussuperman,,8,189,289,478
30621,prattmic,,32,8,4,12
30622,m0th,,22,11,7,18
30623,pkimmich,,19,1,1,2
30624,technoguyrob,,4,100,98,198
30625,dsprox,,39,9,2,11
30626,andysmith25,,5,10,6,16
30627,thadjudkins,,18,17,20,37
30628,janelsee,,18,4,5,9
30629,quasiquarck,,3,10,14,24
30630,waltm005,,19,1,7,8
30631,mizmoxie,,19,2,1,3
30632,warpspasm,,13,5,2,7
30633,bobbymac,,19,314,13,327
30634,gltexas,,43,2,1,3
30635,sallyknows,,42,4,1,5
30636,omoplata,,19,10,9,19
30637,dashOw,,20,1,2,3
30638,Ephewall,,4,103,144,247
30639,Jhonie_Fklits,,12,19,22,41
30640,shrike3000,,22,2,5,7
30641,driveways,,18,1,5,6
30642,tizona,,43,1,1,2
30643,thejungleman,,18,12,24,36
30644,lokai_,,18,6,4,10
30645,syoutsey,,36,4,2,6
30646,solarbeat,,4,15,24,39
30647,altgenetics,,20,2,2,4
30648,supercool,,26,2,1,3
30649,pahncrd,,32,85,112,197
30650,ibrahim73,,32,4,4,8
30651,khlavguy,,31,64,60,124
30652,smaerdnekorb,,1,23,17,40
30653,homesick,,12,9,65,74
30654,Misunderstandingator,,43,1,11,12
30655,leticiagirl69,,13,6,5,11
30656,PocketCultures,,0,12,4,16
30657,notsleepy,,28,7,2,9
30658,skeena1,,0,109,241,350
30659,llamaesque,,32,6,7,13
30660,neongod,,21,1,3,4
30661,ireddit2,,39,5,3,8
30662,thisisj3w,,31,7,12,19
30663,thinkerx,,19,276,9,285
30664,mikeylopez,,18,27,22,49
30665,sketec,,1,128,159,287
30666,AIHound,,29,24,25,49
30667,flexible,,31,17,5,22
30668,bordergroves,,17,8,12,20
30669,trademark912,,18,25,44,69
30670,bmdubpk,,34,4,9,13
30671,gomexz,,32,4,7,11
30672,kandams0415,,1,1,1,2
30673,unreason03,,13,6,2,8
30674,LindsS,,17,2,1,3
30675,Brantin,,19,163,46,209
30676,NecoRadio,,18,8,12,20
30677,wgosel,,20,18,10,28
30678,timjpriebe,,18,17,17,34
30679,jpatten,,19,25,21,46
30680,al343806,,13,38,101,139
30681,todahawk,,18,148,71,219
30682,Nelstone,,6,23,12,35
30683,drewlott,,19,1,1,2
30684,Ziggurattt,,18,34,103,137
30685,svendavids,,34,8,3,11
30686,DismissMystics,,1,18,23,41
30687,TheAtomicMoose,,22,25,48,73
30688,Piotr1,,1,1,1,2
30689,little_evil,,19,133,284,417
30690,honestbender,,31,1,1,2
30691,mediaman2,,19,7,10,17
30692,BBMainsequence,,20,1,3,4
30693,sugaredpeaches,,35,2,1,3
30694,michael_palin,,13,223,179,402
30695,osamabladen,,19,3,5,8
30696,seetwist,,19,40,80,120
30697,back-in-black,,18,105,127,232
30698,westsan,,19,157,423,580
30699,Rostin,,13,6,8,14
30700,BeardWand,,1,21,36,57
30701,ryanmonroe,,4,1,2,3
30702,RedditParodiesItself,,19,7,8,15
30703,harwell,,20,6,4,10
30704,tweez,,13,11,1,12
30705,wagerlabs,,20,6,11,17
30706,youngpilgrim,,18,2,1,3
30707,handsomemilo,,27,1,3,4
30708,pubs,,13,1,1,2
30709,gnurag,,1,1,7,8
30710,hyto,,1,1,1,2
30711,shanemitchell,,8,1,4,5
30712,SecurityFirst,,27,2,1,3
30713,monstercack,,1,97,187,284
30714,z3rb,,22,412,571,983
30715,Oryx,,13,1214,1399,2613
30716,BlackPocket,,7,21,49,70
30717,distantstar,,18,1,2,3
30718,gadfly1000,,13,6,19,25
30719,democracy101,,19,2790,73,2863
30720,Toma-,,18,93,81,174
30721,joeyda3rd,,21,1,2,3
30722,SuperHappyFunGuy,,22,1,3,4
30723,coconut_pete,,41,6,4,10
30724,mikemike,,20,8,10,18
30725,cybersphere9,,41,2,3,5
30726,Kalimari,,14,227,441,668
30727,gdamjan,,20,2,1,3
30728,propool,,20,147,258,405
30729,HairSupply,,20,6,7,13
30730,hax0r,,1,262,373,635
30731,troelskn,,20,116,197,313
30732,infinity777,,18,55,14,69
30733,ajh1138,,41,6,5,11
30734,StopJohnMcNasty,,13,97,101,198
30735,compubomb,,19,57,55,112
30736,EndOfTheWorldWeKnow,,18,4,1,5
30737,aristideau,,1,72,83,155
30738,madio85,,18,17,38,55
30739,oddjob60,,6,9,8,17
30740,yelocorado,,32,20,34,54
30741,qgyh2,,34,8360,1186,9546
30742,Smiley,,19,36,48,84
30743,croup,,34,78,169,247
30744,UK-sHaDoW,,20,32,33,65
30745,LinkGCN4,,22,38,51,89
30746,brightyellowsign,,32,3,2,5
30747,tr87,,40,2,1,3
30748,jphudy,,13,6,5,11
30749,sad_bug_killer,,22,178,130,308
30750,oaaao,,20,3,7,10
30751,allspinzone,,13,200,5,205
30752,alta_dena,,32,1,2,3
30753,KCasier,,3,1,2,3
30754,Ty51,,13,9,3,12
30755,Germaphobe,,27,2,1,3
30756,flowsome,,29,1,1,2
30757,greenhat,,20,4,2,6
30758,Corey24,,18,38,66,104
30759,bhumphreys,,32,55,26,81
30760,Nhoji,,18,7,15,22
30761,howL_,,18,41,28,69
30762,omninull,,20,27,45,72
30763,waxwing,,29,83,128,211
30764,The_Mudslinger,,13,3,6,9
30765,Geminize,,1,10,23,33
30766,JustJoekingEX,,13,265,685,950
30767,emordino,,18,26,65,91
30768,nitish0991,,5,2,4,6
30769,Will_T,,13,1,3,4
30770,vaterite,,42,1,1,2
30771,researchbuff,,32,10,2,12
30772,wthomas,,22,1,1,2
30773,hardtalkfk,,18,546,20,566
30774,M44Ist,,27,2,2,4
30775,U_n_I_verse,,31,2,6,8
30776,Morningstar,,20,3,4,7
30777,starman68916,,18,1,4,5
30778,monkey166,,19,2,2,4
30779,monkeydemon,,1,7,21,28
30780,helpyhelperton,,1,4,1,5
30781,smallchanger,,34,122,175,297
30782,artee,,20,17,12,29
30783,rocky_m,,43,1,1,2
30784,slimdizzy,,18,27,102,129
30785,alleagra,,13,517,358,875
30786,ryanabrams,,35,3,4,7
30787,raccou,,18,67,171,238
30788,joebwhite,,19,13,23,36
30789,lsumnler,,20,8,2,10
30790,staticjester,,18,12,32,44
30791,scook0,,20,12,23,35
30792,-___-,,18,47,66,113
30793,carmexjoe,,13,2,3,5
30794,Trindle,,20,1,2,3
30795,SirTrollALot,,12,33,34,67
30796,enochrisen,,43,5,1,6
30797,disfunct,,19,26,43,69
30798,jephthai,,20,3,6,9
30799,MyaloMark,,0,361,637,998
30800,overdosis,,19,3,6,9
30801,iav,,19,15,12,27
30802,Cannabrain,,18,57,73,130
30803,FreeToaster,,31,5,5,10
30804,grimlok,,31,1,3,4
30805,kevinglowacz,,20,9,7,16
30806,gwerstiuk,,32,4,9,13
30807,reggieray,,18,30,51,81
30808,holeeray,,1,135,239,374
30809,kiml4n,,43,1,1,2
30810,chuckieballs,,18,24,30,54
30811,hardrain,,6,13,4,17
30812,kungfulkoder,,26,1,1,2
30813,mike24,,42,2,1,3
30814,brotherbear,,18,35,43,78
30815,einexile,,4,298,542,840
30816,scottmacpherson,,42,2,2,4
30817,casiodrone,,1,2,1,3
30818,aznpwnzor,,18,4,11,15
30819,3littlebears,,13,2,4,6
30820,LudiDabar,,12,1,1,2
30821,doofus2,,13,1,5,6
30822,that_dusty_guy,,1,197,51,248
30823,bradshawz,,1,87,99,186
30824,jesus4u,,19,346,313,659
30825,marklewis87,,12,2,1,3
30826,hennagaijinjapan,,43,126,189,315
30827,americanoddjobs,,13,13,5,18
30828,obamavoter2,,4,3,1,4
30829,sharique9800,,18,38,3,41
30830,ducksa,,4,12,21,33
30831,Jyxtrant,,11,11,13,24
30832,centx,,20,9,10,19
30833,apathy,,19,474,751,1225
30834,monitron,,34,3,3,6
30835,flashboy,,31,2,1,3
30836,fentunfont,,15,163,398,561
30837,javabrewer,,0,4,7,11
30838,teflonbob,,18,43,49,92
30839,obsidianih,,38,155,272,427
30840,bytelord,,20,24,18,42
30841,farra,,20,156,153,309
30842,mdf7g,,32,3,3,6
30843,jal3473,,43,30,43,73
30844,K-W,,20,6,6,12
30845,RedSoxFan,,19,63,27,90
30846,jicksta,,32,1,3,4
30847,afroman,,30,6,13,19
30848,tartle,,31,20,26,46
30849,steveit_is,,29,14,17,31
30850,dareonion,,0,2,4,6
30851,suckitsteve,,20,2,2,4
30852,antiv,,5,1,2,3
30853,jorydotcom,,34,2,9,11
30854,GerFitz,,31,2,1,3
30855,Araya213,,18,24,64,88
30856,mbarlow310,,32,2,1,3
30857,vbsmith6x7,,18,24,37,61
30858,friendlyfoop,,34,2,3,5
30859,ShesGotSauce,,5,22,26,48
30860,jinzo,,20,15,13,28
30861,meldroc,,19,108,34,142
30862,rex84,,13,4,8,12
30863,rsk01,,0,26,8,34
30864,masterflex,,41,3,3,6
30865,burtonmkz,,30,952,1117,2069
30866,silverwater,,13,29,46,75
30867,nikbackm,,20,6,12,18
30868,sakkio,,43,7,8,15
30869,tanhauser,,18,46,64,110
30870,darthgarlic,,34,6,3,9
30871,crl826,,19,6,11,17
30872,testiculan,,0,9,22,31
30873,aornald22,,14,1,1,2
30874,igcatastrophe,,23,1,1,2
30875,dzan,,31,14,27,41
30876,livingtogether,,18,5,8,13
30877,JohnMayer,,20,4,2,6
30878,cosmo7,,20,191,224,415
30879,marklad2020,,34,75,15,90
30880,ashley059,,29,1,1,2
30881,Terex,,31,149,203,352
30882,speedeep,,20,4,2,6
30883,zerogravity,,19,102,345,447
30884,starthirteen,,18,80,123,203
30885,chrisbosh,,0,14,2,16
30886,zandercruise,,20,9,25,34
30887,collintmiller_,,20,1,2,3
30888,FoxSynergy,,32,6,33,39
30889,mr_robert,,16,1,7,8
30890,chetanbhawani,,5,1,2,3
30891,vibaka,,29,2,1,3
30892,snedig,,3,10,18,28
30893,shimei,,20,54,54,108
30894,corranhorn85,,43,9,6,15
30895,AlexPeccator,,19,8,1,9
30896,Dearon,,32,5,13,18
30897,lickedcat,,20,3,4,7
30898,cubey,,30,36,37,73
30899,Fork82,,20,57,73,130
30900,djnrrd,,0,1,3,4
30901,jwszoid,,19,194,23,217
30902,jsinjasonjsin,,20,4,2,6
30903,NerdWeasel,,18,1,1,2
30904,joincamp,,18,9,13,22
30905,xrenditionx,,13,122,20,142
30906,02J,,19,96,169,265
30907,Thimble,,20,546,713,1259
30908,mattxb,,13,241,363,604
30909,jammie1974,,19,2,5,7
30910,manu,,20,20,22,42
30911,Flupkear,,22,1,1,2
30912,trimtab,,13,6,28,34
30913,intehnet,,22,1,1,2
30914,BruceCampbell123,,42,41,62,103
30915,brict,,13,7,5,12
30916,fyl8999,,31,7,5,12
30917,hancocklg,,0,36,4,40
30918,anyb0dyme,,20,1,1,2
30919,denverlarry,,13,2,1,3
30920,stopourdrugwarblog,,10,3,4,7
30921,forbes2008,,31,3,7,10
30922,infinite,,19,1042,1530,2572
30923,rancid_squirts,,27,185,283,468
30924,rcmark,,19,1,15,16
30925,callsorputs,,18,198,32,230
30926,mach7,,20,54,21,75
30927,GonnaRideIt,,1,5,1,6
30928,osfameron,,20,2,5,7
30929,Wheelwright,,20,48,43,91
30930,Simulacron3,,0,16,18,34
30931,diabloenfuego,,5,2,2,4
30932,the_anti_christ,,1,5,8,13
30933,reppit,,18,84,166,250
30934,PhillyNetminder,,1,39,22,61
30935,ffn,,1,95,110,205
30936,ac_dispatcher,,32,1,1,2
30937,Demonmonger,,0,180,69,249
30938,Nutricidal,,19,172,179,351
30939,requestedRerun,,8,1,7,8
30940,Hangly,,6,41,108,149
30941,farmerje,,20,78,30,108
30942,sirscooter,,13,9,19,28
30943,lord_jesus_christ,,19,5,7,12
30944,chaos,,20,20,44,64
30945,omgwtfuspolitics,,13,149,64,213
30946,uncle_jesse,,42,1,1,2
30947,shamrick79,,8,3,2,5
30948,laxdef10,,35,1,1,2
30949,festus,,38,3,1,4
30950,mpdefeo,,30,1,1,2
30951,anonymous11235,,13,23,28,51
30952,mibi,,18,20,44,64
30953,mambo78,,13,1,1,2
30954,wohho,,34,78,110,188
30955,stbill79,,20,15,12,27
30956,getty,,5,3,3,6
30957,lrrr,,6,3,3,6
30958,pimaniac,,20,17,12,29
30959,betamike,,18,6,2,8
30960,tdk2fe,,13,379,585,964
30961,Chromo,,18,1,3,4
30962,mtrommer,,1,13,12,25
30963,maccdrizzle,,18,7,2,9
30964,nobama71,,32,1,1,2
30965,azimuth,,4,13,19,32
30966,troothsayer,,43,2,4,6
30967,scalz1,,19,1,5,6
30968,R-R-R-R-R-R-RONPAUL,,19,34,56,90
30969,bimalr,,20,16,1,17
30970,daemonwolf,,18,1,4,5
30971,doodlesmalone,,20,23,22,45
30972,bitt3n,,10,111,142,253
30973,FlipNasty,,18,10,13,23
30974,jimweirich,,20,1,1,2
30975,aseclear,,29,14,27,41
30976,DavidSJ,,20,347,89,436
30977,prashmohan,,20,3,5,8
30978,wintermute,,20,19,12,31
30979,qgyh1,,34,1,2,3
30980,Tairy_Greene,,43,6,7,13
30981,toddec,,11,1,1,2
30982,ronpaulFTMFW,,19,28,39,67
30983,zakharov,,40,6,2,8
30984,scottpanton,,1,1,1,2
30985,tangentboy,,19,353,534,887
30986,JohnUSeed,,19,67,7,74
30987,shuri,,43,1,2,3
30988,uuiioopp,,0,3,1,4
30989,mrminty,,1,142,273,415
30990,calp,,20,106,161,267
30991,AmericanPatriot,,19,63,19,82
30992,amazoncon,,18,15,20,35
30993,harpoonz,,18,56,51,107
30994,pugface,,32,2,2,4
30995,lovecraftiansock1,,20,2,1,3
30996,chaconne,,31,160,237,397
30997,naive,,15,1,1,2
30998,Gwarek2,,18,46,116,162
30999,chant,,8,3,4,7
31000,stringer4,,18,43,47,90
31001,geekunit,,34,6,1,7
31002,BioGeek,,20,978,66,1044
31003,PainfullyObvious,,18,27,4,31
31004,daveafx,,13,10,14,24
31005,cayennext,,20,3,4,7
31006,pigalien1,,13,9,16,25
31007,icaruswings0,,9,7,14,21
31008,salsas,,5,1,5,6
31009,Grahar64,,18,31,43,74
31010,tikkun,,20,46,86,132
31011,Fixthemedia,,4,3,4,7
31012,miskulecka,,22,4,3,7
31013,baabaah,,15,2,1,3
31014,ThreeWordAl,,13,2,12,14
31015,rizaus,,19,1,5,6
31016,Norseman2,,20,17,20,37
31017,guy123,,1,95,102,197
31018,sublimation,,20,9,10,19
31019,ashkendo,,6,29,13,42
31020,puzza007,,20,10,17,27
31021,madriutt,,18,12,26,38
31022,eras,,20,29,42,71
31023,Hiccup,,19,22,23,45
31024,hvee7,,4,17,8,25
31025,Chanotc,,18,61,100,161
31026,JennSierra,,13,55,1,56
31027,gotfoo,,31,4,6,10
31028,dieselstation,,1,6,11,17
31029,dieselray9999,,0,50,114,164
31030,FalleenFan,,1,6,5,11
31031,jojotdfb,,20,130,206,336
31032,Sh3ut,,13,9,2,11
31033,nfck,,18,8,1,9
31034,econous,,19,90,135,225
31035,david927,,20,7,11,18
31036,DanWallace,,9,1,3,4
31037,woohalladoobop,,18,32,37,69
31038,unix_mind,,43,1,5,6
31039,oobewan,,34,1,2,3
31040,abhoffman,,13,7,6,13
31041,Rodman930,,13,301,288,589
31042,dunkelzahn,,1,3,7,10
31043,happydahg,,19,105,119,224
31044,phaed,,43,62,120,182
31045,blacklouis,,19,7,12,19
31046,justush,,20,4,4,8
31047,John_Idol,,20,26,5,31
31048,natgeo,,18,13,1,14
31049,manatlan,,20,3,3,6
31050,billygoat2000,,0,2,2,4
31051,kazakdogofspace,,13,13,21,34
31052,rlxtr,,13,1,1,2
31053,megadump,,42,3,3,6
31054,I_Love_Dr,,19,3,1,4
31055,SickFinga,,18,150,61,211
31056,dotlizard,,5,3,2,5
31057,versusgorilla,,36,1,2,3
31058,babyjesus31,,19,4,25,29
31059,Einstine1984,,32,1,1,2
31060,uzimonkey,,20,33,50,83
31061,java999,,13,80,164,244
31062,scooby1680,,20,2,10,12
31063,monocle,,13,12,20,32
31064,sudonim87,,20,12,12,24
31065,flinchy,,22,5,5,10
31066,evildrdan,,1,7,15,22
31067,Straus,,32,6,12,18
31068,cleborp,,6,3,2,5
31069,bwargh,,1,28,10,38
31070,boot13,,32,4,3,7
31071,wrathofrath,,1,18,28,46
31072,afaf90,,1,2,2,4
31073,makked,,43,12,13,25
31074,Huvet,,6,2,2,4
31075,ytfcman,,19,1,1,2
31076,Trailing_Offf,,22,1,2,3
31077,ventonegro,,20,67,35,102
31078,bradynliam,,16,2,1,3
31079,BeornS,,20,4,1,5
31080,emagdnim2100,,19,46,40,86
31081,MirrorGirl,,31,1,2,3
31082,enterneo,,20,2,3,5
31083,sgndave,,20,70,80,150
31084,dariusmonsef,,5,29,7,36
31085,bilyl,,4,39,29,68
31086,Kijjii,,0,5,1,6
31087,focus,,18,8,29,37
31088,vazelos,,20,9,1,10
31089,beethovensghost,,43,5,3,8
31090,nmbfdbskf,,30,5,4,9
31091,schmeebis,,8,2,6,8
31092,ankmorp,,18,1,1,2
31093,Tasach,,31,24,21,45
31094,EmileRedant,,23,7,9,16
31095,baatezu,,18,4,2,6
31096,BigBigBigWhoop,,7,1,3,4
31097,bdefore,,19,15,20,35
31098,xeromem,,32,1,1,2
31099,naturboy20,,13,54,30,84
31100,AlphaTeam,,19,2,3,5
31101,applecore,,14,1,2,3
31102,midtable_obscurity,,19,10,25,35
31103,pmh160,,13,119,107,226
31104,hajk,,8,239,568,807
31105,brumoeller,,32,1,1,2
31106,venturanima,,18,54,77,131
31107,jackcrow69,,18,8,16,24
31108,Xet,,18,332,392,724
31109,tsteele999,,13,3,1,4
31110,raplvr,,0,3,2,5
31111,mopel,,20,1,1,2
31112,Iamspecial,,31,1,1,2
31113,stimcaps,,19,61,55,116
31114,EddieStarr,,13,7,1,8
31115,haroldhupmobile,,8,5,5,10
31116,sgblinky,,22,2,11,13
31117,railsjedi,,20,20,6,26
31118,bobpaul,,36,1544,2349,3893
31119,OMGiGotdownmoddedLOL,,8,4,4,8
31120,rhonva,,6,9,10,19
31121,jackson58,,15,3,1,4
31122,potatolicious,,30,120,110,230
31123,kast,,20,7,3,10
31124,rubynho,,20,3,6,9
31125,Celsis,,18,69,26,95
31126,brheath,,1,54,43,97
31127,pawnticket,,32,13,23,36
31128,JuCee,,13,129,188,317
31129,Judy-Lee,,12,29,54,83
31130,gordon_c,,11,7,4,11
31131,srmjjg,,19,725,188,913
31132,frankba11,,43,1,3,4
31133,f3l1x,,1,3,4,7
31134,austinfrank,,18,10,17,27
31135,twinwing,,20,5,4,9
31136,recursion,,43,19,14,33
31137,petra234,,34,3,5,8
31138,component,,15,3,2,5
31139,infininme,,13,4,4,8
31140,Maexotic,,13,1,1,2
31141,lintrone,,36,9,8,17
31142,mackprime,,12,798,1290,2088
31143,twwilliams,,19,19,10,29
31144,Folkvangr,,31,19,4,23
31145,emaa,,31,1,1,2
31146,CrunchyRoll,,32,3,3,6
31147,oofoe,,20,18,22,40
31148,pseudonym_again,,13,2,3,5
31149,igkunow,,1,76,4,80
31150,normmccray,,12,2,1,3
31151,black3ug,,30,1,2,3
31152,joaoma,,20,2,2,4
31153,Vomitron,,32,20,10,30
31154,yousername,,13,5,1,6
31155,daldraeic,,39,3,3,6
31156,nolebotic,,32,8,1,9
31157,silence8086,,32,4,7,11
31158,cynopt,,42,3,10,13
31159,pestcontrols,,18,101,118,219
31160,supersi,,18,25,27,52
31161,mikko22222,,4,3,2,5
31162,rdosser,,32,6,12,18
31163,jeb,,31,32,34,66
31164,cbfreder,,6,53,58,111
31165,FreeBSoD,,20,1,1,2
31166,vgi19,,32,1,1,2
31167,0N1KUDAK1,,17,2,2,4
31168,iamadeathgod,,13,1,6,7
31169,notor,,19,237,181,418
31170,chriswitts,,20,2,2,4
31171,lrhamelin,,29,2,3,5
31172,SuperMechaDan,,1,1,6,7
31173,Cosmonaut86,,8,81,3,84
31174,black_belt_jones,,43,40,124,164
31175,boysha,,20,4,2,6
31176,battlintim,,19,7,1,8
31177,lballs,,31,24,27,51
31178,thedripp,,13,6,1,7
31179,Britney_Spears,,19,9,9,18
31180,smpx,,18,468,597,1065
31181,BoingWhacker,,13,18,37,55
31182,Drifter,,19,18,5,23
31183,JimmyL,,13,82,8,90
31184,robfixmycomputer,,34,5,1,6
31185,drwatson,,18,231,316,547
31186,dieselfrog,,13,109,92,201
31187,maximinus,,20,12,1,13
31188,BiGGMike,,18,1,1,2
31189,pierreman,,42,1,1,2
31190,imissthe80s,,31,1,4,5
31191,hxa7241,,20,18,24,42
31192,ex_veritate_sum,,6,24,31,55
31193,degen,,20,1,2,3
31194,mirvnillith,,20,7,4,11
31195,mystifiedglobe,,19,73,91,164
31196,bungalow,,13,47,51,98
31197,vikophageine,,35,6,1,7
31198,georwale,,0,76,9,85
31199,futuredead,,19,70,10,80
31200,walt65,,0,5,9,14
31201,madman1969,,19,127,294,421
31202,HLHLHL,,18,18,19,37
31203,king_of_blades,,18,2,8,10
31204,jhoge,,0,7,5,12
31205,fiona_,,13,2,4,6
31206,Submitted2State,,13,66,86,152
31207,ieatpants,,13,6,15,21
31208,chiprut,,18,2,4,6
31209,nubela,,18,31,35,66
31210,ShellfishGene,,43,16,18,34
31211,DivideByZero,,20,3,4,7
31212,sjbarker,,5,1,7,8
31213,yipgoo,,14,1,1,2
31214,kbott9000,,1,1,1,2
31215,bunnyland7552,,34,7,23,30
31216,RainMaker420,,18,57,27,84
31217,drj11,,13,1,1,2
31218,mikegagnon,,13,1,1,2
31219,maggs01,,13,13,2,15
31220,blkadder,,31,1,2,3
31221,hamcake,,1,3,4,7
31222,viva101,,4,1,2,3
31223,eioua,,32,35,11,46
31224,slider1985,,13,1,1,2
31225,porman,,31,1,3,4
31226,colonSTABBER,,1,6,7,13
31227,x_entrik,,38,1,2,3
31228,PeteAndRepeat,,4,3,3,6
31229,andresthor,,6,7,8,15
31230,Ranger-phx,,13,13,1,14
31231,madinaz,,34,1,1,2
31232,cops_are_great,,1,1,1,2
31233,Xert,,10,254,494,748
31234,nicholaiman,,20,5,1,6
31235,ttlfantastic,,5,669,65,734
31236,200ernesto,,13,47,14,61
31237,uykucu,,20,6,14,20
31238,hollowhills,,19,5,8,13
31239,iliveinoaklawn,,33,1,1,2
31240,ayb,,1,138,102,240
31241,wodemoneke,,22,4,6,10
31242,nekoloco,,43,25,56,81
31243,gws923,,20,3,10,13
31244,theclapp,,20,54,74,128
31245,sequentious,,7,3,2,5
31246,wokiko,,1,223,324,547
31247,joe24pack,,19,478,708,1186
31248,kap2903,,43,1,1,2
31249,humptydumtonme,,19,42,73,115
31250,fake_brasilian,,42,2,15,17
31251,humpi,,19,9,19,28
31252,himom,,20,2,4,6
31253,Taratis,,30,18,14,32
31254,IAmAngry,,18,6,5,11
31255,john75half,,18,6,1,7
31256,jimothie,,23,1,5,6
31257,perpetualstroll,,13,47,11,58
31258,meiforeverfree,,18,4,30,34
31259,Legionofmarduk,,12,2,4,6
31260,artesios,,1,206,264,470
31261,cloeequips,,18,7,25,32
31262,talboito,,20,16,16,32
31263,newseamus,,13,2,6,8
31264,toyman70,,18,2,2,4
31265,Peatey,,12,3,7,10
31266,PunchingBag,,18,31,44,75
31267,mesohungry,,18,177,232,409
31268,Xelopheris,,18,47,41,88
31269,Cenoern,,19,5,4,9
31270,alparsla,,20,98,74,172
31271,redditjimmy,,14,3,2,5
31272,DontBeStupid,,1,7,10,17
31273,Unturned1,,18,23,57,80
31274,sleepydude,,1,30,3,33
31275,anotherhydrahead,,42,42,39,81
31276,FLCLFan,,1,16,16,32
31277,cwillu,,20,19,62,81
31278,48klocs,,20,168,137,305
31279,millions,,13,2,2,4
31280,CannedMango,,19,705,913,1618
31281,neekburm,,16,1,2,3
31282,alxalx,,5,45,74,119
31283,reappear,,20,3,3,6
31284,meramera,,43,118,129,247
31285,cupcupcup,,20,50,7,57
31286,dim_mak,,43,2,1,3
31287,heymister,,1,148,154,302
31288,pcfx,,32,4,7,11
31289,DaylenDOA,,19,3,5,8
31290,snthaoeu,,22,10,18,28
31291,whatteaux,,31,2,1,3
31292,rofltosh,,1,7,8,15
31293,srot3,,19,1,1,2
31294,monxcracy,,31,107,129,236
31295,DerSpeicherplatz,,42,1,1,2
31296,cirisme,,39,1,1,2
31297,TwoToke,,34,946,1248,2194
31298,rainbowface,,32,1,1,2
31299,Sparklepuff,,30,2,5,7
31300,BPolitic,,19,9,17,26
31301,darkon,,3,128,170,298
31302,Looniee,,43,68,9,77
31303,FaithInMe,,13,6,1,7
31304,Bombheart,,18,15,20,35
31305,jaiwithani,,43,288,130,418
31306,witty,,19,1,1,2
31307,oh_shaw,,34,9,8,17
31308,foobar83,,39,2,2,4
31309,Gort,,19,5,7,12
31310,niceyoungman,,30,49,61,110
31311,aliengoods1,,13,135,130,265
31312,kawpp,,14,2,3,5
31313,blue1,,20,6,9,15
31314,Porkfish,,43,1,2,3
31315,squareoak,,20,14,2,16
31316,alfredosauce,,39,2,1,3
31317,Risiko,,19,141,228,369
31318,foulpudding,,29,7,2,9
31319,jujuguy,,13,61,192,253
31320,Rowsdower,,6,4,4,8
31321,icculus20,,1,1,1,2
31322,Brittlg06,,29,1,1,2
31323,Caleb666,,31,29,28,57
31324,zhico,,32,3,6,9
31325,jesuslol,,42,80,108,188
31326,gilead89,,31,5,5,10
31327,phrozenwind,,3,2,2,4
31328,Smockie,,0,3,6,9
31329,PuppyHat,,29,264,360,624
31330,tcycle,,8,5,4,9
31331,Cannabis-American,,5,1,1,2
31332,joseph11h,,4,10,5,15
31333,googleferrari4ever,,19,1,3,4
31334,exhibitionthree,,1,264,158,422
31335,jammmet,,39,8,9,17
31336,trukin,,12,1,1,2
31337,mungmung,,20,13,15,28
31338,Sonizel,,32,1,1,2
31339,trilorez,,1,6,5,11
31340,Slikkster,,18,1,1,2
31341,AtheniaStarr,,36,2,2,4
31342,jeffquipp,,5,361,41,402
31343,shawnmsimpson,,9,3,2,5
31344,hellotherepine,,10,1,2,3
31345,Lord_Illidan,,20,183,325,508
31346,luanda,,42,2,2,4
31347,UserAccount,,43,5,22,27
31348,jubilusv,,29,1,2,3
31349,skifreaknyc,,32,61,13,74
31350,JaniceJane,,14,1,1,2
31351,vnnzo,,2,2,1,3
31352,MegaRouge,,30,7,7,14
31353,boba,,6,16,16,32
31354,mojority,,1,32,1,33
31355,saxomophone,,5,3,5,8
31356,larrisonw,,18,19,1,20
31357,loklocke,,18,4,4,8
31358,interiot,,20,73,102,175
31359,grantdent,,42,13,8,21
31360,bronny14,,11,1,1,2
31361,fre3k,,0,3,5,8
31362,Bamrz,,31,4,16,20
31363,freethis,,34,8,12,20
31364,writersteve,,34,28,5,33
31365,brg500,,13,2,2,4
31366,dws,,20,23,37,60
31367,borga,,19,15,37,52
31368,metabaron,,1,16,26,42
31369,kmcx8,,13,1,2,3
31370,BlueBeard,,21,1630,1734,3364
31371,chibiele,,18,2,2,4
31372,drez24,,4,17,16,33
31373,jcairns16,,29,18,3,21
31374,aceregen,,12,6,12,18
31375,psi-,,20,135,160,295
31376,polyGone,,19,95,205,300
31377,may05,,31,34,51,85
31378,Thrip,,20,127,164,291
31379,harajukukei,,0,73,125,198
31380,strfryed,,20,7,3,10
31381,strawmann,,32,17,12,29
31382,duphregne,,42,1,1,2
31383,Doppelganger,,19,4,14,18
31384,egeverything,,13,11,19,30
31385,lexande,,20,2,4,6
31386,farox,,1,80,167,247
31387,oriontechno,,20,2,2,4
31388,begemot,,31,108,133,241
31389,presthatcher,,13,12,4,16
31390,honeybadger,,20,4,2,6
31391,pkej,,32,2,3,5
31392,janhammer,,19,10,21,31
31393,skaufman,,32,1,1,2
31394,chelleeliz,,13,2,1,3
31395,midnitcafe,,20,2,8,10
31396,NotSoHotPink,,34,152,183,335
31397,sp198003,,43,1,1,2
31398,johnnycanada,,29,1,1,2
31399,palmerjp,,18,2,2,4
31400,mooinakan,,18,10,14,24
31401,tehowe,,19,12,1,13
31402,i_c_dumbsheeple,,30,1,1,2
31403,sskatygirl,,19,8,13,21
31404,gislik,,20,1,1,2
31405,squidfartz,,18,23,15,38
31406,khammack,,20,76,126,202
31407,kimberst,,19,3,5,8
31408,ishmetot,,31,8,17,25
31409,DKKat,,20,89,129,218
31410,nasorenga,,34,74,137,211
31411,kerouac_,,18,5,14,19
31412,gk3coloursred,,43,7,21,28
31413,SuedeRS100,,1,67,84,151
31414,polarix,,18,27,74,101
31415,SlideGuitar,,34,9,6,15
31416,uriDium,,20,16,35,51
31417,kengrandlund,,13,31,2,33
31418,pikonu,,43,13,13,26
31419,arnorhs,,42,8,5,13
31420,Biogeek22,,29,1,1,2
31421,williampbarnes,,5,2,5,7
31422,rejs7,,18,8,15,23
31423,aquavit,,32,11,12,23
31424,javiercero1,,43,1,4,5
31425,sfhippie,,32,1,1,2
31426,howshotweb,,9,1,2,3
31427,Ramone1234,,20,20,25,45
31428,no_kahn,,5,2,1,3
31429,YourNameHere,,43,31,53,84
31430,megatron12,,20,1,1,2
31431,zbranigan,,21,1,1,2
31432,nexus6,,20,1,1,2
31433,RhyminS,,18,9,13,22
31434,rickligg,,34,5,2,7
31435,Sampo,,29,6,6,12
31436,Tulle,,34,1,2,3
31437,carotids,,0,58,33,91
31438,Sneakas,,31,2,8,10
31439,zarmao,,19,23,16,39
31440,AlwaysAwake,,34,42,5,47
31441,matthank,,13,421,940,1361
31442,heyjohn07,,17,1,1,2
31443,lambosv21,,34,6,6,12
31444,synthoid,,42,77,82,159
31445,mike744,,31,1,2,3
31446,entropyfails,,29,158,115,273
31447,Devilish,,20,61,67,128
31448,PRONEUELE,,18,59,93,152
31449,Salim101,,42,1,1,2
31450,Sarahsahara,,1,4,10,14
31451,halobob98,,31,50,77,127
31452,cboshuizen,,20,4,5,9
31453,sayhar,,19,21,9,30
31454,strazys,,19,50,15,65
31455,bjanas,,1,3,1,4
31456,marioletto,,13,1,2,3
31457,Winoria,,34,286,319,605
31458,yanikd,,14,1,5,6
31459,Arcoril,,22,4,7,11
31460,raruler,,20,5,8,13
31461,aiz,,20,2,1,3
31462,uncoveror,,13,15,21,36
31463,Downtown,,18,45,47,92
31464,kmm3,,18,95,13,108
31465,pear22,,20,1,1,2
31466,TerreC,,18,1,1,2
31467,Jackm7,,30,191,125,316
31468,Jadedknight,,20,35,13,48
31469,Manalore,,18,2,6,8
31470,kcafka,,29,17,21,38
31471,weaselword,,32,52,56,108
31472,bbqbot,,13,2,5,7
31473,sarafiq,,19,3,1,4
31474,mouseh,,18,2,7,9
31475,jorge,,31,7,6,13
31476,25121642,,32,5,6,11
31477,ate4m,,19,10,8,18
31478,ryodoan,,18,11,9,20
31479,Carioca,,20,124,145,269
31480,andymad,,18,165,30,195
31481,torgski,,1,1,1,2
31482,CountFerdinandVonZep,,30,9,20,29
31483,rdermody,,2,5,8,13
31484,gregtron,,1,28,33,61
31485,nobrakes,,32,7,5,12
31486,claymeyers,,19,9,1,10
31487,TheKRF,,22,30,1,31
31488,viniciusfs,,20,5,4,9
31489,useful_idiot,,20,6,9,15
31490,frogmander,,34,84,103,187
31491,wonderdolkje,,34,13,17,30
31492,tedprodromou,,5,4,1,5
31493,crdoconnor,,29,36,41,77
31494,aideity,,31,6,12,18
31495,Avinio,,18,79,6,85
31496,yakovsmirnoff,,19,5,20,25
31497,oppositionradio,,19,4,2,6
31498,Sqwirl,,13,404,485,889
31499,chipsambos,,4,3,1,4
31500,Schoens,,20,17,12,29
31501,Jeffrey903,,39,2,1,3
31502,drewcee,,19,8,2,10
31503,hobocop,,32,36,62,98
31504,fitstretching,,41,1,3,4
31505,scobot,,21,1,2,3
31506,Erox1234,,18,96,45,141
31507,MR_LAFRALDO,,1,98,122,220
31508,Lirael,,32,2,4,6
31509,hoelzro,,20,32,37,69
31510,hookabooka,,6,5,2,7
31511,DDDdean,,8,1,1,2
31512,darksabrelord,,1,49,94,143
31513,brandong,,19,32,27,59
31514,georgehotelling,,18,4,5,9
31515,PoliticalMari,,14,1,1,2
31516,undimensionalman,,32,24,17,41
31517,illforgetitshortly,,1,1,2,3
31518,toolshed,,20,18,29,47
31519,cattnack,,19,54,78,132
31520,thunderdan7000,,18,1,7,8
31521,cheezel,,13,42,61,103
31522,shepherd81,,19,4,5,9
31523,OldGrandet,,13,6,10,16
31524,kilooneniner,,4,3,3,6
31525,david-icke,,36,1,1,2
31526,Skuld,,22,194,403,597
31527,yurbud,,13,110,12,122
31528,dkrazfoo,,19,16,3,19
31529,snz333,,22,1,2,3
31530,patrick_,,20,2,4,6
31531,niloc132,,1,6,6,12
31532,tenebrousx,,1,46,56,102
31533,snookerboy,,29,2,3,5
31534,zimmdj,,18,2,1,3
31535,protoopus,,29,347,761,1108
31536,royagole,,18,82,1,83
31537,FAILBOAT,,43,1,1,2
31538,gurki,,20,7,8,15
31539,thrind,,20,5,8,13
31540,netzdamon,,20,91,186,277
31541,hal2000,,18,6,10,16
31542,the_bob,,18,265,478,743
31543,piotrm,,16,2,3,5
31544,rujith,,19,24,31,55
31545,Zat,,32,5,7,12
31546,TheCityOfZing,,36,2,1,3
31547,abethebrewer,,18,55,97,152
31548,wtfmf,,18,13,10,23
31549,twist_420,,4,12,14,26
31550,SteefHarsley,,18,4,4,8
31551,dehm,,16,1,1,2
31552,diggoryvenn,,1,3,2,5
31553,jdiamond,,21,1,2,3
31554,jaybee,,20,158,164,322
31555,pulse_dial,,14,7,5,12
31556,rheimbuch,,20,6,7,13
31557,thallium205,,43,4,2,6
31558,jefurii,,34,5,1,6
31559,MikeyMadness,,18,23,35,58
31560,Edalgo,,42,127,280,407
31561,Bakie,,34,105,20,125
31562,crake,,19,111,148,259
31563,SDPBMX,,13,2,2,4
31564,T-MACK,,18,10,25,35
31565,blackbellamy,,32,4,5,9
31566,jvongator,,13,88,15,103
31567,bugnuker,,14,2,1,3
31568,ogijun,,41,34,15,49
31569,skypnd,,2,4,11,15
31570,the_bees_knees,,3,4,8,12
31571,timcoleman,,10,2,1,3
31572,junky24,,31,11,9,20
31573,wcarss,,1,1,2,3
31574,alexanderkjerulf,,43,94,15,109
31575,horizon_effect,,19,18,10,28
31576,woodeee,,14,3,1,4
31577,kemitchell,,19,38,93,131
31578,zitterbewegung,,20,147,119,266
31579,mike2386,,36,4,7,11
31580,hashedmac,,20,25,4,29
31581,thefixer90723,,1,3,3,6
31582,valermos,,20,4,2,6
31583,louizatakk,,20,11,19,30
31584,Reify,,20,8,13,21
31585,Odenized,,5,13,18,31
31586,werpon,,32,2,3,5
31587,djimmy,,43,10,14,24
31588,mykdavies,,20,42,36,78
31589,itshurleytime,,0,5,13,18
31590,mcrezin,,18,3,10,13
31591,tidderllor,,19,2,1,3
31592,mundungous,,1,631,270,901
31593,geoff422,,13,552,787,1339
31594,gilbertgrape,,5,248,122,370
31595,jimbopouliot,,29,1,2,3
31596,Verroq,,12,131,203,334
31597,BigBob1216,,17,7,7,14
31598,BleakFuture,,1,1,1,2
31599,lfbayer,,12,1,2,3
31600,alchemist,,1,1,2,3
31601,jade_22,,14,4,3,7
31602,BattleHall,,5,3,2,5
31603,c27penn,,12,12,16,28
31604,ITolerateLosAngeles,,36,1,1,2
31605,chinacatridr,,13,16,1,17
31606,jomohke,,20,1,4,5
31607,daw_ards,,32,2,2,4
31608,snakeysnakes,,18,3,3,6
31609,derivation,,12,11,6,17
31610,koolsitez,,19,59,47,106
31611,disquietus,,19,1,4,5
31612,YellowBlueGreen,,13,4,6,10
31613,kalithieu,,23,3,1,4
31614,jamougha,,20,22,30,52
31615,wang-banger,,13,2698,449,3147
31616,justrudd,,16,1,2,3
31617,dotrob,,19,318,534,852
31618,DownX,,43,6,13,19
31619,leonh,,20,88,93,181
31620,futpoo,,15,1,1,2
31621,ggk1,,18,121,318,439
31622,hopson2462,,8,2,4,6
31623,hjst,,20,22,33,55
31624,lux1955,,13,1,4,5
31625,bowlofudon,,18,15,10,25
31626,Dan_Farina,,20,74,126,200
31627,johanlbotha,,20,1,1,2
31628,Spankmeister,,11,1,3,4
31629,abrs,,12,8,8,16
31630,semanticdesigner,,19,3,3,6
31631,coolweb,,5,103,1,104
31632,DUG1138,,18,23,19,42
31633,wolf550e,,20,16,21,37
31634,sledcat,,1,2,11,13
31635,bahumbug1,,32,26,31,57
31636,ottilie,,8,19,14,33
31637,ocdude,,20,187,243,430
31638,Errenden,,3,7,12,19
31639,paulreiners,,20,5,6,11
31640,EvanRWT,,31,6,10,16
31641,badpauly,,34,7,19,26
31642,noeljohnhoward,,42,35,48,83
31643,jmpeters,,19,77,15,92
31644,jack2damx,,22,10,11,21
31645,booshack,,34,4,8,12
31646,ksiz,,0,2,3,5
31647,rber,,22,2,3,5
31648,lordspesh,,0,9,15,24
31649,stas,,20,27,4,31
31650,drdwi,,19,3,1,4
31651,Mainsley,,13,1,3,4
31652,Faja22,,1,1,1,2
31653,kylevonblum,,15,1,2,3
31654,husla3x,,13,38,1,39
31655,randyest,,31,46,84,130
31656,zigbar06,,20,2,1,3
31657,duaneduane,,13,1,1,2
31658,reir,,31,2,3,5
31659,capiCrimm,,22,122,155,277
31660,mystery-meme,,43,5,6,11
31661,Badekar,,22,34,70,104
31662,eliatic,,13,109,288,397
31663,Xhippie,,19,21,57,78
31664,newnetmp3,,18,128,143,271
31665,pbwill95,,34,6,4,10
31666,just4fun,,5,16,1,17
31667,JodoYodo,,15,9,16,25
31668,aemadrid,,20,24,5,29
31669,northzilla,,18,33,102,135
31670,bannana,,34,56,124,180
31671,skepchick,,6,1,2,3
31672,ximprezax,,1,4,4,8
31673,areallylongusername,,42,2,3,5
31674,beaner25,,32,3,2,5
31675,OldSpice,,29,1,1,2
31676,Niten,,4,297,333,630
31677,IAmimperfectlyCalm,,13,6,3,9
31678,Admiral_Winfield,,19,1,1,2
31679,RockStories,,13,11,24,35
31680,chak,,20,3,5,8
31681,shiva777,,19,12,15,27
31682,csixty4,,14,88,155,243
31683,mrhinsliy,,21,1,1,2
31684,jillsy,,1,59,56,115
31685,rainywrath,,13,6,10,16
31686,airshowfan,,13,26,2,28
31687,alternon,,42,1,1,2
31688,crunkworks,,2,4,3,7
31689,jrdn,,4,6,5,11
31690,Alexace31190,,22,93,121,214
31691,Mother_fucker,,43,3,1,4
31692,roskopp,,5,1,2,3
31693,obmud,,19,8,5,13
31694,rhouse,,13,47,87,134
31695,zwigby,,11,1,2,3
31696,ElfWord,,19,5,5,10
31697,minderbinder,,18,16,2,18
31698,cordsie,,20,12,3,15
31699,badge,,20,1,5,6
31700,Joe_Smlter,,19,24,20,44
31701,peg_leg,,19,250,557,807
31702,mems,,19,4,2,6
31703,shadowfox,,20,88,152,240
31704,wal9000,,42,118,187,305
31705,ArtieZiff,,31,2,1,3
31706,gavinpanella,,20,7,4,11
31707,slaptijack,,6,63,8,71
31708,cats-is-hungreh,,43,8,7,15
31709,zomgsauce,,18,9,15,24
31710,ksforpedro,,13,29,1,30
31711,Ranma-kun,,20,20,18,38
31712,samg,,20,201,288,489
31713,tribs,,18,9,5,14
31714,tommym,,13,25,15,40
31715,jayekub,,29,1,1,2
31716,phxboy,,13,464,14,478
31717,ironpony,,1,247,480,727
31718,ASupertramp,,32,14,22,36
31719,newacctlol,,5,4,3,7
31720,fathead,,22,6,4,10
31721,AnneHalibut,,13,7,8,15
31722,jonra,,13,334,72,406
31723,heyiquit,,18,55,60,115
31724,vietnamesesandwich,,43,1,1,2
31725,theangleshavegone,,1,3,7,10
31726,mathewjm,,22,61,22,83
31727,Saamfou,,0,1,1,2
31728,theknifeman,,43,4,4,8
31729,ST2K,,36,523,875,1398
31730,minibadger,,13,8,6,14
31731,chimerical_brio,,20,17,4,21
31732,dryguy,,18,98,5,103
31733,mkjones,,12,281,123,404
31734,opabinia,,1,29,37,66
31735,brothers,,22,2,3,5
31736,askjoe,,19,24,18,42
31737,KirillM,,1,16,25,41
31738,talo1019,,41,1,1,2
31739,emoticon,,19,550,7,557
31740,trendykendy,,18,28,5,33
31741,dickinson,,40,1,2,3
31742,spek,,30,28,62,90
31743,moistastic,,18,97,21,118
31744,gracecommunityfellow,,13,2,1,3
31745,angryletter,,5,4,1,5
31746,brutalunicorn,,43,2,3,5
31747,mattrussell,,20,1,2,3
31748,atlasx,,31,1,1,2
31749,uwflatlander,,1,2,1,3
31750,nofreelunch,,0,1,1,2
31751,shumizzle,,18,5,4,9
31752,m4dc4p,,20,43,22,65
31753,Canadian_Infidel,,1,390,753,1143
31754,rivenwolf,,41,1,4,5
31755,mmgreenmms,,1,2,2,4
31756,40_lb,,18,4,9,13
31757,supertoned,,42,46,75,121
31758,Grim_Chook,,3,3,3,6
31759,bronyaur1,,9,1,8,9
31760,dadrik,,34,1,1,2
31761,nsfw808,,5,2,2,4
31762,vineire7,,20,1,1,2
31763,wiegraff13,,20,1,1,2
31764,mitchwells,,31,28,25,53
31765,cyks,,18,149,227,376
31766,dotnetrock101,,13,66,109,175
31767,knobwrangler,,18,18,45,63
31768,cdickerson,,20,1,1,2
31769,superisaac,,20,1,2,3
31770,tenfttall,,5,3,16,19
31771,ubernostrum,,20,368,439,807
31772,sonja77,,1,1,1,2
31773,chalfont_alarm,,22,3,8,11
31774,klutometis,,21,2,7,9
31775,ironlenin,,13,32,48,80
31776,swerdna,,22,58,89,147
31777,ratatask,,0,1,9,10
31778,shimbob,,22,1,1,2
31779,butwait,,20,129,176,305
31780,normchow,,20,142,13,155
31781,acangiano,,20,708,297,1005
31782,Cultist,,18,59,12,71
31783,clone00,,11,17,23,40
31784,ThorYourGod,,30,16,43,59
31785,hellofriends2,,22,5,3,8
31786,bioskope,,22,513,621,1134
31787,esun,,19,10,11,21
31788,wethefallen,,42,5,2,7
31789,cb22,,20,67,71,138
31790,mainman3322,,18,5,3,8
31791,redditsucksball5,,19,5,1,6
31792,blubloblu,,41,57,71,128
31793,cap10,,3,3,4,7
31794,KillsItBad,,4,4,7,11
31795,amanda2007,,1,279,50,329
31796,charlie230,,43,31,19,50
31797,broalex,,5,4,7,11
31798,cccmikey,,1,7,21,28
31799,nabsy,,43,1,2,3
31800,ironfighter2008,,42,1,3,4
31801,kman001,,19,47,60,107
31802,Dionadah,,22,14,19,33
31803,Zerokool5string,,41,4,1,5
31804,shivernz,,20,12,19,31
31805,toastr,,13,1,2,3
31806,JohnnyNemonic,,30,2,2,4
31807,jarjarbinks,,22,5,5,10
31808,carbon28,,42,12,10,22
31809,djshaw,,20,2,3,5
31810,all2hectic,,13,2,7,9
31811,freethinkers,,18,8,9,17
31812,kdjakq,,40,1,2,3
31813,caesar_honeybee,,17,3,15,18
31814,scottiesan,,19,18,23,41
31815,dodisman,,18,211,477,688
31816,Voor,,19,54,73,127
31817,rit,,3,23,34,57
31818,orad,,18,6,7,13
31819,jiarb,,36,10,11,21
31820,grauenwolf,,20,1774,1571,3345
31821,HofmannsDelysid,,29,7,10,17
31822,daltonlp,,43,65,11,76
31823,spazmaster,,33,2,4,6
31824,hellfeuer,,20,5,7,12
31825,daftdad,,19,30,44,74
31826,stebbiv,,43,33,67,100
31827,jnoempire,,18,16,7,23
31828,scrat,,18,6,6,12
31829,nickcald,,22,3,4,7
31830,dotc0m,,34,2,3,5
31831,TheMemoman,,18,281,413,694
31832,matasar,,30,2,1,3
31833,oldFonzie,,23,4,2,6
31834,mclovinsuperpower,,19,6,68,74
31835,blackflag77,,31,111,231,342
31836,yog,,27,1,1,2
31837,bidou,,22,130,59,189
31838,edguy,,5,143,214,357
31839,mcantelon,,20,892,805,1697
31840,vawn,,19,2,1,3
31841,mookieXL,,42,14,27,41
31842,disastrophe,,19,31,37,68
31843,talex5,,20,2,4,6
31844,SFWopinions,,13,6,14,20
31845,mpollan,,17,7,1,8
31846,Brady1984,,0,18,37,55
31847,JohnnyCanuck,,30,124,211,335
31848,pookybum,,18,4,5,9
31849,ionspin,,1,13,11,24
31850,meatydelight,,20,31,30,61
31851,n9e9o9,,14,5,17,22
31852,JamesJanega,,5,18,5,23
31853,oaklandcory,,5,1,2,3
31854,kiwi1986,,18,60,10,70
31855,wowlolcat,,18,78,93,171
31856,sanat,,20,15,9,24
31857,shortboarder,,1,1,9,10
31858,coolpoints,,12,3,4,7
31859,icexe,,18,17,33,50
31860,KPrime,,22,1,1,2
31861,wh0wants2know,,20,11,4,15
31862,derekbox,,12,2,6,8
31863,rocapotamus,,20,6,4,10
31864,outcastspice,,1,10,12,22
31865,patrickdennis25,,13,2,2,4
31866,seeldee,,29,19,19,38
31867,stpauley45,,13,26,51,77
31868,todd_s4,,20,1,1,2
31869,migelius,,20,61,96,157
31870,kuraikaze,,1,126,207,333
31871,MatiG,,19,35,51,86
31872,jasurbek,,26,3,2,5
31873,panders,,29,5,23,28
31874,Fauster,,1,1256,999,2255
31875,atoothforatooth,,19,4,3,7
31876,santu,,18,2,2,4
31877,Dickwad,,34,12,22,34
31878,adamsplugins,,20,1,1,2
31879,SentientU,,34,97,168,265
31880,twitternut,,15,1,1,2
31881,rik7,,19,4,2,6
31882,taxi81887,,5,2,2,4
31883,adriano,,20,1,1,2
31884,svuori,,20,10,16,26
31885,what_a_nice_castle,,22,2,4,6
31886,NotPortlyNJ,,10,41,55,96
31887,illiteratebeef,,1,21,32,53
31888,mieczyslaw,,6,8,9,17
31889,fismo,,19,2,4,6
31890,sunsunsun,,1,81,203,284
31891,colusito,,1,11,5,16
31892,cephyn,,19,3,4,7
31893,katcol26,,43,5,1,6
31894,chexzie,,29,5,5,10
31895,joekro,,13,6,14,20
31896,lightthenations,,31,2,1,3
31897,franz_dawonk,,42,1,1,2
31898,ablock,,20,1,1,2
31899,boriskin,,31,25,29,54
31900,nerp,,43,8,11,19
31901,nherd,,20,4,3,7
31902,Whipsnake,,13,4,1,5
31903,jlongstreet,,20,4,3,7
31904,nemodomi,,0,9,15,24
31905,jwaters,,20,9,13,22
31906,KaptainKraken,,18,19,45,64
31907,idreamincode,,43,71,49,120
31908,reddista,,20,1,1,2
31909,DaTroof,,14,4,3,7
31910,carlfish,,18,16,27,43
31911,kjfarley,,18,22,9,31
31912,F3AR,,43,140,33,173
31913,Ariox,,9,2,2,4
31914,jedipunk,,22,4,4,8
31915,uteunawaytoy,,0,7,5,12
31916,xipetotec,,22,149,184,333
31917,WackyWorld,,18,6,5,11
31918,Bobgnote,,29,2,1,3
31919,lucidreamstate,,19,34,4,38
31920,why,,20,3,2,5
31921,Matthew_atNAL,,1,1,1,2
31922,holaworld,,27,1,1,2
31923,4569294,,22,1,1,2
31924,DrEnigma,,14,1,2,3
31925,zyx,,1,13,10,23
31926,shan564,,13,68,19,87
31927,cstor,,12,1,1,2
31928,lolza,,18,44,6,50
31929,gott_ist_tott,,31,1,1,2
31930,db4n,,20,186,307,493
31931,dreale,,19,78,222,300
31932,lebishop,,43,6,4,10
31933,Netsufr2k7,,18,8,19,27
31934,aensues,,4,33,42,75
31935,vaclev,,30,2,3,5
31936,blenderhead,,1,5,8,13
31937,meu,,43,1,4,5
31938,AdRook,,5,10,12,22
31939,thesheqq,,1,10,23,33
31940,ajensen,,20,31,11,42
31941,prioryofsion,,19,9,15,24
31942,sonof101,,2,2,1,3
31943,nrgianni,,22,20,36,56
31944,trogo,,18,32,72,104
31945,Rantosune,,38,1,1,2
31946,tophat02,,20,105,119,224
31947,tmetzger,,19,16,10,26
31948,SweetSauce,,5,4,2,6
31949,sr4free,,31,6,8,14
31950,P_ro,,5,3,6,9
31951,metalbox69,,18,52,68,120
31952,stopgo,,22,102,26,128
31953,deadcat,,31,132,156,288
31954,mrdctaylor,,13,11,2,13
31955,YouFunnyToo,,20,1,1,2
31956,courtowndave,,15,3,1,4
31957,JimmyCrackedCorn,,5,35,7,42
31958,valarmorghulis,,22,9,17,26
31959,norrsson,,43,163,9,172
31960,senex,,20,5,3,8
31961,stoool,,29,34,67,101
31962,JustAZombie,,1,35,26,61
31963,jsmith77555,,0,4,5,9
31964,bionicseraph,,1,98,123,221
31965,taxandspend,,13,9,8,17
31966,happyday,,19,20,27,47
31967,mccoey01,,1,5,4,9
31968,james39,,18,15,43,58
31969,MobileDigit,,19,11,11,22
31970,apotre,,1,31,59,90
31971,sgrace575,,18,100,172,272
31972,bplus,,20,13,15,28
31973,LouFisFucktarded,,15,15,12,27
31974,e2tango,,1,46,56,102
31975,seattlevisitor,,43,1,1,2
31976,citizenwhite,,1,31,16,47
31977,thedaniel,,20,32,55,87
31978,devslashnull,,20,16,18,34
31979,rwinston,,20,96,38,134
31980,monkeyslikebananas,,13,110,87,197
31981,peaceyp,,18,51,55,106
31982,federal_employee,,13,38,42,80
31983,ktr73,,20,19,6,25
31984,vitaltrade,,30,3,2,5
31985,baffle,,30,2,5,7
31986,nedrUoD,,20,6,3,9
31987,freefrombroke,,5,1,2,3
31988,daveloper,,18,56,65,121
31989,phdsharkey,,22,2,5,7
31990,Ultravod,,17,137,30,167
31991,_sheeple_,,19,2,4,6
31992,blamedesign,,29,1,2,3
31993,fryguy,,28,1,1,2
31994,RadioFreeJimmy,,33,2,1,3
31995,NotQuite,,4,5,1,6
31996,I_LIKE_PIE,,8,1,1,2
31997,mistereff,,42,1,1,2
31998,nathananderson,,32,35,19,54
31999,matzero99,,20,1,2,3
32000,chesterjosiah,,13,56,18,74
32001,boynton,,34,6,1,7
32002,jdrake3r,,20,1,4,5
32003,Shrubber,,32,65,101,166
32004,nillio89,,32,7,1,8
32005,fietspad,,22,2,5,7
32006,FLX,,31,27,29,56
32007,ZisforZebras,,19,4,5,9
32008,biggu_makku,,18,8,17,25
32009,egotripping,,18,27,47,74
32010,number5,,20,38,8,46
32011,xxxalio,,43,6,9,15
32012,indi,,19,19,10,29
32013,ilkkah,,20,21,5,26
32014,ResN8,,19,1,2,3
32015,Blckman,,39,3,5,8
32016,Sackboy1980,,35,1,1,2
32017,bluegrama,,9,1,4,5
32018,soonerpet,,5,22,17,39
32019,xael,,32,41,87,128
32020,SNIa,,30,2,1,3
32021,myredditaccnt,,32,4,4,8
32022,coder21,,20,63,39,102
32023,dll,,22,18,27,45
32024,chrj,,20,86,34,120
32025,harbinjer,,20,8,20,28
32026,ecogeek,,5,34,8,42
32027,estherschindler,,20,87,8,95
32028,magikaru,,18,94,85,179
32029,indierockclimber,,18,17,25,42
32030,rr82,,14,1,3,4
32031,panda129,,42,7,8,15
32032,PvtGoon,,6,6,6,12
32033,theanti9,,20,54,7,61
32034,wankware_police,,18,7,6,13
32035,DuBBle,,18,43,33,76
32036,peregrine,,20,229,239,468
32037,vikingbuddhist,,10,2,2,4
32038,Lordcain9,,13,2,1,3
32039,runako,,19,2,3,5
32040,xac00fm,,13,14,14,28
32041,richardfarley,,10,2,1,3
32042,bahuma,,1,4,4,8
32043,banzai3,,1,1,1,2
32044,majorbta,,34,1,2,3
32045,grules,,43,70,6,76
32046,wroteit,,3,20,33,53
32047,schtog,,20,6,10,16
32048,athurston,,20,34,38,72
32049,DarthMaul,,43,1,1,2
32050,huw1000,,1,4,5,9
32051,cowboysstar,,42,36,3,39
32052,digg_suxx_bigg,,0,253,326,579
32053,amazingwealth1,,34,1,1,2
32054,leonardscarlow,,1,45,28,73
32055,epe,,20,7,6,13
32056,SurlyJason,,6,15,14,29
32057,superconnected,,1,1,2,3
32058,Synx,,30,22,19,41
32059,h3jh0g,,6,22,2,24
32060,nastysuicide,,1,30,36,66
32061,tephe,,0,1,2,3
32062,millermj,,6,1,5,6
32063,thefuture,,19,1,3,4
32064,jwkolberg,,13,44,61,105
32065,liquilife,,22,113,57,170
32066,conspirisi,,19,1,2,3
32067,coffeegeek,,32,6,3,9
32068,BobSaget,,10,1,1,2
32069,wfwfe123,,18,2,3,5
32070,jrmorrill,,22,2,7,9
32071,basementcat,,18,74,127,201
32072,dalore,,1,37,55,92
32073,d07c0m,,43,580,795,1375
32074,nonprofitpirate,,29,2,6,8
32075,a1k0n,,20,192,243,435
32076,bart9h,,20,58,129,187
32077,georgelazenby,,29,236,336,572
32078,chiphead2332,,18,26,33,59
32079,rharmelink,,31,4,3,7
32080,johnnyAnon,,30,1,1,2
32081,nadslkvvn,,20,7,3,10
32082,alexybeetle,,32,1,1,2
32083,Leonidas_from_XIV,,20,265,393,658
32084,Orsenfelt,,14,1,1,2
32085,oblommer,,13,12,9,21
32086,mrstinton,,18,14,10,24
32087,jadtrue,,5,1,1,2
32088,Jesus_,,19,4,3,7
32089,volkadav,,20,5,2,7
32090,dancing_bagel,,22,74,98,172
32091,tenmillion,,13,1,2,3
32092,Kesslerjfox,,1,68,146,214
32093,randomexpert,,31,24,27,51
32094,nsfworker,,43,2,3,5
32095,PhotonJohn,,8,15,16,31
32096,DrywallThief,,13,1,1,2
32097,Steak_Efreet,,32,7,10,17
32098,ralf_,,6,94,125,219
32099,s717ch3s,,1,129,76,205
32100,elrizzy,,19,1,1,2
32101,donnie_dark0,,34,42,78,120
32102,shmorsh,,4,1,1,2
32103,averyv,,19,377,627,1004
32104,glebaron,,22,1,1,2
32105,Shlight,,3,83,32,115
32106,zipdog,,43,169,230,399
32107,dnh,,31,4,4,8
32108,MiiCH3LL3_N3ON,,25,1,1,2
32109,nessaneko,,4,17,29,46
32110,xgjkp,,8,2,1,3
32111,JabberBody,,0,4,1,5
32112,jba,,13,95,60,155
32113,BeowulfShaeffer,,13,16,29,45
32114,dcristoloveanu,,12,1,2,3
32115,thetreeoflibertyorg,,1,2,3,5
32116,hseldon,,18,4,6,10
32117,stewartallyn,,34,18,18,36
32118,Smithwick,,13,5,2,7
32119,cwmonkey,,18,132,254,386
32120,BeZany,,5,26,31,57
32121,cymen,,20,12,31,43
32122,anonami,,12,8,5,13
32123,fujimitsu,,23,1208,1699,2907
32124,vtail,,20,3,2,5
32125,Bjango,,18,2,4,6
32126,ITP404,,13,2,1,3
32127,davelong,,20,2,2,4
32128,wicbldw,,19,11,9,20
32129,dlukegordon,,15,2,2,4
32130,sanchitosonria,,18,616,214,830
32131,webist,,18,38,79,117
32132,romanovsky,,18,1,1,2
32133,GLeD,,30,19,24,43
32134,chrisrico,,13,43,44,87
32135,DocXango,,19,14,25,39
32136,jroes,,20,19,10,29
32137,Gajolo,,5,1,3,4
32138,Estaris1,,18,2,6,8
32139,roconnor,,20,241,278,519
32140,someguyinkali,,19,37,44,81
32141,nomdeweb,,18,1478,105,1583
32142,dmisda,,7,5,4,9
32143,Humboldt,,16,1,2,3
32144,wycats,,20,1,3,4
32145,kyle_kennedy7,,4,4,2,6
32146,L8sho,,0,16,33,49
32147,pkredditor,,31,2,5,7
32148,rgdfilms,,19,2,1,3
32149,Terras,,13,4,12,16
32150,bbqribs,,16,664,1009,1673
32151,medeshago,,31,3,8,11
32152,nacorom,,19,11,8,19
32153,GingerBoyIV,,15,1,1,2
32154,bluetshirt,,22,70,116,186
32155,StandardBearer,,34,3,10,13
32156,pfalabella,,30,1,2,3
32157,americanjackass,,19,5,3,8
32158,TimFinnegan,,22,8,17,25
32159,bitados65,,13,2,2,4
32160,krg6O9,,13,27,50,77
32161,polysics,,12,3,19,22
32162,RedditAHole,,43,5,1,6
32163,obamalie,,19,3,3,6
32164,Cris987,,6,14,15,29
32165,InanePenguin,,18,3,3,6
32166,paxsifal,,19,8,11,19
32167,GodJesusHolyspirit,,5,10,23,33
32168,jumberboy,,36,2,3,5
32169,cynicalmoose,,13,1,5,6
32170,TinyTim08,,32,3,1,4
32171,fiction916,,13,13,4,17
32172,bat-mite,,31,6,6,12
32173,twinkle720,,8,1,3,4
32174,moogle516,,21,2039,2233,4272
32175,llou,,20,1,3,4
32176,alittlerebel,,5,4,6,10
32177,letdinosaursdie,,20,1,1,2
32178,chorny,,20,3,13,16
32179,Baaz,,21,2,5,7
32180,ravindraS,,20,15,23,38
32181,UrzaJR,,0,1,5,6
32182,bdki,,32,3,11,14
32183,dzkalman,,30,39,20,59
32184,ReddiThor,,18,5,6,11
32185,lockart,,19,1,2,3
32186,razzmataz,,22,48,109,157
32187,aph,,13,1,1,2
32188,bigboehmboy,,12,141,134,275
32189,AndrewBlevins,,13,3,2,5
32190,chris462,,18,11,53,64
32191,hereticjoe,,13,9,17,26
32192,malapropist,,19,57,48,105
32193,dzappone,,13,11,16,27
32194,buthead,,14,14,21,35
32195,celestec,,34,54,16,70
32196,Singletoned,,20,42,4,46
32197,akston,,13,59,24,83
32198,regulator1,,43,10,11,21
32199,horneraa,,8,14,16,30
32200,feeman_4_life,,22,3,5,8
32201,SenorCarbone,,30,1,2,3
32202,kryptor,,32,1,2,3
32203,nofxet,,13,4,2,6
32204,joshtradomus,,13,1,3,4
32205,ninjadave,,19,3,1,4
32206,cippirimerlo,,18,2,5,7
32207,ThomasMueller,,20,3,1,4
32208,BlendNewYork,,6,4,2,6
32209,cwcheang,,34,1,1,2
32210,mlusher,,34,6,3,9
32211,lanevo,,18,2,1,3
32212,5am,,34,19,37,56
32213,AHFX,,34,11,11,22
32214,commonslip,,20,618,596,1214
32215,runevault,,20,6,8,14
32216,LKM,,31,33,31,64
32217,unsee,,18,125,177,302
32218,vurx,,18,13,13,26
32219,itburnzwineyep,,18,1,1,2
32220,tonic,,0,14,8,22
32221,vedema,,18,2,5,7
32222,maido,,18,51,2,53
32223,almkglor,,20,208,354,562
32224,trock,,1,75,103,178
32225,dhaffner,,1,5,9,14
32226,savvu,,29,102,144,246
32227,laconicfunk,,18,231,41,272
32228,doomcomplex,,13,515,378,893
32229,lotek0000,,18,4,4,8
32230,bitecode,,18,14,18,32
32231,pwb,,9,34,1,35
32232,blackbullet4749,,31,2,1,3
32233,rastrillo,,1,3,2,5
32234,guinnessstout,,19,113,160,273
32235,sdpope,,42,42,40,82
32236,ReverendResidrew,,30,2,1,3
32237,metaldogman,,13,248,94,342
32238,t86d,,13,1,1,2
32239,zapcon,,18,4,5,9
32240,blondin,,18,219,347,566
32241,SINGLE_ENTENDRE,,34,5,6,11
32242,disambiguate,,20,10,3,13
32243,Damario,,30,1,1,2
32244,AcEBAthunTeR,,19,1,1,2
32245,ro4ers,,31,150,138,288
32246,basque_linguist,,18,3,1,4
32247,triskaid,,19,91,239,330
32248,tjclassic82,,5,4,18,22
32249,urigzu,,30,187,210,397
32250,nukalarbalm,,0,5,21,26
32251,rooskyranger,,1,6,9,15
32252,divia83,,22,2,8,10
32253,urbinsissy,,1,3,1,4
32254,SeguroKC,,31,56,74,130
32255,wzzrd,,20,2,1,3
32256,byouk,,19,3,3,6
32257,insertusernamehere,,32,5,4,9
32258,cleverfoo,,20,12,7,19
32259,sonne611,,18,61,4,65
32260,eaFriendly,,13,18,25,43
32261,icantstanditanymore,,43,1,1,2
32262,friedgoop,,36,3,4,7
32263,wodehouse,,19,15,5,20
32264,admiralmatt,,30,6,18,24
32265,underscore,,20,1,2,3
32266,daenerys,,43,1,3,4
32267,antisthenex,,18,126,131,257
32268,rickyshaw,,18,422,13,435
32269,Haaretz,,31,2,1,3
32270,echo_chamber,,19,134,120,254
32271,republiwho,,0,1,1,2
32272,popic,,30,2,1,3
32273,sshenanigans,,22,26,13,39
32274,katsumio,,34,1,1,2
32275,Sid_209,,43,17,19,36
32276,mridlen,,19,53,19,72
32277,vannion,,0,1,2,3
32278,traitor_qgyh2,,34,2,1,3
32279,sizah,,19,23,2,25
32280,usrbinladen,,38,2,1,3
32281,wreckit,,13,2,1,3
32282,rbarfoot,,42,378,523,901
32283,zloog,,19,16,21,37
32284,FAIL_INSPECTOR,,39,2,2,4
32285,Tetraca,,1,180,387,567
32286,WilliamJLepetomane,,42,1,2,3
32287,ninjaknowell,,18,23,6,29
32288,RadioZonde,,18,2,6,8
32289,gu13,,0,18,31,49
32290,hole-in-the-wall,,18,1,8,9
32291,nascent,,20,103,186,289
32292,haydepops,,18,72,3,75
32293,reportage,,13,18,5,23
32294,tristanp,,11,1,1,2
32295,adityaw,,18,16,12,28
32296,web3,,20,7,3,10
32297,XzeroX,,19,179,116,295
32298,king_kenyon,,19,4,8,12
32299,seidaku,,13,37,1,38
32300,kgen,,20,21,26,47
32301,elabogado,,18,3,7,10
32302,j0ey,,31,3,1,4
32303,lostlogic,,17,63,52,115
32304,the_observer,,0,35,20,55
32305,vizzeroth,,19,2,3,5
32306,Narcotic,,14,27,43,70
32307,Zaii,,41,1,9,10
32308,jsoul,,30,1,2,3
32309,joaq,,19,2,1,3
32310,MarkTraceur,,1,200,267,467
32311,Wires,,19,8,9,17
32312,Soccer-Bot,,32,4,11,15
32313,Parsolamew,,34,7,9,16
32314,tnevlos,,19,1,1,2
32315,penguinfeather,,13,31,12,43
32316,seventythree,,1,4,13,17
32317,psycosulu,,5,1,1,2
32318,jwallenfeldt,,13,1,9,10
32319,Buelldozer,,13,33,33,66
32320,aadcock,,13,16,23,39
32321,st3v3,,20,3,1,4
32322,stygyan,,18,101,138,239
32323,Pyronaut,,13,1,1,2
32324,DRMacIver,,20,446,329,775
32325,mirthcontrol,,18,6,12,18
32326,zakqwy,,0,11,3,14
32327,st1710,,18,29,20,49
32328,runner166,,40,1,2,3
32329,Chris2048,,20,38,60,98
32330,MGDIBTYGD,,13,5,8,13
32331,edward,,22,48,2,50
32332,londawg,,6,5,3,8
32333,somestranger26,,1,10,23,33
32334,kadjar,,18,3,3,6
32335,yoyo,,8,1,1,2
32336,queensnake,,20,74,98,172
32337,sfultong,,20,392,539,931
32338,chumpy4747,,19,3,1,4
32339,atronic92,,18,4,10,14
32340,accidentallywut,,31,22,27,49
32341,shellybell,,1,2,1,3
32342,nutsack,,19,25,31,56
32343,guyonphone,,18,33,45,78
32344,JoeShlabotnick,,18,1,1,2
32345,mragreeable,,29,18,10,28
32346,cs123,,20,5,6,11
32347,internetstreetnoledg,,42,2,2,4
32348,kkania,,29,2,4,6
32349,xsoapboxherox,,18,110,164,274
32350,dri3s,,5,101,42,143
32351,daood,,31,6,6,12
32352,borf003,,22,3,1,4
32353,xyroclast,,18,169,328,497
32354,HarveyBirdman,,22,1,1,2
32355,mlandis,,18,1,5,6
32356,jimdesu,,6,24,55,79
32357,kazino,,43,1,11,12
32358,ignatus,,1,6,5,11
32359,glugglug,,29,7,16,23
32360,youre_an_idiot,,27,2,1,3
32361,maradeath,,0,5,2,7
32362,pcaisse,,33,3,7,10
32363,prospitrage,,8,1,1,2
32364,JeremyPridemore,,18,3,1,4
32365,flyingpotato,,22,11,9,20
32366,perenzo,,20,2,3,5
32367,Auger,,22,18,18,36
32368,PiZZaBAGEL432,,34,5,6,11
32369,tomkzinti,,13,3,4,7
32370,TylerR,,19,6,2,8
32371,chloecatkins,,31,8,2,10
32372,promarket,,13,1,2,3
32373,palalab,,5,199,465,664
32374,animalcrackers,,18,21,24,45
32375,samwichz,,0,6,8,14
32376,doctorgnx,,8,1,3,4
32377,jasen,,19,4,3,7
32378,MissClara,,18,3,1,4
32379,proudbuy,,13,2,1,3
32380,teetante,,20,284,68,352
32381,mazerrackham,,13,4,6,10
32382,dgnw,,34,3,3,6
32383,taskmistress,,41,1,2,3
32384,winsmith,,43,12,34,46
32385,GraceKungFu,,31,1,1,2
32386,huguley,,0,6,3,9
32387,xposijenx,,3,2,4,6
32388,gaggedbythealien,,3,310,487,797
32389,rattboi,,20,4,2,6
32390,furbius,,32,18,2,20
32391,raditha,,14,1,1,2
32392,tokyo,,12,34,80,114
32393,fewfw,,13,58,97,155
32394,oddlyattractive,,0,20,41,61
32395,Noxious,,18,1,2,3
32396,tptmonkey,,31,1,1,2
32397,Sly_R,,19,17,17,34
32398,russbo50,,9,1,1,2
32399,rictic,,20,98,43,141
32400,RightBrainLeftBrain,,31,4,4,8
32401,nospmis_remoh,,20,3,2,5
32402,jonnyathan,,4,10,19,29
32403,jalanb,,20,8,10,18
32404,plehu,,19,166,76,242
32405,KOM,,5,353,530,883
32406,team_ira,,7,11,6,17
32407,charlesesl,,43,208,340,548
32408,Freop,,18,1,1,2
32409,iff2in,,42,2,1,3
32410,rgov,,15,1,1,2
32411,shadymilkman,,13,1,1,2
32412,kathano,,2,19,27,46
32413,imprinter,,19,1,3,4
32414,slevin,,19,9,2,11
32415,Superschill,,1,46,50,96
32416,PopeJohnPaulII,,22,1,1,2
32417,naven,,12,21,48,69
32418,gigglescale,,19,1,5,6
32419,ayn_rand_worshipper,,19,423,167,590
32420,kzn,,20,2,2,4
32421,Fantomapple,,18,4,6,10
32422,shmoyko,,32,2,7,9
32423,PrettyWilbur,,13,15,79,94
32424,yleviel,,0,14,2,16
32425,gorkon,,13,8,13,21
32426,tuki,,32,70,95,165
32427,africabound,,1,1,2,3
32428,dsmgirl,,13,1,1,2
32429,dznqbit,,18,34,73,107
32430,tommytwotats,,13,116,62,178
32431,fuglybear,,43,18,22,40
32432,octophobic,,12,97,243,340
32433,Siegy,,30,19,26,45
32434,SPConsulting,,18,2,9,11
32435,upstream,,19,56,55,111
32436,ecmendenhall,,15,40,1,41
32437,howest,,18,1,1,2
32438,isanmateo,,39,6,3,9
32439,diein2fires,,20,2,1,3
32440,gabriele,,31,2,1,3
32441,gordond,,43,8,11,19
32442,lickmygiggle,,42,6,4,10
32443,bulgakovish,,43,11,15,26
32444,Your_Sister,,22,1,1,2
32445,OctopusMan,,1,48,28,76
32446,ZuG,,3,36,42,78
32447,harry8227,,19,53,104,157
32448,TigerCityTrails,,0,1,1,2
32449,epsd101,,13,159,55,214
32450,tapster,,21,1,10,11
32451,y0k0,,13,6,5,11
32452,hughperson,,20,23,16,39
32453,justtiffer,,13,13,1,14
32454,MosX,,2,12,13,25
32455,dbell,,13,5,6,11
32456,MDoubleM,,4,1,4,5
32457,genefarmer,,8,2,1,3
32458,trashrockx,,20,3,2,5
32459,mazarax,,20,2,2,4
32460,xjvz,,20,85,153,238
32461,molestake,,18,436,154,590
32462,rulebook,,29,3,1,4
32463,log1cstudios,,43,6,10,16
32464,runningscared,,8,98,80,178
32465,blogger75,,5,28,2,30
32466,vthacker03,,20,66,15,81
32467,j1o1h1n,,7,3,14,17
32468,chickenbandit,,20,1,3,4
32469,Agent-Smith,,0,1,1,2
32470,pbegley,,36,3,2,5
32471,FalseAnimal,,1,2,1,3
32472,writerchick,,19,4,4,8
32473,QuantumNeedledick,,36,1,1,2
32474,agaley,,34,2,4,6
32475,burtleboo,,18,14,31,45
32476,ABTechie,,19,13,7,20
32477,__god__,,1,1,3,4
32478,seanalltogether,,42,304,221,525
32479,u2boy_nl,,12,36,19,55
32480,emilbjorklund,,20,3,3,6
32481,cheese_puff42,,1,35,61,96
32482,MrPolite,,19,5,7,12
32483,kataztrophy,,42,1,2,3
32484,pivo,,20,16,42,58
32485,quackmeister,,30,342,359,701
32486,Iamfrontosa,,18,1,7,8
32487,rscubes,,13,7,1,8
32488,kanetrain,,28,21,30,51
32489,zube__,,31,4,7,11
32490,kharlowe,,13,4,19,23
32491,spif,,26,1988,396,2384
32492,Shadowrose,,22,80,133,213
32493,Prysorra,,1,1978,1755,3733
32494,gmtruckclub,,6,2,2,4
32495,Emergencist,,4,2,2,4
32496,vincentk,,20,21,31,52
32497,giant_robot,,4,1,3,4
32498,seldon3,,43,1,1,2
32499,molsi01,,20,3,2,5
32500,greyflcn,,13,16,32,48
32501,duncanf,,1,15,9,24
32502,dum_spiro_spero,,18,13,17,30
32503,faswich,,22,8,18,26
32504,frobischer,,0,127,161,288
32505,shockdoctrined,,13,2,8,10
32506,McDeath,,32,7,9,16
32507,marcinwk,,18,18,32,50
32508,uniques,,13,7,5,12
32509,bamfb2,,15,5,9,14
32510,hunterkll,,32,15,9,24
32511,ChaoticLlama,,13,89,8,97
32512,jackrobinson1,,30,4,3,7
32513,themanlog,,1,6,1,7
32514,Sanyo3456,,18,12,20,32
32515,421,,41,1,1,2
32516,takakoshimizu,,20,56,68,124
32517,timschon,,43,23,20,43
32518,skoh,,18,59,26,85
32519,norcon,,18,5,4,9
32520,LCnSac,,43,1,1,2
32521,joeblow80,,43,3,2,5
32522,dstopping,,34,81,4,85
32523,Joke_Police,,43,113,192,305
32524,dbug,,13,1,5,6
32525,niels,,20,10,6,16
32526,Ruiner,,18,26,24,50
32527,rac1,,12,1,3,4
32528,elx9c0,,13,5,4,9
32529,CForsythe,,43,1,2,3
32530,headtale,,1,6,3,9
32531,holyfool26,,0,130,193,323
32532,erangi,,7,4,2,6
32533,blitzbaby,,15,5,7,12
32534,CaptnHector,,29,57,59,116
32535,aseriesofenemas,,18,4,1,5
32536,artpop,,20,6,10,16
32537,Fiendish_Jam,,31,22,24,46
32538,Macdaddy357,,18,33,46,79
32539,sonikk,,13,10,20,30
32540,stealmywealth2009,,26,3,2,5
32541,Chancellor740,,34,29,49,78
32542,obanite,,20,28,33,61
32543,kino101,,13,122,238,360
32544,UpmodMeOrDie,,12,6,5,11
32545,adamnmcc,,8,3,5,8
32546,taleofconstantsorrow,,1,1,1,2
32547,bluesky36912,,43,61,21,82
32548,chomski,,0,3,13,16
32549,GunnerMcGrath,,27,1263,883,2146
32550,monstrosabatier,,20,5,6,11
32551,brc,,4,9,22,31
32552,grub,,19,2,3,5
32553,sipofsoma,,22,11,20,31
32554,AmyNewman,,20,18,1,19
32555,yoshevchoshev,,36,1,1,2
32556,drizzt001,,18,6,8,14
32557,malanalars,,20,285,112,397
32558,TODizzle91,,43,138,114,252
32559,mrjah,,42,28,28,56
32560,buildmonkey,,31,319,482,801
32561,AdamSelene138,,32,1,2,3
32562,scsp85,,18,9,19,28
32563,Sangermaine,,31,597,799,1396
32564,nupetfish,,31,2,1,3
32565,ragipy,,36,76,109,185
32566,ccolec,,5,40,54,94
32567,Independent,,19,375,228,603
32568,ruffimonster,,13,77,14,91
32569,berserkur,,29,14,41,55
32570,ananthmv,,20,27,2,29
32571,freedomfritos,,11,1,4,5
32572,Hastin,,39,22,45,67
32573,ngai,,31,1,3,4
32574,benwad,,19,2,1,3
32575,Jameswa,,5,6,3,9
32576,BoredHottie,,39,123,207,330
32577,javimahai,,31,50,54,104
32578,xanderhud,,18,2,3,5
32579,MFLUDER,,13,24,7,31
32580,brooksbp,,20,29,15,44
32581,Brandon_Sachse,,19,1,1,2
32582,justanotherone,,19,1,4,5
32583,bardioc,,19,4,6,10
32584,mrsantonio,,31,13,30,43
32585,culbeda,,19,406,432,838
32586,bmeckel,,18,60,62,122
32587,lejuscara,,6,11,12,23
32588,bgraves20,,16,183,45,228
32589,damonpoole,,20,32,22,54
32590,ReelDeel,,13,27,19,46
32591,garamond10pt,,43,72,52,124
32592,news_addict,,20,16,18,34
32593,Liebre,,13,37,29,66
32594,wewa,,36,176,167,343
32595,JokerTrain,,12,15,22,37
32596,didumos,,6,1,2,3
32597,TripMaster_Monkey,,32,578,500,1078
32598,24sparky,,19,129,206,335
32599,mbchoe,,34,2,1,3
32600,ukcz,,19,359,277,636
32601,miahfost,,20,3,4,7
32602,nyteryder79,,32,58,133,191
32603,sharth,,20,29,55,84
32604,jlo7719,,43,59,4,63
32605,snaut,,20,21,44,65
32606,mathesonmd,,40,1,1,2
32607,dr_pyser,,18,73,8,81
32608,akmark,,18,11,16,27
32609,OhioDude,,19,109,154,263
32610,maep,,18,4,4,8
32611,ma7moudshadi,,34,17,3,20
32612,saobi,,13,127,18,145
32613,JayBrezny,,13,53,4,57
32614,thecosmicfool,,11,18,24,42
32615,johnd24,,19,146,1,147
32616,thehayworth,,26,3,11,14
32617,garamon,,3,14,25,39
32618,LegalSlave,,5,1,3,4
32619,FatBelly,,22,1,2,3
32620,copurate,,31,1,1,2
32621,SquidLord,,20,1,1,2
32622,carinda,,1,9,21,30
32623,uzerzer,,0,63,109,172
32624,Snoron,,22,662,867,1529
32625,lotllotl,,0,1,1,2
32626,bijantehrani,,1,1,3,4
32627,greatsites,,13,2,1,3
32628,zemsta,,1,169,120,289
32629,emacdona,,20,19,7,26
32630,jakesonaplane,,12,48,21,69
32631,awaken,,12,123,6,129
32632,mybrainisfull,,19,9,13,22
32633,monkeylectric,,18,1,1,2
32634,firebird84,,29,50,55,105
32635,guyal,,18,1,3,4
32636,dijkstra,,20,6,6,12
32637,tharxide,,18,5,8,13
32638,justnoise,,18,5,9,14
32639,cornflakepirate,,5,1,2,3
32640,Pufflekun,,18,75,93,168
32641,hmmmmmmmmmmm,,15,1,1,2
32642,jasperx,,0,109,29,138
32643,juiceboxrock,,12,248,222,470
32644,Cooptwentysix,,32,1,2,3
32645,druski,,0,1,3,4
32646,XanderCage,,4,17,12,29
32647,internetbadass,,43,4,10,14
32648,smartsingh,,0,48,39,87
32649,Ollietheweatherman,,32,1,1,2
32650,jordankasteler,,18,642,30,672
32651,stunkcrunk,,4,2,1,3
32652,dhinchak,,31,14,13,27
32653,fatshady,,13,8,11,19
32654,jewz911thinkaboutit,,18,2,3,5
32655,JoelB,,18,73,106,179
32656,JSTARR356,,19,15,13,28
32657,hjkl_,,30,1,1,2
32658,jgumpert,,34,17,3,20
32659,baller,,31,2,3,5
32660,howhard1309,,10,2,1,3
32661,Chrisstines,,19,2,1,3
32662,kirkyak,,0,15,13,28
32663,linux_traveler,,1,7,7,14
32664,eliot999,,19,6,6,12
32665,happyphilter,,18,24,10,34
32666,burningion,,15,5,2,7
32667,reddituser000,,13,1,1,2
32668,Schlichten,,31,359,111,470
32669,NutrientCyclist,,13,1,1,2
32670,dgodon,,19,33,15,48
32671,biteableniles,,18,20,28,48
32672,Kwilco,,20,9,11,20
32673,ohyouknow,,29,3,4,7
32674,mcflyfly,,18,6,9,15
32675,I922sParkCir,,22,39,61,100
32676,fireorgan,,18,69,138,207
32677,theropolitans,,32,2,1,3
32678,reed311,,19,298,277,575
32679,andyisaramblinman,,30,2,1,3
32680,underanalt,,32,31,37,68
32681,Roxja-it,,31,6,7,13
32682,switch72,,18,78,84,162
32683,d3dkat,,1,1,1,2
32684,alfonsoeromero,,12,1,1,2
32685,CellBlock,,29,35,31,66
32686,CYG,,20,1,1,2
32687,niles,,6,21,31,52
32688,sunroom,,18,32,24,56
32689,greentangent,,19,147,358,505
32690,tobidotman,,0,1,1,2
32691,anargeek77,,20,2,3,5
32692,green777,,5,1,1,2
32693,i_am_my_father,,18,85,202,287
32694,narkee,,30,179,112,291
32695,thedarkman,,42,2,5,7
32696,nova1989,,5,1,1,2
32697,brandondos,,34,40,70,110
32698,terrel,,22,5,2,7
32699,shawnl2,,19,2,4,6
32700,God_The_Almighty,,19,50,47,97
32701,flydog2,,13,251,223,474
32702,howdyduty,,36,1,2,3
32703,bluestater,,18,2,4,6
32704,topcat31,,5,39,4,43
32705,mentalfruit,,18,86,38,124
32706,AngelFury,,13,5,1,6
32707,mscaprikell,,5,1,2,3
32708,McNutty,,42,7,7,14
32709,snarfman,,5,1849,61,1910
32710,jwshapir,,18,4,3,7
32711,supaphly42,,43,409,782,1191
32712,cfire,,1,6,1,7
32713,IBFreddy,,0,10,15,25
32714,recluce,,0,14,6,20
32715,racsismisbadmkay,,13,1,2,3
32716,dokijic,,6,19,30,49
32717,kitsune,,20,138,57,195
32718,dacrinton,,20,2,1,3
32719,steven_p,,18,11,5,16
32720,jrockway,,20,536,741,1277
32721,cyclops79,,1,29,12,41
32722,uhwhat,,19,1,2,3
32723,vaquero,,13,2,10,12
32724,kaska1,,19,2,1,3
32725,producerism,,34,8,28,36
32726,ttread,,19,20,10,30
32727,feralmonkey,,22,14,13,27
32728,perjorativejinx,,22,55,56,111
32729,mikeshine,,19,17,19,36
32730,SadyeBabi,,1,33,4,37
32731,pkeane,,20,7,2,9
32732,Badtz,,31,8,11,19
32733,gorzak,,19,1,2,3
32734,propanbutan,,20,3,7,10
32735,vanliao,,41,2,1,3
32736,killeole,,0,1,1,2
32737,tejas3d,,14,1,1,2
32738,ColdSnickersBar,,23,547,716,1263
32739,SashaNein,,8,1,2,3
32740,Abuchner,,19,18,4,22
32741,pabs,,20,52,52,104
32742,bystandereffect,,18,2,3,5
32743,grudolf,,18,2,4,6
32744,BeeBole,,20,25,12,37
32745,tangoholic,,19,3,4,7
32746,unitvector,,18,7,5,12
32747,pano200,,31,1,3,4
32748,mrchak,,43,127,184,311
32749,Toxygene,,43,34,32,66
32750,ltdraper,,13,3,6,9
32751,slithymonster,,18,29,43,72
32752,NeoWhig,,0,83,81,164
32753,the-outlier,,13,28,36,64
32754,worldtraveller,,21,193,21,214
32755,pchalich,,29,15,11,26
32756,medicalsteve,,19,2,4,6
32757,bjschnei,,20,103,2,105
32758,kindageek,,22,7,2,9
32759,melissaf,,15,4,1,5
32760,c53x12,,32,331,395,726
32761,dodeja,,19,1,1,2
32762,Firehunter,,1,11,16,27
32763,malcontent,,31,2135,3102,5237
32764,Matt08642,,18,80,12,92
32765,sankyo,,20,1,2,3
32766,robinw,,20,15,1,16
32767,Cookie-Monster,,42,1,1,2
32768,StupidCrocs,,13,1,4,5
32769,gormly,,6,18,15,33
32770,clippedtoofar,,18,11,9,20
32771,Neuro420,,18,250,433,683
32772,2GuysAaron,,18,1,1,2
32773,doctor_x,,1,10,10,20
32774,tienm23,,26,2,2,4
32775,PuP5,,19,310,507,817
32776,shawnaroo,,13,2,2,4
32777,morimoto,,3,3,9,12
32778,blkguyattheprty,,13,55,36,91
32779,oshout,,1,118,106,224
32780,Insom,,20,2,2,4
32781,dourk,,26,2,16,18
32782,ScottAlexander,,19,13,9,22
32783,leexine,,0,46,16,62
32784,another_one,,22,1,1,2
32785,dadadada,,18,274,137,411
32786,SamReidHughes,,20,26,38,64
32787,aroras,,18,6,4,10
32788,snissn,,20,86,125,211
32789,ChimpWithACar,,18,68,92,160
32790,echostorm,,18,19,9,28
32791,137,,27,24,12,36
32792,ToasterCoaster,,1,16,15,31
32793,jluebbert,,20,1,1,2
32794,Teaboy,,1,148,127,275
32795,binkabinka,,0,28,9,37
32796,hugeness,,31,4,4,8
32797,michael003,,42,46,1,47
32798,NearlyHuman,,18,49,14,63
32799,buckethead--,,34,18,24,42
32800,dave007,,43,3,2,5
32801,slashninja,,13,2,1,3
32802,d42,,19,910,840,1750
32803,mmiikk,,13,21,72,93
32804,jrhass,,20,3,3,6
32805,iDrifter,,18,1,5,6
32806,Canadian_Imperialist,,19,16,9,25
32807,pintsize317,,1,1,3,4
32808,mattraibert,,20,22,3,25
32809,GlryX,,39,6,10,16
32810,BillMTracer,,9,1,1,2
32811,yehauma,,23,1250,2225,3475
32812,SantiagoRamon,,1,381,426,807
32813,smgilroy,,0,1,1,2
32814,jlks,,19,347,555,902
32815,elihusmails,,13,7,1,8
32816,wrldcmnt,,13,1,1,2
32817,lovelinuxlove,,20,2,4,6
32818,autonomousgerm,,13,6,12,18
32819,dra_cula,,1,22,39,61
32820,Capps83,,18,1,1,2
32821,Kesko,,18,491,15,506
32822,washcapsfan37,,3,432,575,1007
32823,ArcticTurtle,,43,48,6,54
32824,NewsCrew,,1,1,1,2
32825,artman,,5,1090,1714,2804
32826,spooky47,,13,101,13,114
32827,milesphenn,,43,8,21,29
32828,711was_a_retail_job,,20,217,354,571
32829,qlight,,43,12,24,36
32830,pyderi,,11,2,1,3
32831,DodgeStRegis,,15,24,49,73
32832,audioeric,,13,36,28,64
32833,somersault,,4,4,4,8
32834,erickt,,20,1,3,4
32835,gasface,,22,53,42,95
32836,DR_SBAITSO,,29,2,1,3
32837,nescafe,,8,4,1,5
32838,guitardemon,,18,51,10,61
32839,lazyfriction,,1,4,3,7
32840,simpat1zq,,42,2,1,3
32841,hschenker,,0,41,34,75
32842,smovorg,,2,3,4,7
32843,clea,,43,253,195,448
32844,djreedps,,19,5,4,9
32845,jdavis301,,18,278,219,497
32846,yodacallmesome,,34,1,3,4
32847,miamistu,,29,4,8,12
32848,MrRadar,,20,88,28,116
32849,Xophmeister,,1,309,333,642
32850,illleaveafterthis,,13,2,5,7
32851,tsondie21,,27,160,140,300
32852,verticallyintegrated,,1,1,1,2
32853,snaxion,,19,58,145,203
32854,LinuxFTW,,15,36,82,118
32855,playful,,5,15,13,28
32856,puetzk,,20,18,38,56
32857,akirksey,,4,11,10,21
32858,Kavok,,39,56,85,141
32859,jhi,,20,2,5,7
32860,Stripper-Cookie-Girl,,1,1,3,4
32861,espergreen,,20,4,7,11
32862,runningskull,,18,35,6,41
32863,Catch-22,,18,126,68,194
32864,treerex,,20,31,68,99
32865,thetable,,22,2,1,3
32866,karmakillernz,,20,9,17,26
32867,falyst,,13,1,2,3
32868,quitNow,,19,14,2,16
32869,gecko,,20,87,71,158
32870,phunc,,18,4,13,17
32871,glorax,,18,2,6,8
32872,carlito99,,8,1,3,4
32873,luisnarvaez582,,32,1,2,3
32874,tooslow,,19,56,21,77
32875,arthur_d,,31,5,11,16
32876,piratetyler,,34,6,6,12
32877,digg_sucks,,19,2,5,7
32878,jmurphy,,10,3,2,5
32879,benalene,,4,99,15,114
32880,TearsOfRage,,17,645,1094,1739
32881,OvidPerl,,20,123,67,190
32882,wesumd,,41,70,55,125
32883,swag,,18,2,15,17
32884,viller,,16,50,86,136
32885,moonglow,,43,30,48,78
32886,code6226,,20,10,3,13
32887,dcinsea,,22,2,7,9
32888,alisdair,,13,1,1,2
32889,gerg6111,,29,298,636,934
32890,jocamero,,8,3,6,9
32891,megamega2,,5,1,1,2
32892,spam_bogey,,42,1,1,2
32893,shy_bc,,22,6,11,17
32894,MrUniverse,,34,162,32,194
32895,eiclectis,,42,1,3,4
32896,h2so4hurts,,42,145,5,150
32897,iysdjp2rk0,,20,1,1,2
32898,Gregorus,,13,5,2,7
32899,thatAnonymousGuy,,34,2,3,5
32900,bloodniece,,12,64,102,166
32901,dfan,,20,98,47,145
32902,dirtbiker,,13,1,6,7
32903,danniboi33,,5,64,43,107
32904,rjminniear,,20,3,2,5
32905,WRYYYZARD,,1,10,14,24
32906,macseminal,,13,62,2,64
32907,andylepp,,43,18,44,62
32908,clarkster,,22,15,18,33
32909,jessman1982,,18,1,1,2
32910,Glitch29,,18,95,118,213
32911,redsky989,,19,3,2,5
32912,paal349,,1,14,29,43
32913,NorthernView,,13,27,37,64
32914,r275delta,,43,1,2,3
32915,k1114,,19,3,9,12
32916,JimmyGarcia,,19,15,21,36
32917,davidconnell,,34,14,5,19
32918,Stiophan,,13,14,24,38
32919,indigoparadox,,20,23,31,54
32920,hendler,,31,5,7,12
32921,Jay_kay_au,,22,18,29,47
32922,gracefulfailure,,12,21,9,30
32923,sqjtaipei,,3,58,82,140
32924,dankeezer,,18,67,67,134
32925,okayUK,,9,54,7,61
32926,ApostropheNazi,,19,1,7,8
32927,enigma66marktwo,,13,336,570,906
32928,razend,,42,1,3,4
32929,iggyviola,,13,375,62,437
32930,Anonymous7777,,0,126,88,214
32931,kavedaa,,22,17,22,39
32932,straightalk,,5,1,1,2
32933,madcoweater,,43,22,27,49
32934,markthis,,43,5,3,8
32935,b0xii,,13,3,2,5
32936,ajmoir,,20,12,15,27
32937,fringzxk,,19,6,15,21
32938,mactep86,,43,123,8,131
32939,onepostpseudonym,,19,5,1,6
32940,RockHardplace,,43,1,1,2
32941,dskerman,,17,27,15,42
32942,slartibartfas,,18,11,19,30
32943,parsim,,1,15,13,28
32944,IAmInLoveWithJesus,,13,1494,532,2026
32945,kmonk,,26,210,284,494
32946,iamverycanadian,,13,80,66,146
32947,lackingin,,20,1,1,2
32948,deadringer76,,19,3,2,5
32949,kmakmfa,,20,13,28,41
32950,mailinator1138,,19,252,172,424
32951,densitywave,,18,4,4,8
32952,oblique_parallax,,13,1,1,2
32953,korran,,20,6,7,13
32954,adamrgolf,,43,125,178,303
32955,mccord,,20,31,36,67
32956,SubvertMSM,,43,20,20,40
32957,kill_the_xtians,,42,1,1,2
32958,FlyingFoetus,,13,4,3,7
32959,swedegeek,,15,26,10,36
32960,silentlaw,,22,23,20,43
32961,drunkenfud,,22,32,2,34
32962,chrisfranklin,,39,2,2,4
32963,jayssite,,22,393,491,884
32964,edditr,,20,17,21,38
32965,mll,,31,9,5,14
32966,Juppylolo,,0,1,4,5
32967,SuperDanny,,13,1,9,10
32968,conesieur,,13,1,1,2
32969,Smithore,,1,5,9,14
32970,DiatomaceousEarth,,1,1,6,7
32971,sambowman,,29,9,5,14
32972,robofetus,,31,22,11,33
32973,RCHD,,0,3,6,9
32974,4_STAR_GENERAL,,8,1,1,2
32975,stalyn,,1,5,3,8
32976,2Ricky,,20,1,4,5
32977,bradhannah,,30,3,2,5
32978,slhandler,,2,1,5,6
32979,turkourjurbs,,34,1197,1534,2731
32980,WWFStern,,13,5,4,9
32981,zsouthboy,,20,47,74,121
32982,pirate742,,1,1,1,2
32983,spam99,,13,134,140,274
32984,Hookhand,,18,34,77,111
32985,indrid5000,,13,7,6,13
32986,PPatBoyd,,36,31,28,59
32987,kkhunziker,,19,33,43,76
32988,wesamel,,19,9,6,15
32989,gadimus,,12,11,14,25
32990,kytsune,,32,5,16,21
32991,vittles,,0,1,2,3
32992,bsdboy,,12,81,127,208
32993,banksnld,,10,5,12,17
32994,khanthe,,19,36,5,41
32995,antslater,,18,1,2,3
32996,sunbeam60,,18,24,20,44
32997,Perkstoph,,13,8,2,10
32998,scenerio,,18,3,3,6
32999,ellemnopee,,18,64,73,137
33000,macandcheese,,32,13,19,32
33001,PanTardovski,,18,2,3,5
33002,dwvvz,,32,3,10,13
33003,bmswa,,8,7,7,14
33004,prestonberryworth,,18,8,12,20
33005,bigbada,,34,2,1,3
33006,coolmartin160,,0,63,1,64
33007,cheez-it,,42,155,157,312
33008,itsmeee,,1,79,148,227
33009,TheElitistCoup,,36,2,5,7
33010,Poromenos,,22,2440,3211,5651
33011,msbehaviour,,41,4,11,15
33012,atomic_fireball,,31,16,12,28
33013,ScottBartell,,19,6,12,18
33014,claybodie,,34,566,9,575
33015,BoiledToothpaste,,31,6,8,14
33016,amga10,,33,9,7,16
33017,corrhea,,32,5,9,14
33018,karcass,,34,140,154,294
33019,fineadc,,13,1,1,2
33020,Aggronaut,,13,3,6,9
33021,REdd06,,1,68,107,175
33022,pointNumberOne,,17,2,6,8
33023,evanbd,,0,1,1,2
33024,ultraturd,,18,2,2,4
33025,dimpki,,18,7,2,9
33026,KindlyRequests,,19,12,21,33
33027,wurly,,19,6,5,11
33028,infohawk,,15,1,1,2
33029,zekel,,32,62,11,73
33030,zelpop,,13,300,17,317
33031,antronx,,18,4,4,8
33032,paul_bunyan,,10,1,1,2
33033,apethedog,,18,12,22,34
33034,distortedHistory,,31,463,534,997
33035,daveross121,,18,1,3,4
33036,Reliant,,30,410,653,1063
33037,highlandery,,0,1,2,3
33038,marklubi,,42,28,22,50
33039,Captain_Oblivious,,31,1,4,5
33040,ezmobius,,20,10,9,19
33041,callturk245,,33,1,3,4
33042,ferriswheel,,13,102,46,148
33043,DudeAsInCool,,6,713,1301,2014
33044,bigbango,,13,1,1,2
33045,violetknickers,,31,10,18,28
33046,fit4130,,18,81,106,187
33047,Browner,,43,6,1,7
33048,anibus,,13,28,2,30
33049,mikm,,20,210,372,582
33050,Steven87,,32,5,7,12
33051,BeetleB,,20,360,441,801
33052,prodiglow,,21,209,24,233
33053,abnormalbrain,,34,35,59,94
33054,jasonscheirer,,20,1,8,9
33055,whespe,,4,6,8,14
33056,sule21,,31,143,198,341
33057,devilsenigma,,20,188,56,244
33058,akatherder,,4,611,568,1179
33059,rex420,,19,8,2,10
33060,biess06,,5,4,1,5
33061,utcursch,,20,36,36,72
33062,ckopack,,42,2,2,4
33063,DustinEchoes,,22,1,1,2
33064,Miyamoto_Musashi,,20,1,2,3
33065,p0lt,,23,3,2,5
33066,carraway,,43,7,9,16
33067,Anisty,,34,1,3,4
33068,digdug2020,,43,6,4,10
33069,StiveGonzales,,0,1,3,4
33070,lynchie,,18,1,2,3
33071,greginnj,,8,1056,1601,2657
33072,hokie86,,38,3,2,5
33073,budtske,,43,5,4,9
33074,SlippersIsClean,,13,3,1,4
33075,drunkVoodoo,,0,2,7,9
33076,jonshinn,,5,2,1,3
33077,morselsrule,,20,60,44,104
33078,timidlikerivers,,31,7,8,15
33079,heden,,18,1,1,2
33080,jordo3284,,43,5,10,15
33081,bmiguy,,31,1,1,2
33082,Froztwolf,,31,17,4,21
33083,accvrat,,34,6,13,19
33084,catalytica,,43,18,38,56
33085,nobomican,,19,1,1,2
33086,RanaFuerte,,32,16,24,40
33087,renegade,,32,193,181,374
33088,larphenflorp,,3,2,2,4
33089,reasonable_dude,,19,1,2,3
33090,yirra,,39,2,1,3
33091,ShinyCobra,,12,7,8,15
33092,z0zqx1,,22,5,10,15
33093,sindisil,,20,79,55,134
33094,sapato,,31,6,6,12
33095,x4294967295,,20,4,1,5
33096,oldno7brand,,18,141,206,347
33097,hillgod,,5,168,273,441
33098,alteralias,,43,1,1,2
33099,dankluz,,22,1,1,2
33100,stuff_sux,,20,7,3,10
33101,-snarf-,,22,1,2,3
33102,psy966,,31,1,3,4
33103,xftwitch,,19,19,5,24
33104,SurferDude,,34,22,21,43
33105,SirNuke,,42,6,14,20
33106,tendrils,,43,51,111,162
33107,christ_,,20,21,25,46
33108,NintendoGal,,18,8,9,17
33109,brush,,20,11,3,14
33110,WNxNukeem,,20,2,4,6
33111,weffy,,19,1,3,4
33112,yishan,,26,131,134,265
33113,firetruck1,,22,18,18,36
33114,ashwinb,,12,1,2,3
33115,AlanYx,,19,232,175,407
33116,blookins,,20,18,1,19
33117,KPM1,,30,1,1,2
33118,semianonymous,,21,2,3,5
33119,Felicia_Svilling,,20,132,246,378
33120,pomyao,,29,5,1,6
33121,DAE,,22,4,2,6
33122,magixx,,18,28,28,56
33123,Sir_Isaac_Lime,,1,16,11,27
33124,retardo,,20,649,322,971
33125,FakenameMcAlias,,1,59,76,135
33126,cautionhot,,13,8,1,9
33127,merid85,,36,2,2,4
33128,janl,,20,18,6,24
33129,passwordispassword2,,1,2,2,4
33130,lex99,,19,257,231,488
33131,bmpwe,,29,2,1,3
33132,Misio,,18,206,305,511
33133,moshaker,,32,3,2,5
33134,mute_requiem,,1,121,238,359
33135,franksvalli,,18,14,9,23
33136,avsa,,4,1,1,2
33137,zankoubs,,18,14,17,31
33138,LOOSEvsLOSE,,14,1,4,5
33139,martybo,,2,1,1,2
33140,swharper,,6,2,1,3
33141,eric22vhs,,18,8,12,20
33142,Nolari,,20,2,1,3
33143,ldrager,,19,15,37,52
33144,jonscorpio22,,19,1,2,3
33145,tarobaap,,16,6,2,8
33146,digitalmob,,20,21,31,52
33147,wordsNtricks,,19,67,5,72
33148,clevernick,,30,5,8,13
33149,rtomayko,,20,17,15,32
33150,marktully,,13,98,123,221
33151,pasttraveller,,22,1,1,2
33152,thade,,18,3,3,6
33153,dopewars22a,,20,1,1,2
33154,Chambone,,13,7,7,14
33155,bs2k,,6,2,2,4
33156,mwcred,,13,1,1,2
33157,jordanlund,,12,2418,2481,4899
33158,Mr_A,,18,401,422,823
33159,garrettl,,31,1,2,3
33160,evilknee,,4,12,6,18
33161,zangorn,,19,24,21,45
33162,Zylo,,1,24,14,38
33163,bmatul,,1,10,17,27
33164,dasschwein,,19,1,2,3
33165,gulik,,13,3,12,15
33166,whymewhyme,,13,1,1,2
33167,Stelman,,19,19,3,22
33168,somacore,,19,27,21,48
33169,IamCitiznInsane,,1,1,5,6
33170,10gic,,31,1,2,3
33171,TempusFugitive,,18,1,5,6
33172,ike368,,1,50,68,118
33173,futuramaboy,,18,48,79,127
33174,seattleite99,,20,4,5,9
33175,barapa,,14,36,34,70
33176,RufusJSquirrel,,27,63,18,81
33177,brohan,,20,1,1,2
33178,Zweben,,12,414,455,869
33179,TheNewAndy,,20,56,78,134
33180,marr,,20,4,10,14
33181,9bpm9,,32,68,74,142
33182,kidfury,,34,50,106,156
33183,sandusky_hohoho,,18,29,9,38
33184,rainboy,,20,3,5,8
33185,FloyDejesus,,32,31,36,67
33186,johnarras,,20,2,1,3
33187,novas0x2a,,20,5,1,6
33188,Rubric,,9,2,1,3
33189,deadcell,,32,5,3,8
33190,jollyllama,,31,62,65,127
33191,reddicted,,20,1,1,2
33192,tarsier,,36,1,2,3
33193,adjohnson916,,12,2,8,10
33194,raptorl3,,21,1,2,3
33195,alchemist23,,32,22,25,47
33196,jozzas,,1,378,444,822
33197,rickf71,,18,68,69,137
33198,Sweetgum,,18,107,192,299
33199,Swans_Flight,,0,2,2,4
33200,deadi,,19,5,8,13
33201,theefaulted,,20,1,1,2
33202,joper90,,27,21,27,48
33203,stopwastingyourtime,,20,1,1,2
33204,opie_why,,32,1,1,2
33205,immortalilych,,20,36,49,85
33206,Cheddarwurst,,13,2,2,4
33207,Portman,,20,1,1,2
33208,bigital,,8,21,10,31
33209,mianwaheed,,13,4,1,5
33210,jtor2020,,13,2,3,5
33211,mr_malarky,,1,81,34,115
33212,Danchan,,13,1,5,6
33213,systay,,20,38,18,56
33214,iowaxproud,,18,3,7,10
33215,desbaratto,,13,11,36,47
33216,notsotragichero,,29,2,3,5
33217,libtec7,,19,2,2,4
33218,killbrad,,34,34,59,93
33219,dr_speck,,6,50,89,139
33220,rhino666,,32,36,40,76
33221,DarkStars2882,,13,2,6,8
33222,karenlovestosmile,,18,20,6,26
33223,crazyass13,,13,1,1,2
33224,markturner,,19,7,1,8
33225,shotmaker,,19,1,3,4
33226,Bobachu,,34,1,2,3
33227,kuhawk5,,13,596,914,1510
33228,iicare,,12,6,6,12
33229,SidVacuous,,32,11,5,16
33230,rumblinggryphon,,13,14,19,33
33231,ElGaucho56,,18,707,395,1102
33232,apathist,,34,1,2,3
33233,wrat,,15,5,14,19
33234,old_snake,,18,64,129,193
33235,stayingdeadfornow,,13,6,5,11
33236,Jpool,,13,13,28,41
33237,prosper_spurius,,20,1,1,2
33238,phloggy,,18,3,3,6
33239,neopariah,,18,13,28,41
33240,mentol,,5,247,149,396
33241,OprahsVaJayJay,,13,3,2,5
33242,fxer,,1,59,109,168
33243,doatdays,,18,6,9,15
33244,fyl60000,,22,5,7,12
33245,bellmounte,,18,1,4,5
33246,flmz,,22,3,9,12
33247,bocephus1125,,6,7,1,8
33248,cnirrad,,19,3,7,10
33249,GodEater,,43,4,3,7
33250,oggusfoo,,4,10,29,39
33251,tch,,43,1159,337,1496
33252,Smokalotapotamus,,31,274,252,526
33253,jordanblock,,43,28,26,54
33254,zanthraxnl,,18,14,11,25
33255,Cowwan,,18,25,31,56
33256,SheepleAlarmClock,,36,1,2,3
33257,insidiousfckr,,43,72,9,81
33258,buttson,,18,3,9,12
33259,owlie_s,,29,6,4,10
33260,jkramar,,29,24,43,67
33261,bluetech,,20,1,6,7
33262,broohaha,,19,616,521,1137
33263,theslip74,,32,2,6,8
33264,RickS2,,34,2,3,5
33265,ajb44,,20,2,6,8
33266,norinea,,17,1,1,2
33267,tictactactics,,18,19,3,22
33268,happystinky,,3,4,3,7
33269,aeturnum,,18,1,1,2
33270,fuzzwonder,,20,1,1,2
33271,Fratm,,43,20,8,28
33272,athfalcon,,11,3,1,4
33273,drjaffiliate,,5,2,6,8
33274,tdaonp,,0,61,16,77
33275,nickgarner,,41,22,2,24
33276,clausy,,13,116,108,224
33277,mg_reddit,,18,1,3,4
33278,llvmaster,,20,21,5,26
33279,lansingite,,32,89,63,152
33280,varungoswami01,,4,2,1,3
33281,sherijr,,29,1,1,2
33282,Anjin,,19,156,70,226
33283,Tymeteller,,1,118,93,211
33284,michael2367,,1,2,2,4
33285,znook,,31,1,1,2
33286,Vinay92,,18,60,101,161
33287,IvanB,,5,9,1,10
33288,inf1ni,,11,1,1,2
33289,vende,,13,7,10,17
33290,iStig,,18,4,10,14
33291,sitstaygoodblog,,18,2,4,6
33292,moah099,,18,54,1,55
33293,brobak,,1,211,187,398
33294,ihateyoumost,,29,56,90,146
33295,Joelawl,,18,2,2,4
33296,grishnackh,,18,5,2,7
33297,loyuka,,31,1,2,3
33298,whiffybatter,,31,69,80,149
33299,clickclickbang,,18,9,11,20
33300,isankit,,1,110,171,281
33301,TootAndComeIn,,13,1,1,2
33302,MUD,,13,1,1,2
33303,thorshammer,,19,151,86,237
33304,Junior1919,,1,81,77,158
33305,dmightx,,18,7,12,19
33306,muimui69,,5,388,24,412
33307,whosthemac,,32,1,1,2
33308,hrm,,20,1,3,4
33309,coolflower,,0,3,15,18
33310,not_really_google_it,,41,1,1,2
33311,sugeknight,,18,3,7,10
33312,theblackdane,,0,7,4,11
33313,mookusaki,,13,1,2,3
33314,CritterM72800,,20,5,5,10
33315,bbq,,20,11,7,18
33316,sjpjeep,,31,5,4,9
33317,kamean,,31,1,1,2
33318,gmcnaughton,,8,3,2,5
33319,tugrul,,1,1,1,2
33320,boiboi2000,,1,3,7,10
33321,jgbiggs,,29,2,3,5
33322,chiefster,,18,15,22,37
33323,muffin-noodle,,20,95,75,170
33324,planetmcd,,23,1,1,2
33325,saradipity,,29,2,5,7
33326,varjag,,20,34,78,112
33327,aioujvcklsadj,,22,3,2,5
33328,nicky7,,1,169,255,424
33329,regisb,,18,58,11,69
33330,fantasticplastic,,28,40,69,109
33331,underdawg,,18,19,38,57
33332,jsragman,,13,21,110,131
33333,Madameshabbs,,18,2,5,7
33334,Fltar2,,5,1,4,5
33335,javguerre,,12,103,162,265
33336,laptopfanaddict,,18,13,4,17
33337,evanvolm,,18,549,191,740
33338,naikrovek,,32,5,3,8
33339,factician,,2,6,2,8
33340,remfrebr,,18,1,1,2
33341,Neodymion,,20,55,70,125
33342,k4st,,20,126,208,334
33343,ibm5_25,,20,3,2,5
33344,Homunculiheaded,,20,82,96,178
33345,PatFlorida,,26,3,1,4
33346,omepiet,,22,205,255,460
33347,probabilityzero,,22,12,1,13
33348,pesveld,,19,3,1,4
33349,Mpromptu,,32,408,2,410
33350,MetricMike,,17,2,2,4
33351,nikola_tesla,,34,1,7,8
33352,cowdr,,13,1,1,2
33353,PathDaemon,,18,21,31,52
33354,CreepingTurnip,,8,2,1,3
33355,flagg,,10,19,22,41
33356,Tokenwhitemale,,29,2,2,4
33357,cocoon56,,22,183,193,376
33358,anomalousman,,13,1,1,2
33359,maxp0wah,,13,3,8,11
33360,56d6v5s,,11,1,1,2
33361,grandwino,,29,2,2,4
33362,coparpeticiggio,,43,2,1,3
33363,xxxkubd,,22,1,1,2
33364,Hereticked,,7,2,1,3
33365,dizzyk2008,,1,85,127,212
33366,magnao,,20,1,1,2
33367,gridlock_is_good,,13,3,2,5
33368,nukethewhales42,,20,1,7,8
33369,pjriot,,17,1,2,3
33370,majsucks,,4,7,2,9
33371,McSand,,13,2,1,3
33372,onlywhenimstoned,,42,1,4,5
33373,jonnyamsterdam,,19,2,5,7
33374,fef56,,43,16,33,49
33375,zombispokelsespirat,,20,31,6,37
33376,devmode,,22,53,86,139
33377,bustedagain,,43,62,154,216
33378,fabiocoil,,0,36,7,43
33379,rickiewatters,,5,37,10,47
33380,feebie,,1,313,589,902
33381,confused_canuk,,22,3,8,11
33382,john1725,,18,13,26,39
33383,Mercifool,,18,12,40,52
33384,testtubebaby,,18,88,82,170
33385,NonReligiousPopette,,18,4,5,9
33386,smokebogey,,1,2,5,7
33387,jasondj_at_work,,22,34,28,62
33388,odwyerda,,18,11,2,13
33389,pbkobold,,20,40,49,89
33390,morganstanley,,13,9,2,11
33391,mynameisdave,,9,495,951,1446
33392,jofo,,18,26,54,80
33393,Loch_Ness_Monster,,19,1,3,4
33394,1001noisycameras,,19,54,3,57
33395,sarcasm_repair,,33,1,1,2
33396,jk3us,,27,1119,779,1898
33397,blakesterz,,29,1,1,2
33398,supernovacore,,19,30,15,45
33399,markiek,,21,1,1,2
33400,skorgu,,20,69,118,187
33401,spaceagedisco,,43,3,11,14
33402,the_nomad,,22,3,2,5
33403,de_Selby,,32,113,213,326
33404,ukchris,,1,126,151,277
33405,biGgulp,,18,4,5,9
33406,7rini7y,,6,2,1,3
33407,BlueSteelRose,,26,3,4,7
33408,ultramk,,14,1,1,2
33409,PREZman,,32,18,2,20
33410,1tsm3,,22,4,12,16
33411,flashtastic,,1,72,41,113
33412,pflanz,,13,65,114,179
33413,Tommah,,20,225,555,780
33414,bondagegirl,,1,159,144,303
33415,davywybiral,,20,4,3,7
33416,robkinyon,,20,5,10,15
33417,jrizzo1,,4,2,1,3
33418,ParaJaredDiddle,,35,6,8,14
33419,antifreze,,12,48,49,97
33420,poelmanc,,19,252,367,619
33421,natalyadkmode,,0,33,93,126
33422,tubosalt,,31,9,8,17
33423,Naomarik,,18,17,18,35
33424,JerseyBricklayer,,18,4,3,7
33425,n0tab0t,,31,3,1,4
33426,timdaw,,0,4,3,7
33427,inst,,22,31,10,41
33428,Bodger,,19,8,8,16
33429,steveinrio,,8,13,11,24
33430,ass_clown,,18,37,2,39
33431,kapuchinski,,19,1,6,7
33432,paperhat,,29,70,68,138
33433,bobwagner,,19,74,38,112
33434,clobwhirl,,20,84,127,211
33435,l3enman,,13,1,1,2
33436,lessofthat,,31,35,42,77
33437,meshosh,,43,1,3,4
33438,natolee,,32,1,2,3
33439,key1234,,20,3,3,6
33440,noarchy,,29,31,55,86
33441,hepcecob,,42,1,3,4
33442,redneckhatr,,13,11,21,32
33443,Word_of_the_Day,,43,7,28,35
33444,ginty,,42,1,4,5
33445,workoutiq,,1,13,2,15
33446,CarlosHamburgerJr,,13,2,5,7
33447,sexualpredator,,19,12,13,25
33448,feliandrade,,18,213,68,281
33449,rhartman,,18,139,127,266
33450,beefparty,,1,2,3,5
33451,anderskitson,,8,3,5,8
33452,Ryan0617,,18,328,120,448
33453,dVnt,,32,3,6,9
33454,SpiceMustFlow,,19,301,463,764
33455,_racist_,,18,2,4,6
33456,the-wise-fool,,27,3,2,5
33457,amberfool,,31,1,3,4
33458,jimssc,,18,2,1,3
33459,elliao,,41,2,1,3
33460,thisguy,,20,1,1,2
33461,weasel8,,20,7,11,18
33462,LegokeyChAin,,10,1,3,4
33463,eks,,15,565,226,791
33464,tbogatchev,,22,1,1,2
33465,James_Bong,,0,116,79,195
33466,monkeymanD,,18,80,88,168
33467,carlingford,,29,38,106,144
33468,strixvarius,,20,2,4,6
33469,Jezkah,,34,22,15,37
33470,drstrauss,,42,2,1,3
33471,corporeality,,13,1,5,6
33472,breshnev2,,20,2,1,3
33473,oniram,,20,108,53,161
33474,tjharman,,34,5,9,14
33475,indorock,,18,619,374,993
33476,toooooob,,20,109,139,248
33477,unireg,,17,1,1,2
33478,El_Fajitas1,,31,31,48,79
33479,unsigner,,22,9,1,10
33480,mescalitospoke,,13,7,5,12
33481,Rolthein,,30,4,3,7
33482,trebular,,18,6,21,27
33483,nmichelewicz,,32,1,1,2
33484,bryalflet,,1,1,7,8
33485,Onomatopeer,,27,3,2,5
33486,fronko,,19,2,8,10
33487,zetx,,14,2,3,5
33488,nothingbutjelly,,13,12,3,15
33489,hackenberry,,20,3,4,7
33490,quit_complaining,,22,462,568,1030
33491,qwerty101,,7,1,1,2
33492,ishaq,,0,2,5,7
33493,hopestarr,,11,1,2,3
33494,ghale,,3,36,33,69
33495,Owy2001,,1,5,2,7
33496,sintaks,,20,16,27,43
33497,busman,,13,67,19,86
33498,TruePresence,,19,2,2,4
33499,Spelling-Nazi,,1,1,1,2
33500,kobie,,18,10,10,20
33501,freeplatypus,,0,1,3,4
33502,k00charski,,43,10,12,22
33503,BigCliff,,13,14,25,39
33504,phredderf,,3,3,1,4
33505,lawpoop,,13,2,6,8
33506,lewah,,22,73,29,102
33507,heavyarms,,3,3,3,6
33508,abudabu,,19,1756,332,2088
33509,Jerp,,18,30,61,91
33510,mobius88,,18,33,11,44
33511,bobajoba,,18,52,31,83
33512,marketmou,,5,4,11,15
33513,jpzygnerski,,34,1,2,3
33514,ohmywordxxx,,19,1,1,2
33515,johncabell,,6,14,3,17
33516,mashtun,,18,34,54,88
33517,cmiller1,,4,176,210,386
33518,gsg927,,20,29,49,78
33519,uvm87,,13,208,43,251
33520,SLAS,,42,5,4,9
33521,CptWifeSwap,,17,1,8,9
33522,jack_spankin,,19,92,92,184
33523,SpaizKadett,,18,506,286,792
33524,fareb,,34,1,1,2
33525,TheKarlHungus,,19,36,52,88
33526,redditric,,13,7,3,10
33527,ka-pai,,1,54,131,185
33528,DAN191535,,13,18,10,28
33529,anti-troller,,22,1,1,2
33530,rockinjoe,,19,4,5,9
33531,Steph_C,,4,10,9,19
33532,mateja7,,18,46,3,49
33533,TechNewsSource,,43,1,3,4
33534,tnjohnso,,43,19,25,44
33535,episodic,,18,7,8,15
33536,kelsoATX,,34,40,43,83
33537,alexandrogdl,,18,1,5,6
33538,hdthefishfish,,0,2,9,11
33539,cswetenham,,43,1,3,4
33540,cccv0612,,13,33,29,62
33541,mjeffrey,,1,4,4,8
33542,mhyquel,,1,3,2,5
33543,roddyr2,,19,25,50,75
33544,stonedinxs,,16,1,2,3
33545,FrankBlack,,12,45,112,157
33546,dcb720,,1,113,175,288
33547,diabolicacid,,4,1,1,2
33548,netsui,,13,13,28,41
33549,kedelbrock,,20,27,4,31
33550,borque,,18,38,74,112
33551,almanac528,,0,1,1,2
33552,gsundheim,,33,2,1,3
33553,markng,,43,11,16,27
33554,WaltBusterkeys,,1,13,14,27
33555,Panda_Sex,,32,1,2,3
33556,brhanse,,19,3,2,5
33557,LeonidasRebooted,,13,22,24,46
33558,erebus,,1,327,90,417
33559,cheesemonky,,34,2,2,4
33560,biggy2pac,,20,3,16,19
33561,dondonno,,43,3,5,8
33562,Manitcor,,36,105,139,244
33563,eliben,,20,73,59,132
33564,Cyclops0T8,,18,23,54,77
33565,Thespoian,,34,14,2,16
33566,uwjames,,43,986,1336,2322
33567,hyper24m,,18,1,1,2
33568,zornrot,,30,15,14,29
33569,rm999,,3,322,432,754
33570,allnewecho,,42,63,43,106
33571,twincitylines,,14,1,1,2
33572,usersaurus,,14,1,2,3
33573,genocideisforme,,13,2,1,3
33574,Dea7hLeprachaun,,43,5,4,9
33575,tadrinth,,20,85,73,158
33576,timburrell,,20,2,3,5
33577,just_someguy,,1,2,2,4
33578,foobarbaz,,20,16,3,19
33579,thepeacemaker,,43,20,21,41
33580,GnuSniffer,,13,11,2,13
33581,herpes,,3,1,3,4
33582,champlain32,,13,143,77,220
33583,jimmysack,,13,30,12,42
33584,bothways,,33,1,1,2
33585,ratzero,,19,277,85,362
33586,rickrolled2,,16,1,1,2
33587,momarortotinon,,31,8,9,17
33588,DudeYamaha,,13,1,1,2
33589,guyro,,5,139,17,156
33590,gregny2002,,18,413,482,895
33591,monocasa,,20,164,285,449
33592,pedromarin,,1,1,1,2
33593,adamc83,,15,44,49,93
33594,Palladin001,,19,17,35,52
33595,mediocretes,,13,43,71,114
33596,johnyquest,,18,100,185,285
33597,illectronic,,34,13,1,14
33598,trisomy21,,0,30,36,66
33599,coskier,,22,1,1,2
33600,mdma,,13,2,1,3
33601,BROKENSARCASMDETECT,,42,7,1,8
33602,housecat,,18,12,19,31
33603,ej00807,,43,10,41,51
33604,Discredited,,32,1,1,2
33605,energeek,,20,50,22,72
33606,Enygma,,18,16,8,24
33607,andreyvo,,29,1,1,2
33608,basset_frog,,32,12,6,18
33609,merle93,,34,25,22,47
33610,michaelpaulhartman,,32,96,161,257
33611,aagee,,4,16,8,24
33612,palmTree,,13,22,22,44
33613,jh99,,1,286,317,603
33614,rigobert,,29,12,8,20
33615,dantams,,15,1,1,2
33616,ruaidhri,,29,368,198,566
33617,sogod,,20,5,10,15
33618,bakotaco,,20,4,3,7
33619,bjupton,,4,200,308,508
33620,batcountry421,,23,15,18,33
33621,Vishnu69,,13,2,4,6
33622,rgm70,,18,150,26,176
33623,voltron013,,31,29,55,84
33624,gthiruva,,13,1,2,3
33625,zafiroblue05,,31,141,122,263
33626,frustrated,,43,38,10,48
33627,Twylite,,20,8,1,9
33628,raiseup151z,,23,1,4,5
33629,biscuitbee,,42,10,4,14
33630,saucetenuto,,20,6,8,14
33631,caturday,,1,28,27,55
33632,fishboy1,,1,284,388,672
33633,foodpk,,20,20,22,42
33634,robbyyy,,13,21,1,22
33635,tenmilekyle,,18,1,7,8
33636,face_palm,,13,5,12,17
33637,acdha,,20,43,41,84
33638,lidko,,32,1,1,2
33639,assortedslog,,20,24,16,40
33640,edubs7,,13,342,153,495
33641,Kietedan,,43,1,2,3
33642,ikeed,,13,61,112,173
33643,introspeck,,32,26,18,44
33644,GregEvangelista,,18,2,7,9
33645,kawa,,20,53,40,93
33646,Herbaceous,,32,55,68,123
33647,onepound,,39,2,2,4
33648,antasi,,4,31,5,36
33649,cuethedanger,,18,6,12,18
33650,freznowine,,20,3,1,4
33651,sexymotherfucker,,30,7,10,17
33652,mrcarson2,,36,5,3,8
33653,eddio101,,5,1,1,2
33654,BaboTron,,18,30,73,103
33655,d64,,13,122,146,268
33656,Kingcook85,,34,10,15,25
33657,jimgagnon,,34,72,18,90
33658,aplus_betty,,19,8,8,16
33659,pi31415916,,1,1,1,2
33660,Nekomancer,,22,145,244,389
33661,madir,,42,2,2,4
33662,KingQueen,,20,5,8,13
33663,cereal,,6,119,105,224
33664,liamvictor,,5,31,10,41
33665,kteague,,20,41,57,98
33666,w0wy,,13,4,7,11
33667,outpt,,22,2,6,8
33668,thereviewer,,5,5,7,12
33669,niladmirari,,32,5,5,10
33670,Martha9,,0,45,9,54
33671,volunteer,,41,2,1,3
33672,seagreensky,,20,9,21,30
33673,huckleberry,,22,11,17,28
33674,jbreckman,,20,53,26,79
33675,sakabako,,22,13,21,34
33676,taligent,,20,195,176,371
33677,lololdl,,22,2,2,4
33678,truthrewards,,13,9,10,19
33679,dionysian,,18,9,16,25
33680,gregtmills,,32,18,27,45
33681,Gygy,,41,1,2,3
33682,wreckingball,,13,1,1,2
33683,adamfalkofske,,17,26,43,69
33684,neuro,,19,12,55,67
33685,Megasphaera,,20,133,200,333
33686,ImJustRick,,0,13,15,28
33687,padmeamidala,,5,26,100,126
33688,dbredesen,,22,1,1,2
33689,tmb12,,2,9,12,21
33690,CapnDeviance,,18,7,12,19
33691,Coolhawks,,19,4,23,27
33692,Pazu,,12,3,2,5
33693,alloydwhitlock,,18,2,4,6
33694,chortle,,5,1,2,3
33695,jpotteiger,,42,1,1,2
33696,cozm,,19,8,17,25
33697,figgle,,34,11,11,22
33698,ilikerutypoon,,1,270,133,403
33699,kabu24,,18,3,7,10
33700,Bornhuetter,,18,145,34,179
33701,idikuci,,18,56,132,188
33702,SallyForth,,13,1,10,11
33703,subcinco,,41,2,3,5
33704,marirs,,13,1,1,2
33705,redditors_r_cunts,,20,1,3,4
33706,winampman,,6,100,134,234
33707,JonyEpsilon,,17,1,1,2
33708,saejo,,5,1,1,2
33709,flaake,,6,17,2,19
33710,kanachandra,,19,28,32,60
33711,stuckinreality,,19,1,1,2
33712,oodlesofmoodles,,29,2,1,3
33713,localstatic,,32,26,39,65
33714,simonowens,,6,13,3,16
33715,blackolive2,,12,2,1,3
33716,titlepolicemustdie,,13,4,4,8
33717,NickGK,,19,4,3,7
33718,lessthanjakedude,,42,20,16,36
33719,bjorn,,18,24,11,35
33720,vagif,,20,548,739,1287
33721,cowboyneal,,18,44,105,149
33722,eyebelieve,,31,1,1,2
33723,navadasha,,10,2,1,3
33724,fuzoid,,29,7,1,8
33725,bermuda,,0,12,4,16
33726,heyimmarc,,22,1,1,2
33727,contrarian,,39,1706,2003,3709
33728,RealDeuce,,20,103,149,252
33729,south_beach_nerd,,19,12,21,33
33730,jansseba,,18,26,46,72
33731,cruisn223,,43,2,2,4
33732,tedhenry10,,19,3,1,4
33733,minglemangle,,34,81,120,201
33734,Kes1980,,43,5,7,12
33735,flynnguy,,20,2,2,4
33736,erp,,13,6,16,22
33737,mayankgupta,,5,3,4,7
33738,Shpox,,1,1,5,6
33739,tnjm,,31,1,1,2
33740,pretendperson,,4,75,43,118
33741,OsamaBeanLaden,,18,1,1,2
33742,miguelstil,,5,16,11,27
33743,americanuck,,19,390,553,943
33744,calladus,,32,2,2,4
33745,boomboomroom,,19,23,23,46
33746,fragglecat,,19,3,2,5
33747,SublimeWill,,1,25,2,27
33748,tubeguy,,20,2,4,6
33749,OmicronPersei8,,31,96,101,197
33750,meerkat78,,19,1,3,4
33751,anthony_dadragon,,8,1,1,2
33752,Nagyman,,20,11,25,36
33753,hawkxor,,31,15,23,38
33754,migshark,,3,16,32,48
33755,drekar,,43,20,22,42
33756,enkrates,,20,4,6,10
33757,desimusxvii,,0,101,89,190
33758,kingjehu,,1,156,337,493
33759,Kifoth,,20,26,25,51
33760,choochy,,1,86,83,169
33761,hoorayforleah,,22,4,1,5
33762,joker80,,20,4,6,10
33763,ekal,,5,4,2,6
33764,mist929292,,0,1,1,2
33765,lost-theory,,20,161,185,346
33766,chilehead,,32,90,191,281
33767,karthik3186,,20,9,1,10
33768,Lar-Shemp,,0,117,182,299
33769,phenotype,,32,66,1,67
33770,kogu,,11,1,3,4
33771,livetoad,,19,12,18,30
33772,rachismo,,34,48,57,105
33773,Masihaa,,19,316,24,340
33774,msmarmalade,,32,7,6,13
33775,kwaigon_ginger,,43,1,1,2
33776,smileylich,,18,8,2,10
33777,Maddog_Delphi97,,22,6,5,11
33778,Al_Bundy_,,43,46,32,78
33779,jebbielax,,18,1,1,2
33780,loupgarou21,,0,138,197,335
33781,wwnexc,,3,5,3,8
33782,emp783,,16,1,1,2
33783,kernelkhertz,,8,15,24,39
33784,turkishdelight83,,19,6,1,7
33785,arunan,,43,62,49,111
33786,wenwon,,43,14,8,22
33787,semiquaver,,1,1,1,2
33788,wellyuk,,43,1,2,3
33789,nocent7,,20,37,52,89
33790,pawned,,36,3,4,7
33791,nees,,20,2,2,4
33792,shapattack,,19,131,5,136
33793,SoftwareSimian,,20,1,2,3
33794,jillmwo,,19,4,3,7
33795,majikmike,,18,1,8,9
33796,greganem,,16,18,27,45
33797,OpenOffice,,22,1,1,2
33798,koorogi,,20,18,21,39
33799,friednerds,,18,3,7,10
33800,OneSalientOversight,,15,387,217,604
33801,p3do,,0,237,165,402
33802,HeliumFlash,,0,213,14,227
33803,jskeetjr,,18,33,13,46
33804,redass,,18,15,1,16
33805,miero,,20,12,13,25
33806,waddupeverybody,,8,15,1,16
33807,eclecticgamer,,29,1,2,3
33808,jasonkolb,,19,12,15,27
33809,cryptorchidism,,34,133,244,377
33810,oregeno,,18,1,1,2
33811,jvgreene,,13,13,10,23
33812,tjstix,,18,14,8,22
33813,CaptainSnuggleBunny,,13,101,18,119
33814,festivus,,31,11,9,20
33815,teem,,18,4,2,6
33816,pfunkmunk,,1,6,8,14
33817,djrok212,,17,12,10,22
33818,ssam,,20,30,48,78
33819,flieslikeabeagle,,18,21,18,39
33820,jcharum,,19,28,31,59
33821,lepetitoiseau,,4,4,7,11
33822,Zman11588,,1,79,66,145
33823,silentchaos,,22,1,2,3
33824,davidthedrake,,10,148,17,165
33825,megamerican,,19,11,3,14
33826,BeatnikDude,,19,85,177,262
33827,goldguy,,8,2,1,3
33828,punjabikura,,31,5,9,14
33829,toothravisher,,13,5,1,6
33830,wquintero,,13,4,1,5
33831,moongirl,,22,1,1,2
33832,kwanbis,,34,4,3,7
33833,LiveBackwards,,22,90,70,160
33834,smartbomb,,3,1,1,2
33835,pickle-head,,13,4,12,16
33836,nlevend,,34,1,2,3
33837,tkang,,31,16,15,31
33838,laughingplague,,0,3,7,10
33839,pavaranda,,9,4,1,5
33840,eltictac,,19,26,7,33
33841,SandyFaye,,13,9,12,21
33842,nutmeg,,20,3,9,12
33843,bkudria,,20,24,32,56
33844,rararasputin,,1,3,7,10
33845,truckmonkey,,35,9,12,21
33846,bluGill,,20,702,1339,2041
33847,ForthRightAfter,,0,1,3,4
33848,MesopotamianBowl,,1,1,1,2
33849,awj,,20,180,275,455
33850,dune2098,,19,10,4,14
33851,phathiker,,18,253,281,534
33852,macros,,14,3,2,5
33853,ninjaa,,4,1,1,2
33854,kapaka,,22,23,18,41
33855,DirtyBinLV,,18,107,113,220
33856,techlyc,,6,15,21,36
33857,brianjherman,,18,10,37,47
33858,neelakantha,,18,97,22,119
33859,squareball,,20,45,65,110
33860,r_schleufer,,4,2,4,6
33861,markbesada,,20,7,11,18
33862,doberboy,,18,35,20,55
33863,hpgrenade,,18,4,3,7
33864,clarkstud,,3,10,17,27
33865,aduric,,20,13,13,26
33866,thaxor,,43,1,2,3
33867,yoshhash,,18,57,52,109
33868,USBrownShirts,,34,2,1,3
33869,allegedmark,,0,1,1,2
33870,TeaParty,,19,227,289,516
33871,etotheprimez,,22,120,368,488
33872,Emouri,,32,2,2,4
33873,alzorus,,39,1,1,2
33874,gnossos,,19,29,50,79
33875,rojerton,,22,2,1,3
33876,tinytouchneednocalib,,0,1,1,2
33877,milominderbinder,,18,5,1,6
33878,juliejgirl,,18,3,2,5
33879,anyfoo,,18,347,116,463
33880,jeffwong,,19,40,46,86
33881,kwarren84,,0,2,2,4
33882,pavedwalden,,18,120,210,330
33883,kras8live,,31,1,1,2
33884,sassanix,,42,107,106,213
33885,desiever,,18,16,19,35
33886,tableturns77,,18,17,67,84
33887,grignr,,18,578,635,1213
33888,roblightbody,,19,32,31,63
33889,bizzy,,13,30,5,35
33890,xxxMDKxxx,,18,5,10,15
33891,theawesomelucas,,18,10,6,16
33892,e_0r,,43,2,1,3
33893,wcchandler,,1,123,112,235
33894,yqiang,,20,5,2,7
33895,booch,,20,10,17,27
33896,rarebit,,19,10,7,17
33897,yourkamden,,13,5,2,7
33898,mbrownerhamlin,,13,35,11,46
33899,derekpaco,,0,10,19,29
33900,pluke,,13,248,213,461
33901,Bertwad,,18,7,19,26
33902,carycary,,12,1,1,2
33903,sk11,,32,160,135,295
33904,zxymkd,,16,9,9,18
33905,fps,,20,3,2,5
33906,sage99,,0,1,1,2
33907,benjorino,,22,9,9,18
33908,anthem123,,18,19,3,22
33909,truncheon,,18,6,6,12
33910,qryan,,12,1,1,2
33911,OXMWEPW,,13,35,62,97
33912,aquadoctorbob,,42,3,1,4
33913,SlimBackwater,,20,4,5,9
33914,Bing11,,8,359,390,749
33915,michael333,,0,109,315,424
33916,Kinakuta,,18,1,4,5
33917,AtlasEditorials,,20,3,11,14
33918,pirateddit,,1,4,3,7
33919,TomDLux,,1,1,1,2
33920,bedfordn,,22,21,22,43
33921,Grimpuppy,,18,171,37,208
33922,EverestFreeman,,0,6,1,7
33923,Golgo13,,18,26,48,74
33924,diafygi,,13,65,7,72
33925,matt2500,,13,11,6,17
33926,x_gas,,13,2,1,3
33927,elihu,,20,1,3,4
33928,tmoertel,,20,11,15,26
33929,Stigmataman,,19,21,16,37
33930,redditoked,,0,2,1,3
33931,inkieminstrel,,20,215,220,435
33932,forever497,,19,6,12,18
33933,mosby,,9,2,1,3
33934,pyrmont,,18,1,8,9
33935,adr,,20,2,4,6
33936,roguevalley,,19,30,48,78
33937,jward,,30,18,33,51
33938,NCRider,,18,11,13,24
33939,hack4cash,,3,1,2,3
33940,plopgun,,18,4,6,10
33941,bryarcanium,,19,2,2,4
33942,stoned_dog_race_fan,,43,1,1,2
33943,graynut,,18,3,7,10
33944,beckka,,36,1,3,4
33945,zooch76,,18,339,401,740
33946,thadudesbro,,1,93,109,202
33947,devacon,,20,28,28,56
33948,Vacuum_Tube,,32,1,1,2
33949,jreza2k3,,31,66,78,144
33950,gandalfian,,0,17,29,46
33951,jadanzzy,,31,20,10,30
33952,awb,,20,448,331,779
33953,HellSpam,,31,9,3,12
33954,freenowdude,,43,4,14,18
33955,HunterST,,34,1,1,2
33956,turdfurg,,20,15,24,39
33957,RonaldMJR,,13,1,2,3
33958,downvoter1,,31,1,2,3
33959,dogchasecars,,18,1,2,3
33960,loulan,,13,1,1,2
33961,africandave,,22,5,7,12
33962,comradeluke,,13,13,9,22
33963,lubos,,20,21,17,38
33964,AndrewKemendo,,29,303,263,566
33965,WillPheeler,,18,128,36,164
33966,redudown,,3,38,59,97
33967,eonwe,,20,32,7,39
33968,hglman,,43,34,68,102
33969,toddritt,,1,2,1,3
33970,Fox318,,12,11,31,42
33971,notfrench,,32,4,3,7
33972,pseudoswamy,,1,34,89,123
33973,ukerinfo,,19,1,1,2
33974,joeyeh,,19,11,13,24
33975,physicistjedi,,18,96,1,97
33976,brandonrambo,,18,4,1,5
33977,Causemos,,12,57,119,176
33978,michnuc,,1,32,67,99
33979,delaware,,13,26,14,40
33980,alyoshaPo,,1,68,21,89
33981,derg,,19,9,8,17
33982,xianpryde,,22,7,5,12
33983,bnizzz,,43,10,28,38
33984,Jessapow,,13,8,5,13
33985,JewStyleKungfu,,32,74,86,160
33986,berberine,,32,986,230,1216
33987,kermie1,,19,2,1,3
33988,imitationcheese,,34,239,96,335
33989,berklee,,13,30,40,70
33990,Willum,,18,7,12,19
33991,ahalsall,,19,7,2,9
33992,tvoglou,,20,1,2,3
33993,flen_paris,,20,20,14,34
33994,mihrz,,18,6,13,19
33995,GTFO_NAO,,19,1,1,2
33996,omellet,,35,13,20,33
33997,Nemesoid,,34,25,27,52
33998,gooneruk,,43,117,135,252
33999,keeganspeck,,13,1,1,2
34000,dominateastheking,,19,3,6,9
34001,jax9999,,31,639,1316,1955
34002,ashes2ashes4040,,13,1,1,2
34003,dogbait,,0,37,70,107
34004,DrSausage,,13,153,207,360
34005,erichhaubrich,,13,6,4,10
34006,spaceywilly,,1,6,7,13
34007,normansoddy,,13,325,242,567
34008,astrochicken,,18,11,11,22
34009,danjayh,,29,2,2,4
34010,GuidoLibido,,13,74,26,100
34011,snort_,,43,2,1,3
34012,DrJosh2,,41,9,1,10
34013,oldstyle21,,6,2,2,4
34014,moomooman,,13,34,24,58
34015,hairyman,,20,3,3,6
34016,marcosh08,,31,1,1,2
34017,Copperhe4d,,12,21,27,48
34018,uassholes,,20,4,7,11
34019,mrBlonde,,19,133,233,366
34020,rolandboard,,13,20,65,85
34021,treitter,,20,4,4,8
34022,zerostar,,13,2,8,10
34023,fryguy8,,20,9,11,20
34024,elysiumarie,,13,3,2,5
34025,cobain_angel,,43,28,75,103
34026,craigmj,,3,6,7,13
34027,yolfer,,10,2,2,4
34028,wefwefwef,,30,2,2,4
34029,Bennifer,,39,9,6,15
34030,crashkg,,13,547,469,1016
34031,Captain_Obvious_,,34,4,5,9
34032,spgarbet,,20,45,32,77
34033,mm911,,17,1,2,3
34034,bradisdrab,,5,2,1,3
34035,djsaturnine,,31,29,9,38
34036,NovaSupreme,,18,3,1,4
34037,righty,,13,136,177,313
34038,charlieboy,,5,929,43,972
34039,idonotlikereddit,,19,6,2,8
34040,iraebrasil,,18,2,4,6
34041,fallenangel42,,18,2,14,16
34042,turbothy,,43,42,77,119
34043,zpinter,,13,1,1,2
34044,search9,,20,1,1,2
34045,Franco_Tacotacotaco,,34,1,1,2
34046,Vette,,19,21,17,38
34047,silberj,,13,3,8,11
34048,targetx,,18,3,11,14
34049,danswim393,,5,2,5,7
34050,jflanger,,5,1,4,5
34051,jimll,,29,7,2,9
34052,catamorphism,,20,8,12,20
34053,anonymgrl,,19,1684,175,1859
34054,klusha,,31,3,2,5
34055,the_foo_maker,,42,98,56,154
34056,SheilaBroflovski,,0,6,19,25
34057,rancmeat,,9,490,951,1441
34058,reddit_men_r_creepy,,19,5,4,9
34059,poorjeff,,19,17,38,55
34060,yogihaji,,29,81,92,173
34061,Sephian,,42,33,65,98
34062,shawnjan,,13,2,2,4
34063,bloggaplease,,19,49,67,116
34064,adzling7,,5,4,1,5
34065,mcfunley,,20,73,48,121
34066,bananahead,,19,766,1051,1817
34067,Towels,,43,83,185,268
34068,dcoolidge,,34,6,10,16
34069,TitaniumLizzard,,0,9,3,12
34070,gr8whitesavage,,18,15,12,27
34071,confidencecow,,18,6,7,13
34072,ICLW,,18,86,40,126
34073,auggie,,13,115,17,132
34074,Sutibu,,18,756,1329,2085
34075,twiggzor,,18,1,3,4
34076,redrumjack,,5,13,12,25
34077,callott,,19,7,9,16
34078,WillyPete,,13,85,129,214
34079,stern54,,20,3,4,7
34080,TriangleMan,,5,17,28,45
34081,jackattack102,,30,1,2,3
34082,vclarke,,43,2,5,7
34083,pipecad,,32,8,9,17
34084,lickme,,0,10,1,11
34085,apassy,,19,3,9,12
34086,scheme,,20,9,26,35
34087,bauhaus31,,18,4,1,5
34088,illmonk,,1,3,4,7
34089,pinewhine,,42,2,1,3
34090,sbhixon,,0,1,2,3
34091,blueeyedmonster,,1,58,19,77
34092,Jinbuhuan,,1,478,837,1315
34093,jpo415,,10,6,8,14
34094,electrocuting,,19,62,77,139
34095,gr3yasp,,42,83,167,250
34096,jsimms,,0,3,7,10
34097,croser,,20,1,1,2
34098,rkeller4,,31,15,26,41
34099,glengineer,,0,9,13,22
34100,aecarol,,4,86,67,153
34101,bcoleman,,13,7,8,15
34102,egoviri,,18,14,13,27
34103,guruscotty,,13,2,3,5
34104,prettyprinceofparty,,39,1,1,2
34105,Pierredenorvege,,1,3,4,7
34106,kwen25,,32,90,171,261
34107,primoris_causa,,19,216,391,607
34108,purpmint008,,19,8,7,15
34109,beagle3,,31,8,9,17
34110,hechacker1,,20,146,184,330
34111,viniosity,,18,8,7,15
34112,mythin,,4,46,76,122
34113,Arclight,,0,107,163,270
34114,orestis,,20,32,18,50
34115,skitz0,,5,1,4,5
34116,eveisdawning,,18,14,18,32
34117,hstern,,18,4,8,12
34118,Iznik,,5,82,159,241
34119,miriad,,5,7,3,10
34120,Mikul,,29,5,5,10
34121,nebm,,19,579,108,687
34122,erwerew,,20,1,1,2
34123,AttackTheRight,,31,1,1,2
34124,processinformation,,20,3,2,5
34125,datawocky,,20,1,2,3
34126,t-train,,35,1,1,2
34127,andy_rogers,,4,2,1,3
34128,trunkboy,,1,32,2,34
34129,Scyth3,,18,91,58,149
34130,JohnStays44,,29,1,5,6
34131,Ferris,,36,1,1,2
34132,poign9,,22,2,3,5
34133,Tyrone_LVL20_Wizard,,26,2,1,3
34134,erasser999,,6,4,1,5
34135,hyperkill,,18,6,7,13
34136,brw,,19,2,3,5
34137,qpalzm,,1,14,16,30
34138,b111,,20,19,14,33
34139,Politikil,,17,5,6,11
34140,ballinintransylvania,,4,4,1,5
34141,undidredo,,20,1,1,2
34142,yakobusan,,5,21,1,22
34143,myopiczeal,,43,46,77,123
34144,bjtuna,,19,48,57,105
34145,Arkansan,,13,4,10,14
34146,snowcrash81,,22,33,42,75
34147,directrixx,,18,24,45,69
34148,whatthedude,,5,3,7,10
34149,parkamark,,31,3,3,6
34150,CliffsNotes,,19,8,16,24
34151,Pitfan,,5,2,3,5
34152,LetsGoHawks,,13,237,273,510
34153,eugene_spencer,,12,3,5,8
34154,Daniel_SJ,,10,239,216,455
34155,domlachowicz,,20,28,27,55
34156,sioked,,19,3,3,6
34157,Fairdeal,,13,21,63,84
34158,jimic79,,8,2,2,4
34159,ubikuor,,5,2,3,5
34160,secret6,,19,102,189,291
34161,leapetra,,11,1,2,3
34162,braahyan,,20,14,21,35
34163,Brenbren25,,18,114,142,256
34164,charleycoyote,,21,5,5,10
34165,Renegade98,,13,2,1,3
34166,Hellevator,,20,14,21,35
34167,dt403,,32,6,4,10
34168,ptangirala,,31,17,15,32
34169,duplico,,20,84,42,126
34170,pr0nmee,,30,1,3,4
34171,rawkeye,,32,3,3,6
34172,vk0,,20,3,4,7
34173,MazdaEric,,18,41,96,137
34174,kbot777,,9,6,10,16
34175,Field_Effect,,4,1,1,2
34176,Kevin_Ar18,,20,10,11,21
34177,diamondtron,,43,78,130,208
34178,krush_groove,,18,7,7,14
34179,Fidodo,,34,362,624,986
34180,tumtum,,11,3,4,7
34181,chinchillla,,18,15,16,31
34182,schickm,,18,3,4,7
34183,spiky_boy,,36,1,1,2
34184,hydIndian,,0,15,23,38
34185,drhull,,20,55,35,90
34186,denier,,15,1,2,3
34187,flashmcgallion,,33,53,41,94
34188,snalien,,31,1,1,2
34189,galaxy67,,16,5,5,10
34190,ranprieur,,1,414,227,641
34191,daphaze,,13,20,17,37
34192,drzaeus,,18,9,9,18
34193,taninsam,,30,3,1,4
34194,ckendrick,,8,1,1,2
34195,Piyh,,17,3,2,5
34196,rollotomnasi,,19,2,3,5
34197,mothsmoke,,19,3,4,7
34198,MorningThrush,,13,3,3,6
34199,nognir,,19,55,16,71
34200,xibalba89,,31,63,63,126
34201,omrifiv,,20,1,1,2
34202,subscript,,19,15,4,19
34203,knew,,0,27,2,29
34204,sinscriven,,14,1,3,4
34205,gmontague0205,,18,1,1,2
34206,uvarov,,43,76,115,191
34207,oodja,,31,30,54,84
34208,billtron,,1,4,11,15
34209,chbrules,,32,333,409,742
34210,gensek,,31,325,510,835
34211,MarquisDeSaid,,35,2,1,3
34212,dramaticChipmunk,,18,95,12,107
34213,komokuten,,21,11,1,12
34214,treyjp,,32,15,40,55
34215,manganese,,31,36,47,83
34216,jus1haz2,,1,78,13,91
34217,neimadmt,,42,1,1,2
34218,bigrjsuto,,1,6,9,15
34219,mssnlayam,,39,8,6,14
34220,BostonBlackie,,18,1,5,6
34221,leapsntwirls,,18,6,14,20
34222,argo97,,34,357,16,373
34223,marcandre,,19,6,11,17
34224,AmusedMuse,,5,2,10,12
34225,Shreela,,32,21,68,89
34226,ChrisMatthews,,22,2,4,6
34227,amansman,,18,26,34,60
34228,juvel,,10,1,3,4
34229,smoove,,1,27,32,59
34230,Cosmin1,,19,3,7,10
34231,xerodeth,,32,2,4,6
34232,jazzyb,,32,9,22,31
34233,jetpack,,30,11,15,26
34234,barracuda150965,,19,1,6,7
34235,pseudohippie,,39,3,1,4
34236,rogerdrabbit,,19,2,7,9
34237,marsz-marsz,,17,1,2,3
34238,old_folkie,,19,2,4,6
34239,Wi-Fi-Guy,,20,3,11,14
34240,Gsuslovesme,,18,67,104,171
34241,SkipperMedia,,0,129,8,137
34242,disturbd,,32,206,262,468
34243,_KS,,20,33,9,42
34244,polychrome,,0,1,3,4
34245,frelling_drenn,,1,4,10,14
34246,den31,,20,5,6,11
34247,tonyhajdu,,19,8,12,20
34248,Toastums,,29,1,4,5
34249,can_i_haz_cheez,,31,22,26,48
34250,StoneMe,,31,658,602,1260
34251,zaradox,,0,329,11,340
34252,free888,,18,42,102,144
34253,vvy,,20,2,6,8
34254,moonguidex,,1,28,47,75
34255,cochico,,18,28,54,82
34256,AngledLuffa,,10,502,627,1129
34257,erlich,,0,2,1,3
34258,XeroQ,,43,2,2,4
34259,scott127,,18,1,1,2
34260,silverstreak,,18,274,64,338
34261,gnuvince,,20,728,493,1221
34262,volleyballmaniac,,18,2,1,3
34263,psynix,,20,7,4,11
34264,jolhoeft,,8,1,1,2
34265,greyspace,,18,6,15,21
34266,grahamlester,,19,501,115,616
34267,expectingrain,,9,522,625,1147
34268,brite2006,,19,2,1,3
34269,olympicherojohn,,34,2,2,4
34270,virtigo311,,18,3,3,6
34271,KlassyGuy,,31,211,251,462
34272,el_pie_eater,,18,3,10,13
34273,Satguy,,19,2,2,4
34274,annodomini,,20,72,73,145
34275,lockmary,,20,1,1,2
34276,maskull,,1,1,1,2
34277,DannyRhodesHaugh,,19,7,11,18
34278,USMC_Megladon,,19,27,45,72
34279,optimmal,,28,2,1,3
34280,turnrighttogoleft,,19,89,102,191
34281,ashlea555,,19,5,6,11
34282,tourgee,,13,8,4,12
34283,42nt1,,31,4,8,12
34284,z_at_detonate,,11,3,1,4
34285,riddlar,,18,11,8,19
34286,xysm,,30,1,2,3
34287,jamesinc,,22,130,239,369
34288,martizzle,,4,4,10,14
34289,cacci,,42,2,1,3
34290,babakshirazi,,19,19,18,37
34291,danamcdaniel,,18,8,7,15
34292,suckup,,19,5,7,12
34293,Chelsea_Clinton,,19,3,4,7
34294,Atlai,,0,111,92,203
34295,andy_63392,,20,15,27,42
34296,amph,,43,53,51,104
34297,davidlt,,31,2,2,4
34298,turbotito,,43,1,5,6
34299,coleman57,,18,205,325,530
34300,vividvew,,0,1,2,3
34301,suziebee,,32,1,1,2
34302,stormyreddit,,42,21,1,22
34303,bork99,,42,6,6,12
34304,saralk,,22,213,209,422
34305,gitwtf,,20,5,3,8
34306,chefranden,,18,1173,147,1320
34307,AndrewCoja,,1,5,5,10
34308,Surfer51,,19,1,4,5
34309,ericrtrue,,19,2,3,5
34310,zenbit,,13,20,31,51
34311,DrNeutral,,0,36,3,39
34312,doesntmatter,,13,1,3,4
34313,alekti,,13,8,12,20
34314,daliuso,,2,3,5,8
34315,EricKow,,20,32,43,75
34316,lkjhg,,43,10,7,17
34317,dianaND,,42,1,2,3
34318,schammy,,20,74,90,164
34319,awesley,,18,50,89,139
34320,Sikul,,18,9,12,21
34321,rasbill,,21,2,2,4
34322,thristian99,,20,35,13,48
34323,whenchristianattack,,18,1,1,2
34324,dbnull,,20,22,30,52
34325,reallynotme,,19,2,1,3
34326,hans1193,,19,677,396,1073
34327,mrcsmith,,19,3,4,7
34328,happyjuggler0,,19,329,369,698
34329,ABSTINENCEKILLS,,19,4,3,7
34330,burichi,,18,3,8,11
34331,hammer74,,39,1,1,2
34332,0x44,,20,14,32,46
34333,mikeriley,,13,1,2,3
34334,fudged71,,1,137,239,376
34335,redheadjessica,,1,15,11,26
34336,jake27,,18,3,3,6
34337,brendankohler,,20,39,66,105
34338,eidetic,,18,6,18,24
34339,bennc,,13,26,28,54
34340,whys,,20,1,1,2
34341,svoldbaek,,34,4,4,8
34342,the1,,13,4,8,12
34343,shamen_uk,,31,27,30,57
34344,stoic_penguin,,19,14,17,31
34345,sonnichj,,35,1,1,2
34346,thsunifeelas0ne,,19,23,30,53
34347,sigjuice,,20,1,3,4
34348,Pylly,,18,178,101,279
34349,pupppet,,31,5,1,6
34350,ffsffsffs,,18,3,7,10
34351,fsjobs,,31,1,1,2
34352,laughingoutloud,,19,4,8,12
34353,The_Cake_Is_A_Lie,,23,206,294,500
34354,aeronumen,,18,1,1,2
34355,genpfault,,20,114,240,354
34356,rootleaf,,31,4,1,5
34357,dasbill,,19,3,1,4
34358,zlhill,,15,1,4,5
34359,sussyfan,,20,2,2,4
34360,swicklund,,32,31,32,63
34361,tehrahl,,30,12,1,13
34362,singhpr,,19,10,22,32
34363,vmass20,,13,11,24,35
34364,BeleiverTDW,,22,1,1,2
34365,demonstro,,1,404,301,705
34366,funshine,,20,16,17,33
34367,WafflCopterz,,1,25,34,59
34368,nht007,,29,3,2,5
34369,nikke10292,,8,4,1,5
34370,Symphic,,12,1,1,2
34371,Poleris,,20,12,4,16
34372,kd5lct,,18,4,13,17
34373,45441,,18,1,4,5
34374,paperface,,31,37,46,83
34375,sid0,,20,39,61,100
34376,ainokami,,22,52,33,85
34377,rigbypat,,18,1,3,4
34378,msposato,,13,2,4,6
34379,Fallout,,1,22,18,40
34380,screamingshillalert,,36,3,6,9
34381,manyou,,6,3,1,4
34382,edwin177,,13,48,15,63
34383,felix,,1,9,2,11
34384,rkzda,,19,3,1,4
34385,kareems,,31,91,83,174
34386,isre,,15,3,7,10
34387,7thString,,1,28,14,42
34388,bigethan,,20,8,9,17
34389,x-fi,,22,1,2,3
34390,posterxx,,0,29,1,30
34391,gunguy,,4,2,3,5
34392,shannonest,,22,11,11,22
34393,johnny2k,,35,2,3,5
34394,clows,,30,5,1,6
34395,eplan,,39,15,4,19
34396,jeresig,,20,181,114,295
34397,PrimeExample,,9,2,1,3
34398,janesinclair,,13,15,1,16
34399,monkeytron,,33,1,2,3
34400,pun_Krawk,,8,3,5,8
34401,outshined,,43,18,23,41
34402,jj555298,,43,30,44,74
34403,blackf1sh,,13,93,81,174
34404,BabyBoomer47,,19,1,1,2
34405,lemonjuicefake,,20,28,20,48
34406,SocialSoundSystem,,18,48,49,97
34407,pinkeyes,,34,6,1,7
34408,dlrow,,13,2,4,6
34409,haschischii,,32,5,4,9
34410,mathmoi,,3,1,1,2
34411,besttrousers,,3,5,1,6
34412,midwesthousewife,,5,2,2,4
34413,stevarino,,31,29,34,63
34414,suader,,20,1,1,2
34415,pavee,,43,1,1,2
34416,jff,,20,1,1,2
34417,zzjodan,,13,1,1,2
34418,jamesmoroni,,16,5,2,7
34419,dickroll,,22,1,1,2
34420,infotekt,,42,1,2,3
34421,PenguinClover,,8,1,2,3
34422,gini_,,31,15,12,27
34423,Soviet_America,,29,2,3,5
34424,readit08,,21,248,24,272
34425,cesef,,13,2,1,3
34426,sydlab99,,20,5,2,7
34427,alk509,,32,89,49,138
34428,tehdiplomat,,12,35,57,92
34429,chaptanon,,20,2,3,5
34430,tearsofmysoul99,,33,2,2,4
34431,Wiry,,0,3,8,11
34432,rockinrollin,,43,2,1,3
34433,starcow,,22,40,63,103
34434,xrousti,,4,4,1,5
34435,mhrogers,,0,11,11,22
34436,Khimiara,,43,187,325,512
34437,reckoner15,,18,60,104,164
34438,foibly,,4,81,103,184
34439,brokenearth02,,31,471,841,1312
34440,skyimp,,1,1,11,12
34441,aberen,,18,41,78,119
34442,ldskye,,22,1,2,3
34443,temporaryaccount1,,1,3,5,8
34444,viama,,5,1,1,2
34445,blackwhitegrey,,6,97,172,269
34446,here1am,,43,1,3,4
34447,kashiwagi,,34,8,14,22
34448,Tychee,,5,7,1,8
34449,vmarker,,18,4,2,6
34450,bigsammer,,6,2,3,5
34451,capuchin,,13,2,2,4
34452,Lacuna,,13,8,17,25
34453,khromium,,19,2,2,4
34454,bloggirl13,,22,11,2,13
34455,sovator,,18,48,53,101
34456,Zal91,,12,18,18,36
34457,spliffy,,43,222,384,606
34458,Alex3917,,8,135,72,207
34459,blah999,,20,5,6,11
34460,belair,,19,189,45,234
34461,snackmaster99,,18,1,4,5
34462,zmobie,,22,4,5,9
34463,Anti-Dentite,,31,36,54,90
34464,xtianpretard,,5,1,2,3
34465,dre1983,,12,1,1,2
34466,Kimmiko,,18,1,2,3
34467,friddysan,,31,2,1,3
34468,nicnic3,,31,4,5,9
34469,Hagai,,43,20,27,47
34470,forgenboards,,1,1,1,2
34471,ldamerow,,20,1,3,4
34472,sim99,,43,9,12,21
34473,Taerk,,6,1,3,4
34474,raymond8,,5,3,5,8
34475,CainerWolf,,13,1,2,3
34476,onebit,,39,368,573,941
34477,yupko,,43,66,162,228
34478,leocha,,5,1,2,3
34479,theinevitable,,31,1,4,5
34480,meammouse,,43,4,7,11
34481,joshualander,,19,3,4,7
34482,taumeson,,13,10,6,16
34483,the_crooked_toe,,21,4,3,7
34484,mfuria,,13,1,1,2
34485,davepp,,30,15,26,41
34486,beegee73,,13,8,1,9
34487,mwmani,,32,3,14,17
34488,AdmiralBumblebee,,32,76,94,170
34489,sxreader,,20,7,4,11
34490,NetPhantom,,19,71,56,127
34491,avac,,19,11,6,17
34492,Ateoto,,23,31,49,80
34493,LordZodd,,19,147,110,257
34494,xochi99,,18,11,18,29
34495,the_sheeple,,19,6,7,13
34496,p0stal,,42,1,1,2
34497,crazyirish,,20,4,2,6
34498,DarkHelmet,,42,12,8,20
34499,Sneezer,,18,9,12,21
34500,Syriako,,31,15,20,35
34501,nmaunder,,13,43,16,59
34502,antiproton,,32,138,148,286
34503,jayzer,,42,7,12,19
34504,mattclark_1,,20,8,10,18
34505,dmy999,,20,5,5,10
34506,barryqu,,18,1,2,3
34507,SmirkingJerk,,22,2,2,4
34508,wdpp8ntba11er,,32,5,4,9
34509,Yoprig,,22,44,72,116
34510,ladyreporter,,34,1,2,3
34511,bonescotch,,0,1,1,2
34512,kwatz,,19,3,3,6
34513,RossPerot,,19,1,2,3
34514,e5india,,6,5,10,15
34515,PGRfilms,,19,123,29,152
34516,dw0rm,,20,5,1,6
34517,TheSpore,,6,29,21,50
34518,springboks,,18,8,12,20
34519,MadAce,,19,95,174,269
34520,neonic,,0,437,695,1132
34521,wintremute,,32,264,504,768
34522,lvl10troll,,13,2,2,4
34523,SianTam,,22,173,326,499
34524,amdar_reddit,,43,6,12,18
34525,imalloutoflove,,13,1,3,4
34526,davidw,,19,417,317,734
34527,boo66,,32,36,80,116
34528,fearofcorners,,22,22,18,40
34529,dismember,,18,146,133,279
34530,andyzoob,,18,19,23,42
34531,Kicking-Fire,,13,8,9,17
34532,d0gmat1c,,2,123,152,275
34533,Fishsticks,,19,33,68,101
34534,exhuma,,20,1,1,2
34535,mrjules44,,5,2,1,3
34536,nuknukjuk,,18,60,248,308
34537,grabmyblog33,,3,2,1,3
34538,n2dasun,,19,9,11,20
34539,joshddy,,4,2,3,5
34540,xiuz,,20,2,1,3
34541,theray78,,19,54,37,91
34542,eastcoast1978,,6,1,2,3
34543,erikpdx,,22,1,2,3
34544,kingfishr,,20,6,9,15
34545,rayed,,13,6,7,13
34546,larryo,,19,5,6,11
34547,Lapp,,18,2,1,3
34548,enaged,,0,1,1,2
34549,helring,,19,16,19,35
34550,thareus,,22,15,10,25
34551,twingecko56,,32,2,1,3
34552,powerfox,,29,3,1,4
34553,zeitgeiber,,18,11,1,12
34554,Malcorin,,18,19,33,52
34555,slurppypurr,,19,6,4,10
34556,sub_o,,18,9,10,19
34557,PeterMaclellan,,1,1,1,2
34558,dbaderf,,19,41,9,50
34559,negative_cool,,23,1,1,2
34560,dreamersblues,,31,47,5,52
34561,Ono-Sendai,,20,70,65,135
34562,femix,,18,3,11,14
34563,mathieugothax2,,5,3,4,7
34564,jeffxl,,1,3,8,11
34565,flipgimble,,13,42,17,59
34566,XxDeathxxStarxX,,20,1,1,2
34567,EyeInThePyramid,,19,82,56,138
34568,intelligen,,18,3,3,6
34569,sixtytwo,,1,1,1,2
34570,cigerect,,18,52,64,116
34571,caboteria,,16,3,5,8
34572,Nougat,,32,1145,1198,2343
34573,IronDonut,,13,8,2,10
34574,poopenschaft,,32,2,1,3
34575,fopkins,,15,178,97,275
34576,GoingApeSpit,,13,76,25,101
34577,billybennett,,18,7,11,18
34578,hadronzoo,,13,8,1,9
34579,Thezealot,,22,2,5,7
34580,jsolson,,20,157,277,434
34581,madchicken,,18,2,14,16
34582,pltnz64,,19,24,25,49
34583,quadtodfodder,,32,172,244,416
34584,fellowmellow,,31,133,157,290
34585,dazfromtheshell,,4,1,1,2
34586,not_me,,32,4,3,7
34587,schwah,,32,1,1,2
34588,Ezaroth,,19,1,1,2
34589,dabears1020,,19,657,199,856
34590,dutch,,43,95,9,104
34591,YoMama,,20,5,14,19
34592,roary,,29,1,2,3
34593,bayvet,,13,9,8,17
34594,xenox,,19,32,56,88
34595,EvilSporkMan,,20,127,177,304
34596,kin-d,,19,1,10,11
34597,styroteqe,,20,2,2,4
34598,Quarter-,,1,12,19,31
34599,Tsen,,19,99,155,254
34600,potsd4rn,,20,1,2,3
34601,DrBettyMartini,,20,1,1,2
34602,roblie,,15,1,2,3
34603,ratboythis,,19,1,1,2
34604,anechoic,,29,58,126,184
34605,OllyOllyO,,13,77,16,93
34606,forward,,34,1,3,4
34607,usercc,,19,3,5,8
34608,WuhDeyFuh,,6,4,10,14
34609,codese38,,20,36,21,57
34610,britus,,6,8,9,17
34611,takeda64,,20,350,618,968
34612,zite,,0,5,7,12
34613,monroetransfer,,29,6,15,21
34614,lukewarm,,20,10,5,15
34615,PSUstoekl,,43,1,1,2
34616,IamBriggs,,18,2,1,3
34617,bducanh,,1,2,2,4
34618,Axilla4,,18,29,17,46
34619,grakker,,6,10,14,24
34620,MrPhil,,35,3,3,6
34621,userspacename,,1,2,2,4
34622,babyshake,,20,2,1,3
34623,pthorton,,32,8,14,22
34624,bertrancito,,12,1,1,2
34625,The17,,18,7,8,15
34626,stp2007,,32,84,172,256
34627,vellaem,,16,8,18,26
34628,awol21,,10,6,5,11
34629,_jameshales,,20,33,60,93
34630,neonstereo,,5,134,82,216
34631,notentirely,,22,96,3,99
34632,takeaki,,32,26,26,52
34633,DiskoVilante,,43,373,94,467
34634,lipar,,3,1,1,2
34635,arribous,,35,9,14,23
34636,fromedome,,13,82,3,85
34637,spdygnlz,,20,1,2,3
34638,djcharlechaz,,43,9,8,17
34639,denimboy,,20,6,5,11
34640,cruise02,,20,149,179,328
34641,andrewkendall,,10,2,1,3
34642,buddyx,,18,76,2,78
34643,InRussetShadows,,19,23,27,50
34644,meriwether,,13,14,2,16
34645,notregistered,,20,9,10,19
34646,reddog_x2000,,0,5,2,7
34647,plainolme123,,18,37,7,44
34648,firdaus,,20,7,1,8
34649,TrisMcC,,13,3,2,5
34650,ToeCracker69,,5,279,87,366
34651,frothyfist,,18,6,8,14
34652,Stegg,,31,15,23,38
34653,discombobulator,,20,3,1,4
34654,tdrapeau,,43,1,1,2
34655,kelly2thec,,18,19,12,31
34656,MDKAOD,,18,94,104,198
34657,ndewitt,,0,1,1,2
34658,bogit,,19,1,1,2
34659,psommerfeld,,6,2,1,3
34660,Twenty-Grand,,13,4,1,5
34661,shqc,,12,2,1,3
34662,chefmac,,18,1,6,7
34663,flukk,,19,1,1,2
34664,Pandafox,,17,1,5,6
34665,rightwingnutjob,,32,66,65,131
34666,saurellia,,13,26,44,70
34667,ryan---,,13,6,2,8
34668,geosmack,,22,5,8,13
34669,CrunchyFrog,,4,17,13,30
34670,Seachicken,,18,13,25,38
34671,twanky,,31,9,1,10
34672,nikoliko66,,0,96,161,257
34673,tjstankus,,19,12,27,39
34674,abdelkrim,,6,1,2,3
34675,chubs512,,22,17,30,47
34676,rileyclinky,,13,4,1,5
34677,jcriddle4,,13,2,5,7
34678,gmz,,19,1,1,2
34679,randmcnally,,4,2,2,4
34680,salamandee,,15,2,1,3
34681,forevererratic,,29,51,55,106
34682,clconway,,1,1,1,2
34683,menno,,20,3,2,5
34684,popx,,20,1,1,2
34685,eyeswide,,5,18,18,36
34686,AModernMother,,31,7,1,8
34687,Catman_Doo,,6,7,6,13
34688,dnnk,,20,9,8,17
34689,ricer,,13,91,139,230
34690,thelightfixture,,10,1,1,2
34691,abattoir,,32,3,6,9
34692,gsmbk,,19,1,1,2
34693,diN0bot,,20,141,186,327
34694,Hopeformankind,,34,12,16,28
34695,azeem,,20,4,1,5
34696,decompyler,,22,10,30,40
34697,LuiseC,,18,16,10,26
34698,sciencebzzt,,18,7,1,8
34699,diversionmary,,22,133,238,371
34700,justsomeguyoverhere,,43,37,104,141
34701,pratn,,20,79,46,125
34702,kdamschen,,1,6,2,8
34703,Snullbug,,13,104,253,357
34704,victorria,,1,87,62,149
34705,suha,,34,1,1,2
34706,guitrhr0,,8,6,3,9
34707,Vequeth,,18,36,17,53
34708,karlrovesnosehair,,18,4,1,5
34709,fapman,,0,754,1510,2264
34710,phaaq,,4,2,1,3
34711,Cassio,,43,2,9,11
34712,sontek,,22,2,2,4
34713,danielcavanagh,,18,1,1,2
34714,MarkeD1,,32,1,2,3
34715,ArthurD,,13,1,5,6
34716,jamiew,,22,2,1,3
34717,cronus695,,19,61,60,121
34718,Taffaz,,0,1,1,2
34719,DigiSage,,18,5,3,8
34720,scholar33,,31,55,63,118
34721,schwarzedrache,,20,16,22,38
34722,DobleK86,,32,11,9,20
34723,frugnal,,31,5,7,12
34724,SyrioForel,,18,260,205,465
34725,d1ffEcult,,18,4,11,15
34726,yazzo,,22,32,50,82
34727,DJPho3nix,,16,13,25,38
34728,andon,,13,13,25,38
34729,maweaver,,20,24,42,66
34730,DimBimbleby,,13,11,1,12
34731,rufflesdance,,42,7,18,25
34732,ExxonMcCain,,13,85,63,148
34733,angelinblue942,,27,14,17,31
34734,sharons,,42,4,1,5
34735,the_rara_avis,,19,1,1,2
34736,revquill,,13,2,1,3
34737,okami,,19,9,3,12
34738,malfore,,42,7,6,13
34739,JamesBruni,,19,4,2,6
34740,Beanis,,20,2,2,4
34741,duquesne,,18,5,7,12
34742,mospat,,18,22,31,53
34743,Lyrad1000,,43,336,588,924
34744,karmapolice,,34,10,2,12
34745,wdgiles,,9,1,1,2
34746,stumbles047,,34,27,29,56
34747,andrewingram,,20,7,19,26
34748,g9yuayon,,20,31,10,41
34749,si1entdave,,20,4,6,10
34750,xyuvrot,,42,5,15,20
34751,sillywabbit,,32,11,30,41
34752,wahoorob,,19,252,475,727
34753,jeffotron,,13,12,12,24
34754,decepticrat,,5,10,12,22
34755,31337357,,42,41,88,129
34756,MrMike,,0,28,6,34
34757,Axman6,,20,5,6,11
34758,mrmojorisingi,,16,369,385,754
34759,substance_d,,0,8,6,14
34760,blean1,,31,9,16,25
34761,Halcyon07,,29,1,1,2
34762,RavenNights,,18,5,7,12
34763,Keith_Olbermann,,34,1,1,2
34764,jasonk1234,,18,15,4,19
34765,salmanstacksmoney,,42,2,2,4
34766,recursion27,,20,3,4,7
34767,kryptobs2000,,4,421,607,1028
34768,ICanHazMoo,,35,10,13,23
34769,relevant,,14,17,19,36
34770,ducksauce,,32,36,71,107
34771,AndrewJackson,,18,48,71,119
34772,kunjaan,,20,16,8,24
34773,paulterp,,13,6,5,11
34774,LonestarRanger,,32,21,14,35
34775,chicagodude,,0,12,10,22
34776,razzd,,9,1,1,2
34777,parrotguy63,,19,14,15,29
34778,isharq,,18,119,58,177
34779,reedy,,13,38,49,87
34780,flumphead,,31,61,115,176
34781,saijm,,20,1,4,5
34782,23444858,,20,88,126,214
34783,larfburger,,20,24,20,44
34784,moom,,4,445,372,817
34785,AnalogZero,,7,1,1,2
34786,AuhsojSivart,,42,88,134,222
34787,ZeroOne42,,39,4,2,6
34788,rhapsodyinpurple,,31,2,6,8
34789,eggoeater,,32,34,1,35
34790,endlessvoid94,,20,166,182,348
34791,finfo,,19,15,20,35
34792,warmpita,,42,105,199,304
34793,akumal,,12,79,109,188
34794,dugfresh,,13,105,32,137
34795,ungulate,,20,28,48,76
34796,plouj,,20,58,66,124
34797,pandasonic,,31,459,618,1077
34798,tail,,20,1,1,2
34799,snoosnoo,,13,188,9,197
34800,grotgrot,,31,16,15,31
34801,moomoocow,,26,4,4,8
34802,angryofficemanager,,19,4,10,14
34803,uhmlol,,29,1,2,3
34804,loganis,,42,45,111,156
34805,roserob,,5,2,2,4
34806,Word_of_the_Minute,,22,1,1,2
34807,iobuddha,,18,57,53,110
34808,chaircatmeow,,4,2,2,4
34809,SonD,,13,385,517,902
34810,hintze,,19,20,28,48
34811,HeyTruly,,32,1,1,2
34812,EddieP,,19,6,7,13
34813,k1lg0re,,1,30,53,83
34814,doyoulikeworms,,31,820,1274,2094
34815,BordrGuy108,,13,75,83,158
34816,stephhicks68,,5,5,10,15
34817,tommyhanks,,31,80,112,192
34818,Pilate,,13,113,223,336
34819,TonyBLiar,,18,799,216,1015
34820,PrsPirate,,18,43,61,104
34821,gignam,,22,85,116,201
34822,TommyFarmer,,22,5,2,7
34823,havk,,20,10,14,24
34824,MobiusCoffee,,31,3,3,6
34825,obama_is_god,,33,2,1,3
34826,cthulhudarren,,43,6,16,22
34827,norik,,20,1,1,2
34828,cj8585,,0,26,31,57
34829,ohbeone,,20,2,1,3
34830,ds022b,,5,1,2,3
34831,mexicatl,,8,35,38,73
34832,superjew,,13,1,1,2
34833,vintagecarole,,6,2,1,3
34834,cypherus,,1,38,52,90
34835,verbpreposition,,1,4,3,7
34836,skatetokil,,22,9,9,18
34837,wheresthebeef,,19,6,2,8
34838,evanscotb,,13,50,65,115
34839,notyavgkat,,0,88,5,93
34840,pib,,20,9,2,11
34841,markseger,,38,1,1,2
34842,JanaPinkster,,25,5,3,8
34843,mtndewqueen88,,31,62,36,98
34844,meatloafsurprise,,42,182,266,448
34845,Surye,,10,1,1,2
34846,ImperfectlyInformed,,13,26,20,46
34847,ddddddddddd,,18,43,3,46
34848,fox_man,,1,5,4,9
34849,binkomatic,,1,1,3,4
34850,MuletTheGreat,,42,16,29,45
34851,GalacticOverlord,,19,30,32,62
34852,bluetytanium,,18,1,1,2
34853,erykdb,,5,2,2,4
34854,SoyChemist,,29,31,10,41
34855,mambotomato,,0,1,1,2
34856,Palladian,,34,63,36,99
34857,MadroxKran,,34,46,88,134
34858,johnny_yuma,,13,5,2,7
34859,jonro,,12,1,3,4
34860,wizlevard,,22,49,60,109
34861,PrivateFreedom,,19,71,82,153
34862,mayapetties,,0,8,9,17
34863,slothman608,,14,2,3,5
34864,LieBot,,31,1,2,3
34865,summerchilde,,0,144,168,312
34866,tropicflite,,1,25,34,59
34867,volume4,,20,76,1,77
34868,ColinPowell,,13,1,1,2
34869,MrGravityPants,,19,8,5,13
34870,donmcc,,1,2,1,3
34871,tlog333,,10,1,1,2
34872,hunmik,,4,1,4,5
34873,Tallon5,,42,1,3,4
34874,hairyjerk,,1,2,4,6
34875,sillyputti,,41,21,19,40
34876,insaladwehavetomato,,19,2,3,5
34877,Sherrodzilla,,43,6,10,16
34878,r4a,,14,5,5,10
34879,FreddyDeus,,32,115,11,126
34880,HiggsBoson,,43,80,163,243
34881,jungoh,,1,6,9,15
34882,soooiiieee,,13,1,7,8
34883,ns2k2,,18,2,3,5
34884,kasperlapp,,22,9,11,20
34885,warriormare,,13,2,2,4
34886,GOD_IS_SELFLESS_LOVE,,32,20,7,27
34887,mrsugar,,13,16,27,43
34888,IAmInHateWithSatan,,13,6,5,11
34889,pengo,,20,6,13,19
34890,Christophe,,43,34,84,118
34891,old_gill,,22,229,226,455
34892,wsgeek,,5,1,1,2
34893,S_H_E_E_P_L_E,,19,44,63,107
34894,Ethanmike,,1,4,1,5
34895,igouy,,20,71,122,193
34896,ligyron,,18,4,3,7
34897,kopolee11,,19,84,103,187
34898,stevenconrad,,13,41,34,75
34899,Dunk010,,43,28,10,38
34900,tellner,,13,46,64,110
34901,hikaru87,,5,49,2,51
34902,subutai,,31,17,10,27
34903,gojasonw,,19,49,57,106
34904,amaxen,,39,7,8,15
34905,winson,,20,1,1,2
34906,dnissley,,31,6,12,18
34907,chime,,43,335,347,682
34908,bowzman_26,,6,1,1,2
34909,potent_potable,,4,3,2,5
34910,spicycode,,20,8,8,16
34911,amm,,20,6,3,9
34912,dulieu,,19,13,12,25
34913,qarp,,20,22,30,52
34914,bloosteak,,31,23,49,72
34915,eusephus,,0,172,314,486
34916,nonom,,34,6,4,10
34917,kilranian,,12,32,31,63
34918,Ukonu,,29,4,3,7
34919,bluedeviltide,,43,310,160,470
34920,CaptainConstitution,,13,35,44,79
34921,dave_colorado,,20,35,69,104
34922,Acidictadpole,,1,3,4,7
34923,yourdime,,14,1,1,2
34924,quickhorn,,19,94,110,204
34925,wtfkeyhole2pro,,22,6,6,12
34926,updog,,18,4,11,15
34927,5lashd07,,18,5,7,12
34928,rj3sp,,5,64,42,106
34929,sorbix,,9,209,189,398
34930,h0b0,,20,3,2,5
34931,thehypnotoad9,,31,1,1,2
34932,zouhair,,31,556,1150,1706
34933,ChicksNBabes,,18,59,47,106
34934,noelsusman,,42,197,231,428
34935,deminhead,,18,1,2,3
34936,alvisbrigis,,2,4,10,14
34937,kxar,,32,56,65,121
34938,curson,,1,138,142,280
34939,socketpuppet,,20,9,17,26
34940,ktgm,,13,37,13,50
34941,iggybdawg,,3,126,118,244
34942,acepiloto,,23,3,3,6
34943,sweetlou,,19,78,22,100
34944,Clent,,32,1,1,2
34945,chango,,6,53,23,76
34946,simrenk,,0,205,4,209
34947,nessi,,13,5,10,15
34948,ale402,,34,4,1,5
34949,meccanikal,,19,8,6,14
34950,scotchi,,20,2,1,3
34951,insin,,20,13,29,42
34952,happysinger,,22,667,818,1485
34953,sandharm,,13,1,1,2
34954,apropos_gc,,20,24,2,26
34955,brotherbeal,,20,2,3,5
34956,parallax7d,,42,299,520,819
34957,doctortofu,,32,10,9,19
34958,silence_hr,,31,445,743,1188
34959,dramatic,,20,1,1,2
34960,MankyTed,,15,13,13,26
34961,Aidenag,,5,7,1,8
34962,sixthgear,,20,4,2,6
34963,zoinks,,0,184,276,460
34964,megahurts,,43,1,1,2
34965,The_Borderpatrol,,13,19,6,25
34966,v8lifestyle,,35,3,3,6
34967,anaslex,,18,212,22,234
34968,phucked,,38,1,1,2
34969,whatsnew34,,14,3,1,4
34970,sextastic,,10,2,1,3
34971,tomeedee,,36,1,1,2
34972,UCaudio,,32,2,1,3
34973,monofonik,,19,10,20,30
34974,SkwatTheWorlD,,34,17,30,47
34975,sht,,20,10,18,28
34976,PlayatWork,,20,14,12,26
34977,Caldosa,,30,7,11,18
34978,now,,20,52,13,65
34979,sofreshandsoclean,,13,5,11,16
34980,drudgeman,,21,314,15,329
34981,giantjamsandwich,,20,17,1,18
34982,feelfree82,,31,2,2,4
34983,yangw,,34,47,73,120
34984,regasit,,1,2,1,3
34985,sabayon,,19,65,149,214
34986,chepprey,,20,5,2,7
34987,honeyfly,,43,11,2,13
34988,Mitijea,,1,62,102,164
34989,noneof,,19,2,4,6
34990,dostoevsky2007,,22,13,12,25
34991,oleg_k,,20,3,2,5
34992,system_monitor,,20,1,1,2
34993,kingoftitans,,14,3,2,5
34994,hb_alien,,31,137,301,438
34995,physics-package,,1,7,7,14
34996,lil_nohreaga,,15,5,3,8
34997,mepnosis,,15,105,99,204
34998,h2o2,,20,77,142,219
34999,Dark-Star,,9,688,1027,1715
35000,bipsbop,,20,100,123,223
35001,Envark,,6,250,416,666
35002,Tuviere,,20,5,7,12
35003,dasFisch,,36,4,6,10
35004,codefrog,,20,7,9,16
35005,kessel,,18,55,88,143
35006,iterator,,15,1,1,2
35007,NYCubsFan,,31,75,105,180
35008,Craptain,,20,8,4,12
35009,c04ddbk,,19,4,1,5
35010,luneunion,,5,2,1,3
35011,MountainViews,,32,1,1,2
35012,xkyjuanno,,42,2,2,4
35013,packetinspector,,32,11,12,23
35014,ianbishop,,20,14,12,26
35015,foepaws,,18,6,4,10
35016,flipflip55,,0,1125,2,1127
35017,PrinceVern,,29,1,2,3
35018,jgault,,16,5,4,9
35019,whoadave,,34,608,138,746
35020,gosko,,20,14,3,17
35021,fromagewiz,,19,192,258,450
35022,gmpalmer,,31,9,8,17
35023,Musfuut,,31,1,3,4
35024,Blackstaff,,18,72,172,244
35025,DOUCHEEPLE,,43,1,1,2
35026,machupichu,,18,47,102,149
35027,Llewdin,,18,51,85,136
35028,Hyperbio,,31,1,1,2
35029,hector031,,1,1,1,2
35030,Bedrovelsen,,31,361,388,749
35031,memekiller,,18,4,11,15
35032,kmonee,,0,11,3,14
35033,tringpad,,18,6,22,28
35034,xfrog,,43,22,21,43
35035,jonmac,,32,5,2,7
35036,heidavey,,32,333,106,439
35037,brwilliams,,18,36,40,76
35038,jaybamm,,18,36,54,90
35039,mtrump,,13,8,6,14
35040,Subjunctive_Police,,31,12,11,23
35041,savethebeast,,18,46,79,125
35042,samirshah,,34,12,28,40
35043,goodigg,,5,3,1,4
35044,aemon,,20,10,15,25
35045,prohm,,23,198,273,471
35046,afosterw,,31,11,11,22
35047,mystermarque,,18,131,2,133
35048,bimd,,6,1,1,2
35049,jmw,,18,54,13,67
35050,ky7le,,13,106,197,303
35051,brandar,,32,5,8,13
35052,LynMarcus,,0,1,3,4
35053,Lemmih,,13,1,7,8
35054,queshuns,,20,7,4,11
35055,10101010101010,,6,3,2,5
35056,Shelleen,,1,55,97,152
35057,mrgrackle,,31,122,151,273
35058,strig,,18,3,11,14
35059,paed,,14,25,17,42
35060,notsewkram,,18,3,2,5
35061,SVTBert,,34,5,9,14
35062,jacobmross,,18,6,13,19
35063,usamaizm,,13,5,5,10
35064,5430jx,,0,1,1,2
35065,admanb,,22,236,387,623
35066,Inherit,,22,6,3,9
35067,turtlestack,,0,146,125,271
35068,43P04T34,,31,1082,1602,2684
35069,kensav,,5,1,5,6
35070,andorphin,,32,1,4,5
35071,buckybadger,,13,81,97,178
35072,kftaylor,,13,7,1,8
35073,LukeAtThis,,33,1,1,2
35074,FLY180,,21,1,2,3
35075,stateful,,18,6,4,10
35076,slapsack,,13,5,14,19
35077,alreadystanding,,13,58,38,96
35078,jpkeisala,,0,6,27,33
35079,Morlovitch,,19,4,4,8
35080,unitmike,,43,49,68,117
35081,Nightlight,,13,79,167,246
35082,mbauermeister,,29,3,1,4
35083,xauriel,,30,319,289,608
35084,turk440,,13,14,29,43
35085,amg,,20,12,16,28
35086,AfterShock,,26,2,12,14
35087,jquipp,,5,9,22,31
35088,redditorslashtexan,,39,1,1,2
35089,deserted,,1,16,24,40
35090,atlantis69,,15,5,5,10
35091,JollyRogerBass,,31,3,7,10
35092,mctdotname,,18,45,8,53
35093,DCintheUK,,5,29,14,43
35094,banzai26,,13,3,2,5
35095,Captain-Picard,,19,3,7,10
35096,Kitt84,,28,8,10,18
35097,khazeh,,31,398,570,968
35098,CommentKing,,13,4,6,10
35099,vraylle,,20,3,3,6
35100,kailashnadh,,18,31,65,96
35101,Haven,,1,983,905,1888
35102,grovulent,,19,117,78,195
35103,the-fritz,,20,126,122,248
35104,Agoniscool,,22,275,409,684
35105,dbcoder,,43,8,7,15
35106,joshgi,,30,64,136,200
35107,lightdrizzle,,20,5,2,7
35108,20man,,13,12,34,46
35109,qevlhma,,19,5,10,15
35110,lograh,,32,4,8,12
35111,3th0s,,19,11,33,44
35112,lopi777,,19,5,7,12
35113,Jalisciense,,18,86,117,203
35114,yuyuyuyu,,42,1,1,2
35115,bonniec,,13,1,1,2
35116,danielwarwick,,32,86,8,94
35117,Dasugo,,18,3,9,12
35118,Clinton2008,,39,5,2,7
35119,without_feathers,,19,4,7,11
35120,railrulez,,11,5,12,17
35121,xianny,,14,1,2,3
35122,scruzia,,20,2,4,6
35123,Sthughes1,,0,2,7,9
35124,mustafanap,,13,42,80,122
35125,mo-riah,,18,4,7,11
35126,moehamid69,,30,74,122,196
35127,pedanticist,,18,308,453,761
35128,DrewInBalto,,1,30,37,67
35129,kleeka,,29,5,10,15
35130,reddof,,22,19,41,60
35131,aleahey,,13,7,2,9
35132,ad00d,,32,118,26,144
35133,Straight_Man,,18,15,2,17
35134,Charleym,,13,80,54,134
35135,indifference_engine,,20,71,58,129
35136,caffeinebump,,0,1,1,2
35137,Tantalina,,18,60,3,63
35138,The_Engineer,,13,105,188,293
35139,anothermanoutoftime,,1,51,127,178
35140,radicalheadphone,,1,10,4,14
35141,davidboyd,,5,2,4,6
35142,bgrundman,,42,37,5,42
35143,baysbenj,,1,1,1,2
35144,greenvortex,,13,89,108,197
35145,jballreno,,6,1,1,2
35146,themusicgod1,,30,340,506,846
35147,jules_siegel,,13,41,10,51
35148,isere,,18,4,5,9
35149,moonnigger,,17,1,2,3
35150,Psythik,,18,6,7,13
35151,mastema,,2,1,2,3
35152,alheim,,18,2,2,4
35153,Finardi,,18,2,1,3
35154,asol,,27,1,2,3
35155,sonQUAALUDE,,18,131,264,395
35156,jiggawoot,,0,7,8,15
35157,SwitchBlade430,,42,7,2,9
35158,mgmcmahon,,19,3,2,5
35159,drosdin,,11,58,106,164
35160,BibleNut,,30,3,1,4
35161,mistythescientist,,34,12,9,21
35162,bobcoyote,,27,3,4,7
35163,thamer,,43,78,23,101
35164,gocsick,,1,1,3,4
35165,KennyDeJonnef,,1,32,59,91
35166,idyll,,19,17,3,20
35167,HazKaz,,18,47,17,64
35168,Nshorn,,18,7,8,15
35169,diaf,,10,126,183,309
35170,moyix,,20,9,20,29
35171,miconrender,,19,35,56,91
35172,dkmj17,,13,114,99,213
35173,EmoryM,,0,1,1,2
35174,funnelweb,,31,10,9,19
35175,SqueaksBCOD,,31,29,23,52
35176,kindadumb,,18,4,1,5
35177,DavidM01,,19,55,92,147
35178,BuffaloBuffalo,,20,5,7,12
35179,SemiNormal,,13,4,15,19
35180,nathanielj,,18,604,65,669
35181,gotoday,,20,1,1,2
35182,T-Lily,,41,5,1,6
35183,Loozmotion,,0,206,346,552
35184,lispninja,,19,70,4,74
35185,eximil,,34,2,1,3
35186,trogdor33,,13,166,236,402
35187,top_pops,,20,2,2,4
35188,sreljic,,34,8,5,13
35189,specialkake,,13,15,53,68
35190,nitetrip,,18,11,11,22
35191,birdseye,,13,363,13,376
35192,Melf26,,8,2,3,5
35193,k0mplex,,19,280,51,331
35194,Vibik,,18,45,1,46
35195,CalvinLawson,,32,15,24,39
35196,freakazoid412,,9,6,13,19
35197,randomanonymity,,29,29,58,87
35198,Remingtony,,18,47,2,49
35199,fatty37us,,19,1,1,2
35200,vanyalir,,1,11,5,16
35201,Paranoir,,18,2,4,6
35202,Goose45,,13,123,143,266
35203,jolef,,1,2,1,3
35204,DanMulvey,,1,11,14,25
35205,mrdzuibaisafucknut,,20,2,2,4
35206,jlam,,22,8,6,14
35207,Neeeeeeewop,,19,6,3,9
35208,updater,,7,1,1,2
35209,scycon,,1,13,24,37
35210,chwilliam,,18,7,13,20
35211,christopher100s,,9,36,50,86
35212,rubberyduckie,,12,2,7,9
35213,pbzp,,43,36,46,82
35214,TheThoughtPolice,,22,1,1,2
35215,redditis4leftwingers,,13,1,1,2
35216,scarecrow1,,18,82,135,217
35217,DiamondAge,,18,4,10,14
35218,kinguy,,20,11,2,13
35219,PABeachBum,,5,237,223,460
35220,thermite451,,42,7,14,21
35221,Altoid_Addict,,22,161,215,376
35222,McCain2008volunteer,,43,1,2,3
35223,antifolkhero,,23,1105,1286,2391
35224,ardent11,,15,1,1,2
35225,pix0r1,,20,1,1,2
35226,Earthday_Jim,,19,8,6,14
35227,mebrahim,,20,68,131,199
35228,flmax,,19,1,1,2
35229,pbgswd,,0,20,60,80
35230,rstaehli,,13,1,1,2
35231,hedbngr,,13,3,3,6
35232,erikengbrecht,,30,2,3,5
35233,Redeker,,1,352,62,414
35234,deux11,,17,3,1,4
35235,IRS,,5,1,1,2
35236,simondo,,0,9,9,18
35237,alphacoder,,13,20,5,25
35238,lunohuj,,5,1,1,2
35239,311wasapunkskaband,,19,37,14,51
35240,batttygirl,,1,1,1,2
35241,kaelstrom,,5,2,3,5
35242,ibsulon,,32,232,340,572
35243,gowoodard,,20,1,1,2
35244,avatar4d,,32,2,1,3
35245,greed,,16,3,3,6
35246,JDuke,,19,9,6,15
35247,rustyspy,,31,5,1,6
35248,gitgat,,34,4,11,15
35249,Facehammer,,32,67,151,218
35250,cts,,18,2,2,4
35251,migraine516,,13,38,74,112
35252,tboy321025,,19,113,22,135
35253,antipoet,,18,3,8,11
35254,fdw201,,18,37,2,39
35255,CommanderXenu,,0,6,2,8
35256,marklarg,,31,1,1,2
35257,avinashv,,20,21,16,37
35258,muchmoregooder,,18,6,7,13
35259,starwhal,,22,8,5,13
35260,tehoreoz,,14,2,2,4
35261,ajaxpath,,20,1,1,2
35262,loudthing,,18,12,7,19
35263,tomgillette83,,43,1,1,2
35264,48VDC,,1,9,10,19
35265,tsaylor,,19,23,25,48
35266,drewmanskitto,,14,1,1,2
35267,xzzap,,7,3,5,8
35268,krisdafish,,1,22,8,30
35269,SBStijn,,27,4,5,9
35270,nzfrio,,20,25,54,79
35271,vshioshvili,,31,263,208,471
35272,msiley,,13,15,21,36
35273,vickromanji,,31,2,12,14
35274,Saylar,,0,338,82,420
35275,slaphappyhubris,,3,5,10,15
35276,alevel27mage,,41,30,40,70
35277,j4g3r,,31,3,1,4
35278,Azhain,,29,1,1,2
35279,xabbott,,18,12,2,14
35280,GoFlight,,30,134,177,311
35281,sir5yko,,14,5,6,11
35282,stusmith,,20,13,1,14
35283,zenhabits,,1,15,2,17
35284,drgabriel,,18,5,22,27
35285,mattboston,,22,1,2,3
35286,cheetahtech,,20,31,5,36
35287,devguy,,20,11,1,12
35288,mikeypow,,31,1,1,2
35289,robbiest,,32,11,3,14
35290,thintalle,,42,9,19,28
35291,flatfoil,,32,23,31,54
35292,Z00lander,,13,16,2,18
35293,SteamPunkIsDead,,34,1,1,2
35294,christopherr,,36,15,20,35
35295,spudlyo,,20,37,72,109
35296,Marci_Milfs,,4,4,5,9
35297,TrinityDejavu,,18,17,29,46
35298,rpi22,,19,430,11,441
35299,SearchEngines,,30,51,1,52
35300,mwilson,,20,3,12,15
35301,cookfamily,,19,1,2,3
35302,joaquin,,43,146,56,202
35303,filox,,20,41,35,76
35304,scarferjoe,,32,20,33,53
35305,micha2305,,15,4,5,9
35306,noneofya,,42,7,13,20
35307,sightimestwo,,43,1,2,3
35308,bRYE04,,31,3,1,4
35309,bgolbaba,,22,44,36,80
35310,erpava,,43,14,38,52
35311,ERhyne,,18,13,3,16
35312,dumpc0r3,,22,48,2,50
35313,voidoid,,5,73,65,138
35314,scstraus,,42,262,550,812
35315,spilliton,,18,7,10,17
35316,devonrtfp,,31,1,1,2
35317,tigerthink,,1,610,925,1535
35318,igbert,,27,2,2,4
35319,shotintoeternity,,1,31,10,41
35320,babbass,,9,13,8,21
35321,Xtal,,6,633,674,1307
35322,SargentMajorBlatant,,22,2,3,5
35323,ebenonce,,0,2,1,3
35324,Boulderado,,43,11,56,67
35325,gemadouble,,1,42,61,103
35326,glitterotic,,32,1,3,4
35327,Barbilik1,,0,327,22,349
35328,amstrdamordeath,,19,1652,2418,4070
35329,bryndsi,,38,3,1,4
35330,cosmina123,,5,60,4,64
35331,countingspoons,,32,234,189,423
35332,brqqme,,32,14,13,27
35333,chebuctonian,,20,15,13,28
35334,philoneous,,13,43,63,106
35335,demosthenes1,,20,102,78,180
35336,papercup,,18,60,71,131
35337,howars,,20,153,12,165
35338,klik,,22,31,46,77
35339,patch5,,32,2,3,5
35340,tringtring,,19,16,23,39
35341,davenaff,,30,3,1,4
35342,Mrchocoborider,,18,103,170,273
35343,azdavy,,18,41,121,162
35344,corporaterebel,,34,79,111,190
35345,youfuckingmoron,,5,7,3,10
35346,lovehate,,19,22,48,70
35347,miloshh,,20,24,35,59
35348,scurge,,19,19,6,25
35349,padrephobos,,18,7,10,17
35350,bostux,,11,8,1,9
35351,reesespcs,,13,66,2,68
35352,Pazuzu,,8,1,3,4
35353,DiscusRapidus,,19,6,1,7
35354,testpattern,,42,6,12,18
35355,shivermetimberslads,,19,410,17,427
35356,samgts25,,20,4,7,11
35357,bolapara,,6,3,2,5
35358,Andross01,,31,26,24,50
35359,heartsjava,,19,89,183,272
35360,uhnope,,20,4,2,6
35361,discoloda,,20,3,12,15
35362,geckgeck,,18,1,5,6
35363,MinkyLeRue,,29,2,1,3
35364,GrammyM,,13,1,10,11
35365,yoasif,,8,55,66,121
35366,StringyLow,,13,390,1043,1433
35367,sdufh9,,32,1,1,2
35368,crazytiredguy,,0,127,135,262
35369,Jaymie13,,18,1,3,4
35370,wannahack,,20,3,2,5
35371,epik,,42,156,227,383
35372,hackinthebochs,,13,12,15,27
35373,kieranmullen,,18,44,85,129
35374,laflair13,,19,8,1,9
35375,yokohunter,,1,1,3,4
35376,sinn0304,,13,13,20,33
35377,john_nyc,,18,599,79,678
35378,ignorantsheep,,18,6,12,18
35379,scott,,18,269,382,651
35380,wingedsubmariner,,32,5,2,7
35381,Zespris,,32,37,3,40
35382,joefaz,,1,7,1,8
35383,doublejay999,,17,5,13,18
35384,plasticsoap,,0,6,7,13
35385,nonworse,,18,247,336,583
35386,diaboloney,,13,23,1,24
35387,English_Chef,,36,82,108,190
35388,wardy666,,18,7,10,17
35389,bobsimpson41,,34,1,3,4
35390,saksoz,,20,7,17,24
35391,dcronin90,,19,20,56,76
35392,yourdaftpunk,,20,2,3,5
35393,nyarlath0tep,,43,9,7,16
35394,pattihearst,,32,3,1,4
35395,bigprick,,18,50,72,122
35396,greebowarrior,,1,36,74,110
35397,twofifths,,13,3,5,8
35398,camonz,,20,6,24,30
35399,ComPanda,,27,1,2,3
35400,ILikeChickenILikeLiv,,13,2,3,5
35401,affan,,33,3,6,9
35402,GhostTramp,,13,2,2,4
35403,J-ohn,,42,115,161,276
35404,quimby08,,13,11,6,17
35405,marvinpandroid,,20,2,1,3
35406,Horward,,0,110,16,126
35407,sparsely,,32,17,34,51
35408,sfled,,43,3,2,5
35409,zhk,,43,2,4,6
35410,jjmarq,,1,1,2,3
35411,watershawl,,13,4,2,6
35412,Buckeye_Bill,,1,3,8,11
35413,captainarbitrage,,1,1,1,2
35414,jotunn,,3,3,1,4
35415,lstephen666,,20,8,5,13
35416,wilgamesh,,15,2,3,5
35417,G-M,,42,114,90,204
35418,syslog2000,,31,22,31,53
35419,delkarnu,,42,97,124,221
35420,frenetic,,20,81,2,83
35421,sweet_mackerel,,39,4,8,12
35422,magnacumlaudi,,13,2,1,3
35423,vince07,,6,4,7,11
35424,jton,,42,3,13,16
35425,suamain,,34,2,16,18
35426,trendmaker,,21,374,36,410
35427,say_no_to_rp,,34,3,3,6
35428,TheJBW,,18,3,1,4
35429,observer22,,13,8,20,28
35430,darkbarf,,43,12,25,37
35431,polonius,,1,8,8,16
35432,BartLA,,13,147,3,150
35433,MrMustard,,32,11,28,39
35434,aarthi1,,13,6,8,14
35435,kluenitou,,14,151,20,171
35436,Slinky31,,21,1,1,2
35437,razrx,,19,1,1,2
35438,justinkuto,,20,6,10,16
35439,wigglestick,,20,10,6,16
35440,tiglionabbit,,42,13,18,31
35441,Jonny0stars,,43,40,72,112
35442,duvergerslaw_nopaul,,13,1,1,2
35443,pute,,18,23,73,96
35444,Jeftrokat,,19,19,10,29
35445,bilange,,30,27,34,61
35446,RamdomString,,19,8,4,12
35447,ben_gslr,,22,13,26,39
35448,shahein,,4,11,7,18
35449,mingusrude,,43,36,35,71
35450,iaminhatewithjesus,,18,4,5,9
35451,mt_ski,,31,9,7,16
35452,raymendx,,18,1,3,4
35453,reyofish,,30,97,25,122
35454,salvadors,,20,98,9,107
35455,gomerfile,,0,68,3,71
35456,pyr3,,20,1,1,2
35457,techimi,,9,2,6,8
35458,casull,,32,5,6,11
35459,fuzz,,0,1,1,2
35460,Seanstex,,13,1,1,2
35461,ylph,,19,33,45,78
35462,andrew1184,,4,107,134,241
35463,sjsigler,,1,3,6,9
35464,gmfawcett,,20,50,76,126
35465,toeppen,,13,25,8,33
35466,archant,,32,34,60,94
35467,dunplease,,43,1,1,2
35468,s7aind,,18,38,34,72
35469,anton55,,5,3,1,4
35470,greenpix,,43,34,18,52
35471,gcanyon,,20,38,31,69
35472,dbrannan,,39,3,1,4
35473,incith,,18,16,50,66
35474,TreyBoudreau,,43,1,1,2
35475,Fristle,,0,50,75,125
35476,kyuz,,20,28,28,56
35477,oblivious_human,,13,532,823,1355
35478,LionofJudah,,43,3,6,9
35479,projecktzero,,20,25,54,79
35480,candyman682,,18,2,5,7
35481,jonasblue,,0,80,60,140
35482,CaptainEntropy,,14,1,2,3
35483,yortimer,,19,172,109,281
35484,d-_-b,,14,84,104,188
35485,dodgethegod,,18,2,3,5
35486,anasqtiesh,,31,27,35,62
35487,yukster,,1,37,19,56
35488,luchak,,17,9,4,13
35489,HFh,,19,203,236,439
35490,plasticbottle,,19,46,68,114
35491,mrdorian,,18,30,27,57
35492,azblaze,,1,2,4,6
35493,mishy_mo,,18,1,2,3
35494,gfixler,,1,612,920,1532
35495,dawhoo,,1,79,112,191
35496,yuk2k,,19,18,4,22
35497,GravityPhone,,31,22,31,53
35498,seths,,20,23,22,45
35499,benbot,,29,2,2,4
35500,Koreapsu,,18,20,10,30
35501,fooddit,,20,2,2,4
35502,OpenBSD_Developer,,32,4,12,16
35503,Zai_shanghai,,19,138,320,458
35504,heyt,,1,441,330,771
35505,rhabd0mancer,,19,103,147,250
35506,Nosredna,,20,2,3,5
35507,yjr2002,,5,5,5,10
35508,dentpuzz,,5,2,6,8
35509,32bites,,1,263,387,650
35510,cariann,,22,2,3,5
35511,hyperfat,,1,176,363,539
35512,JonAce,,22,359,311,670
35513,theinternets,,34,71,11,82
35514,lavanderson,,0,1,3,4
35515,cgoldberg,,20,37,12,49
35516,wongiseng,,18,27,31,58
35517,yoyodyne_propulsion,,34,90,135,225
35518,necrotic,,23,1,2,3
35519,mrkleen,,0,18,63,81
35520,ziegfried,,32,320,418,738
35521,starthorn,,20,7,7,14
35522,gadooble,,42,3,1,4
35523,Eskapismus,,5,12,18,30
35524,rob_brez,,13,36,80,116
35525,cowbellthunder,,32,61,86,147
35526,coreal07,,34,3,11,14
35527,andyandthetuna,,5,2,11,13
35528,mkv,,18,41,67,108
35529,purple_tooth,,1,26,14,40
35530,fresnik,,22,4,6,10
35531,ikean,,1,19,41,60
35532,jatanis,,1,4,2,6
35533,dca5612,,4,2,1,3
35534,Andria16,,43,6,18,24
35535,-K-,,18,5,3,8
35536,-J-,,40,432,730,1162
35537,AquaFox,,31,3,4,7
35538,sqweek,,20,3,4,7
35539,SparkleMotion,,5,1,3,4
35540,plonkder,,20,1,1,2
35541,SouthboundPachyderm,,19,2,1,3
35542,yesiamanostrich,,1,88,119,207
35543,jesuswuzanalien,,18,150,129,279
35544,dario1977,,43,78,8,86
35545,laddy,,32,1,5,6
35546,Billy_O_Reilly,,13,8,4,12
35547,ericmoritz,,22,14,22,36
35548,DangerRodneyfield,,13,1,4,5
35549,hisoka,,1,3,4,7
35550,wanakawoman1,,21,1,4,5
35551,Captain-Calumny,,43,4,6,10
35552,mashiyach,,20,1,6,7
35553,abusrur,,18,1,1,2
35554,chadz,,20,193,256,449
35555,DaniBicknell,,19,8,15,23
35556,benfaist,,19,1,3,4
35557,m_van_houten,,43,8,18,26
35558,forgivenessforall,,42,1,1,2
35559,rsenic,,9,2,2,4
35560,killfoot,,0,1,2,3
35561,Astrosexy,,34,3,9,12
35562,jimmux,,18,296,351,647
35563,ChannelCat,,1,17,8,25
35564,Aadje,,42,66,2,68
35565,elev,,34,52,30,82
35566,freesecrets,,5,4,2,6
35567,aUTOMATICuPVOTES,,20,122,201,323
35568,nsfw_handle,,21,2,2,4
35569,JamesIry,,20,37,52,89
35570,bilabrin,,22,8,12,20
35571,thisisafakeaccount,,19,1,1,2
35572,definiteform,,19,17,34,51
35573,jan,,20,73,66,139
35574,jewbama,,43,3,3,6
35575,amalthea,,32,3,2,5
35576,nekt,,31,207,342,549
35577,danhawkeye,,0,101,134,235
35578,SofianJ,,16,4,7,11
35579,Midas7g,,20,3,4,7
35580,zemmekkis,,18,29,15,44
35581,knackers,,19,7,30,37
35582,NilesLesh,,13,4,3,7
35583,hatepirate,,18,37,34,71
35584,Falkvinge,,20,2,1,3
35585,jskaines,,18,1,1,2
35586,Duffer,,13,1,7,8
35587,iQwerty,,18,4,3,7
35588,moosey,,34,27,44,71
35589,TheAbsquatulater,,18,7,5,12
35590,RX9735,,12,91,149,240
35591,lphoenix,,18,2,6,8
35592,abezontar,,41,3,2,5
35593,sox406,,1,15,47,62
35594,TommyTheCorc,,22,2,2,4
35595,monkeypickle,,13,1,1,2
35596,PRgeek82,,18,1,3,4
35597,asaturn,,26,483,1009,1492
35598,slow_as_light,,32,725,128,853
35599,acefearless,,43,1,4,5
35600,kjartanelli,,0,219,142,361
35601,Earthrise,,18,118,136,254
35602,stephanieebarr,,18,4,8,12
35603,benybomi,,18,33,1,34
35604,freshpowpow,,29,3,2,5
35605,ephekt,,31,4,10,14
35606,treasonholdings,,8,1,1,2
35607,sthussey,,19,41,36,77
35608,harryc,,5,11,6,17
35609,Pro8678,,13,1,1,2
35610,jakobjs,,18,3,4,7
35611,darkender,,1,8,18,26
35612,inverse,,1,47,61,108
35613,safety_party,,18,1,2,3
35614,YellowBrickAvenue,,18,58,13,71
35615,chaitan,,43,16,22,38
35616,mostsleek,,0,30,4,34
35617,antich,,18,1,1,2
35618,fartron,,19,239,176,415
35619,weaselmaster,,43,41,33,74
35620,7wheels,,20,22,1,23
35621,marjorie_L,,43,109,38,147
35622,The5thamigo,,19,2,2,4
35623,jhonyorah,,4,4,1,5
35624,lensless,,18,1,7,8
35625,shlomif,,20,4,1,5
35626,convictboy,,15,30,15,45
35627,JesusWasMetro,,39,27,23,50
35628,neeeeeep,,20,5,1,6
35629,creaothceann,,20,370,717,1087
35630,hotrod31337,,1,13,20,33
35631,cajolingwilhelm,,34,434,592,1026
35632,originalucifer,,13,35,33,68
35633,Remover,,20,15,30,45
35634,paulgb,,1,34,61,95
35635,whacknrd,,18,43,7,50
35636,ravidgemole,,20,15,9,24
35637,NtroP,,19,16,20,36
35638,stutheidiot,,22,67,65,132
35639,phlipski,,19,120,107,227
35640,scraun,,32,1,1,2
35641,chronichyjinx,,18,9,18,27
35642,nyinjewn,,13,18,2,20
35643,budoudoh,,31,2,2,4
35644,juventus1,,19,32,95,127
35645,pyejamma,,39,1,4,5
35646,jonathansaurus,,8,16,9,25
35647,krustykrab,,13,5,5,10
35648,lungfish59,,13,28,45,73
35649,rgladstein,,19,636,887,1523
35650,nuevo,,19,2,4,6
35651,Xavi-avi,,20,10,8,18
35652,subnet_rx,,10,32,29,61
35653,urfunylookin,,1,5,2,7
35654,Creator_1,,18,17,1,18
35655,DD32,,1,6,7,13
35656,wespog,,30,7,13,20
35657,ntchn,,18,9,1,10
35658,wackygonzo,,5,2,1,3
35659,citizenterminal,,20,7,5,12
35660,MNMark,,18,4,2,6
35661,schulte4e,,20,46,1,47
35662,ilistenisee08,,5,55,134,189
35663,unsung23,,13,20,12,32
35664,LiGht_UrpLe,,30,1,4,5
35665,morshehir,,5,1,1,2
35666,iKonoKlast,,1,123,45,168
35667,Cuchullain,,31,8,8,16
35668,jamesb43,,22,3,2,5
35669,almeisam,,32,1,6,7
35670,alv,,20,18,4,22
35671,spacemanotis,,1,2,6,8
35672,Swimfroggy,,31,1,1,2
35673,kgrashad,,1,7,4,11
35674,macfanboi,,13,86,137,223
35675,Lewsut,,18,10,21,31
35676,rhesuschrist,,43,3,2,5
35677,awesomeusername,,22,10,16,26
35678,elcrazon,,20,3,6,9
35679,MamaPalin,,18,5,3,8
35680,arnie_apesacrappin,,43,30,18,48
35681,leadingtone,,18,12,11,23
35682,shoyu,,8,4,8,12
35683,portablestaplefrog,,18,15,25,40
35684,EggRoll,,19,6,6,12
35685,Zungaar,,14,1,1,2
35686,Anthropoid1,,31,5,16,21
35687,Yossarian42,,13,88,87,175
35688,pfi,,20,8,7,15
35689,PyroLanfyre,,34,1,1,2
35690,Lave,,8,105,55,160
35691,bgieseler,,13,3,4,7
35692,andyc,,20,26,35,61
35693,joemc91,,0,1,1,2
35694,fakeslimshady,,5,10,13,23
35695,critdragon,,43,1,1,2
35696,mingthepanda,,19,24,39,63
35697,gillesthegreat,,13,5,1,6
35698,iBalls,,13,166,293,459
35699,wk2x,,20,11,19,30
35700,DigSomeMore,,5,23,17,40
35701,blaimjos,,29,2,3,5
35702,pbiggar,,20,12,12,24
35703,Guoguodi,,42,111,13,124
35704,jdougie,,31,4,2,6
35705,nobody7,,19,28,53,81
35706,mcfarrow,,18,37,46,83
35707,AllZoo,,13,68,48,116
35708,ralexander,,13,9,7,16
35709,CB201,,31,24,27,51
35710,dschaefer,,43,34,8,42
35711,misanthropegirl,,5,14,11,25
35712,wirbolwabol,,13,43,138,181
35713,jim_scott,,18,13,5,18
35714,rscynn,,1,1,1,2
35715,bephillips,,1,3,7,10
35716,jgator85,,2,1,1,2
35717,God__,,10,1,1,2
35718,isseki,,20,244,545,789
35719,eldermatic,,1,11,18,29
35720,LocoYoko,,5,1,1,2
35721,xaraya,,13,7,1,8
35722,unknown,,19,144,29,173
35723,magic_man8,,0,1,1,2
35724,Kestral,,30,213,279,492
35725,avar,,29,28,29,57
35726,FleeFlee,,34,1,1,2
35727,wookiemonster,,18,4,1,5
35728,BillDunlap,,13,1,1,2
35729,iliketoreadnews,,18,2,2,4
35730,ishmandoo,,18,10,1,11
35731,lainiep93,,34,1,1,2
35732,purrp,,42,106,92,198
35733,enolan,,20,34,20,54
35734,breakz,,22,1,2,3
35735,lordbrass,,43,46,59,105
35736,T8rfudgees,,32,1,2,3
35737,dainwaris,,13,97,114,211
35738,alqbeck,,14,1,3,4
35739,goodhairs,,1,1,1,2
35740,anirbas,,20,3,10,13
35741,MaximumCarter,,18,10,12,22
35742,boomgoesthedynamite,,4,14,14,28
35743,imabitlost,,22,2,3,5
35744,barryicide,,6,675,669,1344
35745,elduke187,,10,202,164,366
35746,patriot_act,,34,1,1,2
35747,ravijp,,15,2,1,3
35748,ecm27,,1,1,1,2
35749,AeroLeviathan,,20,7,8,15
35750,tibber,,30,8,5,13
35751,greenfrog,,19,360,415,775
35752,hfaber,,20,31,21,52
35753,njdfan1241,,34,134,93,227
35754,shamam,,1,31,32,63
35755,raindog,,18,3,8,11
35756,dumbledoreisgay,,29,4,1,5
35757,mnic001,,18,181,178,359
35758,pyramis,,13,20,3,23
35759,yury,,20,2,4,6
35760,ironmanxl1,,26,5,2,7
35761,Shuck,,13,74,31,105
35762,jswan,,43,4,11,15
35763,SuperConfused,,13,10,9,19
35764,benji,,20,2,6,8
35765,tek1024,,43,7,21,28
35766,dman928,,19,67,119,186
35767,eurobeing,,19,95,117,212
35768,rpfinn22,,1,41,19,60
35769,typical_reddit_user,,19,15,18,33
35770,nerdmanpap,,18,129,267,396
35771,spez,,20,644,245,889
35772,mispeled,,19,12,22,34
35773,ux500,,29,22,16,38
35774,asfsaersd,,20,1,2,3
35775,intresting,,18,5,8,13
35776,dsri,,20,4,3,7
35777,Anunnakki,,43,6,7,13
35778,maltokyo,,18,2,1,3
35779,Anon1299,,1,1,1,2
35780,Cheeeef,,32,6,2,8
35781,WednesdayLaw,,5,16,35,51
35782,kellyandbryan,,29,2,2,4
35783,BigPhun,,19,8,11,19
35784,jgfoto,,0,32,48,80
35785,zardoz73,,18,34,110,144
35786,julienbh,,18,8,11,19
35787,bcw19,,19,10,10,20
35788,texastornado,,28,1,1,2
35789,Danegerous,,31,15,13,28
35790,tsfn46290,,19,88,60,148
35791,hillbilly1980,,3,1,1,2
35792,taekwonjer,,13,8,1,9
35793,yajusdono,,22,1,2,3
35794,longini21,,19,14,9,23
35795,arow6k,,43,16,2,18
35796,Godott,,13,3,4,7
35797,ChelseaBlacker,,32,5,3,8
35798,greggles,,14,1,2,3
35799,xphilter,,31,22,35,57
35800,VMX,,6,4,3,7
35801,badarabdad,,32,38,49,87
35802,eagreeyes,,13,27,18,45
35803,cobber2005,,29,1,2,3
35804,surly,,18,3,6,9
35805,furiousidiot,,32,14,25,39
35806,bjorfr,,18,59,105,164
35807,injoy,,1,37,36,73
35808,climbit,,20,4,3,7
35809,bzhu5,,32,4,1,5
35810,drabbit,,18,1,2,3
35811,redhotkurt,,1,173,182,355
35812,lobsters2,,18,10,16,26
35813,jef396,,0,1,5,6
35814,v2r1,,11,8,6,14
35815,Trey_Mendus,,0,5,10,15
35816,Mikola7,,20,3,5,8
35817,miquelon,,30,42,51,93
35818,FrozenThetan,,19,7,3,10
35819,cking777,,29,4,2,6
35820,yolesaber,,1,17,15,32
35821,jj12345,,18,22,36,58
35822,powertool,,20,2,8,10
35823,manghole,,41,1,1,2
35824,netcraft,,22,6,10,16
35825,ido,,20,203,261,464
35826,lawyervon,,19,9,10,19
35827,Elle_Dee,,43,201,1,202
35828,rfulks,,5,22,15,37
35829,pkd,,0,42,3,45
35830,Saktoth,,32,1,2,3
35831,lythey,,13,8,4,12
35832,buckrice,,19,1,2,3
35833,kypen,,1,10,9,19
35834,melikespi,,31,2,3,5
35835,WhoKilledTeddyBear,,13,1083,1347,2430
35836,emont88,,23,7,9,16
35837,AdamToyota,,20,4,2,6
35838,pawnsushi,,29,1,1,2
35839,leoc,,20,112,195,307
35840,athayil,,18,1,1,2
35841,escapist13,,34,6,10,16
35842,tigermac10,,43,1,6,7
35843,Fat_Lady,,43,2,4,6
35844,oohal,,20,1,1,2
35845,stoprock,,31,75,107,182
35846,pjfry,,1,40,45,85
35847,dadenman,,19,3,7,10
35848,spiffyP,,1,38,59,97
35849,ktm1,,31,40,51,91
35850,pensacola,,20,3,1,4
35851,effektz,,13,37,19,56
35852,reggplant,,34,16,26,42
35853,RedditRuinedMyLife,,18,10,13,23
35854,nordbert,,19,36,43,79
35855,spike00,,32,21,21,42
35856,mposha,,13,294,118,412
35857,Morieris,,12,18,34,52
35858,hoppasaurus,,18,58,54,112
35859,twitch18,,0,3,4,7
35860,holyzylo,,18,1,2,3
35861,captnkurt,,0,1,2,3
35862,bumbletowne,,18,83,117,200
35863,MOE37x3,,31,360,203,563
35864,seringen,,0,1,1,2
35865,davemail,,32,2,2,4
35866,kerchov,,20,36,73,109
35867,cdougmah2,,13,11,3,14
35868,guyvatican,,13,1,1,2
35869,ddxChrist,,32,60,81,141
35870,yoyoo,,18,41,1,42
35871,psed,,20,38,55,93
35872,adambrault,,43,1,1,2
35873,Ron_Paul_says,,19,6,13,19
35874,contact287,,0,43,3,46
35875,whiteysale,,18,3,2,5
35876,wensheng,,43,3,4,7
35877,lobstah4,,5,2,13,15
35878,tsswope,,18,30,29,59
35879,jplank1983,,20,207,10,217
35880,gothicsmurf,,30,64,45,109
35881,jc4p,,20,26,16,42
35882,jarilindroos,,3,7,1,8
35883,sci_king1,,13,1,3,4
35884,Morally_Inept,,0,102,142,244
35885,silvercide,,13,1,1,2
35886,slx,,19,75,115,190
35887,msloyko,,18,15,1,16
35888,alexcq,,13,15,3,18
35889,Knowltey,,18,12,38,50
35890,OliverM,,20,10,4,14
35891,hyankov,,18,3,2,5
35892,opentubes,,0,233,299,532
35893,jimmyjoe2008,,39,1,1,2
35894,god-zilla,,1,3,3,6
35895,ksemel,,18,7,8,15
35896,fnule,,12,63,118,181
35897,batmanbury,,42,4,9,13
35898,babysharkjesus,,36,1,2,3
35899,voteman,,18,1,1,2
35900,qarl,,29,162,218,380
35901,MemePolice,,43,5,10,15
35902,joquarky,,19,25,44,69
35903,yuethomas,,18,1,3,4
35904,roger_,,1,352,489,841
35905,thespins,,13,5,9,14
35906,anders113,,20,2,1,3
35907,wakethefukup,,13,43,47,90
35908,mrbucket777,,0,3,6,9
35909,Ryan739,,1,9,5,14
35910,Andreides,,17,1,1,2
35911,ZypherBL,,12,23,33,56
35912,mgurf1,,13,131,47,178
35913,true_american_patrio,,19,22,28,50
35914,terrywagar,,12,2,5,7
35915,berbercarpet,,13,1,1,2
35916,TheSlinky,,22,80,129,209
35917,bustweiser,,15,3,2,5
35918,pandres,,5,1,6,7
35919,target,,10,7,4,11
35920,lanimil3,,1,7,1,8
35921,lftl,,20,41,35,76
35922,712weasel,,18,21,10,31
35923,2275617,,13,3,15,18
35924,kjhatch,,40,4,8,12
35925,m2c,,1,12,19,31
35926,Mithoran,,19,12,18,30
35927,wolfsleepy,,18,133,192,325
35928,rdingwall,,20,21,2,23
35929,pierre_rdy4actn,,19,5,11,16
35930,rebel,,18,20,32,52
35931,jamesfrazer,,23,4,1,5
35932,Cancerkitty,,5,7,4,11
35933,danielcloutier,,18,371,74,445
35934,modestokun,,15,278,453,731
35935,jk7195,,13,12,17,29
35936,godfatha,,18,101,8,109
35937,NoMoreJesus,,11,1,1,2
35938,ifjake,,0,22,28,50
35939,obama4pres08,,33,9,4,13
35940,S_Palin,,22,1,1,2
35941,Mourningblade,,13,93,108,201
35942,WhamBamThanksHo,,13,4,2,6
35943,clarkeee,,1,1,1,2
35944,southpark,,34,1,1,2
35945,jdmesp,,19,4,12,16
35946,fakityfakefake123,,1,1,1,2
35947,rshawgo,,19,3,1,4
35948,spectreblofeld,,9,1,2,3
35949,owlmonkey,,8,1,1,2
35950,Guillermo_the_Good,,19,1,3,4
35951,styrofoam,,13,1,1,2
35952,flapan,,34,1,2,3
35953,LauriL,,9,88,3,91
35954,Cederosa,,20,3,3,6
35955,rektide,,20,66,142,208
35956,Kilogram,,17,2,2,4
35957,jhd,,20,3,4,7
35958,BudWhite,,0,1,1,2
35959,hsuresh,,1,2,7,9
35960,zctaylor,,34,61,70,131
35961,bacchas,,34,1,1,2
35962,alex83,,12,1,3,4
35963,thesolitaire,,13,7,9,16
35964,cabbit,,42,276,337,613
35965,setuid_w00t,,20,312,410,722
35966,ravend13,,19,69,106,175
35967,jjf,,31,6,7,13
35968,Rudy69,,18,33,5,38
35969,sdoafgu,,20,1,1,2
35970,rizzledizzle,,42,3,6,9
35971,canuckian,,35,3,3,6
35972,maka,,19,10,6,16
35973,tdehnel,,1,360,561,921
35974,sonofabush,,42,135,150,285
35975,m4re,,20,2,1,3
35976,Masterminded,,12,24,40,64
35977,alteclansing,,20,2,3,5
35978,Vestan_Pance,,42,9,21,30
35979,tsa_goon,,18,1,6,7
35980,Avenestra,,19,18,14,32
35981,el-bi-ranchero,,14,2,2,4
35982,blackpete,,18,11,15,26
35983,maxwellb,,20,12,24,36
35984,jaciilyn,,18,65,56,121
35985,kris1363,,18,7,1,8
35986,sammy1982,,31,25,19,44
35987,mikeonatrike,,19,4,4,8
35988,KantLockeMeIn,,6,256,371,627
35989,enmand,,20,9,11,20
35990,Anita8B3,,31,1,1,2
35991,danselic,,34,9,4,13
35992,CuriousMind,,8,2,2,4
35993,Hoodwink,,19,121,254,375
35994,ohlala,,15,6,2,8
35995,trainer_,,0,5,20,25
35996,Marutar,,18,19,17,36
35997,tupton,,32,2,4,6
35998,Cakexploder,,6,10,20,30
35999,Vv0rd,,13,28,70,98
36000,serth,,11,3,4,7
36001,vangelos2,,29,1,1,2
36002,noblemaster,,11,8,20,28
36003,mzcora,,19,4,12,16
36004,Akeshi,,20,21,32,53
36005,CockerhamExperiment,,18,5,8,13
36006,MadrasahOsamaObama,,19,74,90,164
36007,hellomynameis,,13,3,2,5
36008,sluggermoore,,32,4,1,5
36009,stinkychild,,12,3,2,5
36010,schwanksta,,22,1,2,3
36011,torttu,,20,1,1,2
36012,bgoodwyn,,20,2,3,5
36013,simulacra10,,13,4,5,9
36014,kr90df,,31,15,1,16
36015,shreknel,,20,2,1,3
36016,foxtwofoxtwo,,18,84,120,204
36017,scrag45,,32,101,126,227
36018,only1rob,,1,5,4,9
36019,Edward_Teach,,4,3,2,5
36020,andar,,10,1,3,4
36021,wushu18t,,1,170,170,340
36022,genericdave,,11,1,1,2
36023,nonsensicaliciousnes,,22,2,1,3
36024,piecewise,,19,41,40,81
36025,yadidamean,,18,2,2,4
36026,peacemaker,,3,1,1,2
36027,darkphan,,30,2,5,7
36028,ekks,,20,21,39,60
36029,fakebook,,12,12,19,31
36030,kmb1794,,8,1,3,4
36031,aisa,,19,3,6,9
36032,petitefleur,,1,10,9,19
36033,microsoftie,,20,2,7,9
36034,crux_,,20,101,144,245
36035,h1ro,,31,10,29,39
36036,caffeind,,3,1,2,3
36037,lockbock,,19,30,3,33
36038,Mattack04,,30,67,33,100
36039,plato1123,,18,44,70,114
36040,mariuz,,20,2,1,3
36041,MrPenn,,19,8,7,15
36042,rfcmofo,,20,13,14,27
36043,civildefense,,43,33,48,81
36044,illlookforit,,18,5,15,20
36045,teentweensblog,,0,75,2,77
36046,lucide,,19,10,24,34
36047,geezas,,19,1,6,7
36048,TyPower,,15,174,99,273
36049,magicRob,,18,6,12,18
36050,yeahbuddy,,14,1,2,3
36051,BobbyFischer,,19,2,2,4
36052,fapfapfap,,43,1,23,24
36053,Kratoz,,30,70,43,113
36054,frijoles,,31,4,3,7
36055,sirreginaldwindage,,18,13,19,32
36056,ish123,,13,50,7,57
36057,Adelaidey,,18,2,4,6
36058,mcwm,,4,2,13,15
36059,m0o,,12,106,101,207
36060,gypsytalk,,18,13,14,27
36061,saxmanb,,30,1,3,4
36062,theeeggman,,32,350,359,709
36063,beattie,,18,6,13,19
36064,Soccerfan12,,19,31,21,52
36065,hoott,,10,6,14,20
36066,trueg,,19,293,266,559
36067,SamHealer,,1,342,376,718
36068,nurdd,,39,1,1,2
36069,japple,,20,263,45,308
36070,relix,,20,108,160,268
36071,tedrrrr,,18,7,2,9
36072,bamonster,,29,201,237,438
36073,schizobullet,,22,585,722,1307
36074,AcidMaX,,19,2,3,5
36075,IainIainIain,,34,6,15,21
36076,ktwar,,31,2,6,8
36077,pashupat,,3,9,10,19
36078,hakzorz,,32,21,16,37
36079,thaabit,,13,7,17,24
36080,koshinn,,18,1,2,3
36081,redditcop,,20,5,7,12
36082,glob,,1,118,173,291
36083,nubberytuckie,,15,3,8,11
36084,glaster,,31,143,173,316
36085,subschool,,1,6,8,14
36086,kylehoff,,31,12,12,24
36087,kzielinski,,20,2,1,3
36088,nicholasaa,,19,1,1,2
36089,11421172,,18,40,52,92
36090,clarity101,,30,3,4,7
36091,Coloradofire,,19,213,309,522
36092,ewald,,20,2,3,5
36093,trannylegba,,10,35,36,71
36094,dr-steve,,31,72,70,142
36095,GoneToCanada,,1,8,7,15
36096,vanessarivers82,,5,29,28,57
36097,robotfuel,,43,215,301,516
36098,five9a2,,20,76,89,165
36099,njhardc0re,,13,2,3,5
36100,somethinlike,,32,1,6,7
36101,Leviathant,,20,12,14,26
36102,FakenameMcAlius,,1,171,108,279
36103,PrinsFoo,,18,19,23,42
36104,bottar,,32,3,13,16
36105,hobbit55,,13,16,1,17
36106,propagandhist,,8,3,2,5
36107,atomictaco,,5,2,1,3
36108,herewegoagainagain,,14,8,10,18
36109,andrewbadera,,20,6,7,13
36110,notcaptainkirk,,30,247,270,517
36111,n_mills007,,19,19,2,21
36112,lj535i,,19,9,10,19
36113,ehundrieser,,31,1,3,4
36114,optionshift3,,18,8,46,54
36115,OA-5599,,6,233,310,543
36116,olavk,,20,50,60,110
36117,Fuuz,,20,28,3,31
36118,abgaffe,,31,128,306,434
36119,trebonius,,29,33,36,69
36120,faulx,,31,4,10,14
36121,Internet_User_001,,13,1,1,2
36122,WaltFrench,,20,1,1,2
36123,MarkCC,,20,2,3,5
36124,Jean_Luc_Picard,,1,17,24,41
36125,Tristan2007,,16,6,7,13
36126,kakes,,31,1,2,3
36127,FatherBusa,,20,4,2,6
36128,b0b0b0b,,20,13,21,34
36129,jboy55,,19,64,64,128
36130,welsinc,,1,1,1,2
36131,logicize,,0,105,5,110
36132,dboothe,,18,1,1,2
36133,testingtesting123,,20,1,1,2
36134,koosh,,29,2,1,3
36135,bmurph83,,4,39,54,93
36136,byronsucks,,18,31,46,77
36137,jthurman,,0,79,31,110
36138,collegeKid,,19,10,27,37
36139,digitalistic,,18,72,114,186
36140,mfarah,,20,20,27,47
36141,jisakujien,,20,6,12,18
36142,toolman667,,19,65,30,95
36143,barack_hussein_obama,,31,7,8,15
36144,Thewhitedsepulchre,,32,114,41,155
36145,riyten,,1,39,21,60
36146,faustoc4,,20,4,9,13
36147,bolder_is_online,,18,1,5,6
36148,juryDuty,,6,2,2,4
36149,gomer,,5,8,3,11
36150,Shinuza,,18,100,61,161
36151,trohil,,40,1,1,2
36152,redpig9,,4,72,85,157
36153,spoiled11,,18,173,297,470
36154,Kitanax1,,18,8,13,21
36155,kansasbob,,39,2,1,3
36156,ri0tnrrd,,11,7,17,24
36157,nohart,,43,1,1,2
36158,ibgeek,,20,5,7,12
36159,thecheatah,,20,245,304,549
36160,nouse4aname247,,42,16,1,17
36161,Bbaily,,13,330,270,600
36162,coolio5391,,20,54,9,63
36163,dave_L,,34,447,677,1124
36164,Obama4Chavez,,22,2,1,3
36165,arthurujn2,,5,7,14,21
36166,fordprefectace,,18,6,5,11
36167,ss6sam6,,19,28,24,52
36168,s-m-a-c-k,,14,128,215,343
36169,butch5555,,31,227,242,469
36170,rayski,,0,9,19,28
36171,mikekole,,19,3,7,10
36172,Tecmobo,,13,217,185,402
36173,sriram_2001,,20,8,2,10
36174,szczupak,,0,1,1,2
36175,BrockObama,,19,2,1,3
36176,mindblast,,18,111,151,262
36177,Syjefroi,,4,25,42,67
36178,bouleverser,,18,11,16,27
36179,lobster-random,,11,5,4,9
36180,whiteboy,,19,367,245,612
36181,markcycle,,5,1,1,2
36182,winnith,,13,13,5,18
36183,darko87,,18,20,32,52
36184,stratospark,,13,32,21,53
36185,bsg75,,20,80,33,113
36186,kashicat,,32,14,2,16
36187,Hatari,,3,1,1,2
36188,sylvan,,30,1632,1655,3287
36189,flamingfenix,,42,2,3,5
36190,DeadwoodInternet,,16,1,1,2
36191,CaptainJesusHood,,12,443,436,879
36192,wsteinh,,18,11,3,14
36193,sharkhunter,,18,7,8,15
36194,aliasbex,,43,3,7,10
36195,joshuazed,,6,22,38,60
36196,W3bbo,,30,2,2,4
36197,elockloran,,32,4,2,6
36198,kmccormick,,43,1,1,2
36199,spudcrazy,,29,1,1,2
36200,PixlNinja,,5,2,3,5
36201,knud,,13,259,313,572
36202,roaringrepublican,,13,10,2,12
36203,Diomedes8,,19,24,7,31
36204,seiga,,1,1,1,2
36205,federalist1981,,5,1,1,2
36206,drewism,,1,15,15,30
36207,Zifna,,4,318,355,673
36208,PinGUY,,43,9,5,14
36209,djshiva,,34,1,3,4
36210,personaehiro,,19,8,12,20
36211,stdlib,,18,3,1,4
36212,oxide7,,32,5,1,6
36213,allholy1,,18,10,22,32
36214,roml,,18,44,153,197
36215,LetYouDown,,24,2,1,3
36216,Leischa,,31,28,34,62
36217,bleemins,,13,4,1,5
36218,roffert,,18,4,11,15
36219,flipswitch,,29,2,2,4
36220,steve_b,,29,14,16,30
36221,Mystitat,,30,4,2,6
36222,regnillub,,13,10,3,13
36223,200iso,,30,26,8,34
36224,phenomenalgat,,13,249,168,417
36225,rhymenocerous__,,19,3,2,5
36226,SayingFucktardIsCool,,15,1,1,2
36227,TakeItDownMikEee,,20,2,1,3
36228,jyanefsk,,31,10,5,15
36229,imrand,,13,4,1,5
36230,manwiththeplan,,18,132,8,140
36231,bitwize,,20,314,554,868
36232,ascii,,20,136,126,262
36233,gananand,,0,67,110,177
36234,NeoYankee,,13,2,6,8
36235,geek_dave,,4,1,1,2
36236,gregjor,,20,52,24,76
36237,tadjik,,14,1,2,3
36238,phatangrywiccan,,13,67,118,185
36239,porscheguy19,,42,20,34,54
36240,cerot,,22,15,33,48
36241,knuta,,20,1,1,2
36242,deivys20,,13,15,25,40
36243,colechristensen,,13,12,20,32
36244,jaquelinehyde,,2,1,2,3
36245,0rbytal,,31,1,1,2
36246,danhs,,19,2,3,5
36247,jtt25c,,18,9,19,28
36248,xopherg,,13,20,6,26
36249,gtani,,20,4,4,8
36250,mrdm242,,18,22,47,69
36251,spork65,,19,42,5,47
36252,Enterprize,,30,1,1,2
36253,hablamierda,,19,142,159,301
36254,turrican,,18,31,64,95
36255,rossriley,,22,77,35,112
36256,euderma44,,18,6,2,8
36257,awfuck,,32,2,2,4
36258,jamiequint,,13,12,15,27
36259,iodine,,22,1,1,2
36260,MrClean88,,1,1,1,2
36261,aussiecynic,,5,2,2,4
36262,Mello_Jello,,42,11,13,24
36263,slackeur,,18,4,5,9
36264,Gorsh,,9,1,1,2
36265,TheWeinerCircle,,22,1,1,2
36266,philipn,,20,72,23,95
36267,desertrat75,,13,7,5,12
36268,borgconsulting,,43,48,64,112
36269,cornbrain,,19,33,34,67
36270,rtjac,,19,1,7,8
36271,riverwalolololk,,36,1,1,2
36272,architectzero,,30,303,257,560
36273,thespiff,,39,1,2,3
36274,Drunken_Monkey,,30,1,1,2
36275,mudra,,1,1,4,5
36276,Boye,,18,290,341,631
36277,Elwood19k20,,26,2,1,3
36278,napalm,,31,15,12,27
36279,wumbo,,19,9,4,13
36280,lief79,,20,481,381,862
36281,thirdlip32,,18,64,51,115
36282,sball352,,32,2,3,5
36283,joelparkerhenderson,,1,1,3,4
36284,zondler,,34,1,1,2
36285,Charel,,0,12,10,22
36286,dujour,,34,2,6,8
36287,feckineejit,,18,92,135,227
36288,alexcarson,,13,39,26,65
36289,bdarbs,,5,599,28,627
36290,edddie,,30,3,1,4
36291,TheCid,,42,411,481,892
36292,xsrevolt,,32,4,9,13
36293,mdemeny,,30,1,3,4
36294,jfpbookworm,,19,183,267,450
36295,supermoo,,13,1,4,5
36296,dondimon,,13,2,2,4
36297,feelphones,,5,20,12,32
36298,bokononon,,39,69,62,131
36299,enyoron,,18,86,91,177
36300,Halgrind,,31,30,37,67
36301,psantora,,36,4,3,7
36302,quadrofolio,,31,33,37,70
36303,samshady,,5,1,2,3
36304,njantirice,,1,32,77,109
36305,Mr_Anderson,,8,1,2,3
36306,thestraightblade,,18,457,3,460
36307,sockstar,,19,26,10,36
36308,radrik,,12,20,30,50
36309,ottobott,,19,15,38,53
36310,obomba,,13,230,199,429
36311,alpenglow,,19,38,13,51
36312,fredcamino,,42,23,20,43
36313,reynante,,5,1,1,2
36314,Bjartur,,18,31,29,60
36315,Darkshine807,,18,2,3,5
36316,lu88ke,,18,24,61,85
36317,yasth,,20,293,380,673
36318,realnowhereman,,20,19,19,38
36319,Mithryn,,12,146,208,354
36320,rubinelli,,20,28,53,81
36321,groanad2,,20,9,13,22
36322,beegl,,4,3,1,4
36323,ninti,,32,66,62,128
36324,inevereveni,,19,3,8,11
36325,egamipeaks,,32,9,14,23
36326,MrRipley15,,19,69,119,188
36327,genghis_mute,,1,6,23,29
36328,TMills,,13,21,24,45
36329,lucidguppy,,13,2,6,8
36330,ontheroadsal,,10,5,22,27
36331,biocs_nerd,,20,223,188,411
36332,hweeny,,13,4,2,6
36333,mod_nobody,,20,5,19,24
36334,Wyrm,,1,313,198,511
36335,Arkaein,,20,88,142,230
36336,abeliangrape,,20,1,7,8
36337,shapul,,36,13,13,26
36338,o6uoq,,42,23,8,31
36339,flubberyduckie,,43,3,10,13
36340,chews,,13,60,4,64
36341,dinkumator,,43,35,38,73
36342,drunklemur,,18,9,8,17
36343,bwa5099,,41,1,2,3
36344,1310nm,,13,5,9,14
36345,naveedjavaid,,18,5,6,11
36346,dbpatterson,,20,44,65,109
36347,berger47,,21,2,1,3
36348,dale_dribble,,13,1,2,3
36349,ibbe,,8,3,3,6
36350,mhsouthpaw,,20,9,17,26
36351,yourvoicenewvision,,31,7,1,8
36352,dpkonofa,,43,4,12,16
36353,lself,,4,2,1,3
36354,thewidowmaker,,18,41,74,115
36355,sgr,,22,3,4,7
36356,amaenza,,10,1,2,3
36357,allan_a,,19,32,44,76
36358,gottaredit,,43,5,13,18
36359,janeybgood,,18,3,14,17
36360,deit9000,,10,1,1,2
36361,mission_to_mars,,20,3,4,7
36362,bernardrieux,,42,1,2,3
36363,dropdibdab,,20,1,1,2
36364,puzl,,19,2,3,5
36365,shamansun,,32,109,68,177
36366,miraimari,,1,8,17,25
36367,RussG,,1,4,5,9
36368,sideways,,1,167,35,202
36369,hypnotoad9000,,18,9,24,33
36370,Monty_Hall,,18,2,1,3
36371,johlin,,6,2,2,4
36372,bluman,,0,2,8,10
36373,cmhdave73,,8,16,41,57
36374,O_O,,20,14,14,28
36375,goodbyeUSA,,13,8,1,9
36376,interjay,,1,1,6,7
36377,mibu9,,32,6,13,19
36378,Jakkli,,22,8,6,14
36379,gizzledos,,5,30,55,85
36380,drklutch,,31,1,1,2
36381,balljoint,,13,6,4,10
36382,FurryMoistAvenger,,18,115,64,179
36383,hellfaucet,,13,1,2,3
36384,theScatman,,33,1,1,2
36385,raket,,31,1,2,3
36386,rockstar1o9,,18,25,32,57
36387,blahblah98,,13,105,109,214
36388,darkmark7,,1,82,24,106
36389,ahpro,,43,26,41,67
36390,prelim,,1,208,44,252
36391,USAF_NCO,,31,686,816,1502
36392,jbot,,0,20,35,55
36393,cactusrex,,18,217,302,519
36394,bwojdyla,,13,7,8,15
36395,jarred00,,13,21,2,23
36396,seopher,,43,371,265,636
36397,AGivant,,20,19,7,26
36398,hexix,,19,4,3,7
36399,William_Occam,,36,1,1,2
36400,wildwomyn,,5,1,3,4
36401,oubiwann,,20,1,5,6
36402,kidmonsters,,6,36,34,70
36403,supertasticfool,,18,18,29,47
36404,aurG,,36,1,3,4
36405,SteveScallion,,1,8,10,18
36406,d3vmax,,0,57,54,111
36407,gdenfield,,13,19,39,58
36408,burndive,,13,4,4,8
36409,EdwinWaugh,,18,8,17,25
36410,rdjj69x,,0,10,3,13
36411,Clev,,19,42,31,73
36412,Dumbledee,,18,2,3,5
36413,ItsLilJon,,22,2,1,3
36414,shivak,,20,2,3,5
36415,Kalima,,39,2,2,4
36416,Blipperpa,,8,4,3,7
36417,FormKing,,20,93,122,215
36418,psynautic,,31,3,4,7
36419,lundman,,13,2,3,5
36420,seand,,39,5,28,33
36421,theallseeingeye,,1,6,1,7
36422,isabella_corona,,1,3,2,5
36423,lysine23,,13,305,401,706
36424,gyrovagus,,13,2,4,6
36425,babylonburning,,19,1,2,3
36426,reddit4820,,13,123,137,260
36427,BullBear,,13,8,2,10
36428,meatdigg,,5,6,11,17
36429,vill4no,,42,5,2,7
36430,nubckaes,,13,16,23,39
36431,templetron,,1,9,13,22
36432,reddog093,,0,140,164,304
36433,agscala,,20,71,54,125
36434,aolley,,1,1,7,8
36435,Foo1io,,32,3,3,6
36436,josephsh,,18,15,1,16
36437,rzala,,0,92,7,99
36438,mktwo,,32,2,1,3
36439,harmony2,,42,1,2,3
36440,simonfoley,,0,1,1,2
36441,redditboss,,5,91,5,96
36442,Kuvaldin,,0,58,130,188
36443,DarkXanthos,,20,47,47,94
36444,digitalbuzz,,18,4,20,24
36445,Wikijo,,19,2,3,5
36446,pindaddy,,20,1,1,2
36447,rivardja,,42,18,16,34
36448,schnuck,,31,399,656,1055
36449,queenmaeve,,18,96,180,276
36450,cyranthus,,43,1,4,5
36451,jkillian,,43,10,6,16
36452,bendylan,,36,13,12,25
36453,mattrock,,18,11,6,17
36454,plecostomus,,32,13,21,34
36455,sjek,,18,7,3,10
36456,Ragoczy,,38,2,3,5
36457,Traceyer,,0,6,3,9
36458,seattlegirluw,,34,621,99,720
36459,dapf,,19,28,47,75
36460,jtyost2,,43,5,3,8
36461,Coca_Cola,,42,10,2,12
36462,forty8roadster,,13,3,1,4
36463,Didimos,,12,20,2,22
36464,hjo3,,19,235,325,560
36465,hayoo,,20,3,6,9
36466,NDhatt1981,,4,2,2,4
36467,dellis,,43,703,1175,1878
36468,newhen,,19,5,12,17
36469,jrpinsd,,19,15,14,29
36470,virtuexru,,18,45,10,55
36471,HopefulNebula,,18,304,75,379
36472,andepthman,,43,3,7,10
36473,soopajane,,32,2,1,3
36474,tinymarae,,31,10,1,11
36475,miaogyver,,7,8,15,23
36476,Elrondaelf,,40,3,1,4
36477,darter22,,13,2,7,9
36478,gcod,,4,1,1,2
36479,Nomara,,31,1,1,2
36480,MXN,,29,1,1,2
36481,ryand,,31,1,2,3
36482,dbqpdb,,1,13,12,25
36483,HamsterNibbles,,29,5,6,11
36484,Charlie24601,,1,241,395,636
36485,kminsull,,20,19,11,30
36486,mitchey,,5,1,1,2
36487,ElCookie,,13,13,24,37
36488,Lev0n,,4,1,1,2
36489,aplindsay,,22,27,34,61
36490,MarlburrowMan,,20,11,4,15
36491,robinei,,22,1,1,2
36492,grayshanks,,18,2,3,5
36493,pooka,,1,5,3,8
36494,NippleNutz,,1,18,22,40
36495,stickoversquare,,19,1,1,2
36496,NakedOni,,18,19,34,53
36497,paizon,,19,15,9,24
36498,artzoom,,5,3,4,7
36499,dstroyr,,20,3,1,4
36500,jitterz,,13,5,5,10
36501,fumbler1417,,29,1,4,5
36502,highwind,,20,88,76,164
36503,nikehat,,31,16,16,32
36504,mannix,,6,71,77,148
36505,xlance,,18,38,29,67
36506,Butterknuckle,,18,49,8,57
36507,digitalmoto,,5,265,17,282
36508,robvedder,,43,1,1,2
36509,youareivan,,0,1,2,3
36510,mashiroikaze,,32,11,15,26
36511,obrysii,,12,128,103,231
36512,PANIC_MAN,,43,12,26,38
36513,SoftwareMaven,,20,20,36,56
36514,cuer,,29,1,2,3
36515,elfgod,,18,10,14,24
36516,buxmeister,,23,1,1,2
36517,Secretus,,12,31,34,65
36518,bryanl,,18,37,5,42
36519,dividendpirate,,19,53,10,63
36520,Anelly85,,5,9,9,18
36521,31337z3r0,,43,4,13,17
36522,afair,,20,1,1,2
36523,Politaction,,13,6,2,8
36524,Lysergic,,6,4,4,8
36525,ABabyAteMyDingo,,4,779,999,1778
36526,korhalf,,20,24,25,49
36527,wasylm,,29,38,45,83
36528,jcmcbeth,,4,86,122,208
36529,jonintc,,6,4,5,9
36530,aseidel,,18,63,47,110
36531,Battleloser,,31,1027,1438,2465
36532,fokker32,,13,43,33,76
36533,marlinspike,,19,8,11,19
36534,web20sucks,,19,105,34,139
36535,marc-kd,,20,555,57,612
36536,Ksam8,,31,5,6,11
36537,tells,,1,2,5,7
36538,jeroenh,,20,3,4,7
36539,raptor3x,,1,1,2,3
36540,ActivationEnergy,,13,1,1,2
36541,ryanvsrobots,,1,6,4,10
36542,gregag,,42,1,1,2
36543,vpetro,,19,1,3,4
36544,jrow,,20,1,1,2
36545,redditrasberry,,20,218,288,506
36546,raveon,,18,2,4,6
36547,mexicodoug,,36,1723,3782,5505
36548,slater,,42,1,1,2
36549,waste,,18,2,8,10
36550,tbmbob,,42,1,2,3
36551,bjpremore,,14,1,3,4
36552,onceuponageek,,18,89,6,95
36553,mattley,,13,1,3,4
36554,lannm,,29,2,3,5
36555,moozxy,,22,1,3,4
36556,samburney,,20,1,3,4
36557,imasaltedpretzel,,32,1,2,3
36558,risdn,,13,4,19,23
36559,kennon,,17,1,2,3
36560,dir21,,31,3,9,12
36561,Pro28,,31,1,3,4
36562,wdlewis47,,13,5,1,6
36563,SFLTimmay,,1,5,3,8
36564,justmytwocents,,21,4,1,5
36565,LoveGoblin,,22,326,610,936
36566,relin,,42,176,22,198
36567,jdgolfster,,13,2,2,4
36568,sixolive,,0,47,3,50
36569,kinebud,,20,53,76,129
36570,aleksey11,,13,3,2,5
36571,joke_account,,22,1,1,2
36572,one0them,,19,121,312,433
36573,petraska,,18,2,3,5
36574,enkeedu,,0,12,13,25
36575,CIA_Agent,,19,57,67,124
36576,rackaboy,,19,10,12,22
36577,tisn,,13,24,38,62
36578,emeidi,,19,1,4,5
36579,Harfish,,43,6,12,18
36580,LordKaT,,18,219,9,228
36581,ah171504,,20,1,1,2
36582,carsonce,,18,176,163,339
36583,tharealmegaman,,6,117,57,174
36584,IVotedForKodos,,19,220,348,568
36585,chag,,14,3,5,8
36586,ywgdana,,20,3,5,8
36587,arlok789,,5,50,6,56
36588,dawnfire999,,0,76,35,111
36589,khabrain,,9,16,1,17
36590,HonestAbe29,,13,2,2,4
36591,wewewawa,,18,52,58,110
36592,zues,,13,2,9,11
36593,agatheredwetness,,20,2,3,5
36594,changuich,,4,2,1,3
36595,mizprint,,4,2,2,4
36596,alllo,,5,48,8,56
36597,douglask,,10,3,6,9
36598,kguill42,,1,14,21,35
36599,cannabia,,4,6,6,12
36600,naxet,,13,5,11,16
36601,crash-hinezumi,,20,1,1,2
36602,culture,,19,341,30,371
36603,cronin1024,,20,301,196,497
36604,thatperlguy,,20,5,2,7
36605,Doblon,,4,1,2,3
36606,brazil101,,30,25,40,65
36607,shaunc,,17,232,233,465
36608,chrisforbes,,20,90,156,246
36609,LyingBackstabbingFuk,,43,5,6,11
36610,kyller,,5,1,1,2
36611,conanite,,32,14,9,23
36612,rayzincrisp,,32,13,11,24
36613,fakeusername2,,18,11,2,13
36614,guestuser,,32,1,1,2
36615,TS409,,1,24,52,76
36616,buhlink,,31,1,1,2
36617,iperry,,20,47,13,60
36618,BobbyKen,,31,109,209,318
36619,balthe,,22,1,11,12
36620,hangbush,,20,1,1,2
36621,isthistakentoo,,18,1,3,4
36622,r3d,,22,90,85,175
36623,guterhund,,8,4,1,5
36624,marduk,,13,70,83,153
36625,mattdbab,,12,31,4,35
36626,egonkasper,,20,8,15,23
36627,IVTmusic,,34,9,1,10
36628,tsphillips,,22,1,1,2
36629,kdeez,,18,3,2,5
36630,evilfoo,,43,8,1,9
36631,genug,,19,1,1,2
36632,Drmonkeydonkey,,18,3,5,8
36633,Phersu,,43,15,18,33
36634,chsonnu,,20,4,6,10
36635,tmpman,,42,1,1,2
36636,nothing_at_all,,4,2,2,4
36637,winter_limelight,,13,6,9,15
36638,psycho79,,1,7,7,14
36639,duck_typing,,20,1,1,2
36640,dogas,,1,4,8,12
36641,CrazedHippie,,19,4,25,29
36642,GeorgeWalkerBush,,0,2,6,8
36643,iDemonix,,19,1,2,3
36644,xkcdzombie,,3,6,1,7
36645,GodHatesFags,,43,17,25,42
36646,Mr-D-uh,,0,2,4,6
36647,saisumimen,,1,69,106,175
36648,pacpub,,5,1,3,4
36649,PacerFan,,39,23,5,28
36650,IkeSW,,18,5,3,8
36651,greyrl,,1,1,2,3
36652,TheBigLewinski,,1,197,83,280
36653,udd,,18,3,6,9
36654,CheatorBeat,,18,55,11,66
36655,OldStonyface,,20,1,4,5
36656,oostevo,,1,11,10,21
36657,frank26080115,,42,29,39,68
36658,electrolegs,,13,4,6,10
36659,Lol_Lolovici,,20,1,2,3
36660,danielalfredsson,,19,1,2,3
36661,kconnors,,18,18,39,57
36662,khmr33,,43,5,10,15
36663,trevdak2,,32,281,279,560
36664,etorreborre,,20,1,1,2
36665,daniel_buchanan,,11,10,22,32
36666,silas0069,,34,12,18,30
36667,rahmad,,22,79,85,164
36668,kevs,,1,3,1,4
36669,FrankLen0607,,18,14,2,16
36670,ottmar,,1,1,1,2
36671,ryanknapper,,23,331,529,860
36672,chavette,,5,1,1,2
36673,w1nt3rmut3,,16,3,2,5
36674,Wikipedo,,27,4,2,6
36675,jellystones,,20,108,13,121
36676,DreamSurfer,,34,50,7,57
36677,tc326,,18,2,4,6
36678,Vystril,,1,140,155,295
36679,iskyoork,,13,13,17,30
36680,scogle,,18,1,2,3
36681,david_z,,6,16,10,26
36682,hahamoviequote,,12,52,72,124
36683,69105,,31,1,1,2
36684,soapyj,,41,2,2,4
36685,Ultimateamp,,19,29,25,54
36686,kingzilch,,7,1,1,2
36687,cmm,,20,19,21,40
36688,boshj,,18,2,3,5
36689,blizz81,,5,4,5,9
36690,md2020,,19,23,50,73
36691,parapliers,,1,69,22,91
36692,joyork,,43,1209,500,1709
36693,To1kien,,13,33,5,38
36694,ChagrinRiddle,,18,71,73,144
36695,Unconquerable88,,13,1,1,2
36696,IRainShitOnUrParade,,22,2,1,3
36697,honoruru,,20,1,2,3
36698,Jesus_Captain,,16,2,1,3
36699,runesmith,,20,2,4,6
36700,futurestack,,23,12,14,26
36701,D-Style,,19,530,535,1065
36702,sabrebutt,,19,16,33,49
36703,duckspeak,,2,1,5,6
36704,lilaz,,13,273,6,279
36705,karlrovesdoublechin,,42,1,3,4
36706,geon,,20,182,244,426
36707,IdeaR,,3,2,3,5
36708,jan_g,,31,26,29,55
36709,yushir0,,20,1,1,2
36710,JeremyBanks,,20,235,292,527
36711,swhitt,,42,2,11,13
36712,culled,,0,1,1,2
36713,ClevelandGirl,,30,1,1,2
36714,ChendaNgak,,13,1,1,2
36715,danger1,,43,12,19,31
36716,evans_simon,,13,33,53,86
36717,kemodan,,13,8,5,13
36718,dbueno,,20,5,17,22
36719,r3su,,30,91,166,257
36720,chitoiup,,18,12,19,31
36721,pbarmasher,,19,6,21,27
36722,blinder,,32,4,5,9
36723,smoothmann,,18,1,7,8
36724,stan205,,22,7,3,10
36725,ZenMastersBlog,,13,55,6,61
36726,ddixonr,,1,53,43,96
36727,ERGOfuturus,,1,1,2,3
36728,Pun_isher,,1,142,84,226
36729,drdorf,,42,23,40,63
36730,dwinder1,,42,3,4,7
36731,bixsciurus,,20,2,2,4
36732,chohoh,,10,8,11,19
36733,Terry_Spadge,,4,2,2,4
36734,Loblaw,,18,182,17,199
36735,mayhym,,8,3,1,4
36736,blackbanner88,,18,4,13,17
36737,Kyarii,,5,33,39,72
36738,TR0N,,8,3,1,4
36739,SassyBlackGirl,,20,1,1,2
36740,bigtunacan,,20,8,7,15
36741,kyleect,,14,108,160,268
36742,jeremyribbink,,1,1,1,2
36743,frugalfran,,43,59,53,112
36744,JoDAWG,,18,1,2,3
36745,jrrl,,34,408,269,677
36746,digits12,,5,198,16,214
36747,jeffredd,,13,19,30,49
36748,JesseOnReddit2,,19,2,4,6
36749,tubetown,,32,3,8,11
36750,dionysos,,20,1,2,3
36751,zeekx4,,35,19,31,50
36752,haniam,,43,1,1,2
36753,optional,,34,4,3,7
36754,perrako,,31,8,7,15
36755,pergus,,41,6,5,11
36756,nivek,,20,24,31,55
36757,micje,,20,9,4,13
36758,LausXY,,18,9,30,39
36759,Netzapper,,42,3,6,9
36760,thegeoman,,19,88,141,229
36761,atlsingh,,18,42,94,136
36762,executor67,,0,1,1,2
36763,heathlander,,31,55,11,66
36764,kidnoodle,,19,4,4,8
36765,mjsolaro,,1,869,1126,1995
36766,MrLove,,31,10,10,20
36767,beavioso,,22,2,1,3
36768,bendl,,4,2,2,4
36769,ropsic,,22,1,2,3
36770,jadedconformist,,32,89,119,208
36771,staplermasta,,20,7,6,13
36772,RIAAgoon,,20,5,2,7
36773,wake_me_up,,13,19,6,25
36774,HukdUnFonx,,19,3,6,9
36775,dccse3k,,43,50,88,138
36776,bchisom99,,2,1,2,3
36777,frenchguy,,20,11,18,29
36778,alephnil,,20,144,248,392
36779,larholm,,20,472,616,1088
36780,forkkkd,,13,1,5,6
36781,ALOT,,10,1,1,2
36782,robeph,,18,406,838,1244
36783,18thstreetmike,,20,2,1,3
36784,acornwa,,19,13,27,40
36785,addicted_to_bass,,20,35,43,78
36786,djork,,42,479,640,1119
36787,geno149,,29,9,6,15
36788,Justagardener,,38,1,1,2
36789,RobinReborn,,29,473,687,1160
36790,BamaStangGuy,,19,84,112,196
36791,iknowzitall,,0,5,11,16
36792,fanboy121,,20,3,6,9
36793,nouggatage,,27,1,3,4
36794,nomie,,23,2,3,5
36795,Alcorsu,,20,5,8,13
36796,willwork4rmb,,19,84,142,226
36797,Tarindel,,1,93,83,176
36798,johnsonjohnson,,29,2,4,6
36799,fazeman9,,42,25,18,43
36800,sdmitry,,42,19,21,40
36801,gn3xu5,,18,109,62,171
36802,zeroquest,,18,122,33,155
36803,BoofBop,,4,31,12,43
36804,zizou_president,,18,14,20,34
36805,Recoil42,,32,1311,1046,2357
36806,cyzoonic,,20,1,2,3
36807,siqtictorn,,1,101,85,186
36808,Shadotek,,42,218,516,734
36809,rufusdog,,34,28,42,70
36810,jungl,,31,9,3,12
36811,berwyn,,34,1,1,2
36812,meridious,,31,2,1,3
36813,vbl,,19,273,399,672
36814,tjogin,,20,493,781,1274
36815,DeepTruth,,20,1,3,4
36816,chris2930,,5,82,97,179
36817,Deeprblue,,22,25,33,58
36818,tvor,,13,1,2,3
36819,nikov,,21,11,11,22
36820,nlangmaid,,43,5,7,12
36821,Conundrum123,,18,9,6,15
36822,chitza,,22,8,19,27
36823,gypsydoctor,,13,246,106,352
36824,iNPHiD3L,,32,25,5,30
36825,miauka,,5,3,4,7
36826,smoked1up,,18,18,21,39
36827,dpm11,,19,15,6,21
36828,billdouglas,,19,31,6,37
36829,phlip,,20,1,2,3
36830,hosemaster,,19,51,29,80
36831,chersolly,,19,89,140,229
36832,britishben,,17,122,241,363
36833,melsue,,19,22,5,27
36834,dreallen,,19,4,1,5
36835,hater2,,0,7,18,25
36836,rudy13,,31,1,1,2
36837,jdh30,,20,48,79,127
36838,mang90,,20,3,11,14
36839,keyshark,,22,162,8,170
36840,koft,,32,52,59,111
36841,ssnider,,20,31,17,48
36842,craftyscreenwriting,,31,5,5,10
36843,cabanaboy,,13,8,10,18
36844,tommyschoolbruh,,31,6,13,19
36845,babua,,1,53,82,135
36846,rick2530,,13,1,2,3
36847,BeardedNoOne,,18,3,11,14
36848,njakubow,,18,95,72,167
36849,mostlyferal,,13,8,2,10
36850,stealthfiction,,28,2,2,4
36851,cardmagic,,1,1,2,3
36852,kabdib,,20,50,96,146
36853,konataizumi,,20,29,35,64
36854,grantaccess,,18,100,54,154
36855,Match_Point,,19,5,10,15
36856,logistix,,43,10,13,23
36857,comcraptic,,14,2,5,7
36858,ertyseidel,,1,6,1,7
36859,noonespecial,,13,7,15,22
36860,tmahmood,,20,10,12,22
36861,MsDrury,,25,36,31,67
36862,jayp12323,,8,1,4,5
36863,snuxoll,,20,15,32,47
36864,eliah,,19,17,8,25
36865,Pooh_Bear,,18,17,23,40
36866,acidflask,,20,3,7,10
36867,ludinom,,27,3,3,6
36868,drapton,,22,1,1,2
36869,Avengelist,,18,6,6,12
36870,ThomW,,32,9,12,21
36871,nkbrockhoff,,1,35,57,92
36872,ThaiTai,,32,30,34,64
36873,xHackAttackx,,6,1,1,2
36874,Clanc,,19,299,570,869
36875,org,,1,1,2,3
36876,dokument,,43,11,6,17
36877,notests,,20,4,6,10
36878,Strikethrough,,30,1,2,3
36879,kyle9456,,33,2,2,4
36880,doshiamit,,41,100,60,160
36881,luisawoods,,13,6,4,10
36882,pjmarsz,,0,1,2,3
36883,p3d0,,4,3,2,5
36884,blogstar,,22,5,4,9
36885,soldier4Jahiliyyah,,13,21,11,32
36886,movin2victoria,,1,1,1,2
36887,drc500free,,31,25,34,59
36888,deadsoon,,1,594,1091,1685
36889,joepeg,,5,8,8,16
36890,RickRolled,,13,172,145,317
36891,sonap,,13,3,4,7
36892,nemesmith,,13,34,59,93
36893,lazylland,,20,2,3,5
36894,joesmoe10,,20,12,27,39
36895,Fattytumor,,1,4,5,9
36896,Mentari,,0,2,7,9
36897,cmdaz,,18,1,1,2
36898,WyoBuckeye,,18,91,61,152
36899,zonyc,,1,31,21,52
36900,nemokrad,,43,3,2,5
36901,rebop,,22,259,394,653
36902,media_lush,,14,16,10,26
36903,HyperspaceHero,,18,21,16,37
36904,alarmist,,19,60,114,174
36905,Truami,,34,5,6,11
36906,blindsyde,,18,2,2,4
36907,kidoblivious,,34,1,2,3
36908,deltageek,,20,27,32,59
36909,Summergirl_94,,14,5,12,17
36910,lunke,,6,17,17,34
36911,had3z,,32,11,8,19
36912,wibblesnark,,16,101,74,175
36913,RespondsToEveryReply,,20,13,19,32
36914,BCSd,,20,3,1,4
36915,Manutd77,,19,5,1,6
36916,BeerRiot,,20,2,5,7
36917,millonzi,,22,1,1,2
36918,eileenfleming,,13,1,1,2
36919,lemonoust,,19,3,4,7
36920,bambadamba,,18,1,6,7
36921,Foxblood,,19,8,14,22
36922,tipu,,13,31,13,44
36923,rkhrkh,,10,5,7,12
36924,Domza,,38,12,19,31
36925,cornedpig,,20,19,27,46
36926,Reddit-Fan,,0,185,13,198
36927,happyspleen,,30,8,10,18
36928,elpollodemuerto,,32,1,3,4
36929,Belgain_Roffles,,42,40,70,110
36930,destro1382,,15,1,1,2
36931,pointblank,,18,146,2,148
36932,mogelbumm,,20,5,2,7
36933,zigi,,20,1,1,2
36934,dunmalg,,14,2,3,5
36935,redvis,,32,9,1,10
36936,bgthigfist,,20,2,3,5
36937,cluuxz,,1,2,4,6
36938,wholl311,,0,1,1,2
36939,bournefree,,34,1,2,3
36940,KingCrimson,,0,1,1,2
36941,cacoreeby,,18,8,1,9
36942,isospace,,19,22,12,34
36943,thingsomething,,18,16,95,111
36944,ababysgiggle,,14,1,1,2
36945,THEGOVT,,1,2,2,4
36946,stunksys,,18,1,1,2
36947,Helland,,31,1,1,2
36948,maksa,,20,4,8,12
36949,egregiousfdl,,13,13,7,20
36950,terranosaurus,,13,165,141,306
36951,eezynow,,18,12,10,22
36952,earl_the_sausage,,19,27,45,72
36953,ltx,,18,324,181,505
36954,Asaf-Shelly,,20,1,2,3
36955,newboner,,31,2,3,5
36956,owevr,,20,1,2,3
36957,beedeecee,,20,1,1,2
36958,pkoi,,12,1,5,6
36959,akkmedk,,29,19,5,24
36960,Izzo,,13,186,234,420
36961,apgwoz,,20,5,9,14
36962,totoneila,,34,1,2,3
36963,maxwgl,,1,16,13,29
36964,jlw,,13,26,37,63
36965,Callahad,,20,94,145,239
36966,jurvis,,1,17,12,29
36967,SithLordMohawk,,1,6,31,37
36968,glennvtx,,29,13,11,24
36969,j7uy5,,8,1,1,2
36970,Bjork,,22,7,3,10
36971,makuserusukotto,,13,5,5,10
36972,jujubees,,3,4,4,8
36973,grdmck,,42,1,1,2
36974,akenaten,,34,2,1,3
36975,Sigma7,,42,60,76,136
36976,wlievens,,20,16,29,45
36977,angry_fat_boy,,43,209,429,638
36978,PatrickSauncy,,30,1,2,3
36979,thing-fish,,11,13,19,32
36980,Leahn,,26,182,366,548
36981,landscapeofsuits,,18,2,5,7
36982,robertcrowther,,20,54,44,98
36983,Starguard,,34,1,1,2
36984,captain_credit,,13,10,7,17
36985,heystoopid,,6,1,2,3
36986,kizzahq,,18,1,1,2
36987,somepancakes,,3,1,2,3
36988,tincholio,,18,12,9,21
36989,Aerik,,32,2302,1382,3684
36990,grimetooth,,43,4,15,19
36991,dogfase,,41,2,2,4
36992,Bumbaclaat,,13,88,50,138
36993,trenholm,,13,34,44,78
36994,NelsonMuntz,,0,2,2,4
36995,twowheels,,23,235,375,610
36996,missourijoe,,5,16,17,33
36997,plunkettt,,0,1,1,2
36998,odgforlife,,0,38,47,85
36999,sparkypine,,18,5,20,25
37000,Infraggable_Krunk,,32,9,18,27
37001,stinkerb,,34,1,3,4
37002,bposert,,34,4,7,11
37003,BCCstu,,5,86,13,99
37004,dfg59,,20,9,16,25
37005,jcatcw,,5,23,11,34
37006,Wadsw0rth,,0,2,1,3
37007,super_crazy,,19,97,156,253
37008,gmanp,,4,2,2,4
37009,SamsChoice,,30,1,2,3
37010,maxbeachguy,,13,179,1,180
37011,Decius,,31,4,6,10
37012,supermike,,19,14,21,35
37013,MichaelCollins,,19,2,4,6
37014,bCabulon,,17,425,731,1156
37015,junkieman,,34,4,1,5
37016,aver,,30,193,192,385
37017,straightcash,,1,3,6,9
37018,ultimo1,,18,51,4,55
37019,JackyBrown,,20,10,1,11
37020,javanperl,,4,2,2,4
37021,mccutchen,,20,32,22,54
37022,tobytripp,,3,2,2,4
37023,tobybuk,,31,180,106,286
37024,phy6uva,,13,101,29,130
37025,inconvenient_truth,,20,14,7,21
37026,MomandGrandma,,19,13,6,19
37027,RedditAddictedChimp,,1,4,3,7
37028,dandy,,20,2,3,5
37029,mchadw,,22,5,7,12
37030,Shinee,,13,1,3,4
37031,Erdrick,,16,258,112,370
37032,hapax,,43,1,2,3
37033,zerophnx,,13,1,9,10
37034,aneworder,,9,9,4,13
37035,dannite,,40,13,18,31
37036,LGarou,,17,3,6,9
37037,happajin,,31,2,1,3
37038,Blackmane,,12,187,237,424
37039,raykwonx,,18,42,22,64
37040,kmh01,,15,96,118,214
37041,Erinjb,,19,2,8,10
37042,elight,,20,2,4,6
37043,Tinidril,,10,342,556,898
37044,azriel777,,42,113,147,260
37045,mhp,,13,3,4,7
37046,sriram_sun,,0,2,6,8
37047,Random_McEric,,1,1,2,3
37048,intheclouds,,1,2,3,5
37049,ccjrbassist,,19,20,7,27
37050,Tiefighter,,43,6,5,11
37051,prof_rhino,,13,4,2,6
37052,Diamonddave1022,,16,1,3,4
37053,kcerb,,20,8,2,10
37054,justonevoice,,21,151,32,183
37055,someguy1,,20,1,1,2
37056,jricher42,,13,101,219,320
37057,sjf,,20,39,34,73
37058,bluecalx2,,6,31,58,89
37059,glib,,20,12,15,27
37060,tophers,,30,6,1,7
37061,tupulus,,20,2,1,3
37062,dimitee,,6,1,1,2
37063,Optimuskong,,6,17,11,28
37064,knightofni451,,3,53,53,106
37065,thegreathal,,1,33,26,59
37066,dagny_t,,19,1,1,2
37067,jussei,,0,19,25,44
37068,halo5,,13,3,1,4
37069,Slonk,,29,32,27,59
37070,anrahman,,20,5,6,11
37071,walkerb,,19,26,26,52
37072,yobi21,,14,7,2,9
37073,wheresandrew,,18,61,135,196
37074,phidda,,13,2,2,4
37075,Sniperman,,43,2,2,4
37076,jake3988,,13,6,9,15
37077,hibby,,18,1,1,2
37078,1968eric,,13,10,5,15
37079,DrKane,,8,4,6,10
37080,windmilltheory,,22,241,348,589
37081,molexrules,,6,34,17,51
37082,ynd,,20,19,9,28
37083,sannysanoff,,20,9,10,19
37084,webbuzzard,,13,5,7,12
37085,Darkfold,,20,2,7,9
37086,djwhitt,,20,66,100,166
37087,arsal,,20,2,5,7
37088,PunctuationWound,,19,8,14,22
37089,0_0,,5,1,1,2
37090,csolallo,,35,1,1,2
37091,snuggl,,20,19,35,54
37092,awooster,,0,52,89,141
37093,swamy_g,,19,11,8,19
37094,benwikler,,19,2,2,4
37095,nate43,,1,1,1,2
37096,ajkucy,,30,19,8,27
37097,paulmg,,0,20,21,41
37098,tycy,,5,3,2,5
37099,btucker,,20,8,7,15
37100,davidkaifuku,,19,1,8,9
37101,zeank,,20,1,1,2
37102,carlgorn,,32,62,54,116
37103,iwishiknew,,18,6,6,12
37104,doubleo7,,10,29,26,55
37105,portugal_the_man,,13,242,407,649
37106,jjrs,,19,873,555,1428
37107,gapus,,13,21,23,44
37108,hhm,,20,35,21,56
37109,smittyarbuckle,,19,15,15,30
37110,Dejime,,31,35,1,36
37111,rhapsody,,0,2,7,9
37112,hockeyschtick,,10,217,268,485
37113,plaidlemur,,13,33,18,51
37114,gauriemma,,6,214,327,541
37115,pete205,,1,30,28,58
37116,funnypla,,18,41,8,49
37117,mdasen,,13,12,10,22
37118,paranoidgeek,,20,17,28,45
37119,tierra_hammer,,18,46,68,114
37120,snipersock,,20,2,4,6
37121,widowdogood,,13,11,45,56
37122,senthil_reddit,,20,4,2,6
37123,coffeenut,,18,1,1,2
37124,shardsofcrystal,,1,14,22,36
37125,masamunexs,,31,18,19,37
37126,Surf314,,6,24,15,39
37127,geekvicious,,31,104,180,284
37128,deadlogic,,1,42,53,95
37129,kip0130,,1,9,8,17
37130,ericd543,,1,27,72,99
37131,HiImFromDigg,,13,5,1,6
37132,purvel,,5,11,30,41
37133,damir,,20,4,1,5
37134,cholly,,34,2,10,12
37135,blahblah6376,,20,1,1,2
37136,psywar,,19,16,2,18
37137,ajwitte,,13,128,185,313
37138,enigmatic_prose,,31,3,2,5
37139,hot_pastrami,,32,8,10,18
37140,jgilliam,,19,57,15,72
37141,Iterr,,18,145,104,249
37142,syzygy3,,32,2,3,5
37143,plastictreeofdoom,,13,8,4,12
37144,jiffy55,,13,2,10,12
37145,Phazon,,1,782,781,1563
37146,34934898,,8,3,4,7
37147,tayl1967,,18,12,23,35
37148,wetsndlvr,,13,1,1,2
37149,didjital,,32,1,7,8
37150,PHTX,,1,27,38,65
37151,sungsam,,0,15,22,37
37152,taylorwilsdon,,1,1,1,2
37153,ChaplainXan,,43,1,1,2
37154,diethyl_ether,,31,4,3,7
37155,amy31415,,13,2,1,3
37156,grips,,8,2,1,3
37157,rogerbadger,,12,3,2,5
37158,erulabs,,22,356,431,787
37159,willbilln,,13,1,1,2
37160,AtheistAvenger,,43,4,10,14
37161,fmcfad01,,13,2,6,8
37162,Praxxus,,18,3,2,5
37163,iconoklast,,18,4,1,5
37164,bwigfield,,6,5,1,6
37165,xnumbersx,,20,20,47,67
37166,pjakubo86,,32,81,58,139
37167,mangolicious,,10,2,1,3
37168,billmeyersriggs,,6,91,104,195
37169,feliz23,,12,1,1,2
37170,ecochick,,5,4,12,16
37171,ArgabargaJones,,42,4,3,7
37172,johnyaya,,19,3,6,9
37173,I_am_not_a_sock,,13,1,3,4
37174,flushing_goldfish,,6,48,92,140
37175,51mona,,3,173,3,176
37176,dandare71,,13,40,24,64
37177,sideshowbarker,,20,10,10,20
37178,Damian808,,1,1,1,2
37179,bufordtwain,,20,10,16,26
37180,textibule,,13,1,1,2
37181,chrisdsn,,6,1,2,3
37182,hst,,18,2,3,5
37183,hmahonen,,20,1,3,4
37184,hammerandsickle,,14,1,3,4
37185,touchor,,34,8,23,31
37186,chaosmachine,,18,627,121,748
37187,abrasax,,18,374,417,791
37188,justing1319,,32,4,6,10
37189,happy__teapot,,6,3,10,13
37190,MasterAaron01,,21,18,14,32
37191,creoderiot,,31,1,2,3
37192,mudkipzez,,6,1,1,2
37193,zlochko,,8,7,3,10
37194,backside180,,13,38,12,50
37195,______o_o______,,18,4,4,8
37196,red7,,19,18,27,45
37197,polymyxin12,,19,86,142,228
37198,PlanetPluto,,22,4,1,5
37199,nickster,,1,3,1,4
37200,Atnan,,20,52,116,168
37201,bkhl,,1,1,2,3
37202,w-g,,20,75,96,171
37203,fo7Jithi,,20,3,2,5
37204,ru469,,13,13,22,35
37205,thadd,,23,3,11,14
37206,goldbug,,19,2,4,6
37207,dizangfoo,,19,3,4,7
37208,HowardWCampbell,,32,10,39,49
37209,somas,,20,95,12,107
37210,toto27,,6,1,2,3
37211,bluesecurity,,22,125,211,336
37212,RNHurt,,20,161,69,230
37213,SilentJay74,,5,2,5,7
37214,Legolas-the-elf,,20,252,322,574
37215,gvn,,18,7,3,10
37216,AmericanGladiator,,31,16,12,28
37217,didyouwoof,,13,3,2,5
37218,pandemic,,1,159,161,320
37219,jpsc,,19,6,12,18
37220,hellchick,,18,53,64,117
37221,xinhoj,,11,831,1404,2235
37222,Sonic_Eternity,,34,3,12,15
37223,joetherugger,,13,16,35,51
37224,ordep,,30,1,3,4
37225,ramdulara,,1,9,7,16
37226,phallacy,,32,30,18,48
37227,goatbreath,,3,36,74,110
37228,herzog31,,19,25,4,29
37229,peted1884,,34,148,295,443
37230,shiner76,,5,2,4,6
37231,superjarvo123,,18,28,32,60
37232,TheEngineer2008,,0,1,1,2
37233,Smelltastic,,18,13,21,34
37234,Mike735,,19,1,1,2
37235,jerguismi,,14,35,26,61
37236,sugarbabe,,12,17,27,44
37237,lauraka,,13,1,1,2
37238,californiascuba,,13,47,74,121
37239,Cynical_Bastard,,20,1,1,2
37240,bneises,,31,9,9,18
37241,ComicPolice,,34,1,1,2
37242,makemeking706,,5,3,2,5
37243,kevwil,,20,2,14,16
37244,placidified,,20,47,25,72
37245,qurashee,,18,7,4,11
37246,jenn79,,2,1,1,2
37247,elephantitis,,41,12,17,29
37248,MonkeyPilot,,13,22,8,30
37249,cratuki,,20,159,203,362
37250,johndarippah,,0,15,1,16
37251,fredhondaman,,31,1,1,2
37252,stilesjp,,1,716,469,1185
37253,qqqqq5,,4,37,51,88
37254,meccano,,34,1,3,4
37255,jeff61813,,19,3,7,10
37256,levyc,,13,2,5,7
37257,kkiran7,,42,12,12,24
37258,Elfin,,14,1,2,3
37259,vlodrac,,18,10,8,18
37260,bobiks,,18,68,3,71
37261,someguy432,,19,1,2,3
37262,gatesclone,,13,146,5,151
37263,enomar,,16,6,2,8
37264,theeth,,20,723,1131,1854
37265,Vid4554,,42,9,10,19
37266,olloe,,5,1,1,2
37267,zeeteekiwi,,3,3,3,6
37268,element8,,34,13,29,42
37269,redditation,,5,7,7,14
37270,snowKFH,,6,3,3,6
37271,RiotGrrrl,,19,10,8,18
37272,artsrc,,20,3,8,11
37273,Aleut,,12,212,228,440
37274,shyven,,18,1,3,4
37275,rane56,,13,9,18,27
37276,yyzed76,,20,20,20,40
37277,rhsarod,,8,1,4,5
37278,acticube,,20,4,1,5
37279,eleventyseven,,6,2,1,3
37280,marney,,18,15,27,42
37281,icStatic,,42,2,4,6
37282,Japface,,18,28,64,92
37283,xento,,19,1,3,4
37284,DARGONTeraAlpha,,36,13,3,16
37285,noneMediocre29,,32,1,1,2
37286,lakhwaira,,18,38,59,97
37287,rboucher,,20,7,4,11
37288,mackerel_pudding,,18,1,2,3
37289,glock22ownr,,5,4,15,19
37290,euphist,,13,3,3,6
37291,ThreadKiller,,0,35,66,101
37292,asev0,,1,25,38,63
37293,saprian,,13,10,9,19
37294,sc0ticus,,20,74,23,97
37295,innocentcriminal,,18,6,13,19
37296,zeos,,13,1,6,7
37297,lost_patriot,,42,2,1,3
37298,jabamodern,,18,4,1,5
37299,bopper,,41,1,2,3
37300,Aidenn0,,20,4,5,9
37301,meiostin,,32,1,2,3
37302,zyb09,,18,29,32,61
37303,henrix,,18,45,96,141
37304,diddy0071,,1,238,494,732
37305,ariagloris,,18,2,6,8
37306,Draders,,30,93,253,346
37307,zamba,,31,20,26,46
37308,GhostyBoy,,1,30,37,67
37309,fxscreamer,,1,11,12,23
37310,eronanke,,39,281,480,761
37311,thewhall,,19,1,3,4
37312,sstrader,,29,57,108,165
37313,pompitous_of_love,,0,46,109,155
37314,nabla,,20,3,7,10
37315,cjbprime,,20,2,1,3
37316,godsmack,,19,6,7,13
37317,berkut,,20,3,13,16
37318,gezas,,19,46,83,129
37319,sv0f,,13,1,1,2
37320,DublinBen,,18,39,46,85
37321,mistermajik2000,,18,597,322,919
37322,RANDOM_UPMOD,,12,6,14,20
37323,veracity024,,0,488,113,601
37324,thewazman,,31,3,2,5
37325,Cochise91,,34,2,1,3
37326,tva,,14,3,1,4
37327,Cheesejaguar,,32,11,11,22
37328,burnitdown666,,32,6,12,18
37329,mistergin,,39,1,2,3
37330,mikelly1220,,12,8,3,11
37331,higgledy,,18,6,11,17
37332,thewarriorclan,,13,6,5,11
37333,c130,,18,8,23,31
37334,davet111,,22,56,46,102
37335,FunkDaddy,,18,7,11,18
37336,2090nen,,29,1,1,2
37337,vertibird,,13,30,45,75
37338,btryan,,31,2,2,4
37339,yelloueze,,0,75,68,143
37340,whitey,,13,30,58,88
37341,blorg,,22,154,251,405
37342,alienRR,,1,12,7,19
37343,ShillOReilly,,31,5,10,15
37344,kobebryant,,19,4,3,7
37345,djrock3k,,18,1,5,6
37346,thepaulm,,35,4,5,9
37347,brandocraig,,4,7,5,12
37348,geigerwf,,12,1,1,2
37349,moonlet,,2,1,1,2
37350,bnw2001,,34,2,2,4
37351,whuddafugger,,29,30,58,88
37352,klyde,,13,684,1284,1968
37353,bejitunksu,,22,2,6,8
37354,pitbull4life,,1,1,2,3
37355,OkcPowerplayer,,1,122,121,243
37356,itookyerjob,,13,58,94,152
37357,funnyhel,,43,1,2,3
37358,vorgalsint,,27,20,47,67
37359,MooseGoggles,,0,27,32,59
37360,CausticPuppy,,6,61,55,116
37361,iDigg,,18,6,11,17
37362,mekanic,,32,1,1,2
37363,FredricBastiat,,33,2,1,3
37364,KNOW_IT_ALL_DOUCHE,,1,2,1,3
37365,nycballer,,13,20,24,44
37366,duncanforthright,,31,15,16,31
37367,quikness,,43,27,15,42
37368,sethph,,43,8,13,21
37369,psdtocode,,22,127,181,308
37370,johngault,,13,12,19,31
37371,douche_bag,,26,1,2,3
37372,FMERCURY,,19,294,390,684
37373,jazo,,34,14,4,18
37374,MoreCowbells,,35,38,87,125
37375,casual_observer,,31,300,231,531
37376,christiangenco,,1,22,15,37
37377,evgen,,20,114,179,293
37378,rfschmid,,32,1,3,4
37379,eternalseptember,,43,21,52,73
37380,shimali,,20,10,1,11
37381,Gamblore742,,0,5,16,21
37382,unforgotten,,5,121,23,144
37383,slalka,,18,2,6,8
37384,pmather007,,6,6,9,15
37385,kristikursty72,,32,1,1,2
37386,gizzywump,,18,5,4,9
37387,wariscrime,,13,29,1,30
37388,yorosa,,13,849,18,867
37389,alexbl,,20,7,3,10
37390,r1c1,,20,16,4,20
37391,ajiusdc,,17,3,5,8
37392,toastercookie,,22,32,42,74
37393,zacha,,19,61,105,166
37394,quakerob,,31,21,8,29
37395,lochlanmasters,,9,23,36,59
37396,athueryt,,18,32,1,33
37397,clueless_grammarian,,43,7,9,16
37398,aelfy,,22,81,73,154
37399,obscurant,,13,130,88,218
37400,mattculbreth,,20,49,24,73
37401,kmad,,30,16,12,28
37402,purfler,,1,6,5,11
37403,MatthewWhitworth,,20,1,1,2
37404,Burgessww,,0,21,5,26
37405,krsvbg,,1,5,9,14
37406,UnreasonableThursday,,3,15,13,28
37407,Technohazard,,13,2,3,5
37408,employee3831,,4,1,1,2
37409,TheGS,,0,1,4,5
37410,aligon,,4,7,5,12
37411,ahmic,,18,4,15,19
37412,chaz64,,20,1,1,2
37413,cup,,31,992,408,1400
37414,oyvindra,,22,9,24,33
37415,resutidder,,18,42,43,85
37416,Erlebnis,,1,7,1,8
37417,AngerIsAGift,,31,4,13,17
37418,FHReddit,,30,29,31,60
37419,goobershank,,31,1,2,3
37420,b4711k,,9,2,1,3
37421,mediaarts,,30,57,114,171
37422,Fr0C,,31,4,8,12
37423,Stormflux,,19,635,745,1380
37424,mitchandre,,13,486,259,745
37425,annagorn,,32,1,2,3
37426,cwj14,,4,1,1,2
37427,Negative_3,,31,2,3,5
37428,beersmith,,6,1,1,2
37429,politicass,,31,12,13,25
37430,mazza07,,5,17,33,50
37431,rlwimi,,20,11,8,19
37432,dinglecherry,,5,2,2,4
37433,yaxu,,20,57,7,64
37434,ssc,,18,4,6,10
37435,SometimesTheFur,,18,21,46,67
37436,kamalfariz,,20,2,1,3
37437,Haron237,,0,1,1,2
37438,TerriSchiavo,,19,2,13,15
37439,ashnayde,,29,5,4,9
37440,wbxp99,,1,4,2,6
37441,jtarchie,,20,3,6,9
37442,DamnRightAnonymous,,34,2,3,5
37443,ShootTheMoon,,34,6,5,11
37444,freemarketsocialist,,13,2,2,4
37445,omarimous,,18,113,45,158
37446,spanky_munkee,,19,1,1,2
37447,VeganZombie,,34,11,16,27
37448,jcn333,,19,4,3,7
37449,lazylion,,12,2,5,7
37450,framob,,23,2,1,3
37451,Popperian,,13,75,116,191
37452,mattflight,,18,9,29,38
37453,southamerica,,19,3,16,19
37454,dougn,,14,1,2,3
37455,hellsbelles,,0,171,188,359
37456,gxti,,20,243,433,676
37457,robjarvis,,32,4,6,10
37458,wyakin,,19,4,8,12
37459,stfu_noob,,1,1,1,2
37460,pilotofthefuture,,18,56,9,65
37461,minerva66,,19,1,1,2
37462,thehippestcat,,18,7,11,18
37463,crosscreek,,0,1,2,3
37464,thedaemon,,12,56,93,149
37465,iiiiiiiiiiiiiiiiiiii,,42,12,11,23
37466,adelcambre,,18,2,2,4
37467,k-zed,,34,2,1,3
37468,ohnoherewegoagain,,31,1,10,11
37469,mazman23,,19,26,36,62
37470,rarebit13,,18,24,3,27
37471,Socioillogica,,43,15,40,55
37472,sstoks,,20,1,1,2
37473,Kamakazi,,31,8,7,15
37474,MechanTOurS,,20,6,16,22
37475,eoliveri,,43,118,236,354
37476,lostmoya,,22,38,6,44
37477,elquesogrande,,0,1093,232,1325
37478,xFUCKTHISx,,14,1,4,5
37479,sujaymahajan,,1,3,1,4
37480,slipkid,,19,134,112,246
37481,THEMACGOD,,32,79,163,242
37482,aeroevan,,22,1,3,4
37483,pilois,,13,17,24,41
37484,Karinett,,18,71,9,80
37485,cuetip,,32,1,1,2
37486,frommyperspective,,20,1,1,2
37487,skribeiv,,31,3,3,6
37488,nom_de_guerre,,20,89,57,146
37489,roses4u,,20,1,1,2
37490,thundirbird,,18,8,12,20
37491,heminator,,13,5,8,13
37492,kssreeram,,20,22,5,27
37493,jast,,20,47,6,53
37494,atorch,,22,1,1,2
37495,redditers_for_units,,13,1,1,2
37496,GrammarMan,,19,1,4,5
37497,clicksnapshot,,17,41,19,60
37498,Happy31,,5,50,60,110
37499,aar0nm,,31,1,7,8
37500,supermansuper,,1,3,3,6
37501,igiveyouahamburger,,4,1,1,2
37502,grigri55,,29,2,3,5
37503,zgress,,1,25,28,53
37504,scipio007,,18,2,4,6
37505,thievedrelic,,10,3,2,5
37506,anions,,1,393,618,1011
37507,down_river,,18,5,8,13
37508,littledan,,20,36,53,89
37509,hexayurt,,13,129,80,209
37510,trevorturk,,20,28,19,47
37511,rmal,,18,12,2,14
37512,knight666,,22,1103,1141,2244
37513,Spell,,20,63,111,174
37514,TheKettle,,1,3,1,4
37515,deuteros,,19,2972,2688,5660
37516,codewaffle,,34,10,7,17
37517,papaia,,1,5,12,17
37518,infaereld,,15,102,17,119
37519,voodoo123,,0,1,1,2
37520,my_complaint_about,,12,8,7,15
37521,financegeek,,34,28,1,29
37522,coloradosteve,,18,111,8,119
37523,duus,,6,1041,2294,3335
37524,krugerlive,,19,1639,1319,2958
37525,truckee,,34,1,1,2
37526,TitanBane,,19,97,50,147
37527,powerdeamon,,18,25,92,117
37528,cotterbo,,19,8,20,28
37529,talios,,18,1,1,2
37530,basf,,20,3,2,5
37531,emice,,14,1,3,4
37532,answerguru,,12,14,29,43
37533,hayzooz,,19,1,5,6
37534,JohnLayman,,5,85,62,147
37535,tchorix,,20,1,1,2
37536,MissMozo,,1,58,41,99
37537,ow1n,,5,105,191,296
37538,TheChameleon84,,31,54,82,136
37539,dirtside,,20,8,3,11
37540,bethy08,,18,266,4,270
37541,sirslim,,18,1,2,3
37542,JustinTheBear,,34,1,2,3
37543,ravi86,,1,10,12,22
37544,kernelpanik,,13,20,22,42
37545,techtonix,,19,1074,43,1117
37546,tarded,,13,44,32,76
37547,groundctrl,,1,100,70,170
37548,Dwersteg,,18,6,7,13
37549,ctkeene,,20,1,1,2
37550,doctorperv,,42,71,75,146
37551,vr6vdub,,18,2,7,9
37552,jamierc,,43,619,662,1281
37553,tgriffin,,0,5,13,18
37554,asleepy0,,18,74,85,159
37555,rdhatt,,43,11,10,21
37556,moviewhoremania,,19,1,7,8
37557,dreqmer37,,32,8,15,23
37558,caryw,,34,1,4,5
37559,eviljames,,30,96,140,236
37560,mbrown758,,19,12,11,23
37561,axthos,,18,4,19,23
37562,freeklicious,,1,1,1,2
37563,bmar,,13,1,1,2
37564,dialector,,13,4,2,6
37565,Hasteur,,23,7,7,14
37566,dwu2,,18,3,1,4
37567,davecrist,,1,3,5,8
37568,Work45,,13,248,158,406
37569,playwithmywii,,0,12,9,21
37570,prophit,,31,35,49,84
37571,fru1t,,4,1,1,2
37572,harryf,,20,224,85,309
37573,tomata,,22,11,12,23
37574,dagneytaggart,,13,8,8,16
37575,basilv,,20,7,1,8
37576,badr0b0t,,15,2,5,7
37577,Dyphy,,43,1,2,3
37578,derb,,15,1,8,9
37579,turbo,,21,166,199,365
37580,taggat,,19,40,74,114
37581,lykeless,,19,37,26,63
37582,pechinburger,,0,675,228,903
37583,highmy7829900,,18,8,1,9
37584,attrib-s-h-r,,13,7,19,26
37585,kripkenstein,,31,556,522,1078
37586,marsanyi,,12,2,2,4
37587,INaktivist,,18,38,83,121
37588,jvdais,,1,7,6,13
37589,goandeatsomestuff,,6,2,4,6
37590,manhands7,,19,1,7,8
37591,lalafalala,,34,52,70,122
37592,Chaoticmass,,20,26,30,56
37593,myname,,31,24,48,72
37594,MrForeskin,,13,165,178,343
37595,r00by,,19,4,6,10
37596,weoh,,20,11,6,17
37597,kaldrazidrim,,18,46,70,116
37598,sbenson,,22,1,1,2
37599,douchemcgee,,15,13,8,21
37600,heyiamt,,34,9,9,18
37601,zack_morris,,13,2,3,5
37602,amaurer,,34,633,83,716
37603,Enlightenment777,,32,40,65,105
37604,england,,18,3,7,10
37605,phaedruss,,43,18,8,26
37606,drokly,,43,10,8,18
37607,gerst-a-burger,,43,4,6,10
37608,newmethod,,22,3,1,4
37609,file-exists-p,,8,17,21,38
37610,TinaBeth,,13,5,6,11
37611,wyclif,,19,41,45,86
37612,dfdffddf,,31,1,4,5
37613,whitey12785,,13,1,2,3
37614,gomoses,,18,647,95,742
37615,WallPhone,,20,69,148,217
37616,pebcak,,11,2,2,4
37617,Tonybonaventura,,19,47,111,158
37618,projomni,,18,11,3,14
37619,illpacin0,,8,10,8,18
37620,eatmyspam08,,18,35,9,44
37621,z5h,,20,22,20,42
37622,kafka0622,,32,9,15,24
37623,Drizzt_DoUrden,,43,2,1,3
37624,zinnate,,12,5,10,15
37625,joelagnel,,20,1,7,8
37626,farfignewton,,9,30,52,82
37627,fargosucks,,18,16,31,47
37628,summernot,,19,285,382,667
37629,fwtskm,,16,10,12,22
37630,mikekfoley,,7,136,8,144
37631,kunkie,,11,2,2,4
37632,GDtrax,,18,4,10,14
37633,warsteiner,,0,56,57,113
37634,Saintstace,,22,8,26,34
37635,chatmonchy,,18,38,10,48
37636,klinny,,34,124,36,160
37637,codoholic,,4,4,3,7
37638,genesai,,13,12,14,26
37639,Beefington,,11,22,35,57
37640,sportsstar67,,13,9,6,15
37641,Fedge,,10,30,36,66
37642,kretik,,20,200,213,413
37643,elucubra,,31,29,40,69
37644,vicissitude,,20,2,2,4
37645,Splody,,19,3,5,8
37646,davebg8r,,13,5,4,9
37647,dizzle67,,19,2261,77,2338
37648,redgrave,,42,1,2,3
37649,drowning,,18,268,16,284
37650,stockefeller,,21,2,2,4
37651,_Hillary_Clinton_,,8,2,1,3
37652,FW190,,1,1,7,8
37653,shinigami3,,20,38,14,52
37654,yamil,,31,11,4,15
37655,weak,,13,49,10,59
37656,rockchops,,32,1,5,6
37657,kilonad,,1,6,9,15
37658,Saiing,,4,752,745,1497
37659,bowiebellapeatipursi,,6,16,2,18
37660,jtbob,,31,23,26,49
37661,rissotto,,34,8,4,12
37662,d00kiestain,,20,34,6,40
37663,gabor,,20,8,7,15
37664,howNowBrownSow,,18,15,33,48
37665,chrishouser,,1,1,1,2
37666,wockyman,,4,337,374,711
37667,GravyJefferson,,1,7,16,23
37668,antiskub,,3,3,2,5
37669,lolomfgkthxbai,,31,365,538,903
37670,fishizell,,22,1,1,2
37671,kru5h,,1,213,323,536
37672,norkakn,,20,62,111,173
37673,jconnell,,31,65,41,106
37674,The_Chaos_Pope,,43,2,2,4
37675,mtx,,12,270,394,664
37676,sneg,,31,30,26,56
37677,Step1Mark,,31,7,20,27
37678,becda289,,13,3,4,7
37679,k4p,,18,4,8,12
37680,egregious,,43,75,306,381
37681,DocOBackbush,,18,38,41,79
37682,FatPhil,,43,60,33,93
37683,kooknboo,,19,3,9,12
37684,ddfreyne,,20,25,27,52
37685,davy_crockett,,42,386,487,873
37686,hypergeek,,42,3,2,5
37687,heywoodidaho,,1,10,33,43
37688,thechrispy,,19,2,1,3
37689,vitali_y,,30,9,5,14
37690,fuckoffcuntface,,12,1,1,2
37691,NancyGracesTesticles,,18,661,1015,1676
37692,Howard_Beale,,18,12,22,34
37693,aperion,,10,1,1,2
37694,fishb0t,,30,1,6,7
37695,joeljohnson,,19,2,1,3
37696,stivnan,,5,1,4,5
37697,flywheel,,0,297,479,776
37698,MackDaddy1,,18,95,6,101
37699,-So-,,12,6,9,15
37700,marthirial,,18,327,375,702
37701,wizardofoz,,15,4,17,21
37702,turbotron,,22,79,75,154
37703,threesheds,,20,7,15,22
37704,lexfor,,32,8,17,25
37705,lazyant,,30,12,9,21
37706,rizzomegav,,28,5,11,16
37707,OMLE,,4,11,4,15
37708,shempey,,1,3,6,9
37709,fartographer,,12,1,1,2
37710,livefree2day,,34,1,2,3
37711,wsoccerl6,,11,9,8,17
37712,Gandhilion,,21,4,4,8
37713,goonsquad,,13,138,57,195
37714,IamTCM,,1,41,44,85
37715,Sweetpipe,,18,2,5,7
37716,radioprotector,,34,4,4,8
37717,sheepster26,,20,1,2,3
37718,steve_g,,20,41,5,46
37719,kratsnitram,,18,1,4,5
37720,derleth,,32,15,14,29
37721,mwickens,,18,1,1,2
37722,clidiere,,2,1,1,2
37723,Holdthepickle,,13,9,22,31
37724,iodian,,18,62,126,188
37725,johnvanveen,,31,34,51,85
37726,eremitix,,19,1,3,4
37727,affffacebooke,,34,1,4,5
37728,qacek,,20,68,59,127
37729,quiso,,20,14,13,27
37730,feylar,,13,9,11,20
37731,cameroncox,,20,12,11,23
37732,eckliptic,,18,18,26,44
37733,sirmizzle,,1,10,8,18
37734,avigesaa,,20,7,12,19
37735,sonofgram,,4,5,7,12
37736,agentq512,,13,11,4,15
37737,arpie,,11,27,11,38
37738,p-o-s-t-a-l,,34,3,5,8
37739,McHenry,,36,3,3,6
37740,runrunwootwoot,,1,719,395,1114
37741,Jamie_Rules,,1,1,3,4
37742,xtn,,16,5,4,9
37743,Gillios,,31,1,4,5
37744,SenatorGovernment,,13,2,8,10
37745,djtomr941,,38,24,32,56
37746,crushedbyadwarf,,13,18,24,42
37747,vlemx,,19,6,5,11
37748,iamnot,,20,8,26,34
37749,ThumperNM,,18,2,4,6
37750,drev,,18,40,30,70
37751,xman2000,,3,21,15,36
37752,Ramb0,,42,115,4,119
37753,troywrestler2002,,13,1,2,3
37754,beedogs,,19,350,408,758
37755,lippop,,31,3,5,8
37756,fuqtard,,20,5,7,12
37757,burntsushi,,29,22,8,30
37758,vlance,,32,8,4,12
37759,tacapd42,,18,4,6,10
37760,I_Think_Youre_Stupid,,0,3,5,8
37761,macaddct1984,,43,2,1,3
37762,joshfern,,22,117,168,285
37763,itsfundamenthole,,13,3,8,11
37764,unusedusername,,8,7,7,14
37765,vornan19,,1,20,50,70
37766,mrmonkey,,20,54,8,62
37767,AchmedDeadTerrorist,,43,1,1,2
37768,Dan_Forden,,20,1,1,2
37769,enlzen,,19,159,216,375
37770,gavinjones,,4,13,9,22
37771,icebird,,6,34,58,92
37772,periodic,,20,57,50,107
37773,GodShapedBullet,,32,72,39,111
37774,amp108,,0,19,16,35
37775,adaptable,,20,37,5,42
37776,PanicBot,,9,7,5,12
37777,RiteJoe,,5,1,9,10
37778,kickm3,,13,2,4,6
37779,fermatapiola,,18,8,1,9
37780,miparasito,,0,140,194,334
37781,kniteshade,,43,13,21,34
37782,ianrhett,,41,2,3,5
37783,sshanky,,18,17,16,33
37784,hencethus,,16,43,43,86
37785,castle9mm,,30,8,15,23
37786,msawyer3,,20,5,1,6
37787,zjunk,,1,30,21,51
37788,nicxvan,,1,198,236,434
37789,sdn,,22,256,316,572
37790,blacky12,,13,1,1,2
37791,jotaroh,,28,581,997,1578
37792,nkosi,,19,10,11,21
37793,samwisefoxburr,,32,9,7,16
37794,wulfilia,,8,76,134,210
37795,erOhead,,14,1,2,3
37796,leedo,,23,2,2,4
37797,chubbiguy40,,13,10,12,22
37798,NashMcCabe,,13,49,71,120
37799,poonerton,,19,5,3,8
37800,rational1212,,32,23,29,52
37801,dadagiri,,21,7,14,21
37802,namesbc,,31,2,1,3
37803,albaum,,13,12,4,16
37804,sean_galt,,22,10,9,19
37805,coding-time,,20,12,5,17
37806,skubajon,,18,7,2,9
37807,kimsagro,,20,1,1,2
37808,simonbh,,30,3,1,4
37809,polipsy,,18,2,6,8
37810,Skamandrios,,43,4,7,11
37811,bhn1997,,13,5,4,9
37812,550,,20,30,8,38
37813,jeremybub,,1,226,365,591
37814,zvisus,,6,9,5,14
37815,cheald,,20,69,85,154
37816,seacreeks,,0,8,14,22
37817,mikec23,,13,18,50,68
37818,Balso,,3,1,1,2
37819,philodespotos,,8,1,1,2
37820,emkat,,13,3,3,6
37821,jr308,,1,6,10,16
37822,cryptyk,,31,103,50,153
37823,zyron,,17,1,1,2
37824,The_Doc,,43,2,6,8
37825,spamly,,13,7,19,26
37826,market,,18,53,42,95
37827,swieton,,20,17,13,30
37828,wesdyer,,20,3,1,4
37829,murphee_,,20,52,10,62
37830,mad4,,5,1,1,2
37831,nsoonhui,,20,113,8,121
37832,observantAlien,,22,5,5,10
37833,Butt_Scratcher,,1,43,68,111
37834,ashuri2,,18,50,30,80
37835,HUAONE,,19,26,42,68
37836,BCTripster,,18,1,4,5
37837,DennisRMortensen,,20,3,1,4
37838,scar_face,,38,1,2,3
37839,Pystt,,34,1,1,2
37840,TanisDLC,,18,1,2,3
37841,BruceSanchez,,32,1,2,3
37842,olivepit,,41,3,4,7
37843,foolinator,,13,64,120,184
37844,joeldsouza,,5,2,1,3
37845,spamelita,,30,7,3,10
37846,runenes,,18,6,12,18
37847,sharpeskii,,17,1,2,3
37848,HappyHarryHardOn,,5,6,12,18
37849,juuley,,43,2,7,9
37850,tangus,,20,32,48,80
37851,CinDan,,15,1,1,2
37852,Uggy,,0,7,7,14
37853,locusto03,,1,47,26,73
37854,asylumua,,20,7,7,14
37855,kingprem,,0,11,6,17
37856,flamable221,,19,19,30,49
37857,wote89,,13,12,12,24
37858,jeff76767,,18,2,9,11
37859,eggnogdog,,29,235,273,508
37860,gersoid,,22,10,9,19
37861,danglingwrangler,,13,6,1,7
37862,gruelin1,,18,1,2,3
37863,cjz0r,,17,2,1,3
37864,mellowcreme,,34,3,7,10
37865,rjuliani,,13,17,21,38
37866,knomb,,19,7,2,9
37867,sa4720k,,13,5,8,13
37868,Starrydancer,,13,1,4,5
37869,jonnyfrag,,39,1,1,2
37870,yess-s,,6,3,3,6
37871,Blackheart,,10,26,44,70
37872,Seakneeboy,,7,5,13,18
37873,dattaway,,33,35,61,96
37874,I_AM_A_NEOCON,,0,902,543,1445
37875,aminakodugumpici,,19,1,1,2
37876,Cdresden,,19,140,261,401
37877,lalemon,,6,74,112,186
37878,LonelyGuy,,0,15,6,21
37879,C_Marivs,,4,30,45,75
37880,hare2dacore,,34,5,7,12
37881,epheron,,30,2,8,10
37882,cableshaft,,20,87,76,163
37883,myworld,,19,32,4,36
37884,BeRoKaViCh,,18,118,137,255
37885,Snoww,,18,98,76,174
37886,Spacksack,,31,1068,802,1870
37887,stevie_h,,31,5,1,6
37888,psi_,,43,9,9,18
37889,pfile,,10,1,2,3
37890,InterPunct,,17,81,116,197
37891,PhotoJim,,18,2,4,6
37892,paulgone,,19,1,1,2
37893,vtwizzie,,19,7,5,12
37894,jer2665,,8,1,1,2
37895,sliter9,,43,4,5,9
37896,maryelens,,19,1,2,3
37897,dmunky,,18,4,7,11
37898,UmberGryphon,,14,61,68,129
37899,ganko,,19,2,1,3
37900,helpingfriendlybook,,13,1,2,3
37901,INKRIMINATOR,,8,5,5,10
37902,clemecha,,0,1,1,2
37903,uglypopstar,,13,10,37,47
37904,stgeorgiew,,43,1,1,2
37905,HattoriHanzo,,20,117,147,264
37906,xakh,,18,49,108,157
37907,last_chance,,0,1,2,3
37908,CyberSol,,13,7,15,22
37909,zamfi,,19,1,3,4
37910,vanblah,,18,2,2,4
37911,veni_vidi_verily,,1,21,3,24
37912,ukeagle,,13,1,2,3
37913,Wolfgangg,,14,2,1,3
37914,NoMcBush,,13,80,65,145
37915,Jawmaster,,5,26,57,83
37916,node1217,,20,1,3,4
37917,Ken_Breadbox,,30,71,78,149
37918,CR1M1N4L,,18,80,87,167
37919,lephron,,20,15,8,23
37920,randomguy348,,0,24,24,48
37921,jonbro,,31,2,1,3
37922,scoomdot,,1,3,2,5
37923,jetfar,,20,259,37,296
37924,TheSchalter,,20,7,1,8
37925,michael111,,18,9,3,12
37926,f0000,,1,2,3,5
37927,BeTheChange,,19,60,78,138
37928,mkfa10,,0,18,31,49
37929,Nimnio,,20,3,7,10
37930,didactus,,20,2,2,4
37931,othermaciej,,20,67,65,132
37932,cheshirepuss,,18,46,76,122
37933,astro,,20,4,11,15
37934,inquisitor5,,5,20,14,34
37935,JesusHusseinChrist,,32,40,61,101
37936,the-gray-squirrel,,19,76,109,185
37937,stickynotes,,4,5,1,6
37938,HunterTV,,43,747,865,1612
37939,merrijk,,22,3,1,4
37940,tyghbn,,42,2,3,5
37941,digidante,,32,15,29,44
37942,shriphani,,20,1,1,2
37943,logos_flux,,43,1,1,2
37944,streem84,,19,160,240,400
37945,mcguyver,,20,6,16,22
37946,Zambtibabuloustic,,43,1,2,3
37947,effervescence,,31,3,2,5
37948,beerboy1,,19,1,1,2
37949,kimol,,20,1,1,2
37950,jakedakat,,13,10,12,22
37951,aeoutfitters33,,29,1,1,2
37952,RagingKegger,,20,32,30,62
37953,ruth3,,1,2,1,3
37954,leonhyral,,1,36,63,99
37955,axonxorz,,0,22,22,44
37956,wang-sucker,,13,1,1,2
37957,aeric,,22,20,31,51
37958,Aliens_From_Saturn,,1,2,2,4
37959,pls,,20,2,3,5
37960,pantsu,,19,20,19,39
37961,digdugdang,,18,3,7,10
37962,zl_xyz_lz,,8,2,2,4
37963,famousbirds,,20,2,4,6
37964,scafe,,31,1,1,2
37965,IamAnt,,13,7,3,10
37966,mrbook,,20,1,4,5
37967,coachFox,,18,90,73,163
37968,aknightnarmor,,13,73,1,74
37969,Sammi72,,19,4,17,21
37970,fashionrobot,,18,3,2,5
37971,eobanb,,43,129,116,245
37972,ichthis,,30,43,33,76
37973,sixthree,,42,24,27,51
37974,bearhunter,,3,2,1,3
37975,failtrain,,28,3,8,11
37976,linuxrebel,,32,23,11,34
37977,Barnlinger,,13,193,153,346
37978,yuurei,,43,31,44,75
37979,monchavo,,22,19,25,44
37980,macadamian,,34,20,38,58
37981,wjessup,,8,1,1,2
37982,Noose,,17,25,27,52
37983,Karrionhardt,,18,4,5,9
37984,bongoboy,,19,4,1,5
37985,mike_at_ysm,,10,1,1,2
37986,tehsma,,18,7,13,20
37987,pr073u5,,29,5,5,10
37988,ekoleda,,20,25,7,32
37989,maxmartin,,43,245,222,467
37990,monkeybanana,,20,1,1,2
37991,serenity450,,19,15,30,45
37992,thealphateam,,43,3,4,7
37993,gregwolejko,,20,18,3,21
37994,asundevil,,5,143,92,235
37995,infectedmushroom,,22,3,3,6
37996,knome,,20,78,111,189
37997,Tantalon,,18,919,12,931
37998,satanist,,6,125,169,294
37999,antihostile,,26,344,375,719
38000,12_strangers,,32,77,127,204
38001,jeremyh42,,13,16,25,41
38002,TheZorch,,0,105,142,247
38003,djreed,,19,12,18,30
38004,Ramonster,,32,117,173,290
38005,funkalicious,,35,3,1,4
38006,hardcoded,,32,65,16,81
38007,Eth4n,,33,12,14,26
38008,ll0l00,,19,1,2,3
38009,simoretu,,19,9,1,10
38010,huttson,,13,9,3,12
38011,jamiemccarthy,,19,20,9,29
38012,iamweasel1022,,18,12,17,29
38013,rrabbits,,20,1,2,3
38014,RickHoncho,,43,1,1,2
38015,jcy,,8,68,95,163
38016,TheMoralOfTheStory,,32,1,1,2
38017,Cody2sDown,,0,1,2,3
38018,mattbob,,13,1,3,4
38019,newPre,,13,8,13,21
38020,alrond,,31,2,1,3
38021,agingpopstar,,10,17,48,65
38022,jmnugent,,20,129,36,165
38023,rufenstein,,42,2,5,7
38024,theDrWho,,26,690,1129,1819
38025,stevesreb,,8,1,1,2
38026,MichaelMelen,,5,1,5,6
38027,random_hyp,,8,2,2,4
38028,nelud,,43,10,3,13
38029,woodeye,,13,79,97,176
38030,woodrail,,32,23,43,66
38031,polarbobbear,,18,187,167,354
38032,flashgeek,,0,5,5,10
38033,barsik_,,18,72,4,76
38034,Jaefster,,42,10,24,34
38035,leieva,,32,8,14,22
38036,d_crosil,,1,1,3,4
38037,spoortehtf,,19,65,81,146
38038,mtdynamics,,1,15,47,62
38039,political,,13,131,105,236
38040,eldre,,8,83,86,169
38041,zoominyoomin,,13,1,2,3
38042,calmlikeabomb,,19,186,223,409
38043,smux,,22,1,1,2
38044,schoolisdeath,,19,24,17,41
38045,Kitchenfire,,32,21,39,60
38046,TacoJackson,,16,3,5,8
38047,cybernuda,,12,5,14,19
38048,meanmeosh,,12,26,15,41
38049,strombom,,30,9,8,17
38050,seemikedraw,,22,4,4,8
38051,crististm,,20,20,3,23
38052,kflasch,,20,24,37,61
38053,markstos,,20,25,17,42
38054,liedel,,12,13,5,18
38055,leosoto,,20,9,17,26
38056,Nidonocu,,4,6,5,11
38057,jeyoung,,22,11,18,29
38058,woolleybear,,31,12,31,43
38059,billydreamer,,19,2,7,9
38060,mango_feldman,,34,4,2,6
38061,davinox,,34,19,27,46
38062,juanjodic,,31,47,90,137
38063,YawningDog,,43,2,3,5
38064,pavlik_fan,,19,2,1,3
38065,lumpy1981,,19,199,313,512
38066,gyani,,43,9,12,21
38067,mac,,20,25,10,35
38068,kristopolous,,31,137,187,324
38069,mccartichoke,,13,16,6,22
38070,Brittix1023,,20,21,15,36
38071,jenks,,22,17,31,48
38072,droolingmnky,,43,1,1,2
38073,brettwojo,,20,1,1,2
38074,Eyesaw,,18,840,15,855
38075,banter_,,22,1,1,2
38076,billyneverdies,,18,6,7,13
38077,Redditman,,2,2,5,7
38078,SumDood,,19,60,1,61
38079,gogobyte,,31,2,9,11
38080,reeseallen,,43,234,70,304
38081,kastlerouge,,5,1,4,5
38082,rainfosys,,18,523,27,550
38083,timecrash,,20,14,8,22
38084,GetsEclectic,,20,10,17,27
38085,g1bb,,1,48,25,73
38086,DAWTSF,,18,46,74,120
38087,CecilBenedict,,19,6,1,7
38088,sbo1,,39,1,1,2
38089,bluebuddha,,13,1,1,2
38090,kubalaa,,20,68,67,135
38091,hypo11,,1,472,425,897
38092,ragor,,18,54,68,122
38093,abofh,,19,13,9,22
38094,almega,,30,50,22,72
38095,guccigirlie01,,19,1,1,2
38096,pdk,,8,9,4,13
38097,jlucamaroz28,,13,15,25,40
38098,naixn,,18,21,11,32
38099,Havage,,18,80,99,179
38100,tick113,,23,6,9,15
38101,neilien,,13,16,34,50
38102,DJGibbon,,31,9,9,18
38103,notanidiot,,39,4,6,10
38104,jaquehamr,,22,37,69,106
38105,annoyed,,19,98,152,250
38106,2tall,,19,9,26,35
38107,cloudform,,18,1,2,3
38108,keithchegwin,,20,8,14,22
38109,jculbertson,,30,3,1,4
38110,lhnz,,10,2,7,9
38111,tuber,,1,1195,1748,2943
38112,donp17,,13,3,2,5
38113,mhrnjad,,20,14,7,21
38114,kurtu5,,31,208,437,645
38115,MissLiberty,,8,1,1,2
38116,olav,,18,1,1,2
38117,Helicon1,,13,28,9,37
38118,self_promotion_whore,,20,2,2,4
38119,Fenrise,,13,17,7,24
38120,SoulShock,,18,50,12,62
38121,serkel,,43,1,1,2
38122,jonsayer,,1,12,13,25
38123,redmouse,,10,1,1,2
38124,dionysis,,18,39,26,65
38125,conspiracy_theorist,,19,299,389,688
38126,spiff56747,,43,2,6,8
38127,Farsay,,29,262,427,689
38128,The_Yeti,,13,449,845,1294
38129,madprophet,,13,2,7,9
38130,robrobrob,,13,3,3,6
38131,justa1timethang,,3,1,1,2
38132,girlsansshoes,,42,1,1,2
38133,capsid,,20,66,52,118
38134,placidwilbur,,19,7,14,21
38135,genron1111,,13,21,50,71
38136,blirg,,20,2,1,3
38137,DigitalHubris,,10,95,115,210
38138,troubleondemand,,30,123,238,361
38139,beef73,,2,1,1,2
38140,Yivo,,4,6,7,13
38141,dlfelps,,18,8,1,9
38142,eb007,,18,175,6,181
38143,mactart,,19,1,2,3
38144,surburban,,20,24,1,25
38145,bananatalk,,18,1323,114,1437
38146,OniNiubbo,,20,14,21,35
38147,Gargilius,,27,688,1103,1791
38148,PlasmaWhore,,22,834,966,1800
38149,GodForbid,,1,61,41,102
38150,Wormwoods,,43,1,1,2
38151,NVShacker,,20,34,46,80
38152,lassef,,23,12,12,24
38153,tremor_tj,,5,2,5,7
38154,koonts51,,18,10,22,32
38155,mmeijeri,,31,91,155,246
38156,sadstate,,20,4,7,11
38157,knowknowledge,,20,262,290,552
38158,maci01,,18,3,16,19
38159,elchupacabra,,18,52,3,55
38160,chengiz,,20,351,314,665
38161,kanokamblameo,,9,6,16,22
38162,Lomaxx,,13,8,8,16
38163,Kale,,20,18,14,32
38164,wheezy360,,11,1,1,2
38165,hoppus,,13,3,3,6
38166,kilvenic,,20,3,10,13
38167,vade,,18,19,47,66
38168,daylight,,18,115,228,343
38169,mbrown,,43,5,5,10
38170,Piratedan200,,32,2,2,4
38171,nickit,,1,1,1,2
38172,ThatcherPark,,16,4,3,7
38173,Jabberwockey,,20,3,7,10
38174,firklar,,20,40,43,83
38175,virmagnus,,6,5,7,12
38176,yoshevhoshev,,0,4,1,5
38177,AdamCohn,,3,3,2,5
38178,woodwater,,1,42,122,164
38179,repeatextension,,41,5,4,9
38180,kc2702,,19,9,18,27
38181,omgzrob,,18,1,5,6
38182,neoporcupine,,15,22,41,63
38183,Mr_Smartypants,,29,1598,2415,4013
38184,DeepThoughts,,1,3,1,4
38185,MikeDimmick,,20,1,1,2
38186,tina306090,,19,6,8,14
38187,1smartasss,,6,2,1,3
38188,accon,,1,6,13,19
38189,s19aw,,31,2,2,4
38190,Palchez,,31,54,81,135
38191,quiller,,32,1336,1805,3141
38192,gardenmandy,,18,153,10,163
38193,youremom,,27,302,457,759
38194,kaythecraven,,1,1,1,2
38195,ami77,,6,4,10,14
38196,nadare,,10,1,2,3
38197,nbuet,,26,5,2,7
38198,read_tfa,,20,2,1,3
38199,shmozz,,18,3,2,5
38200,Duke_,,15,2,4,6
38201,Tordek,,20,36,86,122
38202,tengu,,14,10,19,29
38203,amsterdamn,,13,17,7,24
38204,snoconegypsy,,18,35,1,36
38205,dpholmes,,10,1,2,3
38206,Kawasaki,,19,23,90,113
38207,Mithridates,,13,636,197,833
38208,leoboiko,,22,288,267,555
38209,Ladarzak,,30,133,120,253
38210,wuddersup,,18,392,128,520
38211,quote_bot,,18,1,4,5
38212,asleeponthesun,,22,2,9,11
38213,Jared80KA,,7,2,6,8
38214,mifrai,,20,4,2,6
38215,hoju,,19,66,45,111
38216,Valdus_Pryme,,18,98,321,419
38217,blackbeansandrice,,18,23,25,48
38218,echoman,,36,3,1,4
38219,xblingdaddy2005x,,5,5,12,17
38220,JMV290,,32,61,104,165
38221,Buttercup50,,13,9,10,19
38222,mncaudill,,20,18,21,39
38223,starpage85,,18,1,3,4
38224,cantguesspword,,15,2,8,10
38225,rvidal,,19,3,1,4
38226,hellbox,,22,5,4,9
38227,dcr1256,,39,1,1,2
38228,SmileyChris,,8,3,10,13
38229,jmcguckin,,19,4,6,10
38230,recursivejon,,19,2,4,6
38231,dracovich,,0,57,10,67
38232,itsadok,,18,4,3,7
38233,daviangel,,18,3,3,6
38234,giantsfan134,,4,18,24,42
38235,Madmanden,,43,52,85,137
38236,copperdomebodha,,32,297,192,489
38237,LotR_Rachlin,,19,1,1,2
38238,darylcagle,,0,2,4,6
38239,rz2000,,6,154,265,419
38240,xoctor,,1,175,303,478
38241,hunterjunk,,5,3,6,9
38242,bloodylip,,34,93,130,223
38243,profiteerer,,18,4,3,7
38244,RCSka,,18,11,23,34
38245,longdong,,19,4,1,5
38246,swanyl,,18,407,3,410
38247,XSV_Fizz_,,18,2,7,9
38248,cakeycakes,,18,1,1,2
38249,Icecaste,,18,14,3,17
38250,pappugulal,,13,4,16,20
38251,dh1,,12,7,12,19
38252,tavid,,22,8,1,9
38253,frognutsthe3rd,,13,1,6,7
38254,bogeywebdesign,,13,6,3,9
38255,yanik,,20,7,4,11
38256,Gigwave,,30,2,11,13
38257,tanger,,29,95,118,213
38258,q-_-p,,22,3,6,9
38259,jjash,,32,19,14,33
38260,ravedave,,12,192,252,444
38261,azertus,,30,1,2,3
38262,dorshorst,,22,106,114,220
38263,ANDTHATSAFACT,,4,1,2,3
38264,locklin,,3,28,23,51
38265,niimma,,13,3,1,4
38266,draconnery,,13,28,70,98
38267,CurtisLemay,,19,1,5,6
38268,bxyldy,,43,48,75,123
38269,malexan,,43,27,16,43
38270,jasperjohns,,0,1,3,4
38271,matthavener,,19,4,3,7
38272,Pendin,,8,38,52,90
38273,whynottry,,20,16,21,37
38274,strifeless,,1,19,31,50
38275,rinocom,,31,1,2,3
38276,geppe,,1,99,88,187
38277,Geegee101,,31,2,1,3
38278,100thm0nkey,,0,237,247,484
38279,IvanLeopold,,19,8,15,23
38280,jumpy_monkey,,31,120,105,225
38281,LizzieP,,34,28,33,61
38282,paro,,22,722,935,1657
38283,Desiccant,,32,1,1,2
38284,charles_darwin2,,0,135,63,198
38285,anthesiac,,13,2,2,4
38286,JamesFromCanada,,22,50,99,149
38287,railroadrum,,1,1,2,3
38288,ExtraDigit,,31,5,6,11
38289,Jave27,,13,44,5,49
38290,stkman57,,14,1,2,3
38291,foomp,,18,11,11,22
38292,NinjaOxygen,,41,13,16,29
38293,guilhem,,20,6,5,11
38294,PsychoPenguinGrl,,18,14,30,44
38295,smoknjuan,,22,73,128,201
38296,spencerv,,5,5,2,7
38297,bgates6666,,20,8,6,14
38298,asura0,,1,24,75,99
38299,leesonis,,31,15,14,29
38300,j-smith,,29,1,3,4
38301,foo-tard,,6,34,52,86
38302,Peaker,,31,132,177,309
38303,babylon_drifter,,20,1,2,3
38304,ixeos,,13,7,3,10
38305,OToole,,13,298,389,687
38306,Bimble,,1,25,51,76
38307,boothinator,,19,7,11,18
38308,orbitz,,6,86,125,211
38309,splidge,,20,15,33,48
38310,senko,,20,1,1,2
38311,alleng1,,13,3,1,4
38312,snacktivity,,1,26,45,71
38313,chickenpuff,,18,4,1,5
38314,ugeert,,20,3,2,5
38315,briebert,,18,67,122,189
38316,KrazyGimp,,17,19,31,50
38317,sloak,,43,3,2,5
38318,drdania,,13,15,25,40
38319,iiiiiii,,0,1,1,2
38320,riled,,41,3,1,4
38321,m8m8m8,,32,507,6,513
38322,Silentio,,18,142,248,390
38323,tiff1122,,6,1,1,2
38324,seunosewa,,20,9,15,24
38325,riger99,,11,20,4,24
38326,eplanit,,5,5,6,11
38327,psykotic,,20,370,493,863
38328,agarren,,13,1,1,2
38329,RationalUser,,34,112,76,188
38330,elnon,,31,6,11,17
38331,Snowspot,,31,124,123,247
38332,NanoStuff,,20,36,62,98
38333,mallio,,36,27,21,48
38334,PintOfGuinness,,0,986,439,1425
38335,rev_null,,6,9,9,18
38336,aerialkabuki,,15,1,3,4
38337,MitchAubin,,32,15,25,40
38338,Rhoozer,,5,1,7,8
38339,trf,,1,6,10,16
38340,Whose_Chariot,,34,1,3,4
38341,thurstastic,,13,33,12,45
38342,wufoo,,13,164,113,277
38343,LastAXEL,,18,39,74,113
38344,arnedh,,20,111,125,236
38345,chicomathmom,,1,192,108,300
38346,interestingedamame,,33,2,4,6
38347,mderrick15,,9,9,4,13
38348,elunico28,,19,6,10,16
38349,plexluthor,,17,205,194,399
38350,Cwal37,,19,10,3,13
38351,Cuselax5,,1,1,1,2
38352,vanchunks,,18,5,13,18
38353,mattyxo,,43,87,215,302
38354,lamas,,43,1,1,2
38355,g8rgeek,,43,12,9,21
38356,leftsaidfred,,18,39,4,43
38357,melsonome,,13,1,4,5
38358,tutwabee,,19,177,230,407
38359,stpdrdnk,,22,4,7,11
38360,stats,,19,61,64,125
38361,MetropolisPt31,,13,1,4,5
38362,cjd415,,1,23,17,40
38363,mphafner,,20,6,4,10
38364,shandie,,1,8,10,18
38365,ravy,,13,5,6,11
38366,oldcrow,,3,401,669,1070
38367,myownsummersi,,0,8,7,15
38368,stealthzeus,,19,266,421,687
38369,exiork,,43,37,87,124
38370,twilightearth,,13,18,1,19
38371,Curiosity,,13,9,9,18
38372,gibbdibbofive,,31,2,1,3
38373,Comowl,,1,52,27,79
38374,sakebomb69,,19,1116,1846,2962
38375,openthink,,18,137,19,156
38376,JB5480,,17,1,2,3
38377,CrAzYMaST,,5,5,7,12
38378,derangedsheep,,10,12,14,26
38379,delfinom,,1,4,4,8
38380,sovok,,20,20,35,55
38381,coeal1,,18,1,2,3
38382,shea241,,29,47,17,64
38383,enlightenedgooglist,,19,10,21,31
38384,HaloOnFire,,31,3,2,5
38385,FenPhen,,35,373,517,890
38386,Marvel27,,1,265,180,445
38387,Rhinoceros,,18,20,48,68
38388,qtuner,,6,3,10,13
38389,gregkr,,5,72,55,127
38390,penrynchips,,40,40,10,50
38391,CountRumford,,13,4,6,10
38392,cm03d,,13,11,13,24
38393,alepuzio,,20,3,1,4
38394,heatbreak839,,13,1,1,2
38395,zorno,,19,988,793,1781
38396,jailbushnow,,0,4,1,5
38397,spitdog,,6,1,1,2
38398,labboypro,,0,17,65,82
38399,reverie,,22,2,3,5
38400,Syrp,,20,7,5,12
38401,FeepingCreature,,20,169,267,436
38402,slowridesleazy,,13,5,3,8
38403,sockppet,,19,1,5,6
38404,aspartam,,34,2,8,10
38405,zangrene22,,43,9,1,10
38406,dotcoma,,19,284,389,673
38407,ltcolonelnemo,,8,99,19,118
38408,madmop,,18,1,1,2
38409,AntoninScalia,,13,1,1,2
38410,understudy,,18,3,15,18
38411,sv3n,,26,6,10,16
38412,muaddib420,,13,51,30,81
38413,zorander,,20,1,8,9
38414,richhickey,,20,19,24,43
38415,nebouxii,,13,2,6,8
38416,pdanese,,20,32,41,73
38417,asokoloski,,29,100,141,241
38418,redavni,,31,185,232,417
38419,srparish,,20,5,10,15
38420,ppc1040,,31,275,173,448
38421,gizmo490,,20,13,17,30
38422,funwheel,,20,2,3,5
38423,serifoblique,,22,10,32,42
38424,dutchdyke,,19,1,1,2
38425,snowco,,31,4,8,12
38426,JohnnyRB,,20,15,1,16
38427,prepgroove,,9,1,1,2
38428,191wasadyslexicjob,,20,7,8,15
38429,avavra,,5,46,54,100
38430,ZeroInput,,18,9,15,24
38431,technesis,,19,1,4,5
38432,djamesmanny,,13,4,2,6
38433,tjndaltx,,20,2,1,3
38434,edeloso,,20,13,21,34
38435,cardinalReason,,19,5,8,13
38436,joet86,,5,1,2,3
38437,jumbles1234,,34,1,3,4
38438,keitharoo,,19,12,13,25
38439,mermermer1,,1,1,1,2
38440,cheezdoodlez,,42,2,1,3
38441,modusponens66,,39,22,34,56
38442,w1shEX,,4,2,1,3
38443,546mpster,,27,1,1,2
38444,qazzwer,,20,1,2,3
38445,theg33kshow,,18,55,79,134
38446,fergie,,20,74,107,181
38447,eljeffe,,18,34,1,35
38448,weoriu293r8,,9,1,1,2
38449,RJCantrell,,5,35,25,60
38450,admiralANCHOR,,19,5,5,10
38451,paddyoloughlin,,20,4,2,6
38452,Halliburton-Shill,,13,27,9,36
38453,danceswithbabes,,34,9,10,19
38454,YouSaidWhat,,22,1,1,2
38455,RocketNinja,,19,22,12,34
38456,keedon,,22,3,2,5
38457,CatMan_Dude,,32,17,10,27
38458,jonathan_,,42,15,29,44
38459,turangaziza,,32,5,18,23
38460,knobgoblin,,36,2,2,4
38461,fletcherkildren,,1,28,11,39
38462,rodelrod,,20,19,28,47
38463,lemekim,,19,3,4,7
38464,Serious-Bizness,,13,58,57,115
38465,pandamoniumheaven,,40,2,3,5
38466,ceallo,,18,36,27,63
38467,zyzzogeton,,19,513,592,1105
38468,greenconspiracy,,31,37,7,44
38469,mcwiggin,,10,5,2,7
38470,turbotard,,18,25,24,49
38471,jeffdavis,,20,1,1,2
38472,shenglong,,36,2109,444,2553
38473,dorbak,,30,14,22,36
38474,RoundSparrow,,31,5,13,18
38475,attilad,,34,17,25,42
38476,CollegeStud3nt,,0,1,2,3
38477,bmore_leader,,20,2,2,4
38478,stupidgit,,0,11,13,24
38479,adrij,,18,27,17,44
38480,icanhasreddit,,1,17,27,44
38481,artmetz,,31,16,25,41
38482,noneforme,,22,1,1,2
38483,pint,,43,6,6,12
38484,pepe234,,1,1,1,2
38485,drewjoh,,22,1,2,3
38486,greg_rutter,,20,1,4,5
38487,tomchappell,,13,35,32,67
38488,bigkazzyry,,13,6,2,8
38489,sabixatzil,,0,2,1,3
38490,nollig,,31,1,1,2
38491,mezzab,,27,11,1,12
38492,safasdfasd,,42,1,1,2
38493,The_Monster,,20,9,14,23
38494,Thargor,,19,5,5,10
38495,mario_r,,19,10,12,22
38496,breakfast-pants,,20,276,391,667
38497,klhardy1,,37,3,1,4
38498,trumpy714,,13,75,53,128
38499,rockus,,43,14,9,23
38500,jump_the_next_train,,0,82,67,149
38501,2300cc,,42,1,1,2
38502,skalpelis,,22,101,166,267
38503,kokomo,,1,74,2,76
38504,DBpooper,,1,26,7,33
38505,FrozenOrb,,19,2,2,4
38506,ki4gmb,,20,1,2,3
38507,Makal,,22,2,12,14
38508,VeryBadThings,,13,3,4,7
38509,jason_f,,18,26,8,34
38510,glmory,,19,2541,811,3352
38511,Deck,,0,2,2,4
38512,iheartrms,,20,3,4,7
38513,Roentgenator,,22,3,5,8
38514,stfdmv,,18,5,2,7
38515,Jesus_DinoRider,,11,4,4,8
38516,feqgut9r7wat9g,,18,152,351,503
38517,carlief007,,0,18,2,20
38518,alphabetsoup,,13,32,1,33
38519,nemster,,32,15,1,16
38520,katui,,43,32,67,99
38521,pear1jamten,,18,42,23,65
38522,doit3d,,17,13,10,23
38523,bobzmuda,,13,9,8,17
38524,Tiver,,42,115,194,309
38525,fuego0699,,16,4,2,6
38526,boesse,,31,19,50,69
38527,kokon,,20,14,15,29
38528,LoWang,,18,16,42,58
38529,majeriisli,,5,2,1,3
38530,daburr,,0,1,10,11
38531,banjobill,,22,45,50,95
38532,coffeemug,,20,18,5,23
38533,Dildozer,,34,1143,1034,2177
38534,artied,,19,57,85,142
38535,cardinal23,,20,5,3,8
38536,pythwarrior,,20,9,10,19
38537,pesiroil,,43,6,6,12
38538,macroexpand,,20,32,63,95
38539,EsIeX3,,20,57,46,103
38540,tysonmiller,,31,1,2,3
38541,lifeisgoooooood,,18,431,32,463
38542,jrockIMSA08,,12,1,1,2
38543,bremid,,13,1,2,3
38544,nintendoll,,42,27,21,48
38545,OiOiWhatABoy,,36,4,6,10
38546,jackli,,19,23,8,31
38547,frog_99,,31,4,8,12
38548,glasshouse,,30,2,1,3
38549,eegreg,,20,55,52,107
38550,blackrayne,,18,8,13,21
38551,ndaprophet,,42,3,8,11
38552,hats21ricks,,19,121,237,358
38553,tricolon,,1,488,641,1129
38554,mknasty,,1,2,2,4
38555,logicinjection,,10,6,10,16
38556,technothrasher,,17,102,118,220
38557,dmbftp,,43,4,1,5
38558,kolebee,,31,1,1,2
38559,thehotelexperience,,1,22,17,39
38560,haile_unlikely,,43,28,38,66
38561,C-C-C-COMBO-BREAKER,,19,102,63,165
38562,kdeason,,32,1,3,4
38563,Runamok81,,22,1,2,3
38564,Axalon,,18,606,42,648
38565,steve2008,,20,1,1,2
38566,Jonny_5,,29,2,1,3
38567,GuybrushThreepwood,,18,30,22,52
38568,kungfuice,,20,5,5,10
38569,knotty66,,20,5,22,27
38570,szevvy,,42,4,12,16
38571,FUCKDOITLIVESFUCK,,1,2,1,3
38572,josephlucas,,43,2,1,3
38573,jlb1982,,30,4,5,9
38574,poppypig,,19,5,1,6
38575,kyledantarin,,18,7,17,24
38576,blackoliveeater,,42,23,8,31
38577,letsvote,,14,1,1,2
38578,smckenzie23,,23,8,8,16
38579,ihatetotti,,13,12,9,21
38580,Chuwero,,13,3,19,22
38581,stylensf,,7,4,1,5
38582,MilesZS,,20,23,32,55
38583,abroch,,13,85,7,92
38584,ceroptera,,42,50,2,52
38585,xach,,20,236,99,335
38586,wolker,,12,1,2,3
38587,cripister,,13,17,3,20
38588,Green84,,18,1592,8,1600
38589,thomasknowland,,19,21,20,41
38590,grimascent,,19,17,22,39
38591,dolladollabill,,22,18,24,42
38592,spamgobbler,,43,1,1,2
38593,growthy,,34,44,14,58
38594,juicyjames,,1,80,21,101
38595,orn,,4,27,29,56
38596,mrdarrenh,,13,35,59,94
38597,troublestarts,,43,132,231,363
38598,maddAddam,,20,10,12,22
38599,maketv,,34,3,1,4
38600,chrisrhee,,19,10,6,16
38601,TheVietnamWar,,18,2,2,4
38602,UpFromTheGut,,33,2,2,4
38603,thesunshinelive,,18,7,18,25
38604,ethicsfirst,,13,10,16,26
38605,ele7ven,,18,16,27,43
38606,Bytes_U,,18,1,5,6
38607,nicolaas86,,18,12,9,21
38608,RampagingRobots,,18,2,4,6
38609,emc2rae,,23,140,130,270
38610,pneuskool,,31,7,16,23
38611,macrohawk,,0,2,4,6
38612,kwh,,13,632,966,1598
38613,Laminar,,43,83,143,226
38614,rubyruy,,20,11,13,24
38615,bflaug32,,19,1,2,3
38616,pkulak,,19,135,108,243
38617,Hero_In,,36,3,3,6
38618,xexers,,13,1,1,2
38619,OneEyedSnake,,32,38,20,58
38620,miguelxt,,1,20,23,43
38621,Rod_Stewart,,13,13,16,29
38622,seamonkey,,22,2,1,3
38623,jeppr,,12,52,39,91
38624,eatenbyagrue,,20,5,7,12
38625,milkk,,13,17,11,28
38626,gunn666,,0,2,2,4
38627,ealfert,,39,1,3,4
38628,Beriadan,,22,23,37,60
38629,selrahc,,42,56,61,117
38630,plasticquart,,19,91,82,173
38631,nice_halibut,,23,21,27,48
38632,Web_Weasel,,20,16,46,62
38633,pseudosinusoid,,18,12,25,37
38634,ghostlikeswayze,,12,1,1,2
38635,mastershan,,3,3,1,4
38636,muddyalcapones,,18,52,61,113
38637,Shooter,,20,9,5,14
38638,hemetae,,13,76,118,194
38639,Kvetch,,19,12,30,42
38640,badalchemy,,21,23,18,41
38641,bperki8,,30,2,1,3
38642,Garak,,35,316,356,672
38643,ffox28,,1,2,2,4
38644,z0ot,,4,3,8,11
38645,bottom_punch_fu,,8,1,1,2
38646,seabre,,20,326,347,673
38647,expressn,,20,2,7,9
38648,adamjohnson,,20,2,4,6
38649,an7agonist,,43,304,88,392
38650,michpeo,,20,1,2,3
38651,mcdonc,,20,2,4,6
38652,smwhit,,20,2,2,4
38653,jonr,,18,182,258,440
38654,freegamer,,34,10,4,14
38655,reg_1013,,13,1,3,4
38656,hoopycat,,30,16,26,42
38657,wrongguy,,8,1,2,3
38658,datarefuge,,19,63,81,144
38659,itookwhite,,20,5,3,8
38660,jopari,,1,144,123,267
38661,etuxr,,34,10,13,23
38662,ivegotabetteridea,,0,1,1,2
38663,izrits0122,,4,22,23,45
38664,rampantbaboon,,13,4,7,11
38665,julesjacobs,,20,94,102,196
38666,IrishYankee,,32,11,1,12
38667,njetx,,0,56,17,73
38668,webauteur,,20,31,34,65
38669,Kindswinth,,32,29,29,58
38670,oscaronw,,18,3,12,15
38671,rome425,,18,122,140,262
38672,TheRussianFunk,,18,30,67,97
38673,grayputer,,4,6,6,12
38674,Haiku_attack,,0,3,7,10
38675,corjello,,42,1,1,2
38676,SecretAgentMan,,20,2,1,3
38677,Morgin_Black,,12,77,185,262
38678,ciresica,,19,2,2,4
38679,steverrb,,13,2,4,6
38680,Neuropolis,,22,98,106,204
38681,swyyft,,13,4,3,7
38682,unwind-protect,,31,12,6,18
38683,Matzerath,,14,2,7,9
38684,gunigugu,,19,1,1,2
38685,ka62c,,19,254,306,560
38686,dshipp,,31,6,10,16
38687,newfam1,,18,66,165,231
38688,talsit,,20,6,14,20
38689,totalcrap,,19,2,1,3
38690,kpw,,18,7,13,20
38691,thirdwave,,29,1,2,3
38692,yaserbuntu,,20,38,3,41
38693,GarethNZ,,13,1,7,8
38694,ankzap,,0,4,6,10
38695,poeticTroll,,13,3,3,6
38696,darkempath,,32,38,53,91
38697,zentimo,,18,15,1,16
38698,dminor,,20,2,3,5
38699,dest83,,35,1,1,2
38700,spacedout83,,5,5,2,7
38701,heretik,,43,3,8,11
38702,skaun,,32,15,24,39
38703,ihuk,,20,1,1,2
38704,ruddybaby,,36,1,3,4
38705,jtxx000,,20,62,67,129
38706,furtivefelon,,20,14,5,19
38707,spt48,,13,1,1,2
38708,pjdelport,,20,116,163,279
38709,submanifold,,29,33,23,56
38710,luckychicken,,20,3,3,6
38711,caseigl,,19,2,2,4
38712,Sisyphean,,18,1,1,2
38713,Daewwoo,,18,4,14,18
38714,lftjoinsbitches,,18,1,1,2
38715,jaargon,,13,3,7,10
38716,PhilR8,,1,37,44,81
38717,BrooksMoses,,20,2,11,13
38718,jhaluska,,20,73,128,201
38719,eruwaedhiel,,31,4,4,8
38720,Luke2012,,5,60,83,143
38721,bag-o-tricks,,18,1,4,5
38722,fuckedtwo,,1,3,3,6
38723,bayes,,20,5,3,8
38724,postjack,,0,1,1,2
38725,flit,,32,7,8,15
38726,whackker,,1,2,16,18
38727,atomic_rabbit,,13,77,88,165
38728,smeag0l,,0,1,1,2
38729,l124rd,,18,1,5,6
38730,qpwoei,,12,103,94,197
38731,andhelostthem,,18,444,312,756
38732,henry518,,3,44,26,70
38733,arbitus,,18,2,2,4
38734,SearchStudent,,31,2,4,6
38735,null_value,,18,52,80,132
38736,robbutto,,41,72,101,173
38737,kennethlove,,20,4,1,5
38738,ARS_,,0,700,64,764
38739,crapuser431,,43,1,3,4
38740,savage_zombie,,43,14,19,33
38741,skreed,,18,9,21,30
38742,newberry,,12,2,2,4
38743,BritainRitten,,18,11,22,33
38744,NiHao,,1,102,276,378
38745,SirSanfordFleming,,27,4,1,5
38746,skbelile,,30,1,1,2
38747,xDcSx,,13,2,5,7
38748,evvk,,20,15,17,32
38749,desmond_tutu,,43,4,2,6
38750,GreenGod,,13,11,10,21
38751,ioxoi,,19,24,57,81
38752,DebtOn,,29,378,566,944
38753,miroxy,,13,2,1,3
38754,DrunkMonkey,,13,54,95,149
38755,joeschmoe99,,3,2,1,3
38756,ZennouRyuu,,32,13,7,20
38757,joopjoob,,20,14,3,17
38758,oconnor0,,31,7,13,20
38759,lenny247,,19,27,33,60
38760,penyaskito,,20,3,3,6
38761,roryl,,6,101,155,256
38762,themac77,,19,23,16,39
38763,national_bee_council,,31,49,80,129
38764,FatherMario,,19,4,4,8
38765,thedopeness,,18,95,154,249
38766,ryuujin,,13,1,1,2
38767,samanthagreen,,5,3,8,11
38768,Parmeniooo,,6,40,53,93
38769,tdoris,,20,18,5,23
38770,Jimmy,,20,401,500,901
38771,mrevelle,,20,9,20,29
38772,vampirate,,8,7,23,30
38773,atkuku,,29,1,1,2
38774,eqweqewq,,13,2,2,4
38775,Dmitrius22,,13,58,90,148
38776,ericnicolaas,,5,16,1,17
38777,brick_tamblin,,6,1,1,2
38778,gnewsuk,,5,8,5,13
38779,acorscadden,,22,15,12,27
38780,SunnyDLight,,10,2,3,5
38781,GeorgeWLincoln,,13,3,1,4
38782,jl1987,,18,22,31,53
38783,RedditingDrunk,,34,1,2,3
38784,dadamyata,,32,4,1,5
38785,Nikola_S,,31,387,537,924
38786,MoonMan99,,19,2,5,7
38787,qpyh2,,4,1,1,2
38788,Draconis_SG,,18,9,17,26
38789,b3378x,,39,37,48,85
38790,pingpants,,5,1,1,2
38791,BrakTalk,,6,18,35,53
38792,Diet_of_Worms,,8,36,49,85
38793,clintonforbes,,20,4,3,7
38794,sunshinegroopie,,26,7,8,15
38795,aphex732,,13,1,3,4
38796,whism,,20,16,9,25
38797,cuffster,,41,4,8,12
38798,sniles,,4,185,257,442
38799,jmackinn,,43,3,4,7
38800,brendanlim,,20,4,3,7
38801,axodys,,12,2,1,3
38802,coloneltribune,,34,36,5,41
38803,brackish_dip,,12,150,102,252
38804,gedekran,,12,1,1,2
38805,lidaliqa,,31,38,43,81
38806,jfurycat,,18,61,95,156
38807,guPPer,,15,29,27,56
38808,frankus,,19,219,98,317
38809,jamietheking,,33,1,3,4
38810,Crizack,,32,12,21,33
38811,pryans,,18,2,4,6
38812,randroid,,13,470,621,1091
38813,flex_strongo,,19,5,13,18
38814,Hendronix,,32,1,1,2
38815,epriest,,20,8,9,17
38816,Cloud9,,5,20,49,69
38817,klaruz,,20,15,22,37
38818,StinkiePhish,,19,10,12,22
38819,alancabra,,13,1,1,2
38820,SouthFresh,,43,1,2,3
38821,ratn9ne,,4,2,1,3
38822,noidi,,20,8,11,19
38823,ArtificialMorality,,18,3,6,9
38824,justo,,31,2,3,5
38825,dialmaster,,34,7,5,12
38826,shardex,,18,6,1,7
38827,robertfischer,,20,9,11,20
38828,nightbiscuit,,1,201,271,472
38829,snozzberries,,0,229,32,261
38830,nazghash,,20,2,5,7
38831,accurepl,,19,11,3,14
38832,katanoki,,15,2,3,5
38833,wilsonfrisk,,13,5,2,7
38834,Vorsic,,42,12,26,38
38835,garc,,43,5,6,11
38836,snakeshands,,36,1,1,2
38837,corripio,,22,10,6,16
38838,flkdsjflsd,,31,10,12,22
38839,TangoWhisky,,0,8,14,22
38840,whencowsattack99,,43,3,7,10
38841,poukies,,19,2,3,5
38842,nhkenn,,18,97,162,259
38843,cg84,,20,14,4,18
38844,VeryApe,,43,5,5,10
38845,gondie644,,8,5,8,13
38846,duxx,,29,2,2,4
38847,ochizon,,13,15,33,48
38848,starskii,,18,41,1,42
38849,osteele,,20,2,1,3
38850,mrsnugglecow,,13,11,2,13
38851,Trey4,,13,9,3,12
38852,mr_libro,,43,16,14,30
38853,seawaves,,5,1585,26,1611
38854,fartknocker1,,19,47,59,106
38855,abrogate,,13,80,81,161
38856,katacrow,,31,26,21,47
38857,cdigioia,,6,27,21,48
38858,jhoomba,,13,33,2,35
38859,danielandrews,,19,27,59,86
38860,imk,,35,349,347,696
38861,101176,,13,6,4,10
38862,crawford_,,13,17,18,35
38863,fockzhound,,13,62,70,132
38864,akie,,20,90,69,159
38865,jammag,,20,411,7,418
38866,Propane,,5,56,28,84
38867,columbusguy,,27,537,1,538
38868,lloydsparkes,,20,4,5,9
38869,mots,,20,1,1,2
38870,jaazzman,,10,104,203,307
38871,jerleo,,12,1,1,2
38872,scorpion032,,20,40,30,70
38873,delcielo,,13,5,4,9
38874,ZCEREAL,,31,3,1,4
38875,people4power,,15,27,4,31
38876,Darth_Vader,,14,1,2,3
38877,john_amendall,,20,1,1,2
38878,chopchop2,,13,1,3,4
38879,ryg,,3,2,1,3
38880,redditer007,,9,2,5,7
38881,wodon,,18,16,9,25
38882,trominos,,10,140,30,170
38883,algernonymous,,19,3,3,6
38884,demosthenes02,,20,125,110,235
38885,Imperator,,18,75,126,201
38886,donkokse,,34,4,12,16
38887,uioreanu,,18,44,53,97
38888,BigPopaGamer,,1,2,4,6
38889,greenmonstah,,30,1,1,2
38890,stormmaster83,,20,3,5,8
38891,jsober,,20,12,7,19
38892,sasayins,,0,1,1,2
38893,ryles,,20,24,53,77
38894,jimejim,,3,10,16,26
38895,rollbiz,,34,6,13,19
38896,superphly,,34,15,2,17
38897,Communism,,13,1,2,3
38898,sjwalter,,12,3,3,6
38899,trnelson,,1,511,458,969
38900,mediea,,34,1,1,2
38901,vajav,,1,1624,1206,2830
38902,justbigenuffgov,,14,2,3,5
38903,adam-d,,18,2,4,6
38904,riffraff,,20,7,13,20
38905,ioerror,,20,1,3,4
38906,jarts,,30,28,6,34
38907,turnip,,1,9,7,16
38908,klemon,,32,4,8,12
38909,MegaPerv,,43,1,1,2
38910,middkidd,,13,48,47,95
38911,karifrances,,19,10,7,17
38912,Cataclysm,,42,41,65,106
38913,ebola,,43,114,270,384
38914,sparkleyflowers,,5,3,6,9
38915,kitkatkitkat,,38,78,102,180
38916,thatguy5057,,36,2,1,3
38917,Sergiykov,,0,1,1,2
38918,JMCtg,,18,19,23,42
38919,Augzodia,,20,6,3,9
38920,normanspencer,,15,22,21,43
38921,rahuls,,18,68,16,84
38922,this_movie_sucks,,42,1,2,3
38923,bloobloobloo,,11,2,3,5
38924,samurai_cyborg,,20,32,28,60
38925,gavinElster,,23,1,1,2
38926,inthemedium,,18,8,6,14
38927,Livpaamars,,16,2,1,3
38928,lvaruzza,,35,1,3,4
38929,AngelaMotorman,,6,567,962,1529
38930,powarblasta5000,,32,6,13,19
38931,annasaru,,20,18,35,53
38932,commentatorwannabe,,1,1,1,2
38933,gnfknr,,42,15,12,27
38934,lilspikey,,20,13,11,24
38935,ElLechero,,13,6,22,28
38936,LordVoldemort,,20,462,548,1010
38937,srv,,1,522,437,959
38938,ipsofacto,,40,15,7,22
38939,dtallee,,1,83,77,160
38940,wmleler,,13,372,67,439
38941,dontaskagain,,29,2,4,6
38942,jinki,,34,11,2,13
38943,famousde,,32,8,2,10
38944,ChaosChaser,,22,3,3,6
38945,Gorty,,36,5,4,9
38946,pactivate,,43,40,9,49
38947,nroht,,20,1,1,2
38948,Militree,,1,74,30,104
38949,theregoesjulie,,18,205,339,544
38950,Becco,,43,2,1,3
38951,Inferno,,30,66,128,194
38952,floriang,,42,31,35,66
38953,dak1486,,11,21,35,56
38954,plin,,13,20,10,30
38955,brettsplace,,16,1,5,6
38956,tofutu,,34,5,5,10
38957,pkenjora,,20,44,6,50
38958,DallasRPI,,13,22,2,24
38959,hobiwan,,14,22,42,64
38960,kmanracer,,4,2,2,4
38961,triconda,,4,5,4,9
38962,valera,,19,45,75,120
38963,christ_blowz,,19,3,3,6
38964,sethmonster,,6,1,2,3
38965,doktormabuse,,13,29,54,83
38966,jrfulbright,,5,75,56,131
38967,adimoga,,5,67,23,90
38968,dicroce,,20,1,1,2
38969,Gryph0n,,20,1,2,3
38970,sanimalp,,3,317,441,758
38971,ILoveLucy,,0,35,4,39
38972,defunkt,,20,10,2,12
38973,pdc,,20,275,93,368
38974,schlurp,,31,6,9,15
38975,everythingtwice,,6,3,6,9
38976,dww142,,1,5,1,6
38977,iNaNimAtE,,20,4,3,7
38978,tizz66,,18,54,56,110
38979,chuey_74,,18,1,2,3
38980,phuc_head,,29,1,7,8
38981,holyteach,,13,3,1,4
38982,cruzin,,18,18,32,50
38983,clumma,,20,156,253,409
38984,patrickyeon,,30,35,25,60
38985,yef99,,18,23,5,28
38986,DreamoftheEndless,,13,161,269,430
38987,funfunfun,,19,6,4,10
38988,papasmirk,,5,4,10,14
38989,prunetracy,,18,29,43,72
38990,concerned_citizen,,19,4,4,8
38991,sansphelps,,19,10,3,13
38992,nfrost,,3,3,9,12
38993,altaccount123,,1,39,2,41
38994,6562dp,,13,4,10,14
38995,tjcannon,,19,9,9,18
38996,OtengiM,,31,1,2,3
38997,Gobrite,,30,4,3,7
38998,ace2cloud,,19,4,2,6
38999,Pennifred,,18,2,4,6
39000,faol,,41,1,2,3
39001,ninpuukamui,,18,12,25,37
39002,soxy,,13,3,3,6
39003,peachykaren,,1,7,2,9
39004,matthewtb,,6,42,18,60
39005,chris083210,,20,18,4,22
39006,wally4711,,0,38,16,54
39007,HangedMan,,43,1,2,3
39008,ch00f,,1,1334,785,2119
39009,JoeWatchDog,,13,1,1,2
39010,gdm9000,,20,17,23,40
39011,bckids1208,,5,57,28,85
39012,triblady,,34,13,3,16
39013,bobwalker,,20,2,1,3
39014,GoAskAlice,,19,1,3,4
39015,stou,,20,7,7,14
39016,brickcheney,,4,2,1,3
39017,clamothe,,20,4,5,9
39018,jersey_emt,,5,1,1,2
39019,cavadela,,12,40,26,66
39020,chucker23n,,20,29,24,53
39021,spiffiness,,1,10,14,24
39022,d46ron1337,,18,2,2,4
39023,xandercruise,,18,27,7,34
39024,data64,,19,2,1,3
39025,jerryjacky,,13,7,1,8
39026,psyph3r,,13,1,1,2
39027,sean_m_flannery,,18,31,1,32
39028,agsinger,,18,3,11,14
39029,paranormal,,32,1,1,2
39030,theycallhimdon,,22,2,3,5
39031,hfreanzr,,7,3,4,7
39032,laniik,,19,3,2,5
39033,Etni3s,,18,33,29,62
39034,Smellypuce,,18,12,39,51
39035,YourLettersStink,,19,3,7,10
39036,rahvin1,,13,3,10,13
39037,pmrx,,4,7,7,14
39038,bozohiggs,,19,8,2,10
39039,moldycricket,,3,1,1,2
39040,maskaler,,43,2,9,11
39041,theninjagreg,,20,4,4,8
39042,petrux,,13,47,8,55
39043,harvesteroftruth,,19,400,82,482
39044,hynkle,,1,190,261,451
39045,noflashlight,,20,84,68,152
39046,junglecat,,34,52,4,56
39047,boeuf,,43,20,31,51
39048,JoshTwolittle,,1,1,3,4
39049,zbelljegger,,34,13,18,31
39050,darxkies,,22,1,3,4
39051,admiral-zombie,,32,94,91,185
39052,kidmotors,,31,8,5,13
39053,JonAmonster,,3,6,4,10
39054,ncontorno,,6,58,7,65
39055,earthboundchild2,,18,2,3,5
39056,delelles,,19,520,24,544
39057,kennethgack,,34,16,14,30
39058,suzane,,34,1,2,3
39059,owlMaster,,31,1,1,2
39060,scott9380,,18,3,4,7
39061,Brahma111,,43,2,5,7
39062,HenryJonesJr,,32,6,10,16
39063,axel618,,13,2,5,7
39064,seanadb,,13,2,8,10
39065,spookycox,,5,2,14,16
39066,homergonerson,,18,24,76,100
39067,rb2k,,18,29,40,69
39068,mtVessel,,20,62,99,161
39069,Demikhov,,42,9,1,10
39070,tacyppah,,19,10,15,25
39071,utbandit,,28,1438,808,2246
39072,asdlfkjweioruwersdkl,,0,5,18,23
39073,cbob27410,,19,3,2,5
39074,jae3Zu7r,,29,2,1,3
39075,who8877,,30,12,13,25
39076,jpcooper,,20,24,25,49
39077,booster_flush,,19,6,6,12
39078,facingup,,18,6,7,13
39079,bradleydsmith,,31,1,1,2
39080,choppinbroccoli,,22,12,14,26
39081,JoePenn,,20,8,3,11
39082,funkybob,,0,8,12,20
39083,Reddit-is-ruined,,19,18,26,44
39084,slackerIII,,20,100,18,118
39085,AntisemitismIsEvil,,31,6,4,10
39086,neandorman,,18,66,127,193
39087,FixedThatForYou,,12,3,9,12
39088,ender422,,13,2,7,9
39089,cpwtf,,20,14,21,35
39090,rastafurfarian,,30,11,20,31
39091,felipec,,20,1,2,3
39092,schadwick,,29,1,1,2
39093,quirked,,13,90,62,152
39094,silviot,,20,37,21,58
39095,rodimius,,20,23,17,40
39096,free_julie_amero,,18,94,20,114
39097,CaveMike,,31,24,36,60
39098,circusricardo,,23,4,4,8
39099,cejung,,14,1,1,2
39100,PatrickLeahy,,22,33,50,83
39101,JuliusH,,19,7,9,16
39102,shmendrick,,0,8,14,22
39103,Ostrich159,,1,206,178,384
39104,nedbatchelder,,29,1,2,3
39105,ma1kel,,32,89,136,225
39106,snookums,,30,1115,1005,2120
39107,sh33ple,,13,59,76,135
39108,religionvirus,,13,81,1,82
39109,r3x4h,,19,9,18,27
39110,afaik,,32,9,19,28
39111,Time2paint,,22,1,1,2
39112,onewatt,,7,1,1,2
39113,jarvolt,,1,11,8,19
39114,nigret,,39,4,2,6
39115,bswen,,13,97,3,100
39116,svnftgmp,,19,94,7,101
39117,screamsionara,,32,32,51,83
39118,cluster1,,5,8,19,27
39119,friscobob,,12,81,49,130
39120,nerdlor,,20,12,11,23
39121,Chalax,,13,1,2,3
39122,writetoalok,,20,20,16,36
39123,L33tminion,,42,50,95,145
39124,Ellusive,,33,4,4,8
39125,IrmatDen,,32,1,1,2
39126,monkjunkie,,8,2,3,5
39127,tahirbutt,,0,3,1,4
39128,sobriquet,,29,2,4,6
39129,farthinder,,18,49,24,73
39130,beader,,31,9,3,12
39131,Zolty,,5,19,43,62
39132,Paisano1,,13,85,14,99
39133,mkosmo,,16,1,2,3
39134,ohcroatia,,18,16,2,18
39135,brandonthebuck,,5,5,7,12
39136,LuciferH,,1,83,76,159
39137,cryariver,,13,39,75,114
39138,rzocee,,22,1,3,4
39139,Hinstavonin,,43,2,4,6
39140,Daph,,6,7,16,23
39141,heinb,,12,1,1,2
39142,jamesturk,,20,86,20,106
39143,pineappleye,,43,1,5,6
39144,SumErgoCogito,,18,1,1,2
39145,bexmex,,20,1,3,4
39146,prominairy,,1,1,3,4
39147,jprice,,20,8,11,19
39148,makismagoo99,,19,6,6,12
39149,toosas,,12,10,33,43
39150,SterlingCamden5,,20,7,4,11
39151,BossHat,,19,34,55,89
39152,HPIguy,,1,5,3,8
39153,bladeforge,,18,7,7,14
39154,Zepp,,9,2,1,3
39155,whi73rav3n,,5,384,4,388
39156,nickelplate,,20,2,5,7
39157,jgfoot,,20,9,6,15
39158,Killerkirby,,20,4,2,6
39159,FightTheFED,,0,5,7,12
39160,Anthet,,13,3,6,9
39161,majeric,,13,2,4,6
39162,justinmk,,29,68,92,160
39163,postdarwin,,32,249,512,761
39164,JpMaxMan,,39,3,1,4
39165,diso2,,6,1,4,5
39166,robotnixon,,22,237,277,514
39167,moseeds,,31,5,13,18
39168,quraid,,31,40,54,94
39169,jrobelen,,32,285,209,494
39170,phq,,12,1,4,5
39171,pullo,,4,2,3,5
39172,housingbear2007,,19,600,56,656
39173,bitchbang,,18,1,4,5
39174,FarwellRob,,13,1,4,5
39175,Ra____,,34,3,4,7
39176,mageling,,32,35,26,61
39177,FamousMortimer,,19,146,96,242
39178,scoreboard,,19,489,40,529
39179,jamesinraro,,13,59,56,115
39180,DBoone,,32,1,1,2
39181,strider24,,20,1,3,4
39182,jingle2020,,0,21,3,24
39183,Chief123,,42,2,2,4
39184,tmcmh,,3,2,1,3
39185,maceelk,,13,56,60,116
39186,achilles,,19,560,215,775
39187,willia4,,20,12,25,37
39188,DougBTX,,14,1,2,3
39189,indieaz,,13,4,4,8
39190,thedollarisdead,,19,39,15,54
39191,DWRoelands,,10,70,48,118
39192,transisto,,12,22,45,67
39193,lteo,,20,12,7,19
39194,abscissa,,32,9,7,16
39195,saveusjesus,,20,2,1,3
39196,detbar,,18,2,4,6
39197,0sn,,20,44,85,129
39198,matthia,,42,1,3,4
39199,PatRiot21,,13,8,6,14
39200,behemothaur,,31,90,139,229
39201,YasserM,,18,12,17,29
39202,Relativity,,1,2,1,3
39203,ab3nnion,,31,277,395,672
39204,HankScorpioJr,,32,1,1,2
39205,swindler,,19,7,3,10
39206,ra1ndr0p,,12,1,3,4
39207,Codebender,,43,636,957,1593
39208,Hangshai,,40,1,1,2
39209,Kaneda,,22,2,3,5
39210,elsalgo,,3,43,54,97
39211,ubernoggin,,43,164,5,169
39212,Ron_Artest,,28,1,1,2
39213,TruLiberal,,13,51,1,52
39214,dfrifrifri,,1,3,2,5
39215,pinkfan66,,43,1,2,3
39216,OMouse,,20,1004,1204,2208
39217,nataliezmama,,19,1,2,3
39218,reallystatic,,13,2,1,3
39219,boondoggle,,13,2,1,3
39220,marsvolta,,13,20,21,41
39221,jeargle,,43,5,11,16
39222,k4f123,,18,2,1,3
39223,raven737,,20,3,2,5
39224,boogiepop,,34,1,1,2
39225,DrMabuse,,12,4,6,10
39226,TheGreatOldOne,,13,3,1,4
39227,robotrampage,,34,1,2,3
39228,goodbyeworld,,1,573,323,896
39229,charminggeek,,32,203,110,313
39230,chanko,,13,1,2,3
39231,msisaves,,18,1,1,2
39232,vestige,,19,2,3,5
39233,greyox,,43,24,27,51
39234,IO-_-OI,,18,9,11,20
39235,johnm,,20,84,22,106
39236,yuuuuasdlasd,,33,1,1,2
39237,JonathanHarford,,1,688,526,1214
39238,tirador,,43,4,1,5
39239,zorplex,,12,1,1,2
39240,yt314,,19,30,7,37
39241,ccondon,,20,5,9,14
39242,kickelephant,,4,1,1,2
39243,quinientos_uno,,1,17,24,41
39244,ajfa,,13,18,19,37
39245,PlantfoodCuisinart,,13,24,47,71
39246,Alvina,,2,1,1,2
39247,ujewbot,,31,4,5,9
39248,Sigmalmtd,,20,8,3,11
39249,kittychow,,19,9,13,22
39250,BuddyJ,,42,4,1,5
39251,h0ju,,34,1,1,2
39252,arnimann,,19,6,2,8
39253,Tiabin,,32,149,255,404
39254,ecuzzillo,,20,6,6,12
39255,cunningbanana,,32,17,33,50
39256,phoenix42,,34,1,2,3
39257,bldl,,34,2,2,4
39258,PocketOSunshine,,13,18,37,55
39259,btgoss,,31,43,53,96
39260,redsarmy,,29,7,3,10
39261,unexpected,,34,28,22,50
39262,sdflbiy,,6,2,2,4
39263,cheetor,,19,26,24,50
39264,orDover,,36,2,1,3
39265,Wallywart,,13,19,31,50
39266,RobotAdam,,20,9,10,19
39267,Nex3,,20,8,6,14
39268,01208500,,42,1,3,4
39269,art_ross54,,13,3,2,5
39270,captainron,,13,72,168,240
39271,aadnk,,1,6,10,16
39272,joxenford,,31,7,3,10
39273,fluffnfluff,,13,2,3,5
39274,romerom,,19,20,12,32
39275,Fitcheron,,0,131,22,153
39276,scrambrad,,17,1,2,3
39277,bubba_the_cat,,13,18,9,27
39278,CommonTater,,20,2,3,5
39279,Defektiv,,19,333,540,873
39280,entropyfu,,13,22,55,77
39281,msbunky,,18,2,4,6
39282,plutocrat,,6,203,136,339
39283,Rosenthal,,14,3,7,10
39284,ih8evilstuff,,42,268,384,652
39285,xenoguy,,20,61,38,99
39286,nbrntrt,,21,2,3,5
39287,primo44,,8,1,2,3
39288,throwaway2,,20,1,2,3
39289,eichenlaub,,19,16,20,36
39290,infin,,1,40,80,120
39291,slicedbread,,1,90,133,223
39292,kathologist,,13,21,33,54
39293,mitr,,31,24,38,62
39294,drew1234567890,,11,81,6,87
39295,Frohizzle,,5,2,2,4
39296,night0wl,,19,2,3,5
39297,n3wtz,,17,107,93,200
39298,daesun,,18,5,1,6
39299,vtgorilla,,3,36,35,71
39300,rhsumner,,4,4,7,11
39301,Nogwater,,20,14,11,25
39302,jrsmith,,32,4,8,12
39303,Nordlibris,,19,2,3,5
39304,Guns-to-ploughshares,,20,18,21,39
39305,limitbreakerx,,14,3,2,5
39306,mpeters,,20,7,1,8
39307,extemporaneous,,0,2,2,4
39308,khatcin,,31,6,8,14
39309,entor,,18,411,466,877
39310,dropfry,,13,89,95,184
39311,mclin,,20,23,32,55
39312,Mugger15,,21,1,1,2
39313,psylon,,31,66,31,97
39314,wilse,,18,62,46,108
39315,matthewhughes,,0,5,1,6
39316,_bruce_,,6,1,1,2
39317,maynoth,,3,21,22,43
39318,Montage,,16,3,1,4
39319,Quasigoto,,43,7,13,20
39320,Doomed,,22,233,264,497
39321,JeffBlancoII,,13,2,6,8
39322,HaveSomeSTFU,,19,1,3,4
39323,werehippy,,19,3,7,10
39324,urababoon,,13,6,1,7
39325,edavis,,19,103,24,127
39326,courane01,,19,1,1,2
39327,tjm5501,,31,2,3,5
39328,BCHarvey,,30,67,148,215
39329,aantix,,20,29,30,59
39330,MisterSquishy,,16,14,3,17
39331,hunterorion,,5,21,30,51
39332,nkktwotwozero,,14,241,267,508
39333,fjarlq,,20,6,3,9
39334,uglytime,,19,1,1,2
39335,iamamartian,,18,6,1,7
39336,EmptyTon,,42,25,41,66
39337,Baboso,,32,7,30,37
39338,ProfessorOY,,5,1,1,2
39339,godgavemeafacial,,22,17,13,30
39340,iampivot,,19,8,2,10
39341,rtpmatt,,43,20,18,38
39342,Kyleaxe,,19,12,37,49
39343,CelebritySexyWhite,,42,1,2,3
39344,astrashe,,20,2,4,6
39345,matlyles,,13,4,4,8
39346,cmatthias,,29,1,3,4
39347,matsie,,1,1,1,2
39348,Sobchak,,39,3,2,5
39349,IIGrudge,,5,62,113,175
39350,alsiola,,11,17,3,20
39351,randomredditor,,13,2,2,4
39352,tarla,,12,21,19,40
39353,required3,,13,98,104,202
39354,venuism,,27,3,3,6
39355,pholden,,22,3,9,12
39356,oldmanjank,,1,1,4,5
39357,Capulan,,18,17,17,34
39358,toddly,,42,2,1,3
39359,kamaloo,,43,1213,100,1313
39360,rvqbl,,32,2,1,3
39361,sillysir,,42,3,10,13
39362,edf,,20,1,2,3
39363,higdonius,,11,3,5,8
39364,penprthesword,,0,86,38,124
39365,Octoguy,,19,11,15,26
39366,dnewstep,,13,1,1,2
39367,frickel,,13,160,268,428
39368,aigenarn,,22,9,10,19
39369,arthurujm,,20,1,4,5
39370,oakmac,,28,9,4,13
39371,thcman420,,20,5,3,8
39372,derivative,,13,1,3,4
39373,james_taylor,,35,17,5,22
39374,not-my-username,,36,1,1,2
39375,adampieniazek,,13,507,304,811
39376,Lyrell,,31,2,1,3
39377,EvilKarl,,19,1,3,4
39378,dave84,,20,4,9,13
39379,logi,,4,4,10,14
39380,earthboundkid,,20,1148,725,1873
39381,magookle,,34,1,2,3
39382,alamandrax,,22,136,233,369
39383,Moodle,,43,10,13,23
39384,thelawenforcer,,19,35,70,105
39385,jPurch,,1,8,8,16
39386,kennyreborn,,14,20,25,45
39387,limegreenhero,,13,17,8,25
39388,Shloppy,,12,2,3,5
39389,oth3r,,3,2,1,3
39390,stf210,,0,22,6,28
39391,drdolgoldur,,6,1,1,2
39392,durandal,,5,23,30,53
39393,bronco92,,32,14,30,44
39394,sdbear,,13,21,75,96
39395,b4freedom,,0,21,29,50
39396,smj,,20,3,2,5
39397,brassmonkeys,,29,1,1,2
39398,Venti,,17,1,2,3
39399,agave1968,,17,18,9,27
39400,cmvkk,,13,7,3,10
39401,Cronx,,16,1,1,2
39402,rlee0001,,20,164,221,385
39403,Gexus,,18,1,2,3
39404,PenguinOfDoom,,20,3,2,5
39405,bobsil1,,3,197,283,480
39406,Schlaefer,,18,1,2,3
39407,GreenWire,,5,1,1,2
39408,parla,,20,83,105,188
39409,cap0319,,0,8,7,15
39410,Cmdrfrog,,19,2,1,3
39411,drpocter,,43,1,2,3
39412,MTsoul,,20,16,4,20
39413,nationalizer,,13,4,1,5
39414,Millsley,,19,3,5,8
39415,Kemuel,,42,23,41,64
39416,mattroid,,43,2,1,3
39417,DuncanSmart,,20,58,17,75
39418,Mapex2323,,42,11,36,47
39419,sdgfawefawef,,9,1,1,2
39420,eaturbrainz,,31,1008,1867,2875
39421,quilby,,20,8,1,9
39422,yayhooray,,22,7,8,15
39423,mjpboi,,34,3,3,6
39424,maddvibe,,18,4,9,13
39425,scirocco,,13,7,6,13
39426,rio_web,,20,1,3,4
39427,king_felix,,4,30,39,69
39428,radioRaheem,,18,89,152,241
39429,selfish_meme,,15,35,23,58
39430,peter_kay,,0,1,1,2
39431,srkiboy,,20,8,2,10
39432,absolutkaos,,18,32,9,41
39433,timtux,,20,9,13,22
39434,foodcoop,,16,3,7,10
39435,nerve,,1,42,63,105
39436,organicboy,,34,12,1,13
39437,kafitz22,,34,11,8,19
39438,yurtra,,4,1,1,2
39439,RckmRobot,,1,103,46,149
39440,robofunk,,20,65,76,141
39441,carnieguy,,13,11,1,12
39442,realnewworldorder,,19,30,34,64
39443,jbellis,,20,222,245,467
39444,dmdm,,18,6,4,10
39445,DonGiulio,,18,43,6,49
39446,markelliott,,22,80,110,190
39447,686,,29,5,1,6
39448,Sanit,,10,2,2,4
39449,syuk,,18,162,215,377
39450,TheFoxHound,,19,2,1,3
39451,hyperspeed,,20,38,22,60
39452,jpeirce,,18,166,16,182
39453,CatCrap,,11,11,12,23
39454,ow3n,,42,51,66,117
39455,Typhlosion,,30,2,4,6
39456,45bur,,13,35,54,89
39457,gspot113,,13,16,21,37
39458,aramach,,20,1,2,3
39459,cowboy_k,,36,2,4,6
39460,hipnerd,,43,4,2,6
39461,invisibleandpink,,11,1,1,2
39462,redditIsBecomingSh1t,,30,2,1,3
39463,sex_in_the_face,,43,37,61,98
39464,Ender0910,,20,15,10,25
39465,exSO2,,22,3,7,10
39466,TooSmugToFail,,18,11,33,44
39467,lkir,,20,2,2,4
39468,sandiegojoe,,1,93,114,207
39469,ayamami,,18,1,30,31
39470,piratenaapje,,18,88,33,121
39471,richiverse,,13,15,25,40
39472,c0mpl3x1ty,,1,1,1,2
39473,nathanaver,,31,54,61,115
39474,thetoastyone,,31,20,30,50
39475,Shumina,,19,50,119,169
39476,RiverMise,,13,9,5,14
39477,dya1001,,20,7,4,11
39478,zopster,,19,4,5,9
39479,devision,,20,8,29,37
39480,skyshoes,,13,11,39,50
39481,zachv,,1,101,126,227
39482,treetrouble,,13,13,32,45
39483,Sfmindtrap,,18,18,18,36
39484,paidtopublish,,43,1,1,2
39485,twoplustwoisfive,,12,1,1,2
39486,fotoman,,32,27,61,88
39487,politicalcalcs,,20,2,2,4
39488,realtime24,,1,1,1,2
39489,hdklinke,,43,4,1,5
39490,stealthroot,,18,24,22,46
39491,mralex,,19,253,478,731
39492,mr_mcse,,13,399,511,910
39493,saltyjazz_413,,13,4,3,7
39494,ixx,,20,1,2,3
39495,Fountainhead,,19,598,574,1172
39496,Chelle68691,,19,39,14,53
39497,matatk,,22,7,3,10
39498,b100dian,,20,222,284,506
39499,wtfftw,,12,1,2,3
39500,generic_handle,,31,1415,2646,4061
39501,BrandChopian,,31,78,105,183
39502,xirekaj,,19,139,316,455
39503,shavenwarthog,,6,4,14,18
39504,eastern,,20,10,2,12
39505,lyrabee,,29,1,2,3
39506,soccerman,,1,41,62,103
39507,krabz,,8,1,1,2
39508,honkus,,43,3,4,7
39509,thingsarecontextual,,20,1,1,2
39510,itslarry,,20,4,2,6
39511,londonskater,,0,56,3,59
39512,dhogarty,,20,9,9,18
39513,i77,,20,8,13,21
39514,joo_truther,,21,1,2,3
39515,redhatnation,,18,46,51,97
39516,BrendanCAV,,35,1,2,3
39517,rebus,,13,17,16,33
39518,BarracksRoomLawyer,,1,3,8,11
39519,smurfystar,,13,3,2,5
39520,quantboy,,14,2,8,10
39521,darkenergy,,36,1,2,3
39522,dean,,19,16,11,27
39523,dlfnation,,6,4,2,6
39524,dminternet,,19,2,1,3
39525,gcnovus,,27,1,1,2
39526,Wasted99,,22,106,32,138
39527,darnright,,13,8,2,10
39528,theambassadors,,13,98,25,123
39529,Kroc44,,1,84,67,151
39530,boyhowdy,,1,2,1,3
39531,Temp777,,1,1,1,2
39532,otterley,,20,15,15,30
39533,clovertt,,32,12,26,38
39534,lightstorm,,34,82,17,99
39535,informedcrab,,19,3,5,8
39536,BiggerBalls,,9,54,62,116
39537,emfh,,19,22,24,46
39538,theshame,,32,8,17,25
39539,redchicken2,,8,3,2,5
39540,ftpcharlie,,18,13,12,25
39541,psr111975,,20,2,2,4
39542,lbgrowl,,35,3,1,4
39543,Maj12,,30,6,8,14
39544,kucinich_9000,,19,7,3,10
39545,JamesF,,20,6,8,14
39546,mesmeriffic,,43,13,23,36
39547,nadiasindi,,13,12,1,13
39548,jerrygofixit,,18,334,736,1070
39549,ravickanth,,43,2,3,5
39550,BosAnon,,18,18,7,25
39551,l00pee,,1,16,17,33
39552,weavejester,,20,118,187,305
39553,idontgetit,,6,85,91,176
39554,koobe,,4,17,1,18
39555,kofrad,,1,73,55,128
39556,morelikeprincessdied,,13,1,1,2
39557,xardox,,20,34,36,70
39558,nevinera,,20,329,610,939
39559,jimbokun,,20,185,272,457
39560,armor1,,13,58,75,133
39561,Celsias,,34,243,39,282
39562,anahogben,,13,7,12,19
39563,bicyclemom,,10,46,66,112
39564,slowernet,,20,105,2,107
39565,calebsdaddy,,33,1,3,4
39566,Numberwang,,18,285,65,350
39567,xenopho,,43,163,48,211
39568,btipling,,20,106,22,128
39569,Supdawg,,20,1,1,2
39570,typewriteRrrrr,,18,62,75,137
39571,meloveyoulongtime,,18,104,4,108
39572,897,,43,2,1,3
39573,waywardduck,,13,5,1,6
39574,planetearth,,18,4,3,7
39575,sonofgrace,,9,2,1,3
39576,grimtooth,,20,13,41,54
39577,SeriousDude,,10,1,1,2
39578,SlipstreamInsane,,19,22,31,53
39579,kermityfrog,,30,1141,1997,3138
39580,leolegend,,18,2,2,4
39581,stevefolta,,20,38,43,81
39582,TruthSifter,,22,5,6,11
39583,Greenery,,20,12,7,19
39584,superjj,,43,3,4,7
39585,inkslave,,18,1,2,3
39586,Noneedtopanic,,43,44,137,181
39587,zeal3000,,43,4,11,15
39588,thesuker,,1,2,2,4
39589,ieuryas,,43,1,1,2
39590,helio462,,19,27,40,67
39591,enoughgimmicks,,27,1,2,3
39592,snowman,,42,2,1,3
39593,ostinlt,,19,6,1,7
39594,cargoboy45,,13,48,49,97
39595,dschep,,20,39,69,108
39596,Seyen,,20,52,83,135
39597,grandson,,0,76,2,78
39598,mikedt,,5,39,68,107
39599,abgazelle,,4,1,1,2
39600,neat_stuff,,32,233,392,625
39601,jeykottalam,,20,37,44,81
39602,annadel,,5,7,1,8
39603,redmorgan,,43,2,2,4
39604,rabbitspade,,18,4,10,14
39605,yanksn6,,5,6,12,18
39606,langdog,,5,1,1,2
39607,fuchsia,,1,26,24,50
39608,bradhart,,5,3,2,5
39609,kennytilton,,20,4,11,15
39610,bar_skank,,1,1,1,2
39611,QueenMary,,32,7,6,13
39612,txzuke,,18,2,2,4
39613,lemuelf,,28,2,4,6
39614,Cute_Little_Bunny,,22,1,1,2
39615,jwiz,,20,49,63,112
39616,nemodat,,32,3,2,5
39617,oddbod,,20,30,73,103
39618,DrakeBishoff,,32,104,105,209
39619,talkent,,13,1,1,2
39620,superluminal,,1,18,30,48
39621,historian,,33,17,1,18
39622,telemundo,,13,489,493,982
39623,g33kphr33k,,0,3,5,8
39624,PeeWeePangolin,,32,5,6,11
39625,vinylrichie,,18,15,4,19
39626,canen,,20,32,59,91
39627,treadingwater,,4,9,12,21
39628,808,,22,6,5,11
39629,spinspin,,19,230,383,613
39630,Brecca,,43,101,2,103
39631,ReallyEvilCanine,,0,42,44,86
39632,CheckandBalance,,13,69,95,164
39633,tommy-linux,,14,1,3,4
39634,paperboy187,,19,3,1,4
39635,theaustrian,,43,75,17,92
39636,jamesjoh,,20,16,11,27
39637,iamr00t,,17,8,8,16
39638,hellkeeper71,,20,8,11,19
39639,nkspas,,16,14,3,17
39640,Boeing,,43,3,5,8
39641,CrzyMke,,42,11,15,26
39642,mkbehr,,18,2,5,7
39643,bostonvaulter,,20,389,524,913
39644,lorenzo,,20,7,7,14
39645,Turkilla,,18,2,11,13
39646,azeemforever,,29,2,1,3
39647,cxyl,,43,26,65,91
39648,laketrout,,19,22,13,35
39649,xzxzzx,,39,529,742,1271
39650,bman236,,18,246,261,507
39651,tbotcotw,,4,373,534,907
39652,Athas,,20,109,97,206
39653,Savet,,3,4,2,6
39654,Sleezebug3,,18,9,7,16
39655,bufordt,,21,2,4,6
39656,d4n3,,18,25,22,47
39657,docboss,,19,187,277,464
39658,hiro6380,,5,2,4,6
39659,CaptainObvious,,19,7,15,22
39660,mrsolutions,,5,772,44,816
39661,luckenbach,,20,1,6,7
39662,honahursey,,20,3,5,8
39663,financialbabe,,19,397,4,401
39664,robinhouston,,20,9,2,11
39665,lally,,20,19,26,45
39666,cryanweb,,18,2,1,3
39667,I_downmod_you,,19,1,6,7
39668,aleger,,18,32,15,47
39669,MrShlee,,13,2,2,4
39670,largos,,20,21,33,54
39671,ElloChum,,29,3,2,5
39672,potholesgt,,19,5,7,12
39673,frivol1ty,,19,43,41,84
39674,albatrick,,11,1,1,2
39675,jianlin,,41,2,2,4
39676,soundmoney,,13,3,1,4
39677,Capitalism,,23,73,104,177
39678,ballboing,,19,8,7,15
39679,Senator_Roberts,,13,39,41,80
39680,McCorrr,,31,15,14,29
39681,twoodfin,,20,725,949,1674
39682,peteroc,,20,2,3,5
39683,zedoriah,,31,88,101,189
39684,discohead,,18,20,37,57
39685,Rammer12185,,18,6,8,14
39686,ahuramazda,,1,6,9,15
39687,medium_lebowski,,15,1,1,2
39688,hopeseekr,,19,274,111,385
39689,CakeBomb,,19,6,3,9
39690,OK_Eric,,18,46,78,124
39691,JasperO,,20,11,22,33
39692,smatty1,,19,1128,149,1277
39693,quantax,,30,3,11,14
39694,mattahan,,19,2,9,11
39695,supersan,,43,530,303,833
39696,fgw_three,,17,2,2,4
39697,opunim,,20,1,1,2
39698,dontstopnow,,20,1,5,6
39699,psychicpilot,,0,124,172,296
39700,skitzh0,,1,275,380,655
39701,Michaelabehsera,,5,9,4,13
39702,aduck,,18,4,4,8
39703,catxors,,32,44,70,114
39704,schooch,,5,1,2,3
39705,nat1192,,20,16,22,38
39706,protonfish,,20,33,24,57
39707,macrumpton,,13,95,128,223
39708,sciencegirl,,19,1,3,4
39709,BeliefSuspended2008,,9,2,2,4
39710,swax,,20,6,13,19
39711,xmjmx,,30,8,2,10
39712,Saddam_Hussein,,43,1,3,4
39713,Senseitaco,,18,1,2,3
39714,_-_-_,,29,6,2,8
39715,familygeek,,29,1,1,2
39716,goodanevil,,19,7,8,15
39717,ImpulseControl,,42,1,1,2
39718,jda,,20,14,11,25
39719,GeminiRat,,12,4,7,11
39720,ivirtual,,18,3,9,12
39721,Hixie,,39,150,166,316
39722,perei17354,,31,10,1,11
39723,thegom,,19,23,19,42
39724,kansasgirl18,,20,2,3,5
39725,z4ck,,22,6,2,8
39726,krelian,,20,549,286,835
39727,manchegoo,,32,30,29,59
39728,bentcorner,,19,8,4,12
39729,talhaasifdar,,33,1,1,2
39730,automata,,13,1,1,2
39731,one,,19,37,5,42
39732,psykocrime,,20,12,15,27
39733,crazybus,,1,9,10,19
39734,michaelp,,19,13,9,22
39735,hypermark,,32,7,7,14
39736,Psiplex,,34,1,9,10
39737,hotstyle765,,5,12,11,23
39738,bluephile,,1,1,1,2
39739,TheRovingPoet,,39,2,8,10
39740,drakkar4,,34,170,161,331
39741,dmiv,,1,9,10,19
39742,sdkcsdc,,0,1,3,4
39743,stelund,,4,1,1,2
39744,mockjr,,1,1,1,2
39745,deadaluspark,,32,242,218,460
39746,bryklaus,,20,4,3,7
39747,Nafa228,,18,5,12,17
39748,stmfreak,,13,16,26,42
39749,heatindex,,13,24,1,25
39750,hotnakedme,,13,2,1,3
39751,Gabriello,,13,2,2,4
39752,serif,,18,2,4,6
39753,jlwong,,34,1,1,2
39754,crapuser436,,27,1,3,4
39755,asst2drsalary,,34,11,4,15
39756,irishfairy123,,18,9,17,26
39757,josh64,,15,1,3,4
39758,redsymbol,,20,7,5,12
39759,JoshTheGoat,,18,40,37,77
39760,subsaver,,19,1,1,2
39761,soniyashrma,,5,331,32,363
39762,rouzelt,,18,1,1,2
39763,akbusiness,,18,9,12,21
39764,Gahahaha,,19,120,122,242
39765,I_AM_A_LOLICON,,20,33,24,57
39766,jones4590,,31,1,1,2
39767,PunjabPete,,19,10,3,13
39768,firewire2035,,13,126,159,285
39769,sarafina42,,34,18,7,25
39770,skywalker7861,,20,29,1,30
39771,American_Media,,22,1,1,2
39772,mikeymillions,,19,27,7,34
39773,ccookdsc,,19,1,2,3
39774,matthewmpls,,13,38,59,97
39775,SomeIrishGuy,,12,9,12,21
39776,bitmaster20,,18,5,3,8
39777,BlondeTeenageFemale,,30,2,4,6
39778,pdpdjh,,22,28,1,29
39779,sorandom,,0,5,2,7
39780,kenderbunny,,16,1,2,3
39781,la_gib,,23,4,3,7
39782,fkbszfn,,34,13,17,30
39783,jgrimes,,20,1,1,2
39784,murrayrothbardlives,,13,64,39,103
39785,ianmfried,,13,21,4,25
39786,oalsaker,,43,654,1027,1681
39787,beathead,,18,9,9,18
39788,stigurv,,13,1,1,2
39789,longnow,,13,1,6,7
39790,viosca,,22,1,1,2
39791,nohlo,,19,1,8,9
39792,Philipp,,18,433,179,612
39793,tskapo,,31,1,1,2
39794,redfishvanish,,43,81,147,228
39795,treefrog,,19,25,38,63
39796,leeschill,,13,14,2,16
39797,tabris,,1,154,205,359
39798,Mtrey,,43,52,17,69
39799,muhfuhkuh,,0,163,230,393
39800,leakyfaucet,,19,6,7,13
39801,reallybigleaf,,20,33,1,34
39802,ehnonnymouse,,18,17,32,49
39803,PaamayimNekudotayim,,20,21,19,40
39804,Sheeplike,,1,19,20,39
39805,thearchduke,,27,6,5,11
39806,patw85,,19,9,8,17
39807,night,,19,22,8,30
39808,PantsMan,,43,1,1,2
39809,i1chocolat,,5,2,20,22
39810,nickcrz,,13,207,380,587
39811,zulubanshee,,29,247,176,423
39812,Mikkel04,,22,15,27,42
39813,Johnnysimms,,31,9,8,17
39814,robbinzo,,19,5,2,7
39815,bgstratt,,20,17,30,47
39816,anjanb,,20,2,2,4
39817,peeweejd,,43,13,10,23
39818,vote,,19,146,25,171
39819,slacker22,,18,71,77,148
39820,WHGatesIII,,20,1,1,2
39821,cec4242,,18,3,2,5
39822,netengineer10,,19,23,27,50
39823,Aldous,,43,9,8,17
39824,retromadder,,34,17,37,54
39825,BenVic,,18,3,4,7
39826,ilovesaeri,,19,1,1,2
39827,ethytes,,19,3,6,9
39828,yxhuvud,,10,82,87,169
39829,secondkennedy,,19,11,26,37
39830,Cahoots,,5,1,1,2
39831,mcmick,,22,1,1,2
39832,nipuL,,13,43,28,71
39833,maukka,,34,34,3,37
39834,ebenchell,,1,10,3,13
39835,quietlight,,18,2,8,10
39836,afranke,,3,1,1,2
39837,megamike23,,11,5,8,13
39838,aacharya,,20,32,15,47
39839,karaganZoo,,42,2,1,3
39840,xabstract,,20,14,10,24
39841,montag813,,6,15,5,20
39842,acScience,,1,107,38,145
39843,bdu,,1,35,58,93
39844,ganlet20,,43,4,15,19
39845,rory096,,0,423,624,1047
39846,dmagz37,,13,319,27,346
39847,braneworld,,29,1132,356,1488
39848,buellersway,,19,1,5,6
39849,trannypunk,,13,179,296,475
39850,tmbrwolf19,,30,88,82,170
39851,Vacuum_Hooker,,18,206,22,228
39852,mariox19,,13,6,8,14
39853,st3892,,31,3,3,6
39854,astera,,30,2,1,3
39855,mekkelekkahi,,31,7,1,8
39856,clipmann,,18,270,308,578
39857,herdrick,,20,33,27,60
39858,anees243,,34,21,1,22
39859,thymidine,,31,2,4,6
39860,cyklone,,1,2,2,4
39861,TheCleric,,20,37,85,122
39862,dons,,20,1276,589,1865
39863,troll_captain,,12,3,1,4
39864,MoonChildCY,,20,21,4,25
39865,radiowires,,29,3,3,6
39866,anonymous-coward,,31,839,1142,1981
39867,borg,,19,68,102,170
39868,bluj420,,1,2,9,11
39869,sexydarin,,19,26,46,72
39870,harveyswik,,20,38,56,94
39871,gordo65,,31,65,65,130
39872,fusi0n,,19,15,40,55
39873,windsofwar,,13,12,13,25
39874,ichimunki,,22,1,1,2
39875,OttoVonBismarkk,,6,16,8,24
39876,peste,,20,2,1,3
39877,the_architect,,19,239,157,396
39878,Northbrig,,13,5,3,8
39879,count757,,32,41,44,85
39880,spencerwalsh,,18,26,14,40
39881,biggusJmanus,,19,1,2,3
39882,gadget_uk,,31,124,118,242
39883,Chesh,,1,6,14,20
39884,dutter,,43,35,64,99
39885,alexwilhelm,,2,3,5,8
39886,mellolizard,,32,1,1,2
39887,dr3dg,,18,3,21,24
39888,rugulator1,,4,5,14,19
39889,edgesmash,,19,8,5,13
39890,SirHLO,,19,1,2,3
39891,blackstar9000,,32,1002,445,1447
39892,d267,,20,1,2,3
39893,Shaggsa,,2,2,1,3
39894,madse147,,19,2,3,5
39895,jingidy,,31,4,7,11
39896,FatBlog,,13,18,43,61
39897,mazingerZ,,19,2,1,3
39898,notbob,,30,46,22,68
39899,Herzenslust,,34,14,5,19
39900,agreyarea,,18,2,5,7
39901,Logic_Nazi,,22,29,24,53
39902,gordan_freeman,,42,5,2,7
39903,pghjavaman,,20,8,1,9
39904,Agathos,,20,30,49,79
39905,ccheath,,20,1,1,2
39906,easybakeevan,,32,7,7,14
39907,alex10819,,42,8,2,10
39908,aidan_walsh,,43,3,1,4
39909,FilleAmericain,,5,26,74,100
39910,slowbear,,3,1,2,3
39911,greatdepression,,2,2,1,3
39912,kungtotte,,29,161,220,381
39913,Icewurm,,43,5,3,8
39914,colibius,,17,1,1,2
39915,slovett,,13,1,2,3
39916,wblair8689,,19,44,12,56
39917,MeltedUFO,,22,35,35,70
39918,nosneros,,0,7,29,36
39919,CC440,,6,74,71,145
39920,tjay,,20,13,21,34
39921,marcusf,,20,14,25,39
39922,thor666,,18,12,3,15
39923,calliphoridae,,32,167,125,292
39924,Kiedy,,13,1,2,3
39925,soocha,,43,2,3,5
39926,jellydonot,,5,285,29,314
39927,cmhh,,43,1,1,2
39928,AsDumbAsYou,,13,10,37,47
39929,kopchickm,,1,10,14,24
39930,ahendo10,,18,28,53,81
39931,Squeal,,42,1,2,3
39932,fool_on_the_hill,,22,78,83,161
39933,barkythedog,,32,30,10,40
39934,kkrev,,20,238,154,392
39935,walkingwtheghost,,19,55,89,144
39936,thomasthomas,,18,2,6,8
39937,hhhmmm,,1,2,7,9
39938,jredbone,,32,88,176,264
39939,RicardoWilliams,,5,9,21,30
39940,senrad,,32,11,21,32
39941,khirbat,,20,3,3,6
39942,GuigzForAll,,18,214,337,551
39943,katebond,,29,1,3,4
39944,patrick__bateman,,1,6,9,15
39945,reslez,,0,265,338,603
39946,tsunake,,43,9,9,18
39947,SitnikovI,,43,7,8,15
39948,fwrizzi,,20,11,25,36
39949,eville,,19,3,2,5
39950,szembek,,10,1,2,3
39951,BedtimeForSheeple,,31,41,68,109
39952,hortiub,,0,4,2,6
39953,mayoff,,20,31,12,43
39954,karmaB4tards080125,,19,3,11,14
39955,Direct_Link_Nazi,,18,13,11,24
39956,KGK,,13,4,5,9
39957,threads88,,20,9,2,11
39958,pktolar,,31,1,2,3
39959,bettybacon,,18,1,1,2
39960,pizzapops,,18,1,5,6
39961,FrancisC,,19,608,634,1242
39962,p0ppe,,0,14,12,26
39963,natelloyd,,19,94,33,127
39964,Rudy_Giuliani,,1,193,217,410
39965,Path3,,42,8,8,16
39966,schallstrom,,8,1,1,2
39967,buba1243,,18,352,460,812
39968,isaactr,,18,39,33,72
39969,ButterstheBear,,43,25,32,57
39970,brick_tamlin,,1,1,1,2
39971,BTSavage,,0,23,19,42
39972,exactLee,,34,3,19,22
39973,komboje,,5,1,4,5
39974,lemonlimeandbitters,,18,4,3,7
39975,keif,,34,1,3,4
39976,NWoodley,,22,1,1,2
39977,Moosebyte,,34,15,11,26
39978,pearcewg,,13,3,4,7
39979,clickfire,,5,1,2,3
39980,rjhazelwood,,18,11,17,28
39981,TuPapi,,1,5,4,9
39982,ul5255,,20,2,4,6
39983,Leeopus,,17,1,3,4
39984,pianist,,19,350,80,430
39985,sthomas314,,12,1,1,2
39986,tdellaringa,,35,22,18,40
39987,bottombitchdetroit,,18,88,26,114
39988,kirwanator,,31,1,1,2
39989,tekla,,20,1,1,2
39990,Slackerboy,,4,12,16,28
39991,elxx,,22,13,13,26
39992,redditer036,,13,1,1,2
39993,perzosodor,,32,37,8,45
39994,prelawstudent,,19,1,1,2
39995,tthomas,,18,1,1,2
39996,mrmunchies84,,5,2,6,8
39997,eigenmouse,,22,20,13,33
39998,alf77,,32,1,1,2
39999,curi,,20,9,4,13
40000,Skjef,,14,1,5,6
40001,Bloodhound,,19,1,1,2
40002,tetramou,,19,4,1,5
40003,ddon,,41,7,9,16
40004,djkym,,31,1,3,4
40005,fishmammal,,13,2,3,5
40006,ortusdux,,34,127,79,206
40007,kinokonoko,,13,2,11,13
40008,ericje,,13,57,139,196
40009,rataylor,,18,29,28,57
40010,crelm_toothpaste,,18,93,178,271
40011,argeaux,,19,429,533,962
40012,SFauconnier,,22,58,11,69
40013,dakotahawkins,,32,8,18,26
40014,w1sh3s,,18,2,1,3
40015,arrrrg,,18,1,1,2
40016,Gronk,,19,4,2,6
40017,Greenchunks,,42,62,51,113
40018,drodeznop,,1,61,34,95
40019,minks,,29,4,1,5
40020,explicitmemory,,18,225,73,298
40021,garduque,,34,10,22,32
40022,coldwinds,,5,1,2,3
40023,dementedwallaby,,12,28,25,53
40024,darkfrog13,,19,5,7,12
40025,bi_curious_yaktavist,,18,2,1,3
40026,LIONOS,,18,4,11,15
40027,adricm,,19,3,2,5
40028,lunatic604,,30,15,24,39
40029,ArmInAss,,31,13,9,22
40030,suler,,31,1,2,3
40031,ILoveJackDaniels,,6,36,73,109
40032,thebruce,,32,8,8,16
40033,blank,,34,10,21,31
40034,j0yb0y,,32,4,2,6
40035,fredamerican,,19,3,4,7
40036,cloudcyrex,,42,19,1,20
40037,stuckwithjesus,,13,13,1,14
40038,egarland,,30,38,34,72
40039,Uakaris,,18,41,16,57
40040,secede,,32,5,10,15
40041,Stercrazy2002,,13,5,8,13
40042,heatherkh,,13,6,15,21
40043,technogeeky,,13,33,43,76
40044,rigidtools,,14,1,1,2
40045,merf,,19,9,2,11
40046,Paul_Rockbottom,,40,2,2,4
40047,aprilhall,,5,19,18,37
40048,bobovski,,6,332,499,831
40049,mikestarrunner,,30,50,32,82
40050,bigkidbrowser,,19,14,42,56
40051,skew,,20,6,18,24
40052,edcox,,13,1,5,6
40053,jchrisa,,20,3,2,5
40054,esobchenko,,20,4,9,13
40055,frenchrose,,18,8,4,12
40056,sparcxl,,18,2,3,5
40057,MagikalGoat,,18,53,70,123
40058,agbullet,,31,35,49,84
40059,littlezipper,,18,1,1,2
40060,salkin,,32,1,1,2
40061,knv,,20,2,3,5
40062,henningg,,13,1,1,2
40063,regular_voter,,31,1,3,4
40064,truspect0r,,43,20,38,58
40065,sweetsassymalassy,,18,3,6,9
40066,burt_flaxton,,1,113,107,220
40067,doctorcaligari,,13,1,2,3
40068,chobit,,32,4,8,12
40069,jenrzzz,,36,1,1,2
40070,Reddit_Goes_Pathetic,,18,6,17,23
40071,ramses0,,20,16,18,34
40072,happyofficcworker,,31,56,34,90
40073,kriskelly,,14,3,2,5
40074,raizyr,,43,16,16,32
40075,skacr0w,,19,4,2,6
40076,danmichelle2004,,22,8,6,14
40077,ender3456,,18,763,8,771
40078,BernardMarx,,20,33,48,81
40079,rwmjones,,20,41,50,91
40080,liquidpele,,32,709,932,1641
40081,kdkdlskdjfkdj,,13,4,6,10
40082,funkadeliczipper,,3,1,4,5
40083,bobwoodshed,,18,1,1,2
40084,pankus,,5,8,16,24
40085,d1gp1g,,13,208,16,224
40086,EasilyAnnoyed,,22,140,116,256
40087,ilovemullets,,28,1,2,3
40088,mightyjoe,,19,7,6,13
40089,dharmatech,,29,16,6,22
40090,mt33,,22,9,16,25
40091,slimerr,,34,5,8,13
40092,daedalusman,,31,55,34,89
40093,ethanz,,13,9,13,22
40094,hyperartpro,,4,1,1,2
40095,cobweb,,18,15,30,45
40096,bloeboe,,20,9,4,13
40097,smackmybishop,,20,13,26,39
40098,Neurowhoa,,20,3,1,4
40099,enaeseth,,20,2,2,4
40100,bill-of-rights,,13,1,1,2
40101,pets_or_meat,,19,843,357,1200
40102,paryal,,20,2,3,5
40103,corysama,,42,3,6,9
40104,jim45804,,3,20,9,29
40105,catfishman,,18,4,12,16
40106,temroT,,1,1,1,2
40107,joelpt,,32,1,4,5
40108,MrMorden,,13,1,1,2
40109,sporkyy,,13,3,3,6
40110,microsofat,,18,100,158,258
40111,coltonrose,,18,12,3,15
40112,Zest,,13,2,4,6
40113,puns,,43,57,124,181
40114,mle1,,18,2,1,3
40115,Hindean,,15,6,3,9
40116,SeanConnery,,6,71,65,136
40117,pkpkpkpk,,10,20,21,41
40118,mstoehr,,20,30,7,37
40119,ew73,,20,1,1,2
40120,mahnahmahnah,,12,7,24,31
40121,oiballs,,27,1,1,2
40122,JustSayNOBAMA,,19,7,12,19
40123,jimmyjazz14,,20,2,13,15
40124,temporalg,,20,3,3,6
40125,Porges,,20,248,333,581
40126,chirayuk,,20,3,7,10
40127,koannaok,,22,16,14,30
40128,jamesbritt,,20,285,385,670
40129,elements,,22,1,1,2
40130,mrmod,,19,5,6,11
40131,fohat,,12,80,136,216
40132,EarendilStar,,13,12,10,22
40133,Peach,,18,4,1,5
40134,discobreakin,,42,309,282,591
40135,lucianot,,43,30,40,70
40136,Slaky311,,18,45,99,144
40137,pdiddyisme,,22,2,2,4
40138,arecanut,,29,6,10,16
40139,Steppenwolfdoo,,18,189,307,496
40140,pedro_voteforme,,0,44,49,93
40141,SirChasm,,31,9,5,14
40142,lenocinor,,20,7,3,10
40143,catsi,,31,109,163,272
40144,clackerd,,32,200,320,520
40145,SuperHappyPanda,,19,3,11,14
40146,markostyle,,10,1,2,3
40147,forwhat,,3,2,1,3
40148,AKofSpades,,32,1,1,2
40149,deepvote,,19,220,431,651
40150,Gary_Malhotra,,0,2,3,5
40151,MostlyHarmless19,,0,2,8,10
40152,ThePimpOfSound,,42,1,1,2
40153,rickdiculus,,38,2,1,3
40154,maxbarkly,,13,2,2,4
40155,diffyQ,,20,7,15,22
40156,keepingitcivil,,18,122,57,179
40157,hxcadillac,,13,22,10,32
40158,benbernards,,13,12,9,21
40159,Karabasan,,32,9,13,22
40160,Geoffzonit,,2,1,2,3
40161,gnurf,,36,1,2,3
40162,lamabodo,,43,1,5,6
40163,sabat,,19,13,15,28
40164,ghostofyesterday,,5,1,4,5
40165,zeny,,30,8,19,27
40166,jtikalsky,,20,5,5,10
40167,atl,,22,2,1,3
40168,stephenjoos,,18,2,3,5
40169,aurele,,20,9,13,22
40170,Kronikarz,,32,34,29,63
40171,Emowomble,,32,7,9,16
40172,taintedhero,,18,113,224,337
40173,t0mmy85,,22,4,12,16
40174,llmikeb,,20,21,13,34
40175,mikej,,32,2,1,3
40176,palish,,20,20,18,38
40177,krouw,,8,1,1,2
40178,I_AM_XENU,,19,4,19,23
40179,divad1978,,13,2,6,8
40180,phubaba,,22,61,77,138
40181,fjolliton,,20,9,3,12
40182,jimmm33,,26,1,1,2
40183,usian82938,,19,37,50,87
40184,ackza,,1,170,232,402
40185,M0b1u5,,5,532,954,1486
40186,TwistedAnimator,,19,4,2,6
40187,srodrigo,,18,4,9,13
40188,eikelestijn,,20,2,3,5
40189,illiaster,,11,21,22,43
40190,Kaelia,,4,13,11,24
40191,stoetzels,,34,1,1,2
40192,PortConflict,,20,3,3,6
40193,grudes7s,,34,11,2,13
40194,Oplace,,19,1,1,2
40195,vanschelven,,22,1,1,2
40196,Jayizdaman,,18,10,19,29
40197,enoonsti,,1,5,13,18
40198,kitepaint,,20,4,4,8
40199,seanbride,,7,3,3,6
40200,zulucious,,22,3,7,10
40201,perkam,,31,220,319,539
40202,snagster,,18,1,1,2
40203,cobainbc15,,12,24,22,46
40204,Urantia,,13,1,1,2
40205,ieatGUTS,,18,17,32,49
40206,ashipman,,20,1,1,2
40207,scottzed,,30,89,89,178
40208,kryptiskt,,20,44,51,95
40209,emacsen,,20,72,75,147
40210,tedivm,,1,9,8,17
40211,ndot,,19,16,28,44
40212,MrSharkey,,5,2,3,5
40213,fuckitydoda,,11,5,4,9
40214,nat5an,,20,164,37,201
40215,lemonidas,,1,2,1,3
40216,jamasaru,,1,26,30,56
40217,shaggy0798,,13,818,274,1092
40218,ooutland,,19,78,88,166
40219,deavon,,15,1,4,5
40220,sohail,,13,43,12,55
40221,gymz3,,12,1,1,2
40222,presidentmilf,,8,1,1,2
40223,antifeds,,1,6,3,9
40224,tagor,,34,22,32,54
40225,ideaprone,,5,18,12,30
40226,huntersd,,43,1,2,3
40227,thekgb,,22,9,12,21
40228,BrandonRushing,,18,29,28,57
40229,sakananyc,,4,32,8,40
40230,andrewdutko,,20,100,138,238
40231,sirebril,,19,2,1,3
40232,geekussr,,19,2,10,12
40233,Noxieas,,34,10,19,29
40234,unavoidable,,29,12,6,18
40235,jiyunatori,,29,5,13,18
40236,capisce,,20,10,5,15
40237,Arrogancy,,19,14,17,31
40238,capper42,,0,61,3,64
40239,macmancpb,,16,4,4,8
40240,captainbarky,,20,2,7,9
40241,jacksonh,,13,43,72,115
40242,Lonelobo,,19,168,68,236
40243,firewolf,,1,42,3,45
40244,icthus7,,14,2,3,5
40245,BoondockDeacon,,19,1,1,2
40246,MrWizard,,13,22,28,50
40247,rotidder,,20,1,1,2
40248,Zoot,,13,1,1,2
40249,tehxaton,,13,179,262,441
40250,Rawsock,,20,30,51,81
40251,cowsonfire,,28,12,20,32
40252,Dakart,,5,98,138,236
40253,jimbobb860,,13,6,13,19
40254,Orthography_Nazi,,1,5,7,12
40255,Recluse,,18,64,195,259
40256,bingowingo,,5,1,1,2
40257,amyapotheosis,,28,2,4,6
40258,jessecore,,18,1,2,3
40259,inopia,,20,343,240,583
40260,Aesir,,18,27,29,56
40261,lua21,,1,3,1,4
40262,evildeer,,31,6,10,16
40263,axmt,,20,19,2,21
40264,ginxed,,18,6,4,10
40265,jr93087,,0,1,2,3
40266,gumugum,,34,1,1,2
40267,droberts1982,,20,48,27,75
40268,HardwareLust,,42,768,1120,1888
40269,doiveo,,42,114,21,135
40270,miller3790,,13,33,16,49
40271,titoonster,,19,16,34,50
40272,liberals_r_noobs,,19,100,145,245
40273,actualair,,12,3,9,12
40274,jhoneycutt,,20,16,1,17
40275,voltairewildedumas,,13,1,1,2
40276,abjurer,,1,58,63,121
40277,homeworld,,19,1866,992,2858
40278,jms18,,0,3,7,10
40279,treenaks,,20,68,46,114
40280,briankuhn,,20,3,11,14
40281,jairtrejo,,20,24,5,29
40282,chickenwing21,,4,1,2,3
40283,Ed_Wuncler_III,,19,1,1,2
40284,tompiatelli,,0,3,14,17
40285,thunderbird,,12,1,1,2
40286,otterplay,,11,700,1257,1957
40287,ebschiller,,1,2,3,5
40288,stefalex,,22,3,1,4
40289,absolutecero,,1,29,29,58
40290,filecabinet,,20,3,1,4
40291,MaxStax,,42,31,33,64
40292,ith,,43,8,5,13
40293,nonamegirl,,0,42,2,44
40294,the_classifier,,20,1,3,4
40295,mmmelissaaa,,18,27,46,73
40296,SpitfireRed,,18,63,74,137
40297,seanneko,,20,1,1,2
40298,marcushe,,19,50,71,121
40299,neosiv,,43,1,1,2
40300,jtp51,,0,2,12,14
40301,petermichaux,,20,37,28,65
40302,stacyelizabeth,,12,2,2,4
40303,astroid0,,1,6,20,26
40304,dtimo,,32,2,1,3
40305,archju01,,19,36,54,90
40306,lallen,,30,5,8,13
40307,norstar,,32,1,3,4
40308,nirs,,20,26,33,59
40309,Rooster113,,31,20,38,58
40310,unforgyvn,,10,163,270,433
40311,mlw72z,,20,7,10,17
40312,dodecalogue,,22,75,203,278
40313,Ernesttoo,,0,18,1,19
40314,thetedster180,,29,1,3,4
40315,pricklypear69,,4,1,1,2
40316,xfire301,,42,2,2,4
40317,addps4cat,,20,15,14,29
40318,mturk,,43,351,506,857
40319,baropithecus,,12,61,43,104
40320,unabiker,,5,12,24,36
40321,Antebios,,18,306,445,751
40322,fooforthecity,,20,1,1,2
40323,hpot,,39,3,3,6
40324,Ilich,,34,16,16,32
40325,happytron,,13,10,16,26
40326,mypurplelighter,,1,102,155,257
40327,syroncoda,,13,596,1064,1660
40328,Imson,,32,3,6,9
40329,Prometheus25,,19,32,38,70
40330,ifonlywecouldstopjef,,20,48,1,49
40331,Paczesiowa,,20,139,216,355
40332,bbzed,,19,1,1,2
40333,chucky,,20,2,5,7
40334,GDSM,,20,15,10,25
40335,atomofconsumption,,18,17,23,40
40336,softwareperson,,20,2,5,7
40337,taigaIV,,19,3,4,7
40338,spookyvision,,20,162,246,408
40339,omar12,,18,4,7,11
40340,derek985,,18,10,18,28
40341,addingzeros,,19,7,8,15
40342,sniper1rfa,,22,172,301,473
40343,generichandle,,1,2,1,3
40344,captchinchilla,,18,14,9,23
40345,Time2fish,,13,20,12,32
40346,Ellenka,,42,1,1,2
40347,webpimp,,18,30,11,41
40348,Harriv,,20,37,4,41
40349,zagorko,,36,2,1,3
40350,xl-brain,,19,12,12,24
40351,vontrapp,,43,8,12,20
40352,Elleo,,42,16,14,30
40353,protek,,7,1,3,4
40354,steelfrog,,18,19,28,47
40355,SeattleTomy,,13,69,114,183
40356,softwareprogrammer,,20,1,1,2
40357,spaceman77,,13,12,58,70
40358,ruser0,,20,1,1,2
40359,parsap,,18,66,1,67
40360,cratylus,,20,134,178,312
40361,1point618,,4,28,23,51
40362,grodisattva,,18,1,5,6
40363,faaron,,12,3,6,9
40364,bryanut,,20,44,32,76
40365,dreamlax,,20,258,338,596
40366,dokden,,32,11,20,31
40367,mrvix,,34,11,19,30
40368,ryanx27,,14,976,2115,3091
40369,izjay,,12,1,2,3
40370,robotthink,,38,26,43,69
40371,xian,,20,13,29,42
40372,TKappe,,20,18,14,32
40373,reddista2,,36,1,1,2
40374,bazfoo,,20,20,31,51
40375,jonknee,,20,704,953,1657
40376,rolson,,31,86,62,148
40377,knotted_donuts,,43,2,5,7
40378,eroq,,12,79,193,272
40379,substill,,22,62,72,134
40380,seanbateman,,20,1,1,2
40381,chancemaster,,34,1,2,3
40382,Zelbinian,,31,11,33,44
40383,Branyers,,31,58,94,152
40384,panthersrock,,20,44,23,67
40385,realdpk,,18,276,335,611
40386,nicolas11,,18,383,13,396
40387,waste49,,18,8,3,11
40388,sheepskin,,19,139,259,398
40389,Clarke101,,5,3,17,20
40390,scranklin,,18,5,5,10
40391,lavareef,,20,1,1,2
40392,melnormal,,1,38,4,42
40393,toast28,,12,3,9,12
40394,xxxsagaxxx,,30,291,688,979
40395,john_wayne,,43,1,1,2
40396,redditto,,3,316,550,866
40397,DiggerDan,,5,2,6,8
40398,Fishmachine,,13,1,1,2
40399,arrakis-cDc,,27,4,4,8
40400,manole10,,19,3,11,14
40401,dangerousbehavior,,0,1,2,3
40402,joshk0,,20,1,2,3
40403,GBs4DsGs,,32,15,11,26
40404,jimbo78255,,13,111,179,290
40405,cubicarts,,1,19,32,51
40406,mithra,,6,2,9,11
40407,Layali,,13,75,17,92
40408,opticalfader,,19,20,41,61
40409,Either-Or,,32,5,11,16
40410,ncoderre,,31,1,1,2
40411,thumper242,,18,1,1,2
40412,seven999,,3,1,2,3
40413,ih8registrations,,19,514,1017,1531
40414,seventimes,,8,1,1,2
40415,shiner_man,,19,1332,1128,2460
40416,CaptainHypocrisy,,19,3,6,9
40417,Threedcoder,,20,12,16,28
40418,MikeInVB,,1,10,11,21
40419,kinkmeister,,40,17,4,21
40420,steveokay,,14,8,1,9
40421,Asystole,,18,31,18,49
40422,pudo,,20,2,1,3
40423,billdoe,,0,21,53,74
40424,jvdomino,,18,38,9,47
40425,IvyMike,,9,607,419,1026
40426,sirmuffinman,,18,20,32,52
40427,shashankr,,20,5,1,6
40428,BbIT,,13,24,41,65
40429,Uncle_Sam,,19,5,19,24
40430,lokkij,,13,3,9,12
40431,fwchristie,,13,5,3,8
40432,ForzaIbra,,6,1,5,6
40433,wheregator,,15,51,29,80
40434,jimsf,,13,1,1,2
40435,thoomfish,,20,144,166,310
40436,zaim,,1,22,38,60
40437,samimy,,7,1,1,2
40438,joej,,18,6,9,15
40439,cliffordp,,18,73,7,80
40440,qrswave,,19,217,58,275
40441,charliejon,,1,1,1,2
40442,artimas,,18,7,8,15
40443,heyredditaddict,,19,183,14,197
40444,womms,,31,9,3,12
40445,AchieveMaster,,18,1,1,2
40446,indigoshift,,1,342,927,1269
40447,bobbybuilder,,0,2,4,6
40448,sstevesstrong,,31,2,2,4
40449,r04rk,,17,1,2,3
40450,reddeb,,34,911,974,1885
40451,drrobotlove,,0,2,2,4
40452,spookyjon,,13,9,10,19
40453,alfryd,,22,23,19,42
40454,Tanoku,,20,8,4,12
40455,tm8992,,20,48,2,50
40456,coheedcollapse,,18,44,70,114
40457,aclashingcolour,,42,1,1,2
40458,stubob,,4,327,450,777
40459,aleks1980,,18,52,10,62
40460,the_marsupial,,0,22,27,49
40461,bartley,,20,2,1,3
40462,jonasistaken,,18,2,5,7
40463,tomlikestorock,,20,2,1,3
40464,Chris-Hansen,,37,1,3,4
40465,Fat_Dumb_Americans,,18,396,876,1272
40466,JudeanPeoplesFront,,18,5,4,9
40467,clausb,,20,2,3,5
40468,shanem,,18,203,217,420
40469,cheatham,,6,2,2,4
40470,segv00,,12,2,3,5
40471,Grokmoo,,42,70,51,121
40472,cowholio4,,18,6,5,11
40473,autisticmongoloid,,20,18,16,34
40474,bschmalhofer,,3,1,2,3
40475,tomato84,,0,1,1,2
40476,somecunt,,31,2,2,4
40477,zehoppa,,4,1,1,2
40478,akair,,18,20,46,66
40479,cinemascopian,,5,2,1,3
40480,adambard,,20,16,3,19
40481,Austy,,31,1,3,4
40482,zeldamaster666,,43,121,290,411
40483,Newsmyway,,1,9,2,11
40484,jenkstom,,15,1,4,5
40485,doodads,,26,1,2,3
40486,pitou-4,,20,1,3,4
40487,flinxmeister2,,0,1,1,2
40488,Live-love-leave,,29,1,1,2
40489,snarblarg,,34,12,16,28
40490,kramo1,,18,1,1,2
40491,mavetech,,0,4,4,8
40492,Akany,,34,21,8,29
40493,brandonwardlaw,,34,83,36,119
40494,Sortra77,,34,11,21,32
40495,thetruthbeknown,,13,32,69,101
40496,quitehairy,,20,4,4,8
40497,mart_at_reddit,,13,4,8,12
40498,keyforce,,18,15,22,37
40499,algorithmic,,1,4,1,5
40500,enkiv2,,20,6,10,16
40501,HolisticResources,,34,4,4,8
40502,rutabaga,,15,5,4,9
40503,ghosthacked,,14,41,65,106
40504,pinkrabbit,,18,15,5,20
40505,splurb,,30,4,9,13
40506,Ledwick,,18,19,44,63
40507,phono,,19,2,1,3
40508,BeerOtter,,1,271,402,673
40509,codemac,,20,12,21,33
40510,ZXQ,,29,1,2,3
40511,authorblues,,19,1,3,4
40512,Lieutenant-Obvious,,22,5,8,13
40513,the_future,,19,4,10,14
40514,arjie,,31,68,93,161
40515,twitterpaters,,13,43,5,48
40516,jns_reddit_already,,18,18,20,38
40517,beezel666,,22,2,1,3
40518,Offal,,18,2,1,3
40519,revb,,18,36,12,48
40520,tjdick,,13,78,110,188
40521,aezell,,0,47,51,98
40522,huracan,,18,4,5,9
40523,christifor,,19,1,4,5
40524,Retsoka,,18,98,186,284
40525,Willy0Panhandle,,32,6,24,30
40526,brickne3,,31,58,36,94
40527,olddigspices,,8,1,1,2
40528,coopr,,34,6,8,14
40529,mzbin,,13,3,1,4
40530,65daysofstatic,,22,7,4,11
40531,revoman,,19,1433,1493,2926
40532,yogigluv,,0,4,4,8
40533,generaux,,36,2,1,3
40534,Phssthpok,,20,5,4,9
40535,diode1001,,19,1,3,4
40536,bango_lassie,,12,1,2,3
40537,foood,,34,11,12,23
40538,tarapurasson,,34,26,21,47
40539,anonomous_cowerd,,1,12,11,23
40540,random508972509,,0,10,19,29
40541,johndoe75338,,6,5,1,6
40542,p3on,,18,30,64,94
40543,webaddict,,5,1,2,3
40544,ignatiusloyola,,5,6,8,14
40545,DJiK,,18,3,16,19
40546,livedog,,32,64,48,112
40547,superdude4agze,,18,32,49,81
40548,SDgoon,,20,2,3,5
40549,Caluen,,15,74,106,180
40550,fknlo,,18,15,14,29
40551,mogden,,20,3,1,4
40552,Viat,,31,7,10,17
40553,fluffincake,,1,8,15,23
40554,myotheralt,,22,620,1171,1791
40555,MathNinja,,20,23,23,46
40556,JenniferLeh,,13,4,1,5
40557,WonkoDeSane,,19,14,32,46
40558,heypans,,15,19,18,37
40559,Saucemaster,,13,4,6,10
40560,Vajrapani,,42,4,6,10
40561,silconman,,21,27,1,28
40562,abronzan,,14,2,1,3
40563,madma,,20,2,2,4
40564,intangible-tangerine,,19,567,780,1347
40565,jstalin456,,33,3,3,6
40566,NovaBandit,,26,2,2,4
40567,TheWeLikeToParty,,32,1,1,2
40568,skuzzy,,15,1,2,3
40569,dghughes,,30,683,896,1579
40570,GodOfAtheism,,34,48,102,150
40571,kurby125v2,,6,19,6,25
40572,b0jangl3s,,31,28,34,62
40573,imagium,,5,7,3,10
40574,jacques_chester,,20,57,66,123
40575,Yesh,,32,11,15,26
40576,redditer002,,13,2,4,6
40577,sambyfleet,,14,1,3,4
40578,karmafactory,,13,1,1,2
40579,paulbian,,43,19,20,39
40580,krnldmp,,31,68,108,176
40581,linkboi,,43,6,14,20
40582,lufcpdx,,13,20,20,40
40583,majin157,,19,2,1,3
40584,cliffnotes,,6,151,188,339
40585,deathhand,,34,22,39,61
40586,camperman,,1,7,13,20
40587,TMFC,,15,1,1,2
40588,schawt,,32,120,97,217
40589,imaredsfan,,34,5,7,12
40590,ichschnof,,42,4,9,13
40591,wakeupmrfox,,6,3,2,5
40592,libertao,,18,116,146,262
40593,burning_iceman,,0,1,2,3
40594,honeyjew,,32,22,34,56
40595,middlename,,13,34,79,113
40596,andrew1193,,19,13,14,27
40597,VulcanJaded,,8,2,1,3
40598,Pixelatedcow1,,29,1,1,2
40599,Billy_Gates,,18,16,14,30
40600,joelman0,,19,6,1,7
40601,dsl,,20,8,4,12
40602,gyronica,,13,54,60,114
40603,sb76117,,0,17,64,81
40604,condeh,,32,8,13,21
40605,markV101,,18,68,69,137
40606,bathninja,,5,64,45,109
40607,hittingbig,,4,67,1,68
40608,nenolod,,20,4,1,5
40609,brettorical,,43,108,146,254
40610,godtvisken,,19,102,48,150
40611,MisterEggs,,22,275,431,706
40612,johnneat,,19,327,32,359
40613,Shadrach77,,20,5,8,13
40614,ZebraSafari,,31,2,1,3
40615,truedat,,0,3,7,10
40616,Hedonopoly,,1,61,79,140
40617,Fried_Gorilla,,12,107,139,246
40618,heymark,,20,23,17,40
40619,gryph1,,22,11,13,24
40620,bshufham,,18,6,3,9
40621,relato,,1,16,9,25
40622,dogchef,,0,1,3,4
40623,zimm0who0net,,31,134,114,248
40624,-ov-,,19,92,16,108
40625,arcticStylings,,22,6,8,14
40626,the-point,,29,27,38,65
40627,fremcos,,43,2,1,3
40628,fleg123,,9,4,3,7
40629,allanl,,12,38,70,108
40630,davbo,,13,1,1,2
40631,TheOneTrueEric,,13,1,2,3
40632,reflibman,,13,1685,820,2505
40633,raphaelb,,31,2,5,7
40634,jacobolus,,20,75,74,149
40635,samnmax,,19,11,10,21
40636,Jger,,31,8,13,21
40637,Kapidux,,12,62,16,78
40638,B2point1,,8,1,1,2
40639,cloudcityproblems,,1,2,8,10
40640,mrak,,20,1,1,2
40641,pkgraham,,20,1,1,2
40642,encloser,,23,3,1,4
40643,nonex,,18,9,19,28
40644,Kluny,,13,2,5,7
40645,jj666,,20,132,211,343
40646,mikenuman,,12,1,1,2
40647,ablaize,,15,2,2,4
40648,chaosgone,,6,244,264,508
40649,mtech,,19,13,10,23
40650,ohlieoh,,34,1,2,3
40651,zublay,,32,6,3,9
40652,puhnitor,,29,1,4,5
40653,Barack2012,,13,3,4,7
40654,jonaphin,,0,20,7,27
40655,antido,,34,45,15,60
40656,lavantin,,8,1,2,3
40657,nostromo,,31,113,134,247
40658,hexagonalfacepack,,29,6,13,19
40659,ShushanEduth,,18,39,9,48
40660,throp,,20,3,2,5
40661,dfick,,19,1,4,5
40662,andrewnealon,,1,114,98,212
40663,jtbandes,,18,6,4,10
40664,eamon,,20,2,6,8
40665,PatronizingPatriot,,19,3,3,6
40666,meanfish,,19,29,35,64
40667,dickie,,13,1,2,3
40668,gghhddjj,,30,6,10,16
40669,Annom,,22,39,33,72
40670,TCPIP,,43,8,22,30
40671,poliphilo,,19,4,7,11
40672,foxandlion,,43,1,1,2
40673,musashiXXX,,0,208,335,543
40674,guppie,,43,10,6,16
40675,flip314,,13,101,251,352
40676,Replicatorinc,,17,2,5,7
40677,robsnell,,13,15,16,31
40678,pwang99,,1,142,134,276
40679,floodcasso2,,5,76,3,79
40680,howzzat,,8,19,22,41
40681,Scrumtrilescent,,19,44,42,86
40682,zdkm,,42,45,62,107
40683,hillbilly1,,20,9,15,24
40684,Poison1990,,18,4,7,11
40685,squidboots,,34,1022,704,1726
40686,rossoonline,,32,13,8,21
40687,catacombus,,19,15,19,34
40688,keff,,20,47,30,77
40689,jjjsssfff,,0,1,3,4
40690,bestnameever,,1,17,30,47
40691,r00bythen00by,,8,6,23,29
40692,Yaaraina,,34,13,1,14
40693,adrianassecret,,5,5,10,15
40694,terryphi,,32,21,26,47
40695,wingsofseraphim,,22,203,389,592
40696,wwwwolf,,20,5,3,8
40697,spark3d,,3,6,7,13
40698,ddrager,,1,41,52,93
40699,mattpopzzz,,34,5,6,11
40700,KyleVarner,,32,7,2,9
40701,rad157,,20,3,7,10
40702,keithburgun,,42,50,63,113
40703,StuckInNY,,18,33,74,107
40704,Gids,,5,1,1,2
40705,yourparadigm,,32,205,243,448
40706,mg115ca,,32,20,55,75
40707,s0cket,,31,227,267,494
40708,tpicot,,0,5,6,11
40709,bootsandtea,,0,18,21,39
40710,shahpilescliniq,,33,1,2,3
40711,royrodgers22,,18,15,17,32
40712,chrispine,,30,39,63,102
40713,WAKE_UP_SHEEPLE,,19,69,101,170
40714,stoptheshit,,10,2,1,3
40715,ThatOtherGirl,,1,68,126,194
40716,Kilomph,,19,58,91,149
40717,fossuser,,20,36,56,92
40718,hotfudgemonday,,18,25,27,52
40719,whatwentwrong,,18,5,8,13
40720,for_no_good_reason,,20,29,26,55
40721,coney27,,0,1,4,5
40722,neo1513,,4,7,8,15
40723,wowzler,,13,7,4,11
40724,jfv6956,,1,60,23,83
40725,Misinformation,,10,1,1,2
40726,leperkuhn,,20,6,2,8
40727,Nuggets,,37,3,1,4
40728,maddoxreddit,,4,1,1,2
40729,fresh,,19,8,4,12
40730,nighttime,,14,2,5,7
40731,accelleron,,4,173,295,468
40732,cursoryusername,,11,1,2,3
40733,i_work_there,,8,6,2,8
40734,lantech,,32,4,3,7
40735,sobri909,,31,23,23,46
40736,latro,,6,129,178,307
40737,romulcah,,0,47,37,84
40738,Free_Sirhan,,5,19,27,46
40739,LemonHerb,,13,8,14,22
40740,7md2,,32,59,9,68
40741,fuzzyl0gic,,0,8,13,21
40742,Tomble,,18,53,116,169
40743,centrinos,,29,1,2,3
40744,Saulace,,1,25,62,87
40745,uncopyright,,18,6,5,11
40746,IuleI434,,19,2,6,8
40747,redsectorA,,6,254,340,594
40748,jlee11,,18,113,130,243
40749,norm_macdonald,,3,1,2,3
40750,freedompower,,1,70,109,179
40751,mchrisneglia,,43,540,1050,1590
40752,tehrob,,13,26,27,53
40753,TakeBackUSA,,6,2,1,3
40754,barryfandango,,20,40,30,70
40755,slynn315,,8,17,3,20
40756,sarzec,,18,7,32,39
40757,delutz,,18,57,48,105
40758,mfloydc,,13,24,3,27
40759,cecole1,,18,2,4,6
40760,lucifercain,,29,83,99,182
40761,steelydaniel,,18,43,7,50
40762,MosquitoWipes,,18,58,44,102
40763,jasonhdavis,,18,1,2,3
40764,AcuraF1,,39,2,1,3
40765,thegrossman,,43,2,1,3
40766,Doctor,,19,109,209,318
40767,xixor,,22,4,14,18
40768,bman35,,31,37,43,80
40769,dand,,4,18,33,51
40770,sstid,,43,4,10,14
40771,saltfish,,1,22,33,55
40772,YanksRule,,19,3,1,4
40773,Scatterbrand,,27,6,5,11
40774,trolling_anonymously,,33,1,1,2
40775,NoSuchThingAsNoKill,,14,2,1,3
40776,darknebula,,13,110,208,318
40777,Jamer70,,18,7,12,19
40778,MrValdez,,20,21,20,41
40779,moizkhan,,32,2,2,4
40780,gdb,,18,2,1,3
40781,RE90,,13,1,5,6
40782,PresidentBarackObama,,31,2,1,3
40783,putneyswope,,11,2,1,3
40784,scottmartinnet,,13,33,30,63
40785,fluffyflora,,31,3,1,4
40786,PeaceLovingHippie,,19,4,11,15
40787,pr3d,,1,2,3,5
40788,woodreaux,,13,1,3,4
40789,allyant,,18,1,1,2
40790,FoRo,,35,91,120,211
40791,dollarfreefall_com,,19,63,102,165
40792,uilaniespinoza,,6,1,1,2
40793,ch8ind,,18,1,9,10
40794,Godspiral,,19,134,250,384
40795,lar1,,8,1,2,3
40796,Nick127,,1,3,5,8
40797,wonderloey,,19,19,39,58
40798,jsz,,34,226,260,486
40799,mathoms,,43,20,12,32
40800,ShirleyPhelpsRoper,,23,2,2,4
40801,YossarianLives,,31,16,29,45
40802,Orngarth,,0,10,12,22
40803,cryptopookie,,8,5,2,7
40804,BitBrain,,13,120,184,304
40805,natepoff,,13,5,2,7
40806,chris_ut,,8,34,21,55
40807,cowboy-bebop,,19,34,27,61
40808,thcobbs,,11,3,1,4
40809,BigMcLargeHuge,,13,11,23,34
40810,njharman,,20,603,903,1506
40811,skosuri,,19,12,9,21
40812,i_read_it,,0,156,195,351
40813,peasleer,,5,1,1,2
40814,shankargallery,,14,1,1,2
40815,alcorrr,,13,2,1,3
40816,acidity,,31,15,39,54
40817,reaganite,,0,7,7,14
40818,gutterbumber,,18,29,43,72
40819,istiamar,,18,32,72,104
40820,rmi77,,20,2,4,6
40821,ascendant23,,34,165,159,324
40822,polyesterfunk,,19,115,175,290
40823,lemonparty,,19,31,46,77
40824,chois,,13,2,4,6
40825,zombi1101,,18,13,1,14
40826,ameelabee,,19,23,19,42
40827,instntkrma,,18,4,4,8
40828,unlimited,,42,192,159,351
40829,MrSunshine,,43,6,5,11
40830,deathisbad,,19,2,8,10
40831,slothfist,,18,5,8,13
40832,JoeBlu,,22,81,114,195
40833,cledwards,,0,4,6,10
40834,thegoogle,,19,8,9,17
40835,JKrahn,,18,4,4,8
40836,quartz,,18,4,2,6
40837,assface,,20,23,39,62
40838,latatata,,20,1,1,2
40839,Vegeman,,19,1,2,3
40840,nullzero,,10,2,2,4
40841,Aeooo,,4,2,2,4
40842,jopejope,,20,169,154,323
40843,captdets,,32,5,5,10
40844,supakual,,4,62,51,113
40845,nomis80,,20,15,12,27
40846,nkallen,,20,1,3,4
40847,jasonmashak,,15,2,3,5
40848,cvonwallenstein,,20,6,2,8
40849,ipostme,,18,46,2,48
40850,sevhan,,18,6,14,20
40851,Catbert321,,20,44,55,99
40852,aveceasar,,41,251,411,662
40853,equallyunequal,,22,7,9,16
40854,tryagainhaters,,20,1,1,2
40855,johnston360,,18,1,2,3
40856,batypus,,39,67,68,135
40857,kej1701,,6,1,1,2
40858,instantopinion,,11,3,4,7
40859,senseless,,19,6,19,25
40860,jaimev,,0,1,1,2
40861,haporn,,43,37,7,44
40862,wickedwife,,22,5,8,13
40863,ronpaul2008now,,0,1,1,2
40864,CrunkleWotsit,,18,5,7,12
40865,Cilpot,,31,9,21,30
40866,ctrlsoft,,20,1,1,2
40867,nroth,,13,7,7,14
40868,telharsic,,6,3,1,4
40869,eouw0o83hf,,1,283,441,724
40870,skefarius,,43,1,5,6
40871,serious_face,,20,48,59,107
40872,LOUD_HOWARD,,9,6,8,14
40873,arcticfox,,30,129,304,433
40874,JohnnK,,0,259,43,302
40875,HookerBot5000,,18,5,12,17
40876,DrG,,31,9,11,20
40877,Rebooted,,31,1,1,2
40878,starspangledpickle,,18,99,123,222
40879,bigbadsi,,29,8,20,28
40880,scaz,,43,2,1,3
40881,fatmike85,,8,2,1,3
40882,slightlymoreinformed,,13,1,1,2
40883,topsul,,1,181,236,417
40884,atw,,31,6,1,7
40885,pfesta,,28,81,70,151
40886,ellsmall,,34,6,10,16
40887,lscritch,,31,5,5,10
40888,IbbleDibble,,4,15,29,44
40889,aconbere,,20,21,33,54
40890,nicolaslara,,20,8,1,9
40891,throwingks,,29,64,70,134
40892,vatul,,13,3,4,7
40893,recursive,,20,437,635,1072
40894,LankySplotch,,18,36,67,103
40895,aanaedwards,,5,1,8,9
40896,edge211,,34,2,4,6
40897,reddragn,,17,1,1,2
40898,the_argus,,22,1,2,3
40899,d_dreamer,,1,1,1,2
40900,procopio,,18,28,67,95
40901,skissors,,4,16,17,33
40902,Sissom,,42,1,3,4
40903,bissco,,30,2,1,3
40904,akreddit,,5,1,3,4
40905,abdeviation,,0,2,1,3
40906,ispice,,30,11,10,21
40907,buddhisaali,,13,1,4,5
40908,kapow53,,42,7,12,19
40909,f5button,,1,12,7,19
40910,sgoguen,,18,13,38,51
40911,cantusaeolus,,30,1,4,5
40912,LOUDNOISES,,1,1,1,2
40913,jaycliche,,16,8,1,9
40914,AHammer16,,43,2,2,4
40915,Dismal_Science,,10,25,51,76
40916,KetaKat,,35,4,6,10
40917,clin_reddit,,35,120,182,302
40918,xxvmarcvxx,,31,1,2,3
40919,PieceOfShoe,,20,1,3,4
40920,FlawlessKnockoff,,19,9,7,16
40921,scattyboy,,13,5,5,10
40922,Plurals,,1,28,10,38
40923,drapi,,29,1,1,2
40924,requiemforadream,,4,1,1,2
40925,Blakovitch,,43,20,1,21
40926,nick415,,43,115,124,239
40927,hotcha,,3,20,10,30
40928,oemta,,20,23,23,46
40929,eratner15,,34,4,3,7
40930,suhlash,,0,2,2,4
40931,vickibci,,13,8,7,15
40932,sandoval33,,13,1,1,2
40933,jmone,,18,1,3,4
40934,bluespapa,,39,102,294,396
40935,mourning_air,,18,4,10,14
40936,duckie,,14,1,2,3
40937,greasyjay,,31,2,6,8
40938,eicos,,31,33,45,78
40939,tmcwilly,,20,4,4,8
40940,crumpgeri,,18,1,2,3
40941,ncamren,,1,2,2,4
40942,jake103,,13,89,24,113
40943,cf26,,19,68,7,75
40944,blinkgeo,,13,40,4,44
40945,verycheeky,,22,7,3,10
40946,dougletts,,1,269,250,519
40947,kpanik,,13,11,24,35
40948,parm,,29,1,2,3
40949,Woodland,,1,1,1,2
40950,devilhorn,,19,1,3,4
40951,findlove,,19,1,1,2
40952,AlanIn2012,,19,2,1,3
40953,superamit,,14,1,1,2
40954,goddesspyxy,,19,1,2,3
40955,kwikie,,18,81,10,91
40956,Jimmni,,2,13,22,35
40957,chromaphobic,,19,1,1,2
40958,skeptica1,,19,34,49,83
40959,Klytus,,34,2,5,7
40960,Intellectual_Poverty,,18,4,4,8
40961,clojed_over_variable,,20,1,1,2
40962,Lyesit,,6,1,2,3
40963,michaelborchert,,13,4,7,11
40964,tonyskyday,,20,1,1,2
40965,erythrocyte,,1,4,12,16
40966,anotherex,,20,9,5,14
40967,corrupteire,,13,1,6,7
40968,mikeypoo,,29,9,9,18
40969,Ayman,,20,4,5,9
40970,Leviathan89,,31,1,6,7
40971,DarthGuru,,5,3,3,6
40972,bdelena,,5,1,1,2
40973,gfindlay,,34,74,64,138
40974,Cheeta66,,20,29,35,64
40975,BlueDeath,,34,43,36,79
40976,kzskzs,,19,47,5,52
40977,fasterdogs,,34,3,4,7
40978,opafaf,,4,5,5,10
40979,zxquarx,,12,3,5,8
40980,dcousineau,,8,78,35,113
40981,sleepingorange,,18,89,86,175
40982,InCaseOfEmergency,,13,63,113,176
40983,0394803948,,19,8,3,11
40984,cradle,,3,4,6,10
40985,sambeee,,19,1,5,6
40986,redditblue,,7,1,4,5
40987,mikeboers,,20,8,8,16
40988,crazy_phys,,31,3,7,10
40989,ramblasos,,43,68,5,73
40990,rubbertoad,,31,2,1,3
40991,ladyroxanne,,1,9,7,16
40992,glenc,,20,5,1,6
40993,Kichigai,,4,13,5,18
40994,wdsnizek,,42,36,31,67
40995,monikioo,,32,1,1,2
40996,LinusTorvalds2600,,31,2,1,3
40997,rtp,,43,172,134,306
40998,nobodysbusiness,,20,36,31,67
40999,soren_m,,27,1,1,2
41000,chenyu768,,13,32,28,60
41001,heff_in_virginia,,13,2,5,7
41002,shitfuckitwhocares,,22,1,1,2
41003,stevewolkrat,,15,9,3,12
41004,PaddyDX,,19,22,23,45
41005,YoHoMoFo,,14,1,1,2
41006,dman413,,34,71,13,84
41007,progressnerd,,18,250,30,280
41008,mercurytransit,,18,14,18,32
41009,shackleton1,,14,46,52,98
41010,franco9x,,8,3,6,9
41011,phatlikebuddha,,13,27,15,42
41012,HippieWithAGun,,6,14,42,56
41013,LillyFrance,,0,1,1,2
41014,flameboy,,31,4,5,9
41015,fonograph,,12,15,20,35
41016,ROFISH,,42,20,1,21
41017,xiaomai,,20,16,26,42
41018,EIderofzion,,32,335,140,475
41019,Sub_911insidejob,,22,5,5,10
41020,madcowga,,18,590,166,756
41021,DiggaPlease,,1,122,78,200
41022,charlesap,,20,1,1,2
41023,nihildeb,,19,2,2,4
41024,controlphreak,,26,11,7,18
41025,DJFlow,,31,8,4,12
41026,rategil7,,16,4,3,7
41027,realneil,,15,250,192,442
41028,mariet,,36,5,1,6
41029,stuckfugu,,1,1,1,2
41030,Coema,,18,1,1,2
41031,caiomoritz,,20,1,2,3
41032,ryalslawfirm,,18,6,14,20
41033,chebwa,,18,12,16,28
41034,DaveM191,,31,216,269,485
41035,stiennon,,19,99,43,142
41036,anforowicz,,19,4,3,7
41037,burtreynoldsmustache,,18,76,102,178
41038,chrisdew,,20,2,1,3
41039,joaquintides,,34,2,1,3
41040,Margrave,,34,13,43,56
41041,CarbonFire,,18,29,64,93
41042,BelieveIt,,31,2,2,4
41043,kublakhan,,18,230,243,473
41044,Flownominal,,13,43,40,83
41045,bocajuniors,,19,13,15,28
41046,2plus2equals11,,31,7,2,9
41047,rmeredit,,4,52,74,126
41048,wildtalon,,23,2,4,6
41049,deadsy,,20,17,21,38
41050,ladoof,,20,64,83,147
41051,SmooveO,,5,2,2,4
41052,mycroft2000,,32,263,143,406
41053,mui_mui,,27,2,3,5
41054,airbrushedvan,,42,92,167,259
41055,Pub1ius,,19,348,120,468
41056,SEVEREaspergers,,5,20,11,31
41057,mogthew,,31,3,3,6
41058,yonigut,,30,54,12,66
41059,Mitchco,,20,6,10,16
41060,hetero_sex_is_rape,,32,8,16,24
41061,simonmd,,29,11,7,18
41062,andrew1718,,22,2,2,4
41063,rajones85,,31,7,9,16
41064,someitguy,,18,56,93,149
41065,Admiral_Mike_Mullen,,8,1,2,3
41066,runswithscissors,,5,22,9,31
41067,grantimatter,,6,116,101,217
41068,TCal79,,22,1,5,6
41069,aaronny,,22,4,1,5
41070,mattjolsen,,18,18,19,37
41071,mpind,,5,262,22,284
41072,zipfe,,18,76,115,191
41073,evolvenow,,30,21,6,27
41074,Digitalabia,,43,2,2,4
41075,Daigain,,19,3,7,10
41076,gunnaf,,12,1,3,4
41077,alexwhitesides,,13,3,4,7
41078,abrahamafreen,,43,1,1,2
41079,georedd,,13,332,254,586
41080,donaloc,,21,2,1,3
41081,osceola,,8,31,30,61
41082,christophski,,20,22,29,51
41083,CaliforniaEagle,,13,47,11,58
41084,aardvark179,,5,1,3,4
41085,murderball,,18,12,14,26
41086,The_Fonz,,19,11,15,26
41087,Adimof,,5,1,1,2
41088,renison,,22,35,26,61
41089,reformislam,,31,166,42,208
41090,CaptainSmirk,,19,3,7,10
41091,johneth,,6,2,6,8
41092,pilikia,,0,3,5,8
41093,ctcherry,,13,1,1,2
41094,SQLwitch,,42,2,1,3
41095,flybot,,13,1,1,2
41096,foreskin,,38,2,2,4
41097,tommykk,,1,8,20,28
41098,LetsGetParty,,19,3,2,5
41099,SomethingClever,,27,21,35,56
41100,LakiTheGreat,,5,38,8,46
41101,laff,,34,8,18,26
41102,jonben,,20,1,2,3
41103,blackgekko,,19,188,286,474
41104,antarest,,41,3,2,5
41105,washwords,,0,2,5,7
41106,316charlesc,,13,1,1,2
41107,BKMateo,,19,21,28,49
41108,joelsephy,,16,1,1,2
41109,UnSuppressed,,19,1,4,5
41110,lovemorgul,,5,1243,81,1324
41111,andypflueger,,32,1,1,2
41112,nothix,,18,5,7,12
41113,oletizi,,20,1,1,2
41114,Kyderdog,,13,4,17,21
41115,ansong,,13,2,2,4
41116,neo_07,,35,5,10,15
41117,xakfuqua,,20,4,3,7
41118,Pandalicious,,4,23,21,44
41119,louisroy,,18,2,5,7
41120,dfranke,,20,183,185,368
41121,victorkiam,,18,37,6,43
41122,someguyz,,18,35,51,86
41123,mark1983,,20,20,11,31
41124,vladimirptn,,18,35,69,104
41125,Obejuan,,13,10,7,17
41126,AllisonsBrains,,18,14,16,30
41127,Cloakofthenight,,13,2,5,7
41128,Jiert,,1,16,10,26
41129,n0t_5hure,,19,783,556,1339
41130,prolog,,31,57,51,108
41131,dregan,,22,162,231,393
41132,Saoshyant,,20,17,9,26
41133,antischool,,30,5,8,13
41134,BigSexyChicken,,28,5,8,13
41135,Shesthefastest,,30,8,18,26
41136,fanten,,23,4,7,11
41137,manofredearth,,6,3,7,10
41138,heeb,,20,52,93,145
41139,knoit911,,43,16,11,27
41140,nelsonslament,,1,5,15,20
41141,Kapow751,,20,37,56,93
41142,mletonsa,,34,27,1,28
41143,jokertrumps,,31,3,2,5
41144,JUSTREDD,,18,4,13,17
41145,jsdalton,,20,57,12,69
41146,Moonbird,,20,4,4,8
41147,so_sleepy,,19,211,516,727
41148,pieterg,,22,1,1,2
41149,danhebs,,6,5,2,7
41150,tm317,,1,5,9,14
41151,Pituquasi,,0,3,2,5
41152,v1mp,,32,2,2,4
41153,namelessgerman,,0,8,6,14
41154,larsga,,20,576,405,981
41155,rogueman999,,29,119,194,313
41156,auntjomama,,32,1,1,2
41157,sl33percat,,19,2,2,4
41158,kookjr,,12,1,15,16
41159,marcusuperbus,,26,2,1,3
41160,tonetheman,,20,6,5,11
41161,k0ugar,,5,4,5,9
41162,digital,,19,3130,465,3595
41163,bearwave,,19,219,64,283
41164,RandyPonce,,18,24,6,30
41165,pasterhatt,,32,3,11,14
41166,starrj0548,,33,3,5,8
41167,heidola,,5,14,35,49
41168,emeraldcity,,5,916,91,1007
41169,raggifl,,14,1,1,2
41170,Jgrav,,19,4,3,7
41171,LizardKing,,22,62,4,66
41172,ashemedai,,42,7,16,23
41173,Bored,,1,909,602,1511
41174,frankm191,,13,3,3,6
41175,NancyFuckingDrew,,13,7,5,12
41176,xxtralarge,,19,6,10,16
41177,kaufmajm,,13,4,1,5
41178,B3nno,,22,2,2,4
41179,ClubSoda,,13,84,87,171
41180,louis4,,19,22,16,38
41181,th13rteen,,18,43,39,82
41182,barnett03,,39,3,1,4
41183,kolanos,,12,47,69,116
41184,grfgguvf,,20,49,65,114
41185,madbadger2000,,5,1,1,2
41186,titty_mcknockers,,12,8,9,17
41187,1fish2fish,,19,1,11,12
41188,muse345,,5,5,8,13
41189,jsh,,31,125,204,329
41190,crunchie_nut,,6,4,1,5
41191,jln,,20,66,37,103
41192,OCedHrt,,8,51,78,129
41193,Cid420,,18,109,162,271
41194,zombiesaregreat,,31,1,1,2
41195,Ari_Rahikkala,,2,1,5,6
41196,conservohippie,,1,23,28,51
41197,BleuBrenda,,6,1,1,2
41198,apollotiger,,18,34,38,72
41199,mcpeg,,0,4,1,5
41200,dne852,,21,1,2,3
41201,OldManRivers,,17,1,1,2
41202,boulax,,18,10,16,26
41203,hippomille,,32,30,4,34
41204,fedira,,19,428,165,593
41205,quantum-mechanic,,19,269,180,449
41206,Huuuuuge_Asshole,,19,2,3,5
41207,garretta,,43,9,7,16
41208,ironsam,,19,2,4,6
41209,iluvlinux81,,19,8,8,16
41210,Extreme_Moderate,,19,3,7,10
41211,themightyredwood,,43,29,33,62
41212,utexaspunk,,4,611,737,1348
41213,masfenix,,0,25,36,61
41214,NinthAgendaDotCom,,18,196,153,349
41215,NimChimpsky,,30,1,2,3
41216,johnla,,1,8,7,15
41217,cryogen,,1,179,293,472
41218,wilcon,,34,1,4,5
41219,cantastoria,,19,4,6,10
41220,SevereArtist,,18,9,8,17
41221,evolved,,20,66,114,180
41222,gabaji123,,13,2,3,5
41223,huevos,,31,9,7,16
41224,robertwrobel,,23,37,49,86
41225,gmacken,,22,12,10,22
41226,radaway,,32,24,38,62
41227,stainrat,,20,4,10,14
41228,Comrade604,,34,1,2,3
41229,sweet_regina,,42,1,3,4
41230,pinkmj,,1,5,3,8
41231,merkidemis,,6,5,3,8
41232,eggcream,,20,6,3,9
41233,Csai,,18,93,13,106
41234,Scandalous,,32,16,21,37
41235,pilt,,20,15,2,17
41236,RosstaPharian,,19,53,12,65
41237,ihaveindeedreddit,,4,1,1,2
41238,YouTubeComments,,23,5,5,10
41239,laurakl,,18,2,3,5
41240,WakeTFU,,18,5,6,11
41241,MysteryHEAD,,1,3,2,5
41242,iggywig,,23,1,1,2
41243,Traiguen,,13,2,4,6
41244,rolfr,,20,166,41,207
41245,fucknuggets,,20,1,1,2
41246,spiky2,,43,153,80,233
41247,memplant,,32,9,19,28
41248,vvv,,20,23,13,36
41249,Suseki,,22,1,3,4
41250,egmanoj,,20,80,19,99
41251,82ndbrat,,8,1,1,2
41252,JRosePC,,18,4,1,5
41253,leetsauce,,30,1,1,2
41254,Wyv,,18,51,105,156
41255,THJahar,,0,1,2,3
41256,harbo,,31,7,7,14
41257,grammamama,,19,3,2,5
41258,damieng,,20,2,1,3
41259,trojan1500,,5,1,1,2
41260,alexgreen,,43,39,59,98
41261,yetispaghetti69,,1,1,4,5
41262,FUCKINDOITLIVEFUCKNO,,22,5,8,13
41263,ctulhu,,19,14,1,15
41264,cdeponte,,13,13,26,39
41265,Prototek,,18,45,51,96
41266,joe_from_accounting,,6,63,80,143
41267,mad44,,23,3,4,7
41268,mech,,43,4,7,11
41269,matthew49,,19,3,2,5
41270,Paula18,,19,3,3,6
41271,filmratt,,13,7,4,11
41272,crasylemur,,20,9,5,14
41273,seeyardee,,18,40,101,141
41274,matthew26,,34,62,28,90
41275,gman1993,,22,1,11,12
41276,jmmcd,,20,260,397,657
41277,lyyphe23,,13,318,530,848
41278,iknowgeography,,0,1,1,2
41279,iamjason,,43,251,24,275
41280,ingreenheaven,,18,7,7,14
41281,footjo,,34,8,4,12
41282,sworsham,,18,1,2,3
41283,kcb2,,32,34,10,44
41284,saagar734,,5,1,1,2
41285,capitalwon,,13,313,3,316
41286,piojo,,20,7,9,16
41287,amrap,,19,17,17,34
41288,Lexitron,,31,5,9,14
41289,jvarden,,2,10,2,12
41290,spagls,,13,4,6,10
41291,jaims,,31,1,2,3
41292,CliffDropOver,,13,117,185,302
41293,sameboat,,4,1,6,7
41294,geekboy,,18,13,27,40
41295,apocalypse910,,34,85,143,228
41296,disposablename,,19,3,5,8
41297,ManifestoConform,,18,44,60,104
41298,gbarrancos,,20,4,9,13
41299,haytphul,,43,1,1,2
41300,MsJoanne,,13,10,2,12
41301,Ceticus,,2,1,2,3
41302,ketilkn,,42,2,2,4
41303,kneelconqueso,,1,24,30,54
41304,wudi,,13,1,1,2
41305,dane_tmln,,33,1,1,2
41306,a0peter,,20,3,1,4
41307,DCSven,,17,2,1,3
41308,rmn30,,4,3,5,8
41309,jhs,,4,30,20,50
41310,ApochPiQ,,20,11,10,21
41311,particlesaching,,1,11,9,20
41312,brian_c,,1,62,74,136
41313,tommij,,32,7,17,24
41314,cliff_martin,,13,4,4,8
41315,gbirdc,,20,11,15,26
41316,valeriac,,13,1,1,2
41317,mrsiffer,,29,3,7,10
41318,nsimpson,,20,3,3,6
41319,Arcphi,,10,3,1,4
41320,Bardo77n,,16,17,17,34
41321,illegible,,3,83,182,265
41322,Tezasaurus,,42,147,270,417
41323,infoaddicted,,32,198,164,362
41324,toofar,,20,2,2,4
41325,SmokeSerpent,,18,21,39,60
41326,arthurphandler,,18,6,26,32
41327,winkoff,,4,1,1,2
41328,Kaan,,20,2,2,4
41329,Sud,,42,1,1,2
41330,cheponis,,19,46,37,83
41331,danman108,,31,2,4,6
41332,chillywafer,,18,2,2,4
41333,rnicoll,,20,454,499,953
41334,otooleco,,13,2,4,6
41335,timothy331,,38,3,1,4
41336,derkdadurr,,32,4,1,5
41337,ComboBreaker,,1,3,8,11
41338,fenderrocker,,32,45,20,65
41339,VideoDromedary,,19,8,5,13
41340,Squaker,,0,1,5,6
41341,drewlb,,32,40,38,78
41342,abshack,,42,22,37,59
41343,Ahurricane,,8,3,3,6
41344,pilto,,19,711,1007,1718
41345,zulo,,27,1,1,2
41346,Julian_Tempest,,0,1,1,2
41347,IRAN_MIKE_TYSON,,1,176,264,440
41348,KatieR10381,,34,87,73,160
41349,raveland,,0,3,2,5
41350,poopster,,1,24,25,49
41351,cultfigure,,33,3,1,4
41352,Archaia,,19,14,4,18
41353,ebosia,,43,2,8,10
41354,IHaveAnIdea,,20,178,335,513
41355,pyres,,32,5,3,8
41356,corky2515,,43,6,6,12
41357,inthe80s,,34,116,89,205
41358,hodagboy,,31,1,1,2
41359,Royalhghnss,,18,3,5,8
41360,jrbattin,,19,2,2,4
41361,uspn,,0,46,79,125
41362,colinjay,,12,9,10,19
41363,isthis,,26,33,16,49
41364,neversummer427,,43,200,137,337
41365,MrMakeveli,,18,1,6,7
41366,Dethklok,,43,36,65,101
41367,debacle,,18,6,8,14
41368,Vreep-eep,,30,144,226,370
41369,ahmonster,,13,2,3,5
41370,NeoMonkey,,1,95,143,238
41371,idle,,19,16,28,44
41372,inter123net,,6,2,1,3
41373,stopredditcensorship,,29,4,6,10
41374,wormspit,,43,4,6,10
41375,roadkillJESUS,,31,2,3,5
41376,Kevin_Raven,,1,64,90,154
41377,merks,,29,1,1,2
41378,slythfox,,20,109,188,297
41379,gonzinator,,32,1,1,2
41380,bettr,,19,2,2,4
41381,radiantwave,,0,42,72,114
41382,msjgriffiths,,32,4,6,10
41383,schaueho,,20,29,28,57
41384,Aahana,,42,3,4,7
41385,Kektain,,20,7,14,21
41386,HighHorse,,22,1,5,6
41387,anzhansen,,13,32,42,74
41388,interstate,,34,595,774,1369
41389,PleadTheTenth,,3,2,2,4
41390,sleepnow,,36,1,1,2
41391,SisterRay,,13,11,29,40
41392,timran,,13,179,7,186
41393,Swiggy,,19,652,331,983
41394,ccbbb23,,14,1,1,2
41395,achzavoth,,42,1,1,2
41396,moorage,,20,25,2,27
41397,tapedeck,,43,85,123,208
41398,oooeeeoooahhahh,,15,2,9,11
41399,AAjax,,13,383,553,936
41400,ThucydidesNow,,19,81,32,113
41401,drbaskin,,3,2,4,6
41402,rickshawricky,,1,5,2,7
41403,luml0003,,35,3,8,11
41404,elizabklyn,,42,35,46,81
41405,diplowset,,13,21,12,33
41406,jpspeno,,19,4,1,5
41407,kla,,31,71,78,149
41408,buttlord,,20,6,5,11
41409,jherazob,,13,12,23,35
41410,mbemberoui,,18,1,3,4
41411,kzyck,,13,1,1,2
41412,Pythagoras,,22,16,29,45
41413,ffejnamhcab1,,43,1,1,2
41414,inigid,,20,1,2,3
41415,looseshoes,,13,12,23,35
41416,innocenti,,6,3,1,4
41417,blan,,4,2,2,4
41418,brittanyq,,8,1,5,6
41419,askegg,,32,5,13,18
41420,patrick2009sw,,5,2,4,6
41421,watchman,,15,22,4,26
41422,cmprsdchse,,18,42,55,97
41423,travelingwilbury,,20,7,1,8
41424,lobster280zx,,16,1,1,2
41425,MpVpRb,,32,11,24,35
41426,stomicron,,22,256,314,570
41427,TheRealRedditAlien,,32,1,1,2
41428,papandrew,,19,1,1,2
41429,truthslacker,,18,1,1,2
41430,solidad,,6,3,4,7
41431,SomeGuyNamedAl,,39,1,4,5
41432,gotwillk,,18,1,1,2
41433,Comrad_Pat,,30,2,8,10
41434,Captain-Obliviouss,,19,387,724,1111
41435,mongoloid3,,20,7,16,23
41436,Soulbow,,18,39,63,102
41437,ngn,,13,122,34,156
41438,joegester,,19,6,7,13
41439,smoove_criminal,,43,3,1,4
41440,flezgodrit,,7,246,160,406
41441,jludwi2,,18,1,1,2
41442,forgotmyothapassword,,18,54,40,94
41443,clefairy,,18,64,115,179
41444,zyl0x,,34,60,112,172
41445,amarok9,,13,22,13,35
41446,cbergeron,,32,25,53,78
41447,DarthTickle,,34,1,1,2
41448,ALUGO,,6,1,2,3
41449,bradanderson,,20,8,3,11
41450,jmerloni,,13,4,5,9
41451,bye123,,29,1,3,4
41452,blar,,20,4,2,6
41453,ToonArmy,,20,32,50,82
41454,benlong,,19,8,9,17
41455,btc08,,13,6,27,33
41456,LeroyInAJar,,43,1,6,7
41457,jtdgrz,,1,14,8,22
41458,dontbeatool,,19,55,114,169
41459,gromdul,,42,448,767,1215
41460,GRSCHAAF,,18,116,16,132
41461,toni_ch,,20,2,2,4
41462,nerdmom,,34,1,1,2
41463,iredditnewbie,,32,25,32,57
41464,subliminalpie,,20,1,1,2
41465,neuralzen,,1,94,51,145
41466,nemeth,,0,23,68,91
41467,redknob,,18,18,40,58
41468,Billistic,,13,17,58,75
41469,kephnos,,22,7,9,16
41470,Phayded,,4,74,54,128
41471,montresor,,19,55,120,175
41472,leemoore,,13,22,12,34
41473,realfinkployd,,18,17,20,37
41474,jediknight,,14,33,46,79
41475,iNewsit,,39,6,2,8
41476,wkdown,,18,87,212,299
41477,teu,,0,1,1,2
41478,typogenerator,,0,5,21,26
41479,ralpht,,20,6,5,11
41480,bobbyrotten,,13,3,3,6
41481,yogeshtk,,43,1,1,2
41482,er0k,,1,53,96,149
41483,NicholasNizib,,12,63,48,111
41484,goonbee,,18,3,10,13
41485,adamant777,,42,31,54,85
41486,ajv570,,43,7,34,41
41487,ayrsen,,1,1,3,4
41488,killq,,13,43,1,44
41489,Nicolay77,,12,97,349,446
41490,Tanath,,29,144,253,397
41491,mindovermatter,,19,19,12,31
41492,___God___,,32,1,2,3
41493,noshelter,,5,5,17,22
41494,sarahg,,9,1,1,2
41495,ilt,,30,75,116,191
41496,missiontodenmark,,13,18,12,30
41497,l3riann,,32,2,4,6
41498,redsalmon,,31,1,1,2
41499,Quintus,,30,4,2,6
41500,jimmykane,,4,27,45,72
41501,marakith,,1,42,38,80
41502,pheliak,,0,2,3,5
41503,Huuuuuuge_Asshole,,19,17,33,50
41504,TheEnturbulator,,8,17,29,46
41505,geesquire,,11,2,3,5
41506,bloby,,1,1,1,2
41507,URGENTCAPSLOCKMAN,,19,36,80,116
41508,nlee23,,35,2,1,3
41509,SarahPalinIsSatan,,13,73,72,145
41510,wilkinson,,0,11,8,19
41511,badee,,0,87,1,88
41512,greenmonstah04,,13,1,1,2
41513,Anim8me2,,18,24,8,32
41514,t1k,,29,1,2,3
41515,cnn,,13,2,9,11
41516,starrychloe,,1,583,587,1170
41517,joculartesticle,,32,8,11,19
41518,joshuag,,43,20,46,66
41519,LiberalHippies2,,19,121,211,332
41520,Mojah,,20,44,3,47
41521,thorgeir23,,12,25,51,76
41522,IsThisSilicone,,1,33,12,45
41523,quitstaringatme1,,22,1,3,4
41524,dblowe,,6,30,29,59
41525,freon,,7,10,13,23
41526,eshan,,20,5,6,11
41527,spooonmaan,,13,8,36,44
41528,Drainiac,,32,3,2,5
41529,lilipult,,13,2,2,4
41530,nichiyume,,18,43,56,99
41531,jolla,,19,4,5,9
41532,DwarfTheMike,,18,15,15,30
41533,barnutnewman,,19,1,3,4
41534,thecoolestcow,,1,135,102,237
41535,Koush,,13,3,4,7
41536,jnuglife,,34,1,1,2
41537,puredemo,,19,258,551,809
41538,huebner5000,,6,2,1,3
41539,Pluripotent,,0,3,3,6
41540,boogamama,,42,1,2,3
41541,rsmoling,,29,95,123,218
41542,Vince_Walker,,1,1,1,2
41543,salubrium,,20,36,49,85
41544,tpaulman,,17,1,1,2
41545,myglaven,,19,2,1,3
41546,le_piaf,,18,46,89,135
41547,bsr816,,19,7,23,30
41548,tony_landis,,18,10,7,17
41549,QuickThought,,13,11,8,19
41550,mastodan,,1,1,1,2
41551,phreshinger,,19,23,32,55
41552,allarise,,34,124,102,226
41553,hgg,,20,1,3,4
41554,vjack,,32,445,32,477
41555,medusa-zombie-eel,,19,1,1,2
41556,simulacrum,,31,8,4,12
41557,Neesh,,42,14,21,35
41558,robotsongs,,1,311,404,715
41559,cathexis,,18,9,1,10
41560,feltpelt,,17,2,1,3
41561,darwynn,,32,8,7,15
41562,smackjack,,19,65,29,94
41563,hurricaneheta,,18,3,5,8
41564,downwithbigbrother,,28,6,7,13
41565,trifolic,,3,5,7,12
41566,somefoo,,3,1,2,3
41567,chriguhose,,8,1,1,2
41568,agimat,,0,12,30,42
41569,audi_b5_driver_4_lif,,34,1,1,2
41570,iamstig,,18,10,2,12
41571,WealthBoy,,16,25,6,31
41572,killy971,,16,15,1,16
41573,pwilliards,,18,3,1,4
41574,yickster,,13,22,7,29
41575,zettabyte,,19,32,42,74
41576,LOLster,,18,1,5,6
41577,dlacone,,6,32,35,67
41578,frickthejews,,8,101,253,354
41579,stonedparadox,,1,53,78,131
41580,haxored,,18,163,201,364
41581,Zeulodin,,18,19,23,42
41582,xal,,20,12,12,24
41583,bigboi007,,5,1,1,2
41584,Glimjaur,,3,5,7,12
41585,jdc123,,1,128,153,281
41586,metalhead,,6,40,60,100
41587,mrbonglord,,43,4,4,8
41588,caboose263,,1,2,1,3
41589,goolglee,,0,39,16,55
41590,misfit410,,13,23,27,50
41591,blanute,,39,3,1,4
41592,misterthingy,,18,48,21,69
41593,nokie,,18,1,1,2
41594,scrod,,13,19,51,70
41595,malaislinn,,1,42,68,110
41596,cruxdestruct,,19,38,2,40
41597,flaco46,,5,2,1,3
41598,oheard,,34,1,3,4
41599,MozzNJ,,19,8,7,15
41600,archmaille,,1,2,3,5
41601,dave_tart,,31,1,3,4
41602,barrkel,,20,30,29,59
41603,4Chan_Ambassador,,13,9,15,24
41604,zhore182,,6,3,2,5
41605,xpollux,,19,2,1,3
41606,mutard7,,13,41,44,85
41607,welch6980,,19,42,52,94
41608,mattdonovan,,29,12,6,18
41609,bluebandit,,13,2,6,8
41610,majorlyannoyed,,13,24,44,68
41611,jboeke,,6,36,35,71
41612,rklophaus,,20,5,4,9
41613,rory236,,22,25,39,64
41614,thepastagod,,5,102,117,219
41615,oldbasara,,30,3,3,6
41616,aphrodites,,43,4,5,9
41617,sundevilsf,,13,47,14,61
41618,clearwaterlab,,1,24,16,40
41619,pirlok,,5,484,16,500
41620,jkff,,20,50,53,103
41621,hundredaire,,19,1,1,2
41622,asbjxrn,,43,4,14,18
41623,nat_pryce,,20,43,58,101
41624,smurton,,19,35,21,56
41625,7077Y,,22,2,1,3
41626,HeroicLife,,19,288,315,603
41627,yefxyhrxlvbtc,,4,1,1,2
41628,Nwallins,,20,123,201,324
41629,13above,,18,60,3,63
41630,fubberyfuckie,,20,3,3,6
41631,bucshtalk,,19,16,1,17
41632,lazythekid,,43,19,12,31
41633,arthurdenture,,20,114,102,216
41634,YAFZ,,20,9,7,16
41635,IfCelebsMoved2OKNazi,,43,1,1,2
41636,fabriciostudio,,5,3,2,5
41637,evehorizon,,29,4,3,7
41638,GT45,,40,1,10,11
41639,jevon,,18,57,69,126
41640,Black_Fusion,,18,1,4,5
41641,clenard,,5,3,1,4
41642,llurker,,0,9,13,22
41643,wild,,19,5,12,17
41644,marcov,,20,3,4,7
41645,efk,,18,86,213,299
41646,pondy,,13,369,7,376
41647,ryckmonster,,18,10,35,45
41648,jonhohle,,20,146,127,273
41649,dankirsh,,32,1,1,2
41650,SkiCaradhras,,32,37,35,72
41651,NovaX81,,32,48,19,67
41652,leonardoe,,20,44,2,46
41653,computergeek6933,,29,30,42,72
41654,KingofGleak1990,,19,9,9,18
41655,Aardvark1878,,28,3,3,6
41656,alins,,19,639,38,677
41657,cjpro,,17,28,35,63
41658,MrDNL,,19,24,1,25
41659,niomi,,32,22,32,54
41660,mouthofthefraser,,36,1,1,2
41661,peren488,,31,7,1,8
41662,xbillybobx,,1,73,61,134
41663,altaccount,,1,2,8,10
41664,bgaffneysep,,14,7,1,8
41665,DaffyDuck,,18,35,97,132
41666,ob2,,31,43,53,96
41667,schlenk,,20,57,80,137
41668,nk47,,19,1,1,2
41669,wupshaw,,0,2,1,3
41670,curoi,,20,3,2,5
41671,icantseeyou,,19,39,9,48
41672,bpar23,,22,9,7,16
41673,SurRea1,,16,6,5,11
41674,JBaker68,,42,50,9,59
41675,racerz,,19,29,46,75
41676,ismellawumpus,,0,1,1,2
41677,pjleonhardt,,1,12,21,33
41678,phreakre,,9,11,23,34
41679,wulfhound,,4,19,34,53
41680,headfake,,19,10,20,30
41681,busboy,,22,3,1,4
41682,time4drift,,33,3,4,7
41683,bob10,,20,3,2,5
41684,parshul,,18,86,183,269
41685,robdag2,,1,335,364,699
41686,bobbyopulent,,13,11,19,30
41687,MrSaru,,13,103,142,245
41688,f4hy,,20,60,54,114
41689,fredstopp,,15,109,222,331
41690,blake82,,18,16,6,22
41691,39489384848,,8,2,2,4
41692,hoffa_lives,,1,46,80,126
41693,onetimeonly,,18,5,1,6
41694,Oliverotto,,18,37,87,124
41695,watersong,,13,2,5,7
41696,bagels666,,18,20,42,62
41697,justbrowsing,,30,1,1,2
41698,zekester,,18,9,22,31
41699,mdedm,,13,497,304,801
41700,trophius,,19,14,17,31
41701,Belacqua,,13,1,2,3
41702,denvernomad,,22,31,12,43
41703,chcorreia,,18,4,6,10
41704,brrose,,20,86,85,171
41705,macainiac,,32,6,4,10
41706,mayAc,,20,1,5,6
41707,rufusatemylunch,,5,6,1,7
41708,longlivedeath,,20,23,36,59
41709,robbied462,,12,8,4,12
41710,AlekseyP,,1,227,403,630
41711,s810,,1,181,173,354
41712,Drachis,,34,12,16,28
41713,zambal,,20,1,3,4
41714,peterhogg2,,19,28,37,65
41715,thewakebehindyou,,22,63,72,135
41716,randomwolf,,18,13,23,36
41717,TomTerrific,,0,79,32,111
41718,woodenturkey,,0,43,40,83
41719,rwb,,19,93,5,98
41720,migueltronix,,18,19,24,43
41721,TruthHammer,,13,215,320,535
41722,RonnieRightstuff,,13,2,2,4
41723,olliej,,20,17,31,48
41724,yourapostasy,,31,98,181,279
41725,aurrun,,31,4,2,6
41726,mrspaz,,29,28,38,66
41727,thomasw,,19,3,3,6
41728,stigglewick,,20,2,3,5
41729,toughpat,,42,7,5,12
41730,mereimmortal,,13,3,4,7
41731,ezfrag,,1,1,1,2
41732,nordic86,,17,27,27,54
41733,mikezimmer,,19,5,1,6
41734,cydril,,18,2,15,17
41735,Ferrisford,,13,303,24,327
41736,cacheson,,29,72,96,168
41737,pelletierm,,13,1,4,5
41738,jimbobhickville,,20,270,408,678
41739,Frai1ty,,13,4,5,9
41740,rpeters83,,18,10,11,21
41741,mandangalo,,18,1,1,2
41742,curtisblow,,27,1,2,3
41743,napalmdaddy,,18,11,43,54
41744,gl77,,39,2,2,4
41745,DrumMaster260,,18,5,2,7
41746,philoscience,,30,8,8,16
41747,argra,,21,2,2,4
41748,brentmc79,,20,4,2,6
41749,d00ley,,19,395,713,1108
41750,kostakrauth,,18,2,4,6
41751,ice_cold_irony,,1,6,1,7
41752,droob,,6,3,3,6
41753,camus,,20,52,6,58
41754,ardit33,,19,14,15,29
41755,voiceofgrog,,34,55,28,83
41756,acidw4rp,,14,5,8,13
41757,beardedninja,,39,3,4,7
41758,mtl_hed,,34,2,1,3
41759,bushwakko,,19,318,498,816
41760,bcash,,20,775,385,1160
41761,brimshinto,,19,1,1,2
41762,MattHock,,22,149,187,336
41763,lavagod11,,15,1,2,3
41764,hervold,,32,1,1,2
41765,pupdike,,34,59,73,132
41766,hyphen-nazi,,19,3,1,4
41767,minnabakka,,8,13,7,20
41768,TankMan3217,,16,29,42,71
41769,nerdlife,,19,68,169,237
41770,Nessie,,18,5,27,32
41771,pleasepleaseplease,,14,1,1,2
41772,w3stfa11,,20,6,8,14
41773,robrem,,16,8,13,21
41774,blunderwoman,,13,2,3,5
41775,rappin,,18,275,7,282
41776,unbelieve,,26,2,2,4
41777,Deiz,,20,105,129,234
41778,moe,,30,1,1,2
41779,uksjfsduykfvsdfv,,20,41,33,74
41780,doublec,,20,34,27,61
41781,GreySim,,20,28,47,75
41782,mikem93,,19,5,6,11
41783,Herkimer,,13,45,66,111
41784,infz,,20,37,20,57
41785,blueskydiver76,,8,51,55,106
41786,ardalan,,18,2,6,8
41787,MrNeill,,18,1,4,5
41788,MoronicUtopian,,19,17,31,48
41789,deathbob,,20,3,5,8
41790,qweqweiqwe,,14,3,4,7
41791,edisoncarter,,29,5,3,8
41792,Atashi,,39,3,1,4
41793,caust1c,,16,2,1,3
41794,asoneth,,14,1,4,5
41795,asj,,31,5,3,8
41796,rozacruce,,43,10,12,22
41797,ikky75,,32,5,8,13
41798,Wuped,,19,2,4,6
41799,game-master,,20,1,1,2
41800,DoorFrame,,10,666,449,1115
41801,miajade20,,22,1,1,2
41802,skinp,,20,5,6,11
41803,ninguem,,20,185,207,392
41804,Mazaev,,19,3,1,4
41805,teahsea,,12,1,5,6
41806,crash-dev,,19,4,6,10
41807,ndanger,,20,93,9,102
41808,cindybin,,19,21,63,84
41809,mogal10,,21,3,3,6
41810,BlankVerse,,13,772,49,821
41811,97bravo,,13,73,39,112
41812,DoctorRin,,18,17,38,55
41813,jsnx,,20,193,334,527
41814,darthnut,,13,16,13,29
41815,loath,,18,6,9,15
41816,chrissybear,,34,3,2,5
41817,scroggalog,,32,12,16,28
41818,afroisalreadyinu,,20,87,28,115
41819,hwessin,,34,3,4,7
41820,lvx23,,20,3,4,7
41821,mohawke,,34,5,1,6
41822,beaner19,,1,5,3,8
41823,akinari42,,32,11,2,13
41824,jeeeebus,,15,4,7,11
41825,jp57,,20,3,2,5
41826,cigarjack,,5,22,23,45
41827,bjmiller,,34,1,3,4
41828,dreamsubmitting,,33,2,1,3
41829,komu,,20,1,3,4
41830,nme,,41,2,1,3
41831,spitzer,,43,15,20,35
41832,BostonLow,,4,1,4,5
41833,callicles,,29,8,4,12
41834,simonvc,,20,54,41,95
41835,kitisfultly,,29,1,1,2
41836,tbhurst,,34,240,44,284
41837,Darkness12,,18,92,69,161
41838,qprtvy,,19,3,11,14
41839,silouan,,13,69,114,183
41840,robpwalker,,13,4,3,7
41841,zanmat0,,43,1,6,7
41842,Ryan256,,19,6,19,25
41843,Pilebsa,,32,1148,1063,2211
41844,_ex_,,20,28,33,61
41845,gottabekd,,20,10,14,24
41846,niqhil,,20,3,4,7
41847,OrionSmith,,31,4,4,8
41848,Bender1012,,22,8,22,30
41849,dashiel,,13,64,68,132
41850,elvisjagger,,19,21,33,54
41851,werg,,34,22,13,35
41852,drosser,,20,201,314,515
41853,bigmell,,20,1,1,2
41854,zwelch,,13,1,1,2
41855,jesnell,,20,4,3,7
41856,Thaumiel,,20,2,2,4
41857,meti,,31,2,2,4
41858,clockradio,,41,79,134,213
41859,Lryder2k6,,18,3,5,8
41860,scottiebumich,,42,1,1,2
41861,gwest,,33,4,6,10
41862,TehSlippy,,32,51,63,114
41863,onektwenty4,,20,11,12,23
41864,Yst,,22,481,479,960
41865,monkbot1,,18,89,243,332
41866,estesce,,32,6,1,7
41867,uberjooz,,19,5,2,7
41868,mothereffingteresa,,13,552,907,1459
41869,saturn266,,29,4,7,11
41870,bjacob,,20,7,4,11
41871,cvanderlinden,,5,1,6,7
41872,louie12,,20,4,2,6
41873,vermont8,,19,2,1,3
41874,joshwa,,43,107,36,143
41875,BlackNapkins,,43,10,15,25
41876,rotzeach,,1,1,4,5
41877,l0b0,,20,3,4,7
41878,jetjaguar,,12,240,404,644
41879,Vegetabl,,18,1,1,2
41880,sparrow_townshend,,1,12,3,15
41881,zentropy,,32,1,1,2
41882,vige,,20,4,7,11
41883,joelypolly,,13,1,5,6
41884,gunk,,34,1,1,2
41885,wejami,,29,23,41,64
41886,pixel1000,,1,5,2,7
41887,Azradesh,,4,6,16,22
41888,BonzoESC,,20,32,37,69
41889,hellofriends,,0,7,10,17
41890,belandil,,34,1179,1391,2570
41891,m1ss1ontomars2k4,,1,994,1729,2723
41892,Dokugumo,,32,32,33,65
41893,ahmednawaz,,12,3,10,13
41894,mickeytwist,,43,44,18,62
41895,Program_Buddhist,,32,13,2,15
41896,salmarumman,,5,1,1,2
41897,xgrue,,18,1,3,4
41898,lukego,,20,3,6,9
41899,MBlume,,1,110,61,171
41900,cgomez,,22,123,134,257
41901,BannedUser,,20,6,6,12
41902,picar0,,19,95,129,224
41903,Bomberteddy,,18,13,41,54
41904,SikWithIt,,5,125,4,129
41905,skillfull,,5,217,16,233
41906,chych,,22,17,17,34
41907,skipdog172,,6,67,58,125
41908,foundati,,18,4,10,14
41909,wreckingcru,,39,39,60,99
41910,kixx,,20,50,64,114
41911,batasrki,,20,129,70,199
41912,zombieninja,,42,1,1,2
41913,Tincho_,,20,1,1,2
41914,Hezy,,13,9,2,11
41915,bruno_metsu,,4,1,1,2
41916,Hadron,,32,3,1,4
41917,avocat,,31,1,1,2
41918,beckingh,,19,39,42,81
41919,smors,,20,17,20,37
41920,weoriusdlkfjweoiruwk,,34,2,1,3
41921,variflex,,30,1,1,2
41922,James_Johnson,,20,106,161,267
41923,wackjob,,22,6,2,8
41924,Kyrsidal,,31,1,2,3
41925,hookahey,,32,6,10,16
41926,buckX,,22,107,167,274
41927,2ndskin,,32,1,1,2
41928,yellat,,3,82,238,320
41929,ObligatoryXKCDRef,,1,1,2,3
41930,bhog,,19,35,56,91
41931,smitting,,18,5,16,21
41932,2point8,,0,61,6,67
41933,SentientGiraffe,,18,3,6,9
41934,cmyersavi,,4,2,1,3
41935,jstevewhite,,18,1,4,5
41936,Intrebud,,1,10,3,13
41937,nom_de_plume,,43,1,1,2
41938,pavehawk,,20,102,17,119
41939,kstan42,,39,1,1,2
41940,bmdan,,1,283,253,536
41941,monx,,6,12,25,37
41942,logicalstack,,20,3,3,6
41943,rickJ,,6,5,9,14
41944,zik,,12,11,12,23
41945,testerB,,18,2,4,6
41946,adam21924,,13,1,7,8
41947,iammnothere,,36,1,1,2
41948,snuuf,,0,1,1,2
41949,douchefag,,19,1,9,10
41950,thereptilezoo,,0,8,11,19
41951,fruggiedesh,,32,9,7,16
41952,generic_genus,,6,2,1,3
41953,EAREST,,18,1,1,2
41954,mattomatto,,34,124,185,309
41955,Ho66es,,0,2,3,5
41956,Skasian,,18,1,2,3
41957,albolin,,31,14,23,37
41958,curbstompery,,22,129,222,351
41959,Chris_Farley,,18,129,8,137
41960,pjjw,,8,1,1,2
41961,naasking,,20,206,406,612
41962,Narrator,,31,207,222,429
41963,phixa,,19,67,76,143
41964,scordatura,,30,558,182,740
41965,dcueva,,31,108,49,157
41966,Anderkay,,0,80,4,84
41967,in8joy,,43,86,116,202
41968,LockeL,,0,19,20,39
41969,threnody,,19,42,27,69
41970,shcirnuh,,31,3,7,10
41971,grizzydot,,14,3,2,5
41972,kudoz,,0,7,4,11
41973,komal,,13,73,110,183
41974,kminator,,43,168,377,545
41975,davidng,,19,5,2,7
41976,Avocadoes,,1,78,77,155
41977,crowbent,,20,8,9,17
41978,bellow,,19,26,3,29
41979,chewyrunt,,31,3,6,9
41980,strencher,,18,2,6,8
41981,heartsutra,,34,2,2,4
41982,predius,,19,97,102,199
41983,gmerideth,,18,11,9,20
41984,jbester,,20,2,2,4
41985,ILeftDiggforReddit,,1,615,637,1252
41986,Urizen,,19,375,355,730
41987,tabooki,,1,3,5,8
41988,pras,,5,152,187,339
41989,riverrock,,22,77,87,164
41990,rangerkozak,,5,1,2,3
41991,retrojoe,,18,40,7,47
41992,beejou,,22,37,77,114
41993,Hathadar,,0,1,1,2
41994,jhuckabee,,20,14,4,18
41995,robotcaptain,,12,19,11,30
41996,Clue,,33,2,3,5
41997,diggisdead,,13,4,2,6
41998,caveman5,,19,8,1,9
41999,NoBubbles,,31,8,9,17
42000,MagiTekSoldier,,22,117,156,273
42001,WillieJamesHuff,,20,1,1,2
42002,matrixclown,,1,127,166,293
42003,_error,,20,23,23,46
42004,tici_88,,11,6,2,8
42005,multubunu,,8,157,253,410
42006,Takfir,,13,52,32,84
42007,crawf061,,22,48,60,108
42008,satire,,19,76,170,246
42009,fahq,,18,3,1,4
42010,nuxvomica,,16,13,20,33
42011,dugmartin,,20,76,88,164
42012,black330ci,,8,2,4,6
42013,jshardy,,13,6,10,16
42014,wingedhelmet,,18,3,2,5
42015,Bwian,,11,3,7,10
42016,xynny,,5,4,1,5
42017,hsure,,31,23,29,52
42018,CodeMangler,,20,6,6,12
42019,theAngryNorse,,34,5,2,7
42020,maxburke,,5,6,4,10
42021,tomcruz,,20,20,34,54
42022,Ocin,,31,28,42,70
42023,FezWad,,34,8,26,34
42024,recoiledsnake,,20,119,100,219
42025,samwise324,,18,3,7,10
42026,TheDeerLady,,43,32,23,55
42027,jazzdonkey,,36,6,7,13
42028,cswift1,,19,15,12,27
42029,Tekmo,,17,395,519,914
42030,liberdade,,18,144,201,345
42031,nybiara,,22,1,1,2
42032,masterpo,,2,300,870,1170
42033,captainm,,1,31,59,90
42034,lordhumungus,,22,4,5,9
42035,cashflow,,1,9,9,18
42036,nypd_out_of_control,,7,3,1,4
42037,MCallanan,,13,14,2,16
42038,lookingchris,,17,44,92,136
42039,NetworkMeUp,,13,90,13,103
42040,Dodo-Bot,,34,9,3,12
42041,american_moron,,19,12,30,42
42042,ablatocinet,,10,1,1,2
42043,Enrickey,,18,6,11,17
42044,MotherFirefly,,43,10,16,26
42045,wreel,,20,35,19,54
42046,james_block,,20,86,92,178
42047,panzan,,1,48,32,80
42048,cranberrybobbie,,43,3,1,4
42049,kazooz,,5,1,4,5
42050,bprater,,20,36,36,72
42051,xan1th,,18,1,5,6
42052,TheGrammarMaoist,,22,1,1,2
42053,burntbeans,,13,9,1,10
42054,drudru,,20,46,12,58
42055,candylee,,34,41,16,57
42056,Strom_Thermite,,31,1,4,5
42057,newstart,,18,28,36,64
42058,digitizemd,,13,14,1,15
42059,majorbabu,,29,8,2,10
42060,Phlag,,36,8,5,13
42061,tnek46,,43,2,5,7
42062,kdirkes,,19,34,1,35
42063,onestab,,19,222,302,524
42064,focusfriend,,20,1,1,2
42065,shadowie,,1,139,67,206
42066,Grimm,,18,5,1,6
42067,notmyrealusername,,6,4,3,7
42068,manystrom,,22,2,1,3
42069,zyle,,22,429,503,932
42070,rovecheney08,,7,1,3,4
42071,psikic,,13,14,13,27
42072,boraca,,43,1,1,2
42073,spanner3,,43,2,5,7
42074,OSStourist,,21,2,4,6
42075,bouleuterion,,13,3,17,20
42076,Maox,,1,2,8,10
42077,sadmachine,,18,21,21,42
42078,NOWUVEDONEIT,,15,1,3,4
42079,amazed,,19,2,3,5
42080,indescription,,22,394,520,914
42081,mcdoh,,5,55,36,91
42082,tocomeunglued,,29,15,9,24
42083,jcroisant4,,32,5,5,10
42084,amedia,,19,95,186,281
42085,biosphere03,,32,21,25,46
42086,ealf,,20,237,210,447
42087,pastyquail,,1,12,33,45
42088,jerichochicago,,13,1,2,3
42089,csispy007,,19,3,2,5
42090,mnocket,,13,5,10,15
42091,zmwe,,18,5,1,6
42092,MrGrim,,20,25,11,36
42093,thinkgreen,,1,8,24,32
42094,lake-of-fire,,22,50,48,98
42095,killadyvah,,13,14,41,55
42096,MichaelJMotta,,19,12,2,14
42097,brainiac,,19,204,179,383
42098,joe_chip,,20,11,2,13
42099,dankirkd,,19,2,2,4
42100,m8urn,,0,3,1,4
42101,adjective,,8,3,1,4
42102,sr332603,,13,3,6,9
42103,telvana,,43,17,7,24
42104,tantamounted,,34,15,4,19
42105,Btw0,,20,3,7,10
42106,Spacepope6,,32,347,447,794
42107,MsBooBoo,,13,9,4,13
42108,Jsilver,,0,5,1,6
42109,tripoli,,18,2,4,6
42110,svahne,,20,1,2,3
42111,timedilation,,12,17,13,30
42112,vander25,,18,5,2,7
42113,Advocate4Health,,29,1,2,3
42114,guapoo,,20,182,209,391
42115,Joeboy,,31,48,57,105
42116,ricko70,,18,20,44,64
42117,misfit-zero,,42,2,9,11
42118,jeffoverip,,19,107,164,271
42119,p8m,,0,26,35,61
42120,PeterBB,,19,9,10,19
42121,drBrown,,19,1,4,5
42122,pledio,,22,1,2,3
42123,sstrain1,,1,7,13,20
42124,iluvatar,,20,58,63,121
42125,ewankenobi,,31,6,4,10
42126,cargirl,,18,50,13,63
42127,jules_su,,18,5,2,7
42128,melendro,,20,2,1,3
42129,whosywhatSIT,,4,4,4,8
42130,andresvr,,31,41,76,117
42131,0_o,,43,709,731,1440
42132,thetin,,19,1,18,19
42133,Austin08,,19,8,11,19
42134,Celerox,,19,3,7,10
42135,xstphnx,,13,3,10,13
42136,js79,,20,32,35,67
42137,instain_mother,,43,2,4,6
42138,emid,,31,48,63,111
42139,Diice,,32,26,32,58
42140,bogybody,,19,6,10,16
42141,kermit420,,35,4,1,5
42142,Sektor7g,,31,5,3,8
42143,crexor,,17,15,20,35
42144,jon3k,,18,2,1,3
42145,fs55,,20,3,1,4
42146,doogie92,,9,580,12,592
42147,there_are_no_results,,31,1,1,2
42148,JacobFalling,,13,1,1,2
42149,fail_nazi,,1,5,17,22
42150,pblair,,19,90,14,104
42151,bogshrink,,13,3,1,4
42152,state_of_alert,,43,599,726,1325
42153,esthero,,16,6,12,18
42154,netfluffyG,,0,261,37,298
42155,markomat,,10,23,18,41
42156,twotrees517,,13,1,13,14
42157,PSBlake,,1,19,28,47
42158,brainburger,,11,2455,2233,4688
42159,Hindu_Wardrobe,,22,66,110,176
42160,macbookair,,19,5,3,8
42161,corneeeeelius,,18,1,1,2
42162,jplord89,,31,4,3,7
42163,TheDentite,,39,168,323,491
42164,gunslinger81,,18,3,4,7
42165,rplenty,,13,3,4,7
42166,theace41,,31,2,2,4
42167,Siperia,,34,2,4,6
42168,afshin,,43,155,87,242
42169,geoffritchey,,19,1,1,2
42170,mbm,,20,49,77,126
42171,abc2018,,13,1,1,2
42172,RickvH,,20,1,1,2
42173,Popdmb,,13,32,10,42
42174,billybobmac,,30,55,103,158
42175,hassett,,17,258,428,686
42176,oddog,,18,32,5,37
42177,flif,,20,8,9,17
42178,sparkpaul,,19,7,15,22
42179,skeen,,32,238,244,482
42180,jpancake,,20,6,2,8
42181,poopyshoes,,4,3,4,7
42182,thekuroikenshi,,19,5,8,13
42183,theteamtomatos,,3,3,4,7
42184,phile19_81,,19,1,1,2
42185,Snay,,31,7,3,10
42186,Enygma42,,19,3,5,8
42187,LowFuel,,18,48,92,140
42188,chojin_82,,31,1,1,2
42189,derekslager,,20,58,34,92
42190,rayfd,,1,119,52,171
42191,venkattt,,34,35,51,86
42192,freedomcry,,5,14,36,50
42193,indiana888,,34,46,100,146
42194,aanka,,31,6,2,8
42195,thebigsquid,,22,86,99,185
42196,BrightShadow,,20,2,1,3
42197,FluidChameleon,,32,154,57,211
42198,profy,,10,1,2,3
42199,g_unit4lyfe,,18,12,5,17
42200,garf12,,31,1,3,4
42201,simonsharry,,20,1,3,4
42202,harvesterofdeath,,34,1,1,2
42203,twinspop,,19,4,16,20
42204,wgardenhire,,18,38,65,103
42205,ThatMovieAboutRobots,,43,9,13,22
42206,MrLeap,,7,35,36,71
42207,ostrichheaven,,5,12,49,61
42208,bungeman,,20,38,65,103
42209,dokein,,32,173,8,181
42210,lps41,,1,484,619,1103
42211,Mr_Spoiler,,43,22,15,37
42212,lantrix,,14,1,1,2
42213,twhiteley,,40,1,2,3
42214,olihahe,,29,1,1,2
42215,sweetbabyjames,,22,3,3,6
42216,jennmae,,43,15,3,18
42217,cop1152,,20,2,3,5
42218,violence_jakovsky,,13,1,1,2
42219,lovecrafthp,,22,13,17,30
42220,Freeky,,20,408,698,1106
42221,onetimepostaccount,,0,53,1,54
42222,a1mck,,29,1,3,4
42223,Ferrofluid,,13,230,666,896
42224,bcars,,13,62,67,129
42225,maliciousmonkey,,43,1,1,2
42226,slomotion,,18,109,124,233
42227,flopper,,22,6,1,7
42228,mtrier,,20,4,4,8
42229,badsmell,,1,4,1,5
42230,sig_UVA,,4,24,27,51
42231,Th3_C0unt,,15,1,2,3
42232,cwalk,,34,20,26,46
42233,flappinghelmet,,18,17,2,19
42234,jangophat80,,19,5,1,6
42235,cmoney805,,31,22,37,59
42236,climb0r,,34,5,5,10
42237,stuartcw,,43,112,102,214
42238,othercriteria,,20,23,44,67
42239,MadHooks,,1,233,185,418
42240,commentsforreddit,,13,407,632,1039
42241,wildnovacat9,,13,11,6,17
42242,andyjeffries,,20,7,2,9
42243,ramenramenramen,,18,11,15,26
42244,dguido,,20,9,6,15
42245,CBinCovington,,19,10,27,37
42246,Captain_0bvious,,22,3,3,6
42247,Lord_Voldemort,,43,7,7,14
42248,reject,,13,2,3,5
42249,dustingooding,,29,7,9,16
42250,uhclem,,22,42,62,104
42251,Psyko,,10,2,1,3
42252,justdawson,,20,5,3,8
42253,zeelog,,13,11,27,38
42254,lterr,,2,1,1,2
42255,yannt,,13,2,4,6
42256,mycrazies,,5,30,16,46
42257,scuzzy987,,34,1,1,2
42258,baguasquirrel,,20,71,75,146
42259,Chrisvdv,,7,1,1,2
42260,sleepydog,,20,5,6,11
42261,xyyx,,42,14,12,26
42262,jaxontre,,39,3,6,9
42263,colinme,,1,1,1,2
42264,arcang3l,,32,5,8,13
42265,barney0605,,3,26,18,44
42266,GibbieGibGiblet,,19,152,231,383
42267,iheartbbq,,13,135,131,266
42268,shiftshaping,,1,23,7,30
42269,Lams,,34,6,12,18
42270,Sabakunoneji,,18,10,7,17
42271,legutierr,,4,1,2,3
42272,wget-m,,20,2,4,6
42273,tmu,,14,11,9,20
42274,yariv,,20,2,2,4
42275,liberty4ever,,9,4,2,6
42276,TheGrammarAnarchist,,22,49,48,97
42277,Gluncher,,39,3,7,10
42278,jmrsplatt,,1,1,1,2
42279,wfolbrys,,29,2,1,3
42280,tripled153,,0,3,7,10
42281,frasmage,,18,21,12,33
42282,matt_aimonetti,,20,47,17,64
42283,anoved,,22,65,98,163
42284,bdfortin,,22,5,10,15
42285,akhenatron,,32,68,57,125
42286,dritchie,,31,1,1,2
42287,1137,,5,2,2,4
42288,peoplelover,,19,81,105,186
42289,rhoadesb2,,13,860,460,1320
42290,cracell,,20,408,733,1141
42291,rverne8vew,,13,3,2,5
42292,mishap,,22,24,2,26
42293,mulva,,29,1,1,2
42294,Radek3887,,18,4,6,10
42295,doomride,,22,11,8,19
42296,PropaGhandi,,34,7,15,22
42297,pantsoff,,0,316,475,791
42298,madposter,,19,4,1,5
42299,funkyheff,,22,6,4,10
42300,pookie,,13,2,1,3
42301,dsearson,,34,15,11,26
42302,bcrafts,,13,1,3,4
42303,brendano,,20,12,14,26
42304,writh3n,,20,1,3,4
42305,robb01,,0,310,22,332
42306,nihilo503,,1,5,1,6
42307,numix,,20,6,6,12
42308,Aldinach,,18,2,2,4
42309,osteoblastic,,31,44,71,115
42310,kaden_sotek,,6,4,10,14
42311,TheJames69,,32,43,126,169
42312,ODSTAdrianFii,,13,1,1,2
42313,electromage,,22,3,4,7
42314,Ninwa,,1,214,198,412
42315,Rette,,18,159,193,352
42316,ghosttrainhobo,,1,1,1,2
42317,passwordisusername,,1,20,14,34
42318,Gonad,,18,50,23,73
42319,ferruccio,,20,11,21,32
42320,Pooper561,,18,51,1,52
42321,RevSpitz,,13,3,2,5
42322,PerlMonk,,20,20,28,48
42323,LittleWriterGirl,,13,2,6,8
42324,Lambeau,,18,194,172,366
42325,ronsturgill,,1,11,18,29
42326,sp0radic,,18,14,26,40
42327,ryanlubner,,23,2,2,4
42328,halbe01,,38,1,2,3
42329,dailysockpuppet08129,,30,2,4,6
42330,rsk897,,34,1,1,2
42331,jonnytran,,20,78,11,89
42332,LiberalHippies11,,26,12,14,26
42333,xabermanx,,29,2,4,6
42334,passwordistheusernam,,1,1,3,4
42335,Lithium_X,,13,335,225,560
42336,km1116,,32,18,18,36
42337,brutus1964,,19,188,55,243
42338,brownbear,,20,15,9,24
42339,sfhrp,,13,1,1,2
42340,da5id1,,5,87,230,317
42341,AdmiralDave,,32,136,237,373
42342,dblclique,,0,6,6,12
42343,riklaunim,,20,7,4,11
42344,redct,,18,92,4,96
42345,fleejit,,13,2,1,3
42346,rdeal1,,5,15,3,18
42347,Asshole_Police,,0,1,1,2
42348,pedoprankster,,27,4,1,5
42349,blewsyboy,,26,6,10,16
42350,3214,,1,327,45,372
42351,mrgermy,,43,7,20,27
42352,shanejohnsoncartoons,,5,8,3,11
42353,jshark12,,43,22,1,23
42354,ericdfields,,20,1,1,2
42355,billystorm5000,,43,1,1,2
42356,unijambiste,,0,108,104,212
42357,blackdixon,,43,2,3,5
42358,frets,,43,5,7,12
42359,chrissku,,18,54,61,115
42360,jgardner,,20,2,1,3
42361,parasense,,42,8,5,13
42362,JohnnyQwest,,5,34,13,47
42363,ritadog,,1,2,1,3
42364,bangpound,,31,11,7,18
42365,mintskoal,,13,5,5,10
42366,bhasden,,20,1,1,2
42367,simulacra,,20,26,35,61
42368,sgeye,,13,1,5,6
42369,userundefined,,22,35,57,92
42370,kylestaylor,,18,2,6,8
42371,jlaurino,,29,4,2,6
42372,awright4444,,40,4,1,5
42373,civicsi98,,13,1,1,2
42374,scorpAFC,,0,50,32,82
42375,gisellehobbs,,32,1,2,3
42376,meatheltmet,,1,20,26,46
42377,wikiscootia,,18,27,30,57
42378,onemanclic,,13,5,12,17
42379,rafaeldff,,14,11,11,22
42380,brit878,,13,335,111,446
42381,BlueRubberDuck,,31,48,27,75
42382,kanagawa,,20,11,25,36
42383,bobfather123,,19,1,1,2
42384,el_pinata,,16,365,491,856
42385,CaptainOffensive,,30,1,2,3
42386,morgand,,34,2,8,10
42387,fallintothis,,20,11,15,26
42388,Frigorific,,1,131,187,318
42389,stupidgirl,,19,66,99,165
42390,justsignedforthis,,0,2,1,3
42391,smackjer,,20,1,4,5
42392,mrmulyani,,31,12,18,30
42393,brightlightmg,,36,3,4,7
42394,stargazer,,13,2,3,5
42395,maxtypezero,,27,5,4,9
42396,deliveryman,,29,2,3,5
42397,Ryushi,,42,2,6,8
42398,nachochease,,31,2,7,9
42399,klOROX-blEACh,,34,6,6,12
42400,skimmer,,19,209,384,593
42401,fishbulbx,,19,24,6,30
42402,fivus6,,43,2,2,4
42403,dsfox,,13,404,350,754
42404,udontneedaweatherman,,19,698,117,815
42405,SimonSarc,,30,10,13,23
42406,CoachMcGuirk,,4,18,3,21
42407,skygrl37,,13,166,1,167
42408,blitzwig,,22,93,124,217
42409,cconnett,,20,4,5,9
42410,strum,,14,4,5,9
42411,link2zelda,,19,449,133,582
42412,OptionDestroyer,,13,9,1,10
42413,NumNutz,,19,7,16,23
42414,nvaro,,3,7,7,14
42415,antediluvian,,9,155,211,366
42416,MacacaDesi,,19,9,3,12
42417,kayamon,,1,2,7,9
42418,sunson,,41,1,1,2
42419,Nutmegan,,43,1,2,3
42420,cryemoxkidcry,,19,18,33,51
42421,etherealG,,20,2,4,6
42422,maqr,,43,442,444,886
42423,benoa,,13,13,29,42
42424,moonwatcher222,,13,74,103,177
42425,daniel_yokomizo,,20,25,1,26
42426,seat12,,8,1,2,3
42427,LeslieBC,,34,40,26,66
42428,cxyl27,,32,38,48,86
42429,qortra,,14,115,113,228
42430,jamesmusik,,19,4,7,11
42431,TragicComic,,19,59,66,125
42432,gonz808,,20,8,14,22
42433,homealone19,,21,8,4,12
42434,geniusoftheyear,,19,7,20,27
42435,decaado,,32,12,19,31
42436,chrystie69,,0,6,5,11
42437,sentient6,,32,1,6,7
42438,Gaiadok,,22,27,67,94
42439,psych_major,,22,1,1,2
42440,apex211,,1,6,8,14
42441,willer,,20,3,4,7
42442,psreinc,,0,2,1,3
42443,redbull,,13,38,87,125
42444,memesarenotcool,,20,1,1,2
42445,turbotax,,22,1,1,2
42446,CodeMonkey1,,22,207,295,502
42447,Dagur,,22,235,370,605
42448,adventurerneil,,13,4,7,11
42449,hell0o,,15,20,15,35
42450,selimo,,8,43,13,56
42451,gamlidek,,1,8,10,18
42452,keatontaitingfong,,1,2,2,4
42453,shafik23,,20,31,2,33
42454,jmcclean,,20,11,9,20
42455,tymilu,,10,10,12,22
42456,bradym80,,13,174,208,382
42457,easyantic,,22,122,211,333
42458,joshd,,20,3,2,5
42459,Timmeh,,15,148,186,334
42460,xjm,,42,26,28,54
42461,vchakrav,,20,1,3,4
42462,devittron,,5,2,8,10
42463,davidstuart,,29,13,7,20
42464,BongoBoyee,,13,3,1,4
42465,nevenmrgan,,33,3,2,5
42466,inkline,,19,29,10,39
42467,ChickenCoupe,,15,5,15,20
42468,ccshan,,20,24,19,43
42469,rossberry,,18,7,20,27
42470,jippie13,,13,3,5,8
42471,JCE,,19,207,44,251
42472,100k,,20,2,3,5
42473,smartazz,,42,1,2,3
42474,el_duderin0,,18,2,1,3
42475,01Frederic,,18,129,26,155
42476,jeff-is-not-art,,13,6,1,7
42477,bazookajoe55,,18,15,39,54
42478,galaxym100,,32,9,18,27
42479,stevencloud,,43,2,2,4
42480,ibeffron,,27,3,1,4
42481,philosophista,,42,10,5,15
42482,copiloto,,32,7,9,16
42483,mormoned,,19,7,6,13
42484,The_Ultimate_Reality,,33,406,691,1097
42485,lifestyl3,,19,5,4,9
42486,mikesabat,,43,8,6,14
42487,zepplindog,,18,1,5,6
42488,spookylukey,,20,26,12,38
42489,10poundbrown,,19,12,49,61
42490,igowen,,20,51,31,82
42491,mrinterweb,,20,14,15,29
42492,Rathsamiar,,1,1,1,2
42493,Seawolf_87,,19,1,3,4
42494,thisisanewaccountlol,,10,1,2,3
42495,CapsLockMan,,1,1,1,2
42496,redjello,,32,6,10,16
42497,dubqnp,,32,3,12,15
42498,HerbertMcSherbert,,31,578,976,1554
42499,anotherjesse,,20,2,3,5
42500,sloppy_wade,,43,3,3,6
42501,mikkele,,20,44,52,96
42502,simman,,20,1,2,3
42503,nixterrimus,,0,2,5,7
42504,cutchyacokov,,6,2,4,6
42505,cakesy,,19,77,126,203
42506,jimshady2k1,,18,18,2,20
42507,glenra,,18,28,44,72
42508,calebcharles,,13,4,7,11
42509,jorgelo,,43,35,37,72
42510,Eoiny,,6,7,8,15
42511,spiki,,20,14,4,18
42512,bill15,,20,3,3,6
42513,itsafarce,,22,1,5,6
42514,Naxr,,15,28,48,76
42515,allertonm,,20,9,12,21
42516,FannyBatter,,1,7,4,11
42517,blindrage,,18,14,17,31
42518,chipx86,,20,3,5,8
42519,Thoz,,19,1,5,6
42520,Pbrane101,,22,3,3,6
42521,thinkaboutthat,,32,26,9,35
42522,skibberjack,,19,45,34,79
42523,krom0025,,1,17,22,39
42524,xiann,,11,2,8,10
42525,Tom22,,13,169,101,270
42526,voidspace,,20,51,76,127
42527,woolleyj,,0,3,5,8
42528,aghager,,32,3,3,6
42529,Lozzer,,20,2,9,11
42530,CircusHead,,34,3,11,14
42531,jbronn,,20,7,7,14
42532,yuzhou,,20,40,9,49
42533,brianwood,,5,1,1,2
42534,tempguest,,18,15,15,30
42535,silpol,,34,96,67,163
42536,aleborgese,,18,1,1,2
42537,knuu,,16,1,3,4
42538,fwkroon,,20,2,4,6
42539,MarkByers,,4,1843,2315,4158
42540,FiddlingFetus,,19,4,7,11
42541,drzorcon,,34,18,25,43
42542,icikle,,31,6,6,12
42543,pozorvlak,,20,650,1009,1659
42544,ppkk,,33,1,2,3
42545,B_FH,,34,20,33,53
42546,c10h14n2,,15,3,4,7
42547,passwordismyusername,,1,48,20,68
42548,jes6ica,,19,15,17,32
42549,DustinEwan,,11,1,1,2
42550,gnaritas,,20,42,86,128
42551,sans-serif,,20,41,71,112
42552,isande,,18,3,10,13
42553,rooneyrooney,,43,1,1,2
42554,jan33,,18,12,23,35
42555,Transcendentalme,,41,4,2,6
42556,snipps,,4,1,3,4
42557,fudabushi,,19,6,10,16
42558,nosex4travelingman74,,20,1,1,2
42559,munky82,,18,9,27,36
42560,gmork,,19,37,61,98
42561,ajsvin,,19,2,6,8
42562,BlahblahblahName,,18,3,4,7
42563,Cygnarite,,42,30,83,113
42564,creamypouf,,3,2,2,4
42565,EmerilLIVE,,34,6,7,13
42566,dtbelobrown,,20,4,4,8
42567,RygelXVI,,43,11,8,19
42568,emp77,,34,1,3,4
42569,tpurves,,29,5,5,10
42570,noodlez89,,18,1,1,2
42571,Hadu,,32,101,133,234
42572,AdiasAngel,,39,1,4,5
42573,Stuckbetweenstations,,18,5,7,12
42574,pensaint1,,13,1,1,2
42575,radarperkins,,19,5,14,19
42576,naturenet,,0,337,71,408
42577,tat2ts,,18,78,49,127
42578,rock24,,12,88,5,93
42579,zackola,,20,7,19,26
42580,sofacrates,,19,1,2,3
42581,prerus,,6,2,6,8
42582,unno,,41,5,10,15
42583,eddytsp,,32,2,2,4
42584,osu2002,,13,142,10,152
42585,atari_eric,,13,12,17,29
42586,flyyspitt,,19,2,6,8
42587,CorwinShiu,,34,70,61,131
42588,DeadKitten,,13,9,22,31
42589,iamnotaclown,,30,71,95,166
42590,nesloq,,34,29,12,41
42591,escalated,,18,8,18,26
42592,BeverlyHillsHousewif,,19,1,4,5
42593,psmyth,,20,2,3,5
42594,anthroadam,,34,23,41,64
42595,ebcoh,,13,20,23,43
42596,Roosevelty2,,0,1,1,2
42597,ShadeeJake,,5,2,1,3
42598,rochea,,0,2,3,5
42599,marknugent,,7,1,5,6
42600,ATT-HALF,,22,1,1,2
42601,_ak,,20,218,236,454
42602,feijai,,20,316,402,718
42603,eroverton,,1,965,1418,2383
42604,hotsessions,,22,2,7,9
42605,domh,,1,1,1,2
42606,crazysnailboy,,34,13,10,23
42607,bish_poins,,20,16,41,57
42608,DismalScience,,43,46,57,103
42609,fredklabuster,,30,7,2,9
42610,drew_b,,0,11,9,20
42611,desnotes,,19,63,52,115
42612,Littering,,30,2,3,5
42613,_Square_,,18,1,2,3
42614,revets,,31,1,2,3
42615,trustfarm,,1,1,2,3
42616,Onlygirlhere,,19,5,4,9
42617,AtlantaFalcon,,22,9,13,22
42618,jabb0,,18,430,212,642
42619,abw,,20,348,372,720
42620,kc5tja,,20,5,8,13
42621,lolzitt,,0,1,1,2
42622,barthol27,,18,611,125,736
42623,israeln,,18,1,1,2
42624,jowens,,13,5,5,10
42625,SilverMaster,,19,154,5,159
42626,geeknerd,,20,4,10,14
42627,runagate,,20,13,20,33
42628,Jeeezelouise,,19,369,206,575
42629,FUSe,,19,14,19,33
42630,MerlinIII,,23,1,1,2
42631,parched,,1,2,3,5
42632,ef4,,19,213,315,528
42633,Johnny_Cash_,,13,1,1,2
42634,hscalum,,42,1,1,2
42635,unclestiltskin,,17,1,3,4
42636,MrFlesh,,13,755,1274,2029
42637,Botunda,,13,34,17,51
42638,noahspurrier,,36,7,3,10
42639,bodhi,,20,8,12,20
42640,as177,,34,1,1,2
42641,actsasflinn,,20,1,3,4
42642,Gash77,,19,31,34,65
42643,SGeniusNinja,,32,5,6,11
42644,emilyannemurphy,,18,7,5,12
42645,westernorbit,,27,2,4,6
42646,DocMatrix,,1,10,1,11
42647,jjjjjaa,,18,21,38,59
42648,jrchin,,20,1,2,3
42649,jones3316,,18,271,257,528
42650,Jon403,,19,1,4,5
42651,leTao,,43,38,63,101
42652,Hagimir,,39,9,9,18
42653,racy_rick,,1,154,234,388
42654,hseldon10,,31,320,574,894
42655,skyline1187,,4,3,1,4
42656,delpfonik,,34,2,2,4
42657,wtanksleyjr,,20,34,62,96
42658,malefactor,,18,5,3,8
42659,Gella321,,1,231,161,392
42660,schrod,,13,49,101,150
42661,yourstupider,,13,1,2,3
42662,pauls101,,20,24,5,29
42663,rowd149,,10,280,350,630
42664,ilovejavascript,,18,1,1,2
42665,enls,,30,33,35,68
42666,roaddog,,19,83,66,149
42667,Slummervillain,,5,6,9,15
42668,YourLizardOverlord,,31,27,35,62
42669,donknuth,,20,10,10,20
42670,cmaher,,5,4,1,5
42671,winsauce,,13,3,5,8
42672,feuermelder,,22,1,2,3
42673,o1nkqng,,29,2,1,3
42674,cory849,,6,73,57,130
42675,JOKasten,,18,3,8,11
42676,orwell,,19,2,4,6
42677,eltower,,31,102,160,262
42678,skyrocker,,13,14,4,18
42679,polyeidus,,32,1,1,2
42680,orngshusrthebest,,29,5,6,11
42681,fapless,,30,12,9,21
42682,joker12345,,14,1,1,2
42683,readyteddy,,13,2,1,3
42684,Arbitraryster,,43,38,13,51
42685,hafizr,,20,53,3,56
42686,kolacheface,,2,3,2,5
42687,dog4,,32,2,1,3
42688,emeray,,31,32,35,67
42689,whatyeah3,,2,22,25,47
42690,geeeeoffff,,22,804,788,1592
42691,parenthesis,,20,4,4,8
42692,mookiemookie,,19,337,513,850
42693,cjdaniel,,20,7,15,22
42694,sheepleslave,,13,158,53,211
42695,Jugulator,,0,132,3,135
42696,lytics,,18,2,1,3
42697,Gaki,,19,51,69,120
42698,Llanwar,,34,5,5,10
42699,larryj53,,36,1,8,9
42700,claybear1216,,30,1,1,2
42701,Trunch,,32,15,11,26
42702,Niffux,,22,56,66,122
42703,mjoshi,,34,4,8,12
42704,Heyoka,,0,5,9,14
42705,sadflkjsadajkshdfa,,30,1,1,2
42706,iphun,,1,10,18,28
42707,tyler126,,18,1,1,2
42708,googletrickedme,,11,521,158,679
42709,hal9k,,29,2,1,3
42710,zuoken,,19,8,9,17
42711,chibikiba,,1,144,271,415
42712,R3V0L7,,10,6,1,7
42713,funkyboss,,16,1,2,3
42714,cdalkire,,22,1,1,2
42715,amysarah,,3,93,179,272
42716,bohjelaska,,8,1,1,2
42717,dcreemer,,13,114,84,198
42718,MooseBurgers,,13,86,34,120
42719,rmfd,,43,1,2,3
42720,twich35,,18,6,2,8
42721,vegasceincetrust,,7,2,1,3
42722,neoconsmustdie,,19,6,1,7
42723,ajehals,,31,761,1023,1784
42724,danielthepoet,,5,1,1,2
42725,fanflibble,,18,14,17,31
42726,autogynephile,,26,1,1,2
42727,urbanlatinfemale,,1,12,1,13
42728,arbitrarymixture,,17,51,81,132
42729,marcedman,,13,1,2,3
42730,kylev,,32,304,221,525
42731,shadowblade,,19,2,8,10
42732,saladbar,,34,5,9,14
42733,stitchinthyme,,36,5,2,7
42734,tevi002,,19,1,1,2
42735,majungo,,18,22,19,41
42736,Reddit_Cat,,13,1,1,2
42737,3004,,0,7,13,20
42738,BabyJesus,,32,27,48,75
42739,fahdinho,,1,117,129,246
42740,toomanylaws,,14,1,1,2
42741,Beagle17,,19,3,1,4
42742,oneliberalhoosier,,34,1,2,3
42743,base736,,29,146,242,388
42744,iphoneblowme,,13,64,32,96
42745,md12,,19,14,9,23
42746,ObamasPurpleKoolaid,,31,17,16,33
42747,revchu,,12,12,18,30
42748,chrisjones74,,32,14,23,37
42749,Magnus_Geist,,13,31,65,96
42750,xyzpdq,,20,33,51,84
42751,redson,,19,47,6,53
42752,archlich,,43,16,21,37
42753,hayzen,,43,9,21,30
42754,healthybaby,,43,1,1,2
42755,mricon,,20,13,3,16
42756,BoomDizzle,,0,21,8,29
42757,whiteman,,30,15,13,28
42758,deeplyembedded,,10,87,50,137
42759,flynne,,18,6,18,24
42760,bigpappasmurf,,20,3,8,11
42761,smurple,,6,1,1,2
42762,aprilwine,,32,2,1,3
42763,pickles46,,17,2,2,4
42764,GreenGhost88,,5,3,3,6
42765,nefigah,,20,4,6,10
42766,URGENTCAPSLOCKGUY,,30,1,1,2
42767,koavf,,13,329,230,559
42768,foocat,,13,1,4,5
42769,alexBrsdy,,13,239,85,324
42770,guyhersh,,18,19,14,33
42771,goober118,,34,1,1,2
42772,zerohalo,,20,25,16,41
42773,ExKaliiperi,,27,7,11,18
42774,CalResident,,18,6,3,9
42775,Dark1Knight,,42,30,51,81
42776,worduphomefry,,13,26,15,41
42777,hairstyled67,,31,1,1,2
42778,m4ttjirM,,13,4,1,5
42779,peasandcarrots,,1,14,14,28
42780,toord,,18,141,166,307
42781,j0hnny5,,13,1,2,3
42782,hillkiwi,,22,49,61,110
42783,sevenoutdb,,13,38,60,98
42784,raystein,,31,2,2,4
42785,CloudDrone,,18,37,131,168
42786,Cazzaquistao,,20,2,3,5
42787,shivey,,13,1,2,3
42788,GamerSix55,,12,39,3,42
42789,quanfer,,12,3,11,14
42790,atozand1to10,,18,36,70,106
42791,suranwrap,,42,1,1,2
42792,antiteam,,1,2,4,6
42793,libera_me,,32,21,34,55
42794,RobMack,,36,1,1,2
42795,007ltk,,23,1,2,3
42796,urnice,,9,3,2,5
42797,Pampy,,6,1,1,2
42798,bco,,6,6,1,7
42799,dav_k,,43,1,1,2
42800,jan_strach,,18,67,17,84
42801,Naught,,6,26,32,58
42802,supermauerbros,,22,10,12,22
42803,Yoda_Dagobah,,18,1,1,2
42804,laz,,20,10,12,22
42805,MutinusMutunus,,11,1,1,2
42806,icecoldmax,,17,17,13,30
42807,LokiSnake,,1,3,6,9
42808,crunk,,20,58,96,154
42809,slickeddie,,11,3,2,5
42810,bardamu,,20,1,3,4
42811,yonwax2,,17,3,1,4
42812,imcdona,,32,1,1,2
42813,mbarnett,,20,2,7,9
42814,jeanette3654,,19,426,503,929
42815,packman86,,18,6,10,16
42816,internetish,,18,102,17,119
42817,vixtt,,1,19,11,30
42818,hairstyleasd1,,22,1,1,2
42819,Hexagonally,,43,1,2,3
42820,f33dback,,42,37,65,102
42821,ppbottle,,18,5,1,6
42822,tie-rack,,20,51,51,102
42823,kyleflan,,32,1,2,3
42824,Islay12ut,,19,492,35,527
42825,natural_born_lusr,,20,1,1,2
42826,mrcaffeinated,,13,1,1,2
42827,molson2000,,18,19,39,58
42828,cypherpunks,,18,53,5,58
42829,bring_back_king,,22,1,4,5
42830,Fanoffun,,43,82,145,227
42831,rjcarr,,4,736,822,1558
42832,Bognar,,42,57,43,100
42833,girlxfirefly,,13,11,3,14
42834,k1ngcrimson,,18,3,1,4
42835,suyogrulz,,6,2,4,6
42836,caknuckle,,13,239,223,462
42837,synchronicity,,11,1,3,4
42838,xenotype,,18,15,18,33
42839,appiahj,,19,14,38,52
42840,nukiek,,42,16,6,22
42841,weasler7,,19,12,16,28
42842,cheesiefries,,10,27,9,36
42843,joshuasmaximus,,32,9,3,12
42844,octajon,,1,20,47,67
42845,evildeadxsp,,13,200,90,290
42846,XerxesOxalis,,18,2,1,3
42847,notfluffy,,13,18,10,28
42848,elsjaako,,20,19,34,53
42849,i_am_dylan,,20,1,1,2
42850,xkey,,18,83,82,165
42851,MrSnrub,,19,25,102,127
42852,gcube,,12,1,1,2
42853,coldxrain,,1,2,3,5
42854,Foxhound199,,42,177,288,465
42855,some_chump,,20,1,5,6
42856,martinus,,20,2,1,3
42857,romainpi,,8,2,4,6
42858,ihatecookiies,,1,64,58,122
42859,claco,,19,64,126,190
42860,Jaquestrap,,20,2,2,4
42861,smartin42,,34,2,2,4
42862,jyoung98,,22,15,2,17
42863,northbourne,,1,93,183,276
42864,frenchtoaster,,18,43,48,91
42865,Scav,,9,110,23,133
42866,GK_Jonny,,31,1,4,5
42867,sabernar,,20,3,3,6
42868,andre75,,18,4,15,19
42869,thalience,,31,21,17,38
42870,nervousnelly,,19,8,9,17
42871,spamtastik,,13,2,1,3
42872,acid_phlashback,,19,1,3,4
42873,ksilverfox,,18,181,46,227
42874,kezil,,23,1,1,2
42875,pstuart,,22,23,27,50
42876,jeansfrog,,20,2,4,6
42877,maoroo,,32,1,1,2
42878,hot_carl,,43,7,7,14
42879,TheNightMan,,1,6,1,7
42880,Talka,,31,19,15,34
42881,mayaih,,31,3,4,7
42882,Deepblu,,12,1,2,3
42883,g00dETH3R,,13,42,79,121
42884,pistacchio,,20,2,1,3
42885,azth,,18,12,7,19
42886,owesome,,43,3,2,5
42887,davidnewcomb,,20,1,1,2
42888,cheefjustice,,13,56,29,85
42889,branded,,18,155,101,256
42890,Adam87,,8,7,11,18
42891,ajnabee4u,,12,11,24,35
42892,SocratesJohnson,,18,10,4,14
42893,mithrandi,,20,3,1,4
42894,lagann12,,32,3,1,4
42895,backwebcadre,,13,5,1,6
42896,jreim,,0,2,1,3
42897,bestofluck,,18,1,4,5
42898,winkywooster,,20,95,26,121
42899,CountRob,,30,13,8,21
42900,superK,,43,2,5,7
42901,mrfurious,,13,10,9,19
42902,Nomikos,,22,56,101,157
42903,macrael,,20,3,2,5
42904,xjonathanx,,5,1,2,3
42905,undeadhobo,,12,67,84,151
42906,Smallpaul,,20,171,212,383
42907,squirrel5978,,1,22,21,43
42908,LeisureCat,,27,3,1,4
42909,choas,,20,86,44,130
42910,derecho13,,31,42,80,122
42911,WizardOfLies,,18,132,141,273
42912,lurchentsafter,,7,4,4,8
42913,Noexit,,34,239,551,790
42914,nattypol,,13,16,1,17
42915,SenorLovely,,43,1,5,6
42916,Rsardinia,,19,615,613,1228
42917,redbu11,,20,2,5,7
42918,Chaserson,,0,605,20,625
42919,neocontrash,,13,34,72,106
42920,longx223,,32,1,2,3
42921,landtuna,,20,56,78,134
42922,jkjsdhfashdf,,31,2,8,10
42923,Jimeee,,18,39,50,89
42924,Jimmy_Carter,,38,1,1,2
42925,edward_r_murrow,,19,4,8,12
42926,BigBearSac,,13,4,6,10
42927,bpaterni,,20,5,7,12
42928,hailpixel,,18,37,23,60
42929,allodoxaphobia,,30,2,1,3
42930,svolix,,18,6,8,14
42931,sencha,,13,33,12,45
42932,markfinkle,,20,1,1,2
42933,gamer31,,0,10,12,22
42934,broca,,18,6,3,9
42935,chowmeinmao,,29,13,33,46
42936,nathan12343,,20,9,14,23
42937,jenonreddit,,3,7,5,12
42938,brandx1982,,18,52,70,122
42939,mexicanpizza,,13,11,20,31
42940,hypnotikrobot,,18,78,170,248
42941,shawnbttu,,16,4,7,11
42942,BigFuzzyArchon,,18,25,37,62
42943,hcicavok,,1,1,1,2
42944,khatarnaak,,31,33,28,61
42945,majhem,,15,12,45,57
42946,mthode,,4,2,3,5
42947,jakemdoz,,42,28,16,44
42948,johnbr,,20,11,14,25
42949,collegecandy,,12,3,2,5
42950,montanajones,,18,31,115,146
42951,tickbole,,6,2,9,11
42952,nibblit,,19,4,6,10
42953,nicolelinblad,,5,8,4,12
42954,alkalinev,,19,80,79,159
42955,mahakali,,6,2,1,3
42956,pykogapmkc,,20,5,1,6
42957,JohnFuckingMcCain,,29,1,1,2
42958,jkyu88,,5,5,5,10
42959,necron99,,18,10,26,36
42960,arnar,,20,637,917,1554
42961,rustyryan,,20,15,23,38
42962,pete2532,,18,44,80,124
42963,Kronikle,,12,12,8,20
42964,coopervr,,11,4,2,6
42965,dragoon,,31,1,1,2
42966,jackarcalon,,32,21,49,70
42967,alaskarob907,,26,4,2,6
42968,Searil,,19,1,1,2
42969,august17,,1,2,3,5
42970,cactus82,,31,12,14,26
42971,mike2297,,16,3,2,5
42972,joebeck,,20,8,13,21
42973,Beachcoma,,18,110,252,362
42974,mejusthavin,,31,185,228,413
42975,sininc,,22,8,10,18
42976,AxiomShell,,20,149,216,365
42977,EarthMephit,,8,5,11,16
42978,gadlaw,,19,19,20,39
42979,goofdup,,13,24,1,25
42980,phantomgold,,31,3,6,9
42981,shotmenot,,18,42,59,101
42982,redbone,,19,2,2,4
42983,clgoh,,22,25,37,62
42984,alphafrau,,19,5,1,6
42985,ashleymarti,,43,3,8,11
42986,jmuh,,34,6,7,13
42987,basilcats,,11,1,3,4
42988,skeww,,20,48,47,95
42989,preddictit,,13,1,1,2
42990,elitexero,,18,29,80,109
42991,colorred,,20,177,293,470
42992,chris,,20,3,2,5
42993,pc9323,,13,66,1,67
42994,rht,,18,18,22,40
42995,Slavic,,18,6,1,7
42996,RobotBuddha,,32,11,25,36
42997,TheCoelacanth,,20,174,253,427
42998,InksLWC,,13,199,81,280
42999,woahh_cecs,,1,1,2,3
43000,willm,,20,33,30,63
43001,staub81,,19,85,49,134
43002,sprezzatura,,14,13,15,28
43003,starknaked1984,,13,1,1,2
43004,gary_crutchley1968,,22,1,1,2
43005,hardnutz,,18,276,148,424
43006,arghnoname,,20,24,19,43
43007,apunchline,,13,5,1,6
43008,bombastica,,31,42,60,102
43009,glastohead,,41,109,174,283
43010,eurasian,,1,8,5,13
43011,toddthefrog,,18,47,29,76
43012,Kjalnot,,13,23,18,41
43013,chemlock,,18,13,16,29
43014,ed2417,,31,12,3,15
43015,rotarhead,,19,14,18,32
43016,exomniac,,13,10,15,25
43017,joker123,,13,10,28,38
43018,soxfanpdx,,18,429,501,930
43019,sylverlokk,,13,3,1,4
43020,elektroholunder,,1,50,75,125
43021,delph,,1,286,430,716
43022,Dylan1986,,19,100,73,173
43023,expacifico,,13,1,2,3
43024,teletype,,19,12,5,17
43025,P-Frank,,19,6,11,17
43026,dpieper,,29,6,5,11
43027,glw907,,4,1,3,4
43028,cudiaco,,31,298,65,363
43029,NoblePotatoe,,34,13,25,38
43030,flow_,,19,3,4,7
43031,GermanEnglishPolice,,18,3,2,5
43032,dmsean,,1,166,246,412
43033,APock,,30,1,1,2
43034,WhattaDonkey,,1,1,1,2
43035,mauman,,20,1,3,4
43036,phyzome,,20,534,1149,1683
43037,mhh484,,1,1,1,2
43038,TexasMojo,,1,3,5,8
43039,mattblack,,25,4,2,6
43040,whiteoprah,,15,1,1,2
43041,FezMan88,,13,6,4,10
43042,orkut,,13,1,2,3
43043,bcvr,,18,20,27,47
43044,LoganSerman,,13,76,4,80
43045,unique321b,,29,1,2,3
43046,MarkFl123,,20,2,2,4
43047,Clintron,,18,1,2,3
43048,cybrspin,,5,79,19,98
43049,mjagiello,,8,27,30,57
43050,m_eiman,,20,2,3,5
43051,oilytheotter,,43,28,41,69
43052,sbenskin,,22,27,18,45
43053,Siraf,,30,129,145,274
43054,Rickert,,13,14,3,17
43055,Goladus,,41,1,2,3
43056,sheeep,,4,9,13,22
43057,NotJoeSmith,,13,32,14,46
43058,Mischi3vo,,5,3,1,4
43059,teamjimmyy,,4,7,6,13
43060,ChattyKathy,,20,3,2,5
43061,Keyframe,,20,110,103,213
43062,shriver,,41,1,7,8
43063,beardedone,,31,1,1,2
43064,MrKlatuu,,0,12,32,44
43065,arof,,18,9,19,28
43066,blackstar00,,20,7,9,16
43067,marvin,,19,17,6,23
43068,RealMaascamp,,20,6,7,13
43069,funkDoc,,17,19,27,46
43070,skatterbean,,32,2,1,3
43071,coppercrayon,,28,2,5,7
43072,Sense1ess,,18,16,55,71
43073,tjuric007,,32,3,1,4
43074,yohann,,20,5,3,8
43075,kcjameson,,26,245,236,481
43076,bkow20,,12,6,3,9
43077,heokle,,6,15,34,49
43078,KomodoDave,,1,1,1,2
43079,odd-ball,,4,1,2,3
43080,aluk,,31,3,4,7
43081,mreiland,,20,2,2,4
43082,endo99,,34,1,1,2
43083,rhinobird,,0,33,65,98
43084,jromano,,43,6,5,11
43085,deadeddie,,18,20,23,43
43086,stevebratt,,18,24,35,59
43087,dgiri101,,20,6,9,15
43088,Blueberryspies,,31,12,11,23
43089,ratedogs,,34,1,1,2
43090,SidewaysFish,,1,9,7,16
43091,filmmusiclover,,13,9,1,10
43092,asneaxl,,5,2,5,7
43093,candypant,,20,15,22,37
43094,SourSlurpee,,1,5,7,12
43095,ashground,,30,50,37,87
43096,crabperson,,32,8,13,21
43097,nirhmv,,20,1,1,2
43098,sbassin,,19,22,29,51
43099,dreamer90,,32,69,90,159
43100,Ra__,,13,1451,1925,3376
43101,BigEvil,,14,3,1,4
43102,temp_ature,,20,2,5,7
43103,DifferanceQ,,11,1,3,4
43104,jonathan881,,18,8,20,28
43105,texture,,13,954,735,1689
43106,btrettel,,1,4,10,14
43107,falsestprophet,,19,54,5,59
43108,IDownvoteJimmyCotton,,13,4,2,6
43109,ncairns,,19,12,14,26
43110,duggynyc,,19,7,6,13
43111,scarabic,,34,6,7,13
43112,browster,,19,85,112,197
43113,kingnerd,,43,14,32,46
43114,chickenwrap,,39,7,3,10
43115,Magee1205,,19,2,4,6
43116,PlanckEnergy,,18,28,27,55
43117,HawkeyeGK,,19,139,16,155
43118,limerope,,20,1,1,2
43119,jerseycityfrankie,,0,170,273,443
43120,nwii,,4,38,50,88
43121,dfskjdfsklfd,,0,3,1,4
43122,jbjake,,19,9,18,27
43123,cleverhandle,,35,4,2,6
43124,bamba1803,,0,19,8,27
43125,HumpingJack,,31,8,7,15
43126,Anttikoo,,42,35,2,37
43127,MrDoubtful,,5,3,8,11
43128,m_tayseer,,20,3,3,6
43129,Miami13,,19,10,15,25
43130,uberalles,,22,2,3,5
43131,dannykkkjames,,19,3,1,4
43132,infodoc1,,13,2,8,10
43133,azemute,,42,28,62,90
43134,jread,,18,7,12,19
43135,vasilisp,,20,3,4,7
43136,basilisk,,31,11,15,26
43137,whitedawg,,9,166,271,437
43138,tenbull,,34,120,80,200
43139,woo_hoo,,18,87,77,164
43140,Sithsteen,,18,80,46,126
43141,poisiod,,19,4,3,7
43142,mmurch03,,32,103,92,195
43143,Ivape,,19,43,84,127
43144,davidfdm,,18,1,11,12
43145,badalchemist,,18,46,49,95
43146,Ambush,,15,25,37,62
43147,Jesus_H_Christ,,10,3,1,4
43148,Biggus,,0,26,67,93
43149,dmooney1,,19,16,11,27
43150,adymo,,20,7,1,8
43151,bobthebarber,,32,1,1,2
43152,souldrift,,19,325,303,628
43153,framecontrol,,19,10,6,16
43154,otherwiseguy,,32,6,6,12
43155,BlameLayer,,19,5,12,17
43156,autista26,,19,2,4,6
43157,CanadianAsshole,,30,12,29,41
43158,schtum,,19,367,365,732
43159,mikeyarmo,,30,15,4,19
43160,edu,,20,3,1,4
43161,Postradamus,,34,39,2,41
43162,plbg32,,19,6,12,18
43163,mcwifi,,19,34,68,102
43164,dcguy12,,4,6,8,14
43165,minturn,,19,10,7,17
43166,digitalc,,30,498,668,1166
43167,technoweenie,,20,3,13,16
43168,Stormblade,,43,35,61,96
43169,battlegir,,12,4,10,14
43170,oddietaco,,32,34,18,52
43171,mrighele,,20,4,4,8
43172,GregJudysSon,,37,3,2,5
43173,nwej,,19,5,2,7
43174,xnomad,,31,5,3,8
43175,tzk,,43,32,67,99
43176,heanol,,20,2,3,5
43177,Meatshield,,18,4,7,11
43178,R031E5,,0,28,21,49
43179,slackmeister,,7,1,1,2
43180,fox_mulder,,13,55,106,161
43181,boarder4021,,4,4,4,8
43182,sosleepy,,3,2,3,5
43183,rumbling,,1,1,1,2
43184,moneyminds,,5,5,1,6
43185,irishkev,,8,98,22,120
43186,altered,,43,49,80,129
43187,vfx,,31,1,1,2
43188,killing_time,,22,51,55,106
43189,ooKmonkey,,6,4,8,12
43190,mabraham,,32,1,3,4
43191,seven11,,0,335,464,799
43192,michael12345678,,29,1,1,2
43193,schwap23,,0,36,2,38
43194,coringerr,,41,2,1,3
43195,5plus7,,10,9,10,19
43196,sickdimension,,1,132,34,166
43197,cccbreaker,,18,64,15,79
43198,JetSetWilly,,20,71,39,110
43199,davey_darling,,13,11,6,17
43200,nakmario,,0,4,8,12
43201,retroflarical,,18,20,10,30
43202,johnemdall,,19,1,4,5
43203,whistle_440,,12,2,1,3
43204,Gotttzsche,,42,115,164,279
43205,yello,,31,118,55,173
43206,fiddlechick,,1,17,15,32
43207,brandonmarlow,,14,39,12,51
43208,colorrot,,32,41,11,52
43209,MRomney,,30,2,1,3
43210,metagus,,6,1,3,4
43211,VicinSea,,34,901,754,1655
43212,mak11,,3,2,4,6
43213,Peity,,36,1,3,4
43214,pooteeweet28,,13,108,25,133
43215,divv,,42,34,80,114
43216,titsorgtfo,,19,1,1,2
43217,locoza,,19,4,3,7
43218,barbapapa666,,13,1,1,2
43219,rax_s,,10,20,23,43
43220,thetailofdogma,,1,1,1,2
43221,williamsba,,42,64,43,107
43222,nagap,,20,1,2,3
43223,SarahxJane,,1,2,11,13
43224,evilbunnyfufu,,13,5,4,9
43225,metachor,,20,30,76,106
43226,jigilous,,18,1,4,5
43227,mizan,,13,218,37,255
43228,decaff3,,19,9,10,19
43229,keystonesooner,,19,4,5,9
43230,ronflor,,6,1,2,3
43231,kor56,,29,31,43,74
43232,spectator,,21,40,1,41
43233,curtail,,4,3,1,4
43234,maneesh,,12,21,22,43
43235,towner,,0,1,1,2
43236,markandre,,8,4,8,12
43237,grandhighwonko,,14,272,732,1004
43238,chessmonkey,,1,12,16,28
43239,VanillaDeath,,42,2,2,4
43240,EvanSnyder,,32,4,2,6
43241,bloodysinuses,,20,5,2,7
43242,theXarf,,18,85,119,204
43243,adoro,,31,1,2,3
43244,rhavenn,,5,6,3,9
43245,hashcakes,,18,31,54,85
43246,GodILoveAsparagus,,32,57,52,109
43247,cowbob,,2,13,7,20
43248,Tjolo,,19,4,20,24
43249,Dubon,,6,8,20,28
43250,ty_max,,18,4,9,13
43251,bowling4meth,,0,205,408,613
43252,MothershipConnection,,36,1,3,4
43253,iKonic,,18,66,23,89
43254,tehguruofred,,22,11,7,18
43255,hturt,,43,1,3,4
43256,samgalvez,,13,467,16,483
43257,froydnj,,20,66,88,154
43258,MattTheGeek,,18,20,57,77
43259,jeebusroxors,,20,258,347,605
43260,askoruli,,9,1,3,4
43261,kokey,,31,392,608,1000
43262,misaligned,,18,2,11,13
43263,azimir,,18,33,109,142
43264,canyoudiggitman,,19,49,68,117
43265,malpingu,,9,1,3,4
43266,nicolas42,,19,4,8,12
43267,3daddict,,34,1,10,11
43268,b0b0tiken,,32,5,5,10
43269,future_pope,,19,3,2,5
43270,badr,,20,57,22,79
43271,T0RN8R,,19,4,1,5
43272,lambdanaut,,1,24,36,60
43273,2267ghy,,32,1,1,2
43274,zamolxes,,20,7,11,18
43275,GuyWithLag,,20,88,156,244
43276,Capitalismnotgreed,,0,71,89,160
43277,pertex,,31,6,3,9
43278,fremont1817,,18,6,1,7
43279,kstr,,20,29,50,79
43280,gluten-free,,19,9,2,11
43281,ChipZdarsky,,30,2,2,4
43282,tempaccount098753214,,18,1,9,10
43283,ManishSinha,,18,2,10,12
43284,mindless_puppet,,1,2,5,7
43285,astern,,22,33,52,85
43286,sayten,,34,9,4,13
43287,sugarcat,,18,6,18,24
43288,mfrager,,19,53,21,74
43289,belindakay,,18,1,1,2
43290,singleposteremacs,,20,1,1,2
43291,davraamides,,20,3,1,4
43292,workfromhomeking1,,19,27,26,53
43293,crazy2k,,20,2,6,8
43294,blindradar,,19,1,1,2
43295,GiveYouUp,,24,1,1,2
43296,Kain9787,,18,28,24,52
43297,your_computer,,18,1,1,2
43298,Sailormom,,19,29,32,61
43299,oska,,20,171,127,298
43300,spartas,,20,16,22,38
43301,Brittsmac,,19,1,5,6
43302,daughart,,13,8,18,26
43303,Uhohspaghettio,,41,8,6,14
43304,buffy4prez,,34,3,17,20
43305,shiftless,,19,5,5,10
43306,iul,,29,36,50,86
43307,AlphaX,,31,32,35,67
43308,caobhin,,26,4,8,12
43309,MCTynamite,,42,15,45,60
43310,HamburgerBarbie,,18,143,1,144
43311,agaete,,30,25,11,36
43312,MrMach5,,18,19,1,20
43313,j0hnnyb,,34,65,54,119
43314,philippejadin,,20,1,1,2
43315,Duka015,,18,15,1,16
43316,josto,,34,32,24,56
43317,PoopOnGod,,13,4,10,14
43318,dirtybastard,,34,1,1,2
43319,gidpo,,29,19,19,38
43320,agentmd,,20,2,6,8
43321,icanhasusername,,0,388,266,654
43322,GoRonnyGo,,13,4,4,8
43323,Paj0nk,,10,1,1,2
43324,trypto,,20,16,13,29
43325,Ahousai,,31,1,3,4
43326,nightgts,,43,1,1,2
43327,PaperCut_,,31,13,18,31
43328,chucker,,20,279,318,597
43329,incidently,,29,2,2,4
43330,etcshadow,,20,18,13,31
43331,avocade,,43,2,2,4
43332,MattFoley,,20,52,78,130
43333,thefro,,43,424,580,1004
43334,IcedZ,,18,42,59,101
43335,Clevtro,,19,9,16,25
43336,merfolkotpt,,19,42,6,48
43337,rakingleaves,,32,1,1,2
43338,Scytle,,19,102,10,112
43339,engram,,1,90,109,199
43340,cyrano111,,1,36,33,69
43341,pinkiemarie,,34,243,64,307
43342,jarmckenzie,,20,1,1,2
43343,durangotang,,31,7,4,11
43344,awesomepants,,31,6,4,10
43345,hhrt3456,,32,43,15,58
43346,pulvertoastman,,20,14,10,24
43347,jburkert,,0,22,39,61
43348,daivos,,31,40,32,72
43349,clinthill,,13,12,16,28
43350,Random,,4,186,217,403
43351,olpossum,,1,4,3,7
43352,Jugga,,18,1,4,5
43353,MiseBard,,19,24,47,71
43354,Tweet,,8,11,24,35
43355,eh24,,43,2,2,4
43356,LongIslandLolita,,19,7,12,19
43357,eido,,22,5,9,14
43358,buo,,20,9,18,27
43359,mortarbled,,21,128,15,143
43360,funks,,18,32,44,76
43361,patrickstickler,,8,12,27,39
43362,gigas21,,18,26,53,79
43363,Maximegalon,,42,1,1,2
43364,aliased,,20,2,2,4
43365,lpyuejfdpsstnb,,19,8,1,9
43366,redditsucksballs,,19,7,16,23
43367,daevud,,18,7,2,9
43368,cgawne,,19,13,3,16
43369,WRT,,31,13,10,23
43370,ruckgesicht,,22,48,62,110
43371,70moyo,,1,4,2,6
43372,vpoet,,5,1,1,2
43373,they_r_watching,,12,6,2,8
43374,mullacc,,32,1,6,7
43375,fathan,,4,69,73,142
43376,atn420,,12,3,4,7
43377,matts2,,31,1869,3133,5002
43378,Autoplectic,,39,1,1,2
43379,sisyphus,,20,327,500,827
43380,GSto,,29,25,9,34
43381,boolean_patrol,,20,24,53,77
43382,hoges,,18,39,38,77
43383,dwalkinafrica,,18,5,17,22
43384,dullin,,1,3,1,4
43385,gbasic24,,0,43,12,55
43386,rudynoir,,28,2,1,3
43387,areReady,,32,8,6,14
43388,salmagundii,,13,18,21,39
43389,theMrDomino,,20,9,10,19
43390,AspenLiselle,,20,2,3,5
43391,carlomrx,,5,44,1,45
43392,kingraoul3,,6,278,528,806
43393,pasbesoin,,20,49,116,165
43394,tastynaan,,32,21,6,27
43395,havesometea1,,19,508,1021,1529
43396,Astravian,,5,117,187,304
43397,ziutek,,20,6,2,8
43398,metatronscube,,1,30,77,107
43399,redbat500,,33,3,2,5
43400,softwareengineer,,20,1,2,3
43401,doobieBRO,,19,10,3,13
43402,KBax720,,19,3,1,4
43403,MrBrooks,,13,2,1,3
43404,nullroot,,0,100,167,267
43405,usrnamenottaken,,23,2,1,3
43406,MWatson,,20,12,5,17
43407,EzRiDeR,,43,17,25,42
43408,the_zero,,42,84,116,200
43409,JimmyShelter,,20,227,14,241
43410,hpoag,,12,10,9,19
43411,stifffx,,43,1,2,3
43412,Cronus6,,17,16,13,29
43413,GGLucas,,20,24,24,48
43414,ECEGatorTuro,,1,46,53,99
43415,generalk,,20,158,160,318
43416,shastert,,13,1,5,6
43417,darkpaladin,,13,193,128,321
43418,asdwwdw,,20,74,62,136
43419,projecteternity,,30,6,9,15
43420,Fraggle,,31,4,5,9
43421,Gulliver,,13,4,15,19
43422,HadleyBean,,1,3,3,6
43423,ericflo,,20,103,65,168
43424,katiew,,1,13,2,15
43425,jaslak,,13,21,11,32
43426,mouse2k,,20,13,12,25
43427,Midwest_Product,,19,648,390,1038
43428,IFelixtheCatIwer,,43,1,3,4
43429,annjellicle,,6,309,549,858
43430,duudud,,42,2,1,3
43431,immrlizard,,33,140,469,609
43432,tucadebert,,20,1,1,2
43433,cyd,,32,55,70,125
43434,not_the_FBI,,43,1,2,3
43435,ohwolfman,,18,61,28,89
43436,Cryptic0677,,13,99,159,258
43437,fatalrae,,18,12,25,37
43438,forthewin11,,19,38,2,40
43439,mockidol,,18,44,52,96
43440,essix,,31,1,1,2
43441,chuzuki,,18,15,34,49
43442,Dijkstracula,,20,13,11,24
43443,aesop921,,13,21,2,23
43444,Shorel,,20,12,58,70
43445,bettlebrox,,19,8,8,16
43446,panthrosrevenge,,13,13,12,25
43447,ahhinkle,,13,6,2,8
43448,brentathon,,18,3,1,4
43449,contradictorymonkey,,43,5,8,13
43450,PiggPhucker,,32,4,8,12
43451,sa7ouri,,31,217,155,372
43452,SparklingWiggle,,13,3,3,6
43453,krispiti,,30,1,1,2
43454,boblolbob,,20,6,3,9
43455,gypsydancer,,18,7,12,19
43456,josiefaraway,,8,3,3,6
43457,dpadular,,18,27,55,82
43458,endersdouble,,20,26,27,53
43459,CrystalCheer22,,13,6,52,58
43460,Bassdust,,18,2,5,7
43461,paradox460,,18,24,35,59
43462,ohnoihavenoname,,32,15,20,35
43463,tickingbrain,,20,139,143,282
43464,NewEnglish,,18,17,41,58
43465,emberjohnny,,18,384,21,405
43466,mkh,,14,3,2,5
43467,jraines,,31,40,52,92
43468,chri1143,,19,2,5,7
43469,redditman123,,43,5,7,12
43470,zoogr2,,36,4,8,12
43471,Lord_Xenu,,19,2,3,5
43472,thelastword,,43,1,1,2
43473,MrSt1klbak,,18,66,138,204
43474,chuck812,,13,107,21,128
43475,ckpics,,19,4,1,5
43476,nhole1,,22,2,1,3
43477,sinfurious,,31,6,5,11
43478,XxERMxX,,19,141,329,470
43479,m3ch4n15t,,6,5,9,14
43480,TranadaDay,,32,1,1,2
43481,beamin1,,13,2,1,3
43482,Applesauces,,18,82,80,162
43483,darkcard,,18,49,91,140
43484,Thor_Aackerlund,,23,1,3,4
43485,EricRes,,18,10,17,27
43486,allenp,,14,10,6,16
43487,ztaufiq,,13,2,9,11
43488,athiestcutie,,32,7,6,13
43489,skinnedmink,,18,5,11,16
43490,TheAntiChrist,,43,1,1,2
43491,IanCal,,20,104,194,298
43492,sandflea,,13,373,671,1044
43493,a1siggidy,,27,2,1,3
43494,lahuman8,,20,14,25,39
43495,anveo,,20,1,1,2
43496,Quince,,20,43,24,67
43497,zetetic,,0,31,30,61
43498,rarestwords,,31,4,11,15
43499,realstraw,,23,1,1,2
43500,cambamgt,,34,2,3,5
43501,6mDollarMan,,13,32,9,41
43502,dlds,,12,121,131,252
43503,dfk789,,22,38,57,95
43504,fideaux128,,42,3,3,6
43505,peepasaur,,18,3,4,7
43506,jojerose,,43,1,1,2
43507,sethcera,,18,5,23,28
43508,Candlemann,,6,2,2,4
43509,eeebenz,,1,5,8,13
43510,jcrawford,,18,1,1,2
43511,rooch84,,1,1,1,2
43512,jabfake,,20,1,1,2
43513,you_do_realize,,20,343,376,719
43514,michaelkeenan,,4,2,7,9
43515,MadDogTannen,,13,16,9,25
43516,AlDente,,43,258,431,689
43517,ProcrustesX,,32,89,33,122
43518,Frosty840,,34,9,26,35
43519,Causality_Loop,,18,1,1,2
43520,Spatulated,,8,20,6,26
43521,MikeHuckabee,,19,4,1,5
43522,maryriley,,20,2,2,4
43523,TomRich,,5,5,31,36
43524,nakula,,20,5,2,7
43525,revnoah,,19,24,56,80
43526,jbum,,0,1,3,4
43527,Mattyi,,18,29,57,86
43528,shhh,,13,498,33,531
43529,BostonTentacleParty,,14,5,12,17
43530,lostraven,,6,19,32,51
43531,vcharleston,,18,1,1,2
43532,dptronz,,18,171,123,294
43533,dookiemon,,29,9,13,22
43534,amc178,,20,3,4,7
43535,vduffy,,5,2,3,5
43536,ianandris,,31,10,21,31
43537,danieltalsky,,20,7,14,21
43538,99Reasons1,,13,2,2,4
43539,nixfu,,13,35,44,79
43540,dredge1981,,42,148,13,161
43541,arok,,31,1,1,2
43542,itemfour,,28,1,2,3
43543,fox1324,,8,2,3,5
43544,BigBadAl,,13,14,7,21
43545,Pilsner45,,1,2,1,3
43546,vectorz,,13,8,17,25
43547,coderdan,,20,2,2,4
43548,hukarez,,42,4,17,21
43549,ImYoric,,20,6,13,19
43550,animator,,18,1,3,4
43551,cornelius99,,19,175,80,255
43552,macduck71,,1,1,1,2
43553,sligowaths,,20,152,181,333
43554,unperfect,,18,6,15,21
43555,explodyhead,,18,103,6,109
43556,burn2much,,1,11,5,16
43557,DorkBitz,,18,5,17,22
43558,HorusTheHeretic,,18,1,2,3
43559,sogrundy,,30,9,16,25
43560,Jgallstar1,,18,5,9,14
43561,jreichel,,0,1,1,2
43562,poofbird,,1,269,81,350
43563,ice799,,34,50,12,62
43564,wiguleeds,,5,18,12,30
43565,baxx74,,13,6,9,15
43566,YourARetard,,43,2,1,3
43567,mk500,,15,1,1,2
43568,towelsoaker,,0,3,10,13
43569,armper,,18,182,286,468
43570,Tower_Of_Babel,,20,1,2,3
43571,jgrindal,,32,164,62,226
43572,har_9,,13,2,5,7
43573,Riluske,,13,20,11,31
43574,earobinson,,20,4,7,11
43575,robert001,,32,2,1,3
43576,dikini,,20,15,18,33
43577,cyaneyes,,21,2,3,5
43578,jujubetea,,13,3,4,7
43579,sigmaalgebra,,13,10,12,22
43580,stevecopley,,21,1,1,2
43581,Jwoey,,1,319,544,863
43582,allfury,,13,13,35,48
43583,PorkFlavour,,20,14,23,37
43584,be_o3,,0,16,17,33
43585,skuba,,18,5,11,16
43586,vogon,,5,6,1,7
43587,djh816,,22,155,266,421
43588,prolitico,,13,43,27,70
43589,radiks32,,19,3,4,7
43590,straylyt,,21,1,2,3
43591,mmmSoyrizo,,18,75,140,215
43592,AussieDigg3r,,18,2,3,5
43593,ouroborosity,,43,688,1250,1938
43594,eternium,,20,2,3,5
43595,cazbot,,8,19,35,54
43596,bigwig87,,34,2,3,5
43597,Hypersapien,,32,118,188,306
43598,mattycito,,31,2,3,5
43599,mp0,,20,2,5,7
43600,taybme,,13,36,41,77
43601,xjbri,,34,17,17,34
43602,hamstertamer,,31,23,19,42
43603,archon810,,20,2,4,6
43604,kndonlee,,13,9,1,10
43605,hello2you,,6,9,8,17
43606,IRememberRossPerot,,19,3,3,6
43607,dssurge,,22,19,12,31
43608,adelaarvaren,,31,54,93,147
43609,dbeckmann,,39,2,1,3
43610,jkndrkn,,20,167,141,308
43611,jabberwonk,,19,256,24,280
43612,war_is_peace,,19,5,1,6
43613,Nurotasama,,19,14,26,40
43614,oddgodd,,19,19,30,49
43615,riverScrap,,13,44,2,46
43616,Twofer,,18,5,8,13
43617,vityok,,20,35,53,88
43618,CocoLaLoca,,1,1,6,7
43619,saetaes,,14,5,3,8
43620,genericuser,,18,20,45,65
43621,joew515,,42,18,13,31
43622,kscaldef,,20,144,221,365
43623,smacfarl,,19,971,862,1833
43624,Nebu,,10,1,3,4
43625,mrjester,,32,1,3,4
43626,Jean-Paul_Sartre,,22,2,1,3
43627,rolandog,,20,2,5,7
43628,youtalkalotofsh,,34,5,10,15
43629,remleduff,,20,23,22,45
43630,tripstreet,,43,10,16,26
43631,unity2k,,6,1,1,2
43632,ies,,34,8,4,12
43633,froese,,32,53,52,105
43634,designfu,,3,1,1,2
43635,TheAmazingRedditMan,,20,2,1,3
43636,marbleriver,,12,7,10,17
43637,Unique_User_Name,,32,18,24,42
43638,bradypsmith,,36,1,3,4
43639,agatagopee,,6,2,14,16
43640,afreedman,,19,3,2,5
43641,thatmattbone,,20,20,17,37
43642,kinghajj,,20,93,104,197
43643,tuxidomasx,,18,48,16,64
43644,csliwins,,19,122,27,149
43645,IlyaKraft,,16,16,1,17
43646,jermyy,,31,1,2,3
43647,jeflin,,13,4,5,9
43648,odoylerulz,,41,2,1,3
43649,LingLing1337,,1,91,162,253
43650,snowhite7185,,5,14,13,27
43651,RationalBeaver,,19,11,10,21
43652,b0mber,,43,24,46,70
43653,Newspeak,,19,2,1,3
43654,thulasidharan2k8,,13,2,1,3
43655,ohyeahp,,4,1,1,2
43656,zetta,,20,9,10,19
43657,Legionary,,42,4,1,5
43658,Mr_Twister,,20,6,14,20
43659,yason,,20,23,6,29
43660,worship-reptiles,,18,3,1,4
43661,opieum,,39,3,2,5
43662,alecb,,13,2109,125,2234
43663,C_C_C_COMBO_BREAKER,,1,1,1,2
43664,zivtastic,,19,1,2,3
43665,wirry90210,,22,2,3,5
43666,mmilian,,13,77,9,86
43667,chaos_syndicate,,31,15,3,18
43668,b3mus3d,,1,556,538,1094
43669,YouGotServed,,8,1,3,4
43670,kewlduderules,,31,117,112,229
43671,mad_scientist,,19,95,18,113
43672,LostChild,,1,1,6,7
43673,buzaw0nk,,0,252,140,392
43674,cegsic,,8,2,2,4
43675,cochedejmu,,34,152,23,175
43676,nescontroller,,13,8,5,13
43677,xabbu,,19,13,2,15
43678,ramen_ftw,,20,72,93,165
43679,Sulky,,1,12,14,26
43680,bruinhenryd,,31,3,5,8
43681,ixxifortune,,40,1,1,2
43682,Heofz,,30,4,7,11
43683,marcronan,,31,1,1,2
43684,InternetJunkie,,42,1,3,4
43685,panxor,,43,11,15,26
43686,zookiman,,22,1,2,3
43687,crystalis,,12,78,56,134
43688,heffocheffefer,,1,358,342,700
43689,fibrecore,,22,21,35,56
43690,helvetia,,13,19,21,40
43691,fluke,,20,2,4,6
43692,stahl,,32,15,1,16
43693,tripleeddie,,17,99,43,142
43694,eskape,,5,3,2,5
43695,brentolamas,,13,18,24,42
43696,ViennaSausage,,31,2,1,3
43697,ryan_peaceworks,,20,2,1,3
43698,wraithx,,29,82,81,163
43699,cablemigrant,,32,1,4,5
43700,RegDwight,,20,23,23,46
43701,dmpk2k,,20,220,303,523
43702,thisshouldbepolitics,,43,2,1,3
43703,shortwill,,43,3,8,11
43704,milanfan,,1,4,8,12
43705,Postpawl,,13,5,8,13
43706,Captain___Obvious,,13,153,201,354
43707,Yansky,,20,2,1,3
43708,jedberg,,43,848,746,1594
43709,jefflyne,,18,1,2,3
43710,degriz,,8,180,404,584
43711,lbrandy,,20,108,78,186
43712,nickmcclendon,,18,20,4,24
43713,RPaul08,,13,24,9,33
43714,epcmedia,,20,2,4,6
43715,the-illuminator,,31,3,2,5
43716,skittlelover,,32,6,1,7
43717,jreddit,,36,605,630,1235
43718,crellec,,18,8,6,14
43719,salinon,,13,7,5,12
43720,diet_c0ke,,20,13,10,23
43721,poservarial,,12,5,7,12
43722,daveyboy22,,19,156,96,252
43723,bozzskaggs,,6,1,1,2
43724,robertswa,,13,2,6,8
43725,hpymondays,,31,773,478,1251
43726,befs,,40,4,4,8
43727,lidabob,,0,292,1,293
43728,SmokyMtnHiker,,13,31,3,34
43729,noisebleed,,30,9,10,19
43730,mini_meme,,18,10,25,35
43731,loquacious,,1,90,114,204
43732,fuzzywombat,,20,37,13,50
43733,xiga,,1,4,6,10
43734,phdonnelly,,32,36,75,111
43735,Retsejesiw,,32,9,44,53
43736,ta4ka,,34,1,1,2
43737,oorah,,18,10,20,30
43738,duddles,,13,473,286,759
43739,TheBaker,,18,31,15,46
43740,ianglese,,32,14,14,28
43741,potro,,29,26,29,55
43742,blackyoda,,17,17,24,41
43743,b0b,,18,6,20,26
43744,wogzi,,19,10,11,21
43745,jyunghit,,13,2,1,3
43746,bubble_bobble,,10,177,255,432
43747,PhillyBoyRoy,,5,6,3,9
43748,Goym,,18,1,1,2
43749,JaySunFL,,13,8,11,19
43750,jahelton81,,13,11,28,39
43751,eshemuta,,31,98,219,317
43752,jwilliamb24,,31,2,1,3
43753,cleantex,,13,1,1,2
43754,pleasantlybored,,1,2,1,3
43755,DanTilkin,,19,37,49,86
43756,rupa,,43,52,78,130
43757,djpnewton,,20,44,72,116
43758,exotics,,34,188,72,260
43759,edwardmills,,5,4,1,5
43760,superphantom,,19,10,13,23
43761,phayd,,32,5,15,20
43762,lifeofliberty,,19,12,22,34
43763,Sorento,,0,52,115,167
43764,Alpinweis,,20,31,2,33
43765,commandar,,19,51,62,113
43766,causativecorrelation,,20,1,1,2
43767,Ejir,,18,133,279,412
43768,kst9879872,,19,10,16,26
43769,Eismann,,33,98,47,145
43770,floppydrive,,13,5,3,8
43771,ALWAYS_RIGHT,,6,10,12,22
43772,fap-fap-fap,,20,10,11,21
43773,doubleE,,18,102,86,188
43774,theblackcritic,,4,24,2,26
43775,thcmagus,,13,1,4,5
43776,Rufus_22,,33,7,7,14
43777,ombi,,43,1,1,2
43778,mamra,,5,58,1,59
43779,Haddock,,18,139,260,399
43780,nathan82,,22,5,8,13
43781,blakewatters,,1,20,4,24
43782,funkah,,20,144,259,403
43783,aphexmandelbrot,,43,193,443,636
43784,Epic_Peanuts,,32,2,1,3
43785,jagu,,14,1,2,3
43786,brendakay,,20,5,1,6
43787,MattBD,,20,11,5,16
43788,stevewedig,,19,8,5,13
43789,Admiral_Ackbar,,43,22,21,43
43790,Shagata_Ganai,,13,203,395,598
43791,wazoox,,32,98,138,236
43792,rpdillon,,20,99,148,247
43793,neenernenner,,20,5,7,12
43794,tictac99,,18,1,1,2
43795,lamb8192,,22,2,6,8
43796,stupidpoopoohead,,12,1,1,2
43797,ellipticaltable,,20,3,2,5
43798,techie1980,,35,5,2,7
43799,jeebus77,,19,16,14,30
43800,IbeeX,,20,181,6,187
43801,lynchyeatspizza,,34,13,6,19
43802,jstal,,12,1,1,2
43803,cbolts,,19,4,12,16
43804,tidder90210,,1,10,8,18
43805,Chris3411444,,2,51,76,127
43806,Iamthewalrus,,5,190,184,374
43807,Internoob,,32,35,39,74
43808,slimslider,,1,6,6,12
43809,thetensor,,18,15,8,23
43810,DrJ,,0,19,20,39
43811,madhatta23,,29,2,1,3
43812,spencermiles,,15,23,1,24
43813,riemannszeros,,19,268,244,512
43814,aabbqrstp,,14,1,1,2
43815,zaaaaz,,18,238,69,307
43816,buffaloboy,,34,2,2,4
43817,britkid12,,18,15,13,28
43818,yugami,,13,60,190,250
43819,saturn825,,13,104,209,313
43820,bluehands,,32,8,16,24
43821,luster,,13,148,275,423
43822,primefactor,,13,2,5,7
43823,ronaldl79,,19,4,4,8
43824,vikingv,,31,13,15,28
43825,badfish701,,13,32,8,40
43826,IslandAce,,20,7,6,13
43827,BigNormalMan,,30,1,4,5
43828,rubberball,,17,69,153,222
43829,ebonelza,,34,8,6,14
43830,merryungulate,,20,1,1,2
43831,heisec,,20,36,1,37
43832,gameforge,,33,377,537,914
43833,alexthewriter,,18,29,4,33
43834,MrObamasQuran,,19,92,118,210
43835,GavinNH,,0,1,3,4
43836,cjasztrab,,19,6,1,7
43837,icanhasairforceone,,18,14,20,34
43838,qviqve1,,18,4,24,28
43839,Dumpser,,31,1,1,2
43840,Caternary,,9,15,26,41
43841,thedbert21,,15,2,3,5
43842,xwonka,,8,2,2,4
43843,erinlaver,,3,4,1,5
43844,redraider0016,,19,9,9,18
43845,poopsicle,,31,14,4,18
43846,ksool,,0,7,6,13
43847,flyingjay2121,,18,150,1,151
43848,5985958,,20,20,19,39
43849,oswaldheston,,13,3,7,10
43850,asianglowharold,,43,1,7,8
43851,weej,,20,17,33,50
43852,cdharrison,,34,17,3,20
43853,Coffeeee,,43,1,2,3
43854,Anathemic_Nerd,,4,6,2,8
43855,dhark,,31,155,178,333
43856,Myrv,,22,27,29,56
43857,rps5000,,13,68,8,76
43858,redditcensoredme,,29,1430,2094,3524
43859,MisterMerkin,,19,76,168,244
43860,Lifer,,18,8,4,12
43861,mark0x,,35,1,1,2
43862,alphahelix,,18,2,2,4
43863,nello1226,,18,14,47,61
43864,puffybaba,,20,85,137,222
43865,illuminatedwax,,19,663,813,1476
43866,papertiger,,6,2,8,10
43867,mcford26,,13,5,1,6
43868,lazzareth,,1,54,58,112
43869,ouistiti,,1,8,8,16
43870,ebbayartist,,30,7,1,8
43871,Excedrin,,20,23,46,69
43872,stevechy,,20,21,14,35
43873,LAWLESS,,12,1,2,3
43874,MMGuuy,,20,4,4,8
43875,Azurathus,,18,1,2,3
43876,m0neybags,,6,19,21,40
43877,xNIBx,,31,110,149,259
43878,cumdumpster,,22,30,25,55
43879,thebellmaster1x,,1,59,53,112
43880,pinkjello,,35,1,1,2
43881,josephknight,,18,4,1,5
43882,201wasan_underseajob,,43,1,2,3
43883,Rahvin,,22,2,3,5
43884,alanwj,,20,4,4,8
43885,kragensitaker,,20,52,147,199
43886,AR1ST0,,43,17,43,60
43887,daelin,,3,24,35,59
43888,lorettanall,,0,3,3,6
43889,stalepie3,,42,1,1,2
43890,donwilson,,1,46,52,98
43891,harrytuttle,,41,411,297,708
43892,ODSTSpooky,,18,23,26,49
43893,PrimeTime485,,43,4,7,11
43894,LincolnA,,19,14,7,21
43895,demeteloaf,,1,60,76,136
43896,my_nodnarb,,32,1,1,2
43897,Sulac,,23,4,4,8
43898,ismailnc,,13,2,1,3
43899,hshsh,,10,1,1,2
43900,tmwctr,,20,19,3,22
43901,bos,,20,320,84,404
43902,zinger991,,10,1,1,2
43903,Godwins_Law,,11,1,3,4
43904,galderz,,20,1,1,2
43905,pdonni,,12,24,3,27
43906,oxxiox,,19,9,1,10
43907,blueeit,,20,2,2,4
43908,poopdeck,,19,85,83,168
43909,gparadee,,0,13,4,17
43910,kprashan,,3,1,3,4
43911,cudada,,32,3,2,5
43912,SongQuoter,,14,2,6,8
43913,plasticbacon,,19,154,172,326
43914,LyddyPark,,39,4,4,8
43915,ninzee,,43,1404,108,1512
43916,LAPHOQUE,,3,1,1,2
43917,wylde21,,30,26,34,60
43918,ElXGaspeth,,1,3,5,8
43919,CharlesAndrew,,12,1,2,3
43920,madisonman,,1,22,45,67
43921,silver_lining_man,,0,36,70,106
43922,akosokof,,42,14,20,34
43923,DeepSigh,,18,6,1,7
43924,he-who-inquires,,20,15,2,17
43925,jonbuchan,,8,116,17,133
43926,Wriiight,,29,33,66,99
43927,saurabhsawant,,20,12,18,30
43928,rtfx,,20,12,10,22
43929,passwordisconfession,,1,13,2,15
43930,jdeluise,,20,2,2,4
43931,palpatine66,,19,7,7,14
43932,dangerz,,42,110,100,210
43933,spitfire451,,34,8,17,25
43934,johnpseudo,,13,9,4,13
43935,WTFalreadytaken,,1,29,42,71
43936,milkman99,,22,1,1,2
43937,Disposable99,,31,3,2,5
43938,liability11,,5,1,2,3
43939,zoidbergisgod,,42,18,18,36
43940,xolox,,20,26,27,53
43941,arctic_ninja,,18,2,9,11
43942,rbatra,,20,11,4,15
43943,wonderfibre,,22,4,5,9
43944,Captain_Sarcasm,,20,1,1,2
43945,thejaysun,,42,56,66,122
43946,Ell3,,4,2,1,3
43947,xarah,,1,13,14,27
43948,pinkyabuse,,15,97,110,207
43949,theducks,,13,3,7,10
43950,blissfisherman,,36,6,13,19
43951,lazycat,,43,266,5,271
43952,azola7,,22,5,10,15
43953,pixelglow,,20,16,21,37
43954,quantumstate,,20,5,4,9
43955,goishin,,1,12,12,24
43956,quixo,,42,61,17,78
43957,subversemon,,19,8,26,34
43958,Sharpe_27,,43,100,29,129
43959,tchhailo,,1,10,1,11
43960,bigstevec,,1,304,223,527
43961,braindancer,,19,15,23,38
43962,doughoyte,,20,3,2,5
43963,kamander,,13,1,1,2
43964,halfmexi,,13,5,1,6
43965,Zyzzbaluba,,13,1,3,4
43966,Lungs,,4,18,25,43
43967,sarcascio,,29,14,26,40
43968,TwoBirds,,18,36,1,37
43969,monocle612,,26,1,1,2
43970,bigsim,,22,1,1,2
43971,BRCampbell,,0,32,46,78
43972,bloggerp,,18,29,1,30
43973,rkern,,20,2,3,5
43974,iragaines,,18,3,9,12
43975,johnny2bad,,4,1,2,3
43976,aupeters,,13,25,48,73
43977,wmc,,19,20,28,48
43978,garrettj,,1,15,15,30
43979,mitzman,,19,3,6,9
43980,literal,,20,1,3,4
43981,chickelnoodensoup,,41,1,1,2
43982,ball122506,,10,2,1,3
43983,junius,,18,6,8,14
43984,aquateen,,43,7,4,11
43985,kgbdrop,,29,4,7,11
43986,yellowbugs,,8,1,1,2
43987,qsvans,,20,2,6,8
43988,kommissar,,20,14,14,28
43989,mrpatriotic,,33,1,1,2
43990,0x68,,12,1,3,4
43991,jaxspider,,1,288,633,921
43992,barc0001,,31,267,300,567
43993,pasesak22,,13,1,2,3
43994,danweber,,19,1086,757,1843
43995,Rozencrantz,,18,1,8,9
43996,moodle7,,13,1,1,2
43997,altenergy,,1,8,7,15
43998,genericgeek,,13,13,18,31
43999,talentlessclown,,38,1,2,3
44000,cindymaywho,,19,2,2,4
44001,rotel967,,30,2,1,3
44002,shaggy25,,32,6,8,14
44003,jeffp12,,13,54,23,77
44004,friezes,,27,2,1,3
44005,hitsman,,43,989,246,1235
44006,permaculture,,34,798,1443,2241
44007,vutkolh,,29,1,1,2
44008,billyvnilly,,18,2,7,9
44009,Scotiva,,32,11,25,36
44010,ladytrompetista,,1,65,87,152
44011,canadianguy,,31,88,132,220
44012,Grand_Nagus_Zek,,6,10,17,27
44013,needtologinnowand,,13,10,30,40
44014,lamagna,,20,10,1,11
44015,surfwax95,,22,235,259,494
44016,joshrice,,18,9,14,23
44017,seksignome,,1,21,35,56
44018,bleah325,,34,1,2,3
44019,sweetpea2008,,36,1,1,2
44020,uggedal,,20,373,94,467
44021,toddtomlinson,,13,1,6,7
44022,liquidwax,,1,1,1,2
44023,coglethorpe,,19,113,20,133
44024,noodleIncident,,34,2,2,4
44025,meron5,,32,7,4,11
44026,0utput,,4,1,1,2
44027,Lhyzz,,31,4,1,5
44028,poltergeis,,32,11,9,20
44029,caution2thewind,,19,10,11,21
44030,Engramft,,3,1,2,3
44031,niilantey,,43,1,1,2
44032,snowgirl144,,8,1,1,2
44033,cleancut2,,39,6,2,8
44034,tedf23982,,13,59,87,146
44035,Lady_Liberty,,19,10,13,23
44036,fhsm,,42,2,2,4
44037,munkypepper10,,1,1,1,2
44038,RonPaulTouchedMe,,19,545,267,812
44039,calvinbroadus,,18,1,5,6
44040,batosai,,31,4,1,5
44041,cjeris,,20,3,5,8
44042,littlegarth,,34,4,5,9
44043,bugg,,18,1218,39,1257
44044,devilinthedetails,,2,2,1,3
44045,aphoenix,,18,21,23,44
44046,void2487,,19,2,4,6
44047,gx5ilver,,13,59,90,149
44048,Rudzz34,,3,1,3,4
44049,j4mm3d,,32,24,23,47
44050,bulldog20,,19,12,8,20
44051,manixrock,,32,106,139,245
44052,M2K360,,5,1,1,2
44053,moonzilla,,39,895,1311,2206
44054,cberman,,34,307,465,772
44055,harryb6,,4,59,28,87
44056,Sillern,,20,3,5,8
44057,phase,,34,5,7,12
44058,yabcok,,18,9,3,12
44059,SirNiceFellow,,31,4,5,9
44060,erg,,20,23,25,48
44061,trevc2,,43,1,2,3
44062,ArthurCravan,,19,11,20,31
44063,x4096,,19,2,3,5
44064,relient05,,32,3,3,6
44065,rethin,,5,7,7,14
44066,pdovy,,20,5,6,11
44067,starshippooper,,10,1,1,2
44068,amvickers,,32,4,7,11
44069,SodiumKPump,,43,896,1100,1996
44070,Designthing,,13,4,21,25
44071,whaknrd,,40,12,2,14
44072,docholiday,,19,274,291,565
44073,filter88,,13,1,1,2
44074,haxxormaster,,18,83,130,213
44075,maarack,,32,1,1,2
44076,QueenBeeCassi,,1,91,27,118
44077,mikemcg,,22,17,26,43
44078,skittles15,,13,126,19,145
44079,neon,,22,46,49,95
44080,tested911,,19,1,1,2
44081,cmemove,,13,4,1,5
44082,jsn,,20,13,12,25
44083,cwbruce1,,5,9,9,18
44084,undescendedtentacles,,31,3,6,9
44085,the3rdsam,,20,14,9,23
44086,LousyTourist,,20,11,20,31
44087,alexchambana,,10,171,106,277
44088,kraftmatic,,31,245,236,481
44089,rav3nous,,13,1,5,6
44090,removeya,,19,15,24,39
44091,keedt,,20,2,5,7
44092,eatbacon,,18,41,11,52
44093,NecromancyBlack,,13,1,1,2
44094,matt_damon,,0,1,3,4
44095,asdf512tx,,8,1,2,3
44096,hotgrl23,,22,33,62,95
44097,Shabaz,,13,1,2,3
44098,unreasonablefaith,,32,406,43,449
44099,pazna,,42,36,40,76
44100,alapoet,,13,68,3,71
44101,kindall,,12,389,627,1016
44102,danieldrehmer,,32,5,25,30
44103,joe73,,27,1,2,3
44104,sabetts,,29,290,424,714
44105,cipherprime,,31,240,429,669
44106,panic,,20,271,243,514
44107,demarz,,29,21,36,57
44108,rajulkabir,,29,4,7,11
44109,fizzatbeyond,,20,14,4,18
44110,chs,,43,3,11,14
44111,EarBucket,,13,42,80,122
44112,quobobo,,19,67,88,155
44113,greenpower,,8,1,1,2
44114,PopeBenedictXVI,,6,3,1,4
44115,samth0,,20,8,9,17
44116,Impu12,,13,3,5,8
44117,tmiltznc,,0,268,11,279
44118,evilbob,,13,7,5,12
44119,JaredR,,20,1,3,4
44120,painted82,,29,64,65,129
44121,darkrayne,,39,19,42,61
44122,1page,,18,1,2,3
44123,GeekAlerts,,5,1,3,4
44124,carlosz,,13,21,2,23
44125,satanloveskale,,13,16,6,22
44126,greymatter42,,8,1,2,3
44127,mossmaal,,1,11,9,20
44128,oasihdg,,20,1,1,2
44129,CaptainExcess,,8,1,2,3
44130,jlmcfarl,,20,1,1,2
44131,blisk,,0,156,263,419
44132,Elleanee,,19,32,31,63
44133,katalysis,,22,44,22,66
44134,thecouch,,43,21,46,67
44135,morituri,,19,39,81,120
44136,evox777,,0,32,42,74
44137,weekendwarrior,,5,6,15,21
44138,crepitus,,18,21,40,61
44139,mistikofor,,0,1,1,2
44140,seanm74,,20,3,8,11
44141,jerryparid,,29,8,7,15
44142,bowl_haircut,,1,13,49,62
44143,mypasswordisstupid,,1,17,21,38
44144,darkstar999,,6,226,62,288
44145,jerechos,,13,171,105,276
44146,Subhoney,,18,2,6,8
44147,rhumber,,32,78,42,120
44148,billehunt,,32,5,1,6
44149,EmperialK,,5,2,14,16
44150,oughgh,,42,2,4,6
44151,macdude,,1,42,32,74
44152,Lurking_Grue,,32,375,568,943
44153,xk0der,,20,1,2,3
44154,nikec,,12,107,3,110
44155,syspig,,28,16,21,37
44156,dools,,1,5,3,8
44157,dongerty,,0,25,10,35
44158,aliubin2,,22,1,3,4
44159,Orchestral,,18,7,17,24
44160,rej1587,,34,12,6,18
44161,wolfshirt,,18,388,111,499
44162,LAngeDuFoyeur,,1,7,10,17
44163,gjones,,20,21,2,23
44164,likk23,,18,1,3,4
44165,duhduh,,20,2,2,4
44166,donniex7,,36,7,10,17
44167,DarkyHelmety,,1,191,215,406
44168,dustball23,,32,1,2,3
44169,kingofbigmac,,18,30,4,34
44170,sintaxi,,22,29,25,54
44171,aliasone,,30,6,8,14
44172,Trentw,,15,1,1,2
44173,nopointinnames,,35,7,5,12
44174,dipshizzle,,31,11,6,17
44175,Odersky,,20,2,4,6
44176,complexmath,,20,6,11,17
44177,goldmonkey007,,13,7,6,13
44178,Chaubunagungamaugg,,43,108,98,206
44179,lowrads,,29,288,647,935
44180,thedzigner,,5,1,2,3
44181,Percept,,43,146,239,385
44182,SlimFastForYou,,4,237,388,625
44183,DocCottle,,1,21,41,62
44184,supercanuck,,6,145,136,281
44185,citizenkahn,,0,2,12,14
44186,CloseTheCode,,19,2,4,6
44187,wounded625,,0,11,19,30
44188,spudickle,,0,8,5,13
44189,bh_tokyo,,18,32,50,82
44190,x0melissa0x,,43,2,4,6
44191,____________,,13,1,1,2
44192,eliminator,,20,12,7,19
44193,derpderpderp,,36,1,1,2
44194,DownmodMeNazis,,19,2,2,4
44195,phishtree,,22,53,56,109
44196,kturtle11,,0,5,24,29
44197,wilsonx81,,43,67,104,171
44198,Otter,,9,4,2,6
44199,Adagio,,32,14,9,23
44200,imnotarobot,,0,17,21,38
44201,qwerty,,0,5,7,12
44202,stinky613,,20,4,10,14
44203,jjc4good,,19,1,1,2
44204,elfofdoriath9,,34,101,96,197
44205,sammyson242,,13,5,13,18
44206,XzistenZ,,22,1,6,7
44207,awh,,3,1,1,2
44208,jmcdannel,,20,1,1,2
44209,giffen,,18,5,2,7
44210,gamecock,,13,75,91,166
44211,limer,,13,2,1,3
44212,damunzy,,18,92,149,241
44213,gngstrMNKY,,5,32,20,52
44214,santino333,,43,1,1,2
44215,20081227,,36,1,1,2
44216,blm03,,5,12,4,16
44217,emosorines,,1,550,479,1029
44218,puraceta,,19,80,59,139
44219,artvandeleigh,,18,4,6,10
44220,lisainla,,34,2,2,4
44221,superterran,,31,3,2,5
44222,cmoockery,,31,1,1,2
44223,daco,,20,3,5,8
44224,skankedout,,1,105,260,365
44225,throw_away_account,,20,3,5,8
44226,miketheburrito,,31,10,10,20
44227,zeabeth,,32,15,9,24
44228,mac71,,31,54,43,97
44229,sbmon,,13,1,1,2
44230,isarl,,18,21,33,54
44231,OMGbatman,,30,58,52,110
44232,jinic,,13,10,6,16
44233,badgrammar,,18,7,11,18
44234,cycles,,20,69,112,181
44235,lynxia,,14,1,1,2
44236,RadicalBender,,22,7,2,9
44237,Barbie_Thomas,,13,3,1,4
44238,mackstann,,20,394,266,660
44239,sh_hs,,43,3,13,16
44240,mf4633,,34,430,199,629
44241,dlb-nick,,29,2,1,3
44242,xorandor,,12,216,65,281
44243,ericpp,,26,1,2,3
44244,etoipi,,20,33,22,55
44245,jigglebilly,,13,8,31,39
44246,brianfair,,18,547,54,601
44247,KenDowns,,20,4,9,13
44248,Amargosa,,19,2,13,15
44249,habbadash,,0,850,894,1744
44250,YYYY,,13,18,43,61
44251,demontoy,,6,5,9,14
44252,lish,,13,3,5,8
44253,rhcp330,,1,11,9,20
44254,yermom,,10,64,58,122
44255,PhilxBefore,,18,27,27,54
44256,brownie4590,,11,1,1,2
44257,xunil,,14,1,1,2
44258,Foreverbrainless,,18,2,2,4
44259,markashworth,,22,1,1,2
44260,DIGG_IS_FOX,,34,259,232,491
44261,janrito,,13,9,10,19
44262,Vzzbxx,,36,63,103,166
44263,ChrisWalsh,,43,9,15,24
44264,shenanigoat,,18,80,19,99
44265,Goose42,,22,8,2,10
44266,McCallister,,32,2,4,6
44267,bobweber,,22,2,3,5
44268,COindependent,,13,8,1,9
44269,lazyboy401,,30,1,1,2
44270,Oncey,,0,17,22,39
44271,qwentch,,18,5,1,6
44272,StarJonz,,1,1,2,3
44273,kara_zor-el,,32,3,5,8
44274,forkon,,32,1,1,2
44275,suspectdevice,,31,11,14,25
44276,woozefa,,13,2,15,17
44277,inn0,,20,8,29,37
44278,absolut696,,10,196,201,397
44279,junglelady,,34,8,15,23
44280,justsomeguy123,,19,1,1,2
44281,jharper,,0,17,10,27
44282,Hinph,,13,18,15,33
44283,mothereffingtheresa,,31,542,957,1499
44284,britesprite,,34,26,9,35
44285,cameronobscura,,41,1,4,5
44286,tomfoolery9,,13,1,1,2
44287,swift4096,,18,47,7,54
44288,pi_star,,26,7,6,13
44289,L4m3r,,19,5,3,8
44290,fyl8000,,16,2,4,6
44291,ageedoy,,22,4,9,13
44292,alexanderadp,,32,3,2,5
44293,ehwhat,,1,20,30,50
44294,Kilgore44,,29,19,6,25
44295,toothygrim,,5,2,1,3
44296,laurao16,,13,18,4,22
44297,redsteakraw,,10,1,3,4
44298,eirikso,,8,5,1,6
44299,SirCyrus,,31,20,9,29
44300,revelationary,,18,3,1,4
44301,metamorph,,22,3,4,7
44302,PendragnNERO,,31,1,3,4
44303,arturoman,,20,45,52,97
44304,dutchmcnubb1,,36,1,4,5
44305,WhinerMcWhiney,,1,1,1,2
44306,dorel,,20,98,203,301
44307,motravo,,19,69,44,113
44308,mre5765,,19,214,329,543
44309,Milton123,,19,3,13,16
44310,redditsuxx,,43,174,118,292
44311,ff4marvel,,22,21,24,45
44312,gavdoy,,36,2,1,3
44313,syntagma,,1,1,2,3
44314,Sneetches,,10,7,11,18
44315,ZoeStephenson,,20,1,1,2
44316,bobthevirus,,42,5,1,6
44317,gartca,,13,1,1,2
44318,wertyuidjj,,18,4,16,20
44319,dammage,,20,36,32,68
44320,westcoaster,,30,57,48,105
44321,rizzn,,8,2,4,6
44322,iconjack,,20,17,9,26
44323,peterhgregory,,34,43,1,44
44324,blueboy77,,1,2,2,4
44325,kyyla,,18,58,36,94
44326,lilymac76,,5,6,5,11
44327,dpetillo,,43,3,6,9
44328,repoman,,1,143,256,399
44329,WalterBright,,20,147,121,268
44330,LedFire,,29,1,3,4
44331,DougTGN,,5,23,41,64
44332,synthpop,,19,1168,852,2020
44333,BoxerBurn,,5,10,32,42
44334,jackduluoz,,13,4,2,6
44335,redditer009,,19,2,3,5
44336,beastrabban,,18,477,848,1325
44337,Cartosys,,8,20,15,35
44338,nnydarko,,43,46,79,125
44339,crickets,,4,66,72,138
44340,darkner,,35,1,1,2
44341,komodo,,18,118,35,153
44342,atlben76,,20,3,6,9
44343,sockdoll,,1,89,199,288
44344,RobertIsbell,,43,1,8,9
44345,bwilkes,,31,1,2,3
44346,ThePain,,32,43,40,83
44347,VitaliyBSD,,8,3,1,4
44348,hairstyled678,,0,1,1,2
44349,noletrain,,18,206,12,218
44350,ncbaz,,19,4,1,5
44351,ddelony1,,19,1,3,4
44352,empraptor,,27,23,45,68
44353,31d1,,20,16,13,29
44354,herbber,,18,15,21,36
44355,Red-Sox,,19,2,9,11
44356,chick1,,13,60,6,66
44357,jojoman02,,18,1,1,2
44358,Stevew123,,5,27,5,32
44359,mharriger,,43,87,44,131
44360,RedDyeNumber4,,41,1097,1259,2356
44361,charlieee,,40,7,3,10
44362,Ponches,,19,11,15,26
44363,enkid,,31,151,216,367
44364,cha0s,,20,23,38,61
44365,ctscradle08,,1,5,9,14
44366,fsagus,,43,1,4,5
44367,thebigshuck1,,13,2,2,4
44368,cameldrv,,20,15,10,25
44369,ptan1,,13,222,38,260
44370,john1973,,20,2,4,6
44371,kwaalude,,13,4,6,10
44372,fritz2,,1,3,3,6
44373,Ribonucleic,,19,44,11,55
44374,BritishLogicPolice,,18,2,1,3
44375,nix0n,,1,82,82,164
44376,Haspel,,13,2,2,4
44377,knde,,43,51,50,101
44378,imexius,,1,43,40,83
44379,danny,,19,52,79,131
44380,Burdette4,,0,14,3,17
44381,pubjames,,31,450,269,719
44382,ahare,,20,2,2,4
44383,clrwpi,,13,19,26,45
44384,uknownothing,,19,2,6,8
44385,Snork_Porkin,,13,4,4,8
44386,maelfyn,,12,197,130,327
44387,timtastic,,19,3,3,6
44388,djrocksteady,,43,64,137,201
44389,shopperchops,,34,10,20,30
44390,kakerjak,,6,4,5,9
44391,danthefourth,,17,2,2,4
44392,tehmarko,,1,5,9,14
44393,jdwpom,,1,69,125,194
44394,Irwin_Fletcher,,22,3,2,5
44395,oomlout,,19,5,2,7
44396,davebrk,,20,3,9,12
44397,rcadestaint,,13,21,47,68
44398,grandalf,,19,78,100,178
44399,no-lard,,34,13,28,41
44400,aflawinlogic,,32,4,7,11
44401,amix3k,,20,1,1,2
44402,drsubtle,,6,18,32,50
44403,Mordalfus,,32,15,8,23
44404,grime,,40,1,2,3
44405,mrwall2005,,18,1,2,3
44406,FizzBitch,,18,175,212,387
44407,sudjnabjj,,13,57,6,63
44408,prunch,,23,3,1,4
44409,Schaefer33,,10,2,2,4
44410,bk1insf,,19,25,18,43
44411,jarober61,,20,1,1,2
44412,solo_froglet,,33,2,1,3
44413,dannydale,,18,20,102,122
44414,rmc,,20,21,30,51
44415,whozurdaddy,,31,176,201,377
44416,gavalope,,19,2,5,7
44417,beeswax,,8,3,2,5
44418,WittyUsername,,19,14,32,46
44419,jvargaszabo,,17,1,11,12
44420,elmorte,,18,38,58,96
44421,KrazyA1pha,,43,39,54,93
44422,mossblaser,,20,95,182,277
44423,onceonly,,19,3,1,4
44424,00Dan,,18,7,7,14
44425,neop,,20,3,5,8
44426,inimino,,20,1,2,3
44427,corillis,,4,2,6,8
44428,wildsalmon,,18,22,9,31
44429,clarkin2,,22,21,8,29
44430,yaemes,,43,16,23,39
44431,scubaguybill,,34,10,18,28
44432,niveknhoj,,15,10,9,19
44433,philonius,,12,1,2,3
44434,arabesque911,,19,8,4,12
44435,cowgirljess,,43,5,10,15
44436,authorityaction,,42,2,1,3
44437,thing01,,32,10,9,19
44438,johnybutts,,5,1,1,2
44439,Charming_Boy,,43,1,1,2
44440,stoic,,0,10,20,30
44441,stphnclysmth,,12,80,140,220
44442,surlier,,32,3,2,5
44443,jassie,,19,49,3,52
44444,private_dumbass,,22,1,1,2
44445,BaconatedGrapefruit,,18,12,9,21
44446,smeltzertron,,32,1,1,2
44447,e8ght,,19,1,1,2
44448,ElReek,,34,2,1,3
44449,kushman,,18,23,25,48
44450,YourHero,,34,1,1,2
44451,bankonmyth,,18,6,8,14
44452,inmate8188,,19,3,4,7
44453,adewhite,,30,5,5,10
44454,Zibeltor,,6,4,4,8
44455,fouadz,,20,15,11,26
44456,alen_ribic,,20,29,8,37
44457,jokull,,20,42,40,82
44458,hoov,,43,15,19,34
44459,cl52059,,18,156,14,170
44460,mp3geek,,20,10,16,26
44461,toxicvarn90,,1,295,274,569
44462,incaseyoucare,,19,43,44,87
44463,your_father_speaking,,19,2,2,4
44464,leedaflea,,1,2,1,3
44465,cedaf,,18,7,6,13
44466,yiannis13,,23,3,1,4
44467,TortoiseT,,19,13,23,36
44468,Botim2,,13,4,37,41
44469,iusedqu1nn,,19,193,1,194
44470,ayton,,31,2,6,8
44471,danita,,20,1,8,9
44472,menrightsrights,,18,3,1,4
44473,pranavnegandhi,,22,6,5,11
44474,yoki_au,,0,134,161,295
44475,MissCoccins,,18,52,16,68
44476,pzskc383,,12,1,1,2
44477,Elsie_Sie,,34,1,2,3
44478,uninformed_reddit,,19,1,1,2
44479,ian_reddit,,43,1,3,4
44480,officerfarva,,0,5,10,15
44481,beh_aiin,,31,53,20,73
44482,happyhappyhappy,,20,68,11,79
44483,cloondog,,19,53,62,115
44484,foothompson,,20,1,2,3
44485,Oubaassehonne,,43,119,203,322
44486,sm84581,,20,6,8,14
44487,gordo_l,,19,1,4,5
44488,model_citizen,,4,6,10,16
44489,mrtrevin,,18,229,415,644
44490,tiktaalink,,7,7,20,27
44491,chia_pet,,18,6,13,19
44492,ohmytyisis,,34,10,4,14
44493,DarkEyedGirl,,34,2,1,3
44494,sarevok9,,18,159,152,311
44495,SevRogers,,1,3,12,15
44496,cheics,,0,1,5,6
44497,Kellster,,0,14,7,21
44498,lou,,12,71,103,174
44499,EhScuzi,,43,5,7,12
44500,gvol,,20,3,8,11
44501,Drevor,,20,187,135,322
44502,chz,,0,69,73,142
44503,magnus,,20,3,15,18
44504,namelessone,,42,1,1,2
44505,theundersigned,,19,63,87,150
44506,ohyeaaah,,29,2,2,4
44507,IncurvatusInSe,,1,1,1,2
44508,cometoloveseeing,,13,21,22,43
44509,iLens,,43,6,15,21
44510,NightChips,,4,4,4,8
44511,donbueno,,18,326,415,741
44512,ICOrthogonal,,32,34,26,60
44513,psilokan,,22,61,115,176
44514,garg,,22,1081,954,2035
44515,yamshi,,31,61,126,187
44516,SteveBloke,,3,1,1,2
44517,neportocala,,5,13,3,16
44518,Crafts,,13,29,43,72
44519,tactics,,20,306,463,769
44520,onesun43,,20,14,4,18
44521,nickburlett,,43,50,18,68
44522,batgirl007,,22,31,1,32
44523,ripsta,,19,198,240,438
44524,kaosfere,,3,161,129,290
44525,neoprenewidget,,19,16,32,48
44526,cpepinc,,21,1,6,7
44527,stopit,,29,185,171,356
44528,skeptilingus,,26,5,4,9
44529,GunTech,,32,5,2,7
44530,kolektiv,,20,10,17,27
44531,mabbikeel,,20,1,3,4
44532,HawkHawkGoose,,13,1,1,2
44533,mushpuppy,,19,138,264,402
44534,omglazers,,19,152,255,407
44535,okidokedork,,11,42,42,84
44536,pindooca,,18,1,3,4
44537,voodoobru,,13,1,1,2
44538,jacodt,,13,5,1,6
44539,QuinnFazigu,,19,222,363,585
44540,Tallon,,22,99,90,189
44541,TGMais,,6,156,239,395
44542,christpunchers,,34,142,111,253
44543,superman101,,31,1,3,4
44544,lol-dongs,,20,180,155,335
44545,uteunawaytay,,16,1580,2721,4301
44546,k-h,,31,11,18,29
44547,esquimaux73,,13,3,4,7
44548,rossto,,18,74,88,162
44549,stelly,,42,1,1,2
44550,tyham,,1,16,24,40
44551,austin356,,13,46,2,48
44552,tjangaard,,18,13,1,14
44553,zagaberoo,,18,4,19,23
44554,TehOompa,,43,8,8,16
44555,SamIyam,,32,42,30,72
44556,eckle,,19,1,1,2
44557,zingbat,,4,1,3,4
44558,fonik,,32,12,26,38
44559,avatar382,,18,1,1,2
44560,konkeydong,,1,105,172,277
44561,storyuk,,0,10,6,16
44562,zwaldowski,,22,215,325,540
44563,canadug,,1,134,117,251
44564,SvendOlaf,,1,1,1,2
44565,SpaceInvadingMonkeys,,13,43,62,105
44566,SeeZee,,20,3,2,5
44567,jonny_boy27,,42,2,1,3
44568,fjsdakfl,,13,6,11,17
44569,darkbeanie,,13,34,59,93
44570,paintist,,19,114,159,273
44571,redobsess,,16,3,4,7
44572,arachnd,,20,15,23,38
44573,ReligionOfPeace,,0,310,977,1287
44574,Aeropike2011,,34,1,1,2
44575,faderus,,31,108,77,185
44576,gabrielsburg,,29,6,6,12
44577,Moelman,,18,4,1,5
44578,shocs,,5,99,16,115
44579,milos31,,18,223,3,226
44580,podbaydoor,,31,1,1,2
44581,peanut42,,43,34,33,67
44582,Cazaquistao,,5,1,1,2
44583,chuyeow,,20,3,2,5
44584,z0manifest,,41,2,11,13
44585,Faceface,,18,7,15,22
44586,OrMaybe,,36,3,4,7
44587,robato,,19,4,5,9
44588,Radoman,,19,523,344,867
44589,chrizel,,20,33,21,54
44590,threethousandgt,,13,6,11,17
44591,lizzydoodle,,32,11,19,30
44592,hillary2014,,43,1,1,2
44593,MoreInStore,,5,42,47,89
44594,Sarahelca,,32,2,1,3
44595,stickboy144,,22,4,9,13
44596,eldumbasso,,21,2,3,5
44597,bigfoot17,,31,2,4,6
44598,telemkor,,0,35,7,42
44599,Pamphleteer,,0,94,102,196
44600,jayhawk03,,39,4,3,7
44601,Dug565,,11,1,1,2
44602,jmoore63,,0,36,1,37
44603,Pipliest,,7,4,6,10
44604,landryraccoon,,19,7,11,18
44605,scaredofbears,,1,46,72,118
44606,scioglilingua,,13,1,2,3
44607,smug_faced_crowd,,6,10,14,24
44608,abalashov,,11,1,1,2
44609,artimaeis,,22,19,28,47
44610,texaspaid,,19,29,49,78
44611,hep516,,36,1,3,4
44612,taraist,,32,28,41,69
44613,sporrow,,0,106,76,182
44614,audiored,,19,53,95,148
44615,smellotron,,20,28,54,82
44616,craigiest,,43,28,18,46
44617,indieandy,,18,31,41,72
44618,markastafford,,13,1,2,3
44619,valardur,,42,11,25,36
44620,HugeRedBear,,19,7,6,13
44621,ijostl,,34,3,4,7
44622,runtheplacered,,3,7,7,14
44623,bumbledraven,,43,2,3,5
44624,shane111,,20,2,1,3
44625,crazyape123,,31,2,2,4
44626,boblol123,,20,61,44,105
44627,bopolissimus,,22,1,3,4
44628,misterstormcrow,,8,145,203,348
44629,lineer,,18,6,2,8
44630,subredditor,,19,143,156,299
44631,ApathyVsRadicalism,,30,1,3,4
44632,ventomareiro,,12,19,23,42
44633,duyn,,29,15,11,26
44634,alanVolta,,13,1,2,3
44635,littlegreenwheels,,0,2,2,4
44636,loveandlight,,34,132,232,364
44637,TheColonel,,1,1220,1487,2707
44638,Ivatar,,20,2,3,5
44639,roberto1,,1,2,6,8
44640,jespeach,,8,8,14,22
44641,serenader,,31,4,10,14
44642,llnk,,18,15,24,39
44643,BigBladder,,13,1,1,2
44644,McSly,,19,27,34,61
44645,vandahm,,20,9,11,20
44646,jrhuggins,,20,22,33,55
44647,easymovet,,5,9,12,21
44648,danbiking,,13,13,7,20
44649,railk,,20,4,5,9
44650,fucking_god,,0,1,1,2
44651,seliopou,,43,46,25,71
44652,zenphp,,13,5,6,11
44653,Claymore_ws,,20,18,13,31
44654,jossmyth,,20,12,1,13
44655,monk_e_boy,,20,50,60,110
44656,mkr,,13,5,5,10
44657,jbcrail,,9,16,1,17
44658,markovich04,,19,1,3,4
44659,Junior77,,18,123,33,156
44660,LaffyTaffyWrapper,,20,1,2,3
44661,monsda,,19,283,330,613
44662,Gordon_Shumway,,19,72,98,170
44663,scorched03,,13,1,3,4
44664,emkay,,19,66,7,73
44665,marhathoda,,19,100,142,242
44666,Macoo,,0,1,2,3
44667,jkhatter12,,18,3,2,5
44668,sundog1973,,0,10,8,18
44669,reesmaxwell,,36,2,1,3
44670,The_Rectifier,,34,15,35,50
44671,Lizaarrd,,31,2,2,4
44672,yogy,,41,2,3,5
44673,2Tech,,18,8,6,14
44674,JordanOnSports,,18,2,1,3
44675,sumerit,,18,28,71,99
44676,ahmara,,31,17,1,18
44677,blufox,,20,4,9,13
44678,DeathToTheSystem,,22,1,2,3
44679,vanderhuge,,20,19,14,33
44680,jack_alexander,,13,1610,709,2319
44681,mama-mia,,22,2,1,3
44682,shopvavavoom,,18,16,11,27
44683,redditex,,0,5,4,9
44684,Roach55,,13,131,192,323
44685,LessThan3,,22,29,47,76
44686,morefioo,,13,24,1,25
44687,skerlo,,20,1,1,2
44688,phillstac3,,22,297,350,647
44689,greenearthbuild,,13,1,2,3
44690,TJ11240,,1,82,28,110
44691,pkrumins,,20,1381,433,1814
44692,RogueCoder,,34,34,69,103
44693,toaster_fun,,32,166,107,273
44694,tony1kenobi,,20,2,5,7
44695,aschapm,,18,86,111,197
44696,irishjayhawk,,30,9,7,16
44697,ALLGLORYTOHYPNOTOAD,,22,1,1,2
44698,toodor,,1,1,1,2
44699,tora,,20,3,1,4
44700,tflash2612,,13,2,1,3
44701,aeneas07,,18,7,4,11
44702,bemo56,,18,27,66,93
44703,spider_monkey,,34,2,6,8
44704,tlhorset,,43,3,1,4
44705,BroDavii,,18,224,341,565
44706,Amendmen7,,19,140,198,338
44707,born4thesurf,,18,77,29,106
44708,nicholaihel,,40,3,1,4
44709,hibyefriend,,0,4,8,12
44710,basil_seal,,15,13,37,50
44711,assortednut,,19,21,43,64
44712,sharpsight2,,34,255,422,677
44713,devperson,,18,7,26,33
44714,notarebel,,22,30,20,50
44715,militant,,19,357,462,819
44716,SocialSandwich,,18,19,14,33
44717,rhesus48,,28,2,4,6
44718,bob401,,5,4,5,9
44719,wuger,,20,4,6,10
44720,HumanSockPuppet,,40,286,384,670
44721,mezziah,,18,14,38,52
44722,masterstephen,,42,1,1,2
44723,sooner_bluff,,14,2,2,4
44724,highstead,,30,94,132,226
44725,volomike,,20,59,87,146
44726,godwheel,,0,9,1,10
44727,red40,,4,1,1,2
44728,1Marc,,20,2,1,3
44729,elegylegacy,,32,28,33,61
44730,hrung,,31,60,64,124
44731,i_am_insane,,19,12,21,33
44732,sagewah,,1,2,6,8
44733,garethkeenan,,43,105,141,246
44734,scaryberry,,20,3,1,4
44735,puck342,,6,1,2,3
44736,whatevs,,31,1,1,2
44737,pej,,34,1,3,4
44738,Just_Jonny,,29,1,1,2
44739,joel_osteen,,0,7,11,18
44740,__wxc__,,1,1,1,2
44741,wasdwasd,,22,2,5,7
44742,alexdelattre,,12,1,1,2
44743,ForgToor,,0,1,1,2
44744,JohnJYates,,0,1,1,2
44745,dynebolik,,14,1,1,2
44746,garyr_h,,23,707,826,1533
44747,fade911,,0,4,10,14
44748,fleece,,0,60,102,162
44749,sassthis,,19,2,4,6
44750,RonningPaul,,32,21,7,28
44751,fuzzythinker,,20,1,1,2
44752,holygoat,,20,59,141,200
44753,Tack122,,12,287,446,733
44754,rishmish,,19,27,15,42
44755,xethus,,13,8,10,18
44756,Mephisto_,,4,2,4,6
44757,photobasement,,12,1,1,2
44758,superpop,,5,9,11,20
44759,JoePrey,,18,83,101,184
44760,wrongsideup,,18,4,13,17
44761,48522,,19,8,10,18
44762,bob301,,43,12,18,30
44763,teddywookie,,43,1,2,3
44764,Casey-Tech,,41,4,3,7
44765,concious,,0,1,2,3
44766,crellis,,18,2,5,7
44767,chr0nic21,,13,11,17,28
44768,rakeswell,,22,6,4,10
44769,brianhammond,,20,2,1,3
44770,imdead,,43,1,1,2
44771,tas783,,19,4,3,7
44772,what_in_tarnations,,10,2,1,3
44773,FireBred,,1,5,9,14
44774,sorrydaijin,,1,20,29,49
44775,aussiegolfer,,18,184,301,485
44776,eclipsegum,,5,7,9,16
44777,God8myhomework,,19,255,410,665
44778,ajwest,,43,201,114,315
44779,tncdavid,,41,1,1,2
44780,sybrandy,,20,2,5,7
44781,syoung,,19,23,28,51
44782,robbies531,,14,18,34,52
44783,Ewong,,1,38,16,54
44784,flug32,,32,20,18,38
44785,emorockstar,,13,6,5,11
44786,LEE4,,19,2,1,3
44787,kagey61,,20,2,9,11
44788,1995,,1,1,1,2
44789,kirilll7,,36,3,3,6
44790,tholex,,1,93,82,175
44791,DevTopics,,20,45,3,48
44792,shizitz,,41,5,3,8
44793,CommandPrompt,,19,14,27,41
44794,skynex66,,31,1,1,2
44795,savona,,19,3,3,6
44796,6StringSam,,19,6,1,7
44797,seanimal,,41,2,1,3
44798,bushwacker,,32,3,7,10
44799,waynepwr,,22,436,69,505
44800,greywolf31,,5,9,11,20
44801,dorotixel,,0,27,3,30
44802,poeblu,,18,6,11,17
44803,naska,,19,229,163,392
44804,degron,,22,12,18,30
44805,mynamewastaken,,41,1,4,5
44806,Splatterhouse,,0,63,105,168
44807,arronsky,,19,46,17,63
44808,revdroog,,19,30,43,73
44809,wildnaresh,,22,1,6,7
44810,pro547,,20,8,8,16
44811,aaminics,,13,7,16,23
44812,kismet,,31,49,39,88
44813,amafukwit,,19,14,48,62
44814,greediculous,,1,1,3,4
44815,hatchington,,0,108,138,246
44816,plup,,34,46,79,125
44817,michaelrush,,20,3,2,5
44818,Scrumb,,41,2,4,6
44819,abends,,18,9,26,35
44820,mugen612,,13,24,53,77
44821,BlueRenner,,0,54,57,111
44822,davidpack,,42,132,50,182
44823,skippygrrl,,13,30,7,37
44824,elpres,,43,42,2,44
44825,justatempaccount,,17,1,1,2
44826,Brock-O,,20,4,2,6
44827,Tony2Nice,,18,1,1,2
44828,allmybase,,20,9,7,16
44829,thirwell,,18,2,28,30
44830,SurpriseButtsex,,18,11,13,24
44831,swombat,,13,94,90,184
44832,soaringeagle,,19,16,13,29
44833,crackduck,,1,603,798,1401
44834,badbrains,,3,5,6,11
44835,pranksterturtle,,32,19,38,57
44836,brianatee,,14,4,1,5
44837,ethereel,,43,1,3,4
44838,lezardbreton,,34,2,2,4
44839,myotheredditaccount,,29,2,2,4
44840,titebuds,,13,3,8,11
44841,cansbunsandpins,,18,17,42,59
44842,eugeneloanguy,,5,1,2,3
44843,dipset,,18,2,1,3
44844,iKs279,,31,1,2,3
44845,e2mtt,,0,2,1,3
44846,kyki,,18,11,15,26
44847,ebow,,20,2,5,7
44848,bohogirl1,,1,34,83,117
44849,nedkelly136,,43,1,1,2
44850,democrat69,,13,1,1,2
44851,time4dancing80,,13,6,1,7
44852,winterflower,,1,1,1,2
44853,kkkjkjj,,34,7,14,21
44854,tow,,20,1,1,2
44855,Tchortle,,1,4,1,5
44856,cosmopolos,,19,19,6,25
44857,TarBurger,,5,3,6,9
44858,groomy,,12,10,1,11
44859,effigies,,32,87,148,235
44860,lispm,,20,142,196,338
44861,pandaeraser,,34,1,4,5
44862,DiamondGFX,,32,10,5,15
44863,pvrogue,,19,2,4,6
44864,bozena,,0,17,9,26
44865,kpw1179,,34,102,95,197
44866,nifs,,31,1,1,2
44867,mattius,,32,92,34,126
44868,I_Supply_Facts,,43,9,11,20
44869,Hussell,,21,1,4,5
44870,greydit,,19,5,9,14
44871,atrommer,,0,31,64,95
44872,arsefeckdrink,,18,2,3,5
44873,chuckieduckie,,1,2,7,9
44874,phisherben,,1,36,74,110
44875,essie,,3,31,92,123
44876,ObieJazz,,20,13,21,34
44877,roxya,,11,2,3,5
44878,amblin,,4,3,8,11
44879,duckandcover,,20,1,1,2
44880,apostre,,11,2,1,3
44881,RevHalofan,,19,39,48,87
44882,dailymoolah,,5,1,1,2
44883,BadFurDay,,26,59,63,122
44884,ristretto_dreams,,8,6,9,15
44885,Niek,,20,4,1,5
44886,groanad,,42,4,13,17
44887,Banko,,26,157,223,380
44888,icegrillz,,15,2,8,10
44889,SenorAnderson,,5,1,5,6
44890,wrttnwrd,,13,2,1,3
44891,moss,,20,8,13,21
44892,alcoholiday,,22,3,7,10
44893,justindrake,,7,2,3,5
44894,neutronium,,20,2,7,9
44895,rhedwolf,,0,32,46,78
44896,Klarkshroder,,31,2,1,3
44897,Prometheusx,,18,18,20,38
44898,Im-postle-able,,29,22,16,38
44899,UPMODDED,,6,3,4,7
44900,KurtP,,0,51,55,106
44901,bixby1,,18,264,40,304
44902,bjarte77,,20,24,9,33
44903,matefactor,,13,44,23,67
44904,andibabi,,4,37,74,111
44905,trader_dave,,18,1,1,2
44906,TheGambit,,1,132,14,146
44907,martinshiver,,13,1,1,2
44908,noseguy,,34,35,56,91
44909,goodness,,13,150,204,354
44910,peon1234,,18,18,46,64
44911,maxie7482,,19,11,8,19
44912,jgentgesdo,,13,1,2,3
44913,MotherNature,,8,2,2,4
44914,chimobayo,,19,36,72,108
44915,bobthejanitor,,40,6,3,9
44916,afallucco,,13,7,24,31
44917,libs0n,,31,17,22,39
44918,barrybe,,20,85,100,185
44919,ralfonso,,19,1,4,5
44920,kittyhawkstyle,,18,2,1,3
44921,ErikCartman,,32,10,15,25
44922,reddypasta,,0,132,206,338
44923,esnible,,13,5,8,13
44924,fdsfas13,,19,2,4,6
44925,andrewkhui,,31,2,5,7
44926,Ja1GuRuD3Va0m,,34,87,63,150
44927,Eever,,18,3,5,8
44928,zarrobot,,20,14,22,36
44929,Anotherbrick,,19,3,21,24
44930,lisperama,,20,1,1,2
44931,ipinkus,,20,4,8,12
44932,shimrit,,4,178,101,279
44933,AllenJB83,,20,9,16,25
44934,loefflerorama,,19,20,30,50
44935,jeltzz,,2,4,3,7
44936,EmbarassingStory,,1,1,1,2
44937,scobrown,,6,1,2,3
44938,snottynose,,20,2,3,5
44939,achille,,20,11,7,18
44940,ebswift,,12,2,1,3
44941,KaBlammoBoom,,42,24,5,29
44942,thoand,,7,2,4,6
44943,ctkrohn,,20,7,8,15
44944,RickRoll,,19,12,16,28
44945,AbbasJin,,34,31,31,62
44946,SearchRank,,5,10,4,14
44947,o0o,,20,173,398,571
44948,h4mrtime,,42,1,1,2
44949,e1eventh,,20,6,4,10
44950,psionicken,,31,13,11,24
44951,lalop,,8,190,229,419
44952,GuruOfReason,,2,5,2,7
44953,fredsanford,,20,4,3,7
44954,warp,,20,2,1,3
44955,fivestarsoul,,5,43,89,132
44956,nosocks,,13,14,27,41
44957,harveymushman,,1,8,9,17
44958,ordord00,,20,2,1,3
44959,mcao,,22,8,7,15
44960,allantanusa,,13,1,1,2
44961,petepete,,20,52,89,141
44962,itzhero,,29,12,5,17
44963,BovingdonBug,,18,21,54,75
44964,dur23,,0,64,128,192
44965,TehLockes,,1,8,15,23
44966,desultir,,18,28,14,42
44967,rmac54,,32,4,6,10
44968,Solitarian,,1,3,18,21
44969,MPankau,,42,2,3,5
44970,lynn,,1,507,854,1361
44971,garys,,41,5,1,6
44972,martey,,43,2,1,3
44973,yuhndke,,43,1,1,2
44974,bnmathm,,1,156,116,272
44975,hahahahahaha,,22,36,43,79
44976,apocalip,,20,3,2,5
44977,Entropy_,,19,6,7,13
44978,baraka-,,22,1,1,2
44979,sal139,,18,2,1,3
44980,afrojap,,18,4,13,17
44981,indigosin8,,4,269,338,607
44982,greedo,,19,12,21,33
44983,stevehussein,,18,1,1,2
44984,havig,,7,1,3,4
44985,J0nes,,11,1,4,5
44986,LeviNovey,,34,151,4,155
44987,AlLnAtuRalX,,1,242,140,382
44988,LETMESHOWU,,19,69,86,155
44989,doomrabbit,,1,16,30,46
44990,thatch,,43,350,37,387
44991,ChurchHatesTucker,,39,19,53,72
44992,chaschas,,35,5,1,6
44993,myhand,,20,3,3,6
44994,POTUS,,18,20,24,44
44995,chmod777,,18,23,51,74
44996,SuperSneaks,,38,7,10,17
44997,psogle,,5,1946,222,2168
44998,IronWolve,,19,294,441,735
44999,tomfaulhaber,,20,1,1,2
45000,Occulus,,3,1,1,2
45001,anttirt,,20,45,69,114
45002,Decados,,18,3,6,9
45003,aparrish1,,5,1,1,2
45004,disaster_area45,,18,61,64,125
45005,thebm,,13,46,45,91
45006,generic_user1,,1,4,23,27
45007,dr_landrew_5,,6,15,5,20
45008,steve1673,,13,1,1,2
45009,joe_ally,,31,10,21,31
45010,kingbenny,,43,33,64,97
45011,mooted,,13,6,10,16
45012,lowmagnet,,32,8,22,30
45013,sockpuppy,,19,25,16,41
45014,ktan12,,19,6,16,22
45015,PaulThomas87,,13,38,16,54
45016,papabear420,,14,1,4,5
45017,fmota,,20,117,167,284
45018,Marauder,,34,8,8,16
45019,ahabeger,,20,5,14,19
45020,johnnywatkins,,18,432,49,481
45021,HeavyFed,,19,1,1,2
45022,Mark_Logan,,43,53,59,112
45023,iggle2,,19,7,8,15
45024,vinnl,,8,20,12,32
45025,crocafella,,5,1,1,2
45026,ludwig1024,,1,164,286,450
45027,circulate,,19,146,77,223
45028,changwufei801,,4,1,1,2
45029,rate-my-annoyingness,,42,66,156,222
45030,johnjannotti,,38,1,2,3
45031,soylent_spam,,30,2,2,4
45032,sinope,,20,2,1,3
45033,ashmodai,,12,227,397,624
45034,bartel,,19,4,16,20
45035,rmuser,,32,9335,1668,11003
45036,danteembermage,,22,21,19,40
45037,Skippy989,,13,4,3,7
45038,moderater,,19,3,7,10
45039,Philll,,1,17,12,29
45040,Sourcefor,,19,17,16,33
45041,kiffy,,19,4,8,12
45042,Orolokarr,,30,81,93,174
45043,h0dg3s,,33,1828,3405,5233
45044,Sunday_Bunday,,22,14,4,18
45045,Baramin,,20,18,21,39
45046,kirwenj,,32,1,1,2
45047,haydukelives,,0,90,160,250
45048,yaxriifgyn,,18,33,70,103
45049,patticus,,43,3,8,11
45050,gustavl,,43,4,1,5
45051,camilleamber,,18,4,5,9
45052,ziptiespec,,11,6,1,7
45053,pseudologue,,18,17,17,34
45054,BubbaJimbo,,5,78,157,235
45055,leverne,,2,1,7,8
45056,robconery,,20,1,1,2
45057,gmbel,,13,379,158,537
45058,caled,,22,69,51,120
45059,tortus,,18,229,226,455
45060,humbleboaster,,34,20,71,91
45061,Tony_F_Reaves,,13,1,5,6
45062,firepunk,,1,289,414,703
45063,reddiculous,,5,33,19,52
45064,hgsfgx,,8,3,1,4
45065,digital19,,31,116,257,373
45066,theyguru,,1,2,2,4
45067,sverrejoh,,20,12,8,20
45068,sbchapm,,5,36,44,80
45069,astaboy,,22,1,2,3
45070,mindkiller317,,18,60,84,144
45071,bvttf,,20,3,6,9
45072,helot,,1,28,10,38
45073,rhamphoryncus,,20,2,5,7
45074,oceansize,,20,1,2,3
45075,abrielle36991,,29,1,1,2
45076,dwm1129,,19,129,5,134
45077,TheMilkMen,,43,1,2,3
45078,ameo,,18,575,113,688
45079,southswellsurfer,,31,3,1,4
45080,dooglesan,,19,52,45,97
45081,patoh,,36,3,5,8
45082,TheGrammarBolshevik,,22,172,307,479
45083,bennybenners,,13,81,174,255
45084,alragusa,,32,16,24,40
45085,saturn_lad,,20,1,1,2
45086,abramN,,18,4,10,14
45087,DaveDragon,,19,21,64,85
45088,raubry,,22,107,258,365
45089,CaseyCCC,,30,14,29,43
45090,McGarnacle,,15,5,16,21
45091,broadcloak,,18,10,25,35
45092,bigflexy,,19,59,99,158
45093,mechanical_marksy,,36,1,1,2
45094,Jigz,,5,11,29,40
45095,AnthonyInsanity,,18,2,3,5
45096,econnally,,43,1,1,2
45097,screenname,,19,24,30,54
45098,prophet3point0,,9,4,3,7
45099,elija_craig,,13,35,49,84
45100,bredren,,13,62,9,71
45101,mrsinkieminstrel,,19,4,8,12
45102,sulayman,,14,11,4,15
45103,nyc_guy_57,,1,1,1,2
45104,Zorkblat,,0,81,2,83
45105,tolland,,13,10,14,24
45106,daole,,5,8,15,23
45107,jmzhodge,,22,43,12,55
45108,bgeron,,20,83,103,186
45109,apexaviour,,18,5,7,12
45110,raywert,,3,5,4,9
45111,helm,,4,187,350,537
45112,blaquebile,,42,6,3,9
45113,rickmatt,,32,357,86,443
45114,queenmoweeny,,5,194,63,257
45115,Oreyn,,32,7,9,16
45116,biwook,,18,75,10,85
45117,barlaam,,14,183,11,194
45118,sesquipedalian,,19,1,6,7
45119,neocons,,19,15,50,65
45120,elk67,,0,5,11,16
45121,waml,,19,2,2,4
45122,jackoffsky,,19,1,1,2
45123,RedditGirlfriend,,1,14,1,15
45124,justkaren,,5,3,2,5
45125,josiahq,,19,20,14,34
45126,headdesk,,22,10,34,44
45127,LawlingFenix,,1,6,4,10
45128,Bluur,,42,90,76,166
45129,ig1,,20,83,25,108
45130,drew6r19,,19,9,2,11
45131,BobGaffney,,19,1197,1712,2909
45132,zoopzoopzoop,,31,1,1,2
45133,gt1329a,,20,6,9,15
45134,g33kfu,,17,3,4,7
45135,sw17ch,,20,330,400,730
45136,caseinpoint,,18,4,1,5
45137,nihilogic,,19,1,1,2
45138,SpecialKlvl23,,0,317,131,448
45139,Nate_W,,19,398,464,862
45140,MMX,,19,85,83,168
45141,bgholt1970,,19,1136,86,1222
45142,Relativity2,,0,18,51,69
45143,dubdub2,,34,5,1,6
45144,aennil,,1,213,326,539
45145,dodos,,30,10,11,21
45146,tayto,,32,41,49,90
45147,dearabby,,19,23,19,42
45148,boghani,,19,8,21,29
45149,blackbow,,19,2,11,13
45150,C0FFEE,,8,1,1,2
45151,max3o6,,18,4,1,5
45152,bammbamm85,,10,4,6,10
45153,ButtScratcher,,31,47,54,101
45154,knotweed,,19,3,1,4
45155,mgv64,,0,45,76,121
45156,Lylepalooza,,13,7,6,13
45157,kmi187,,32,33,62,95
45158,to_play_us_out,,22,12,20,32
45159,jdcollins,,18,31,77,108
45160,sheeprevolution,,22,744,1222,1966
45161,severeon,,0,1,1,2
45162,varodan,,13,5,10,15
45163,dropkickninja,,18,12,27,39
45164,Hi1202,,20,1,1,2
45165,TomSwirly,,20,75,87,162
45166,fthead9,,19,74,6,80
45167,mbesh,,34,1,3,4
45168,adpowers,,20,3,4,7
45169,Wenix,,1,14,22,36
45170,grogan,,43,5,1,6
45171,arkanes,,20,3,4,7
45172,orthogonality,,12,505,550,1055
45173,twotime,,20,222,259,481
45174,lpxxfaintxx,,9,145,39,184
45175,someguyatwork,,18,3,6,9
45176,Histrel,,13,15,44,59
45177,notsol337,,0,1,1,2
45178,Sp00ns,,20,6,9,15
45179,Kid97GTS,,5,2,6,8
45180,headinthegame,,13,14,2,16
45181,slider527,,19,1,1,2
45182,kancgab,,8,1,1,2
45183,tjwarren,,13,2,2,4
45184,dr_eiff,,1,5,2,7
45185,deathofregret,,32,33,26,59
45186,seertaak,,20,1,2,3
45187,egearman,,19,8,11,19
45188,nkuvu,,17,66,95,161
45189,dduong16,,34,30,2,32
45190,rjrebel75,,18,1,2,3
45191,endofworld,,19,382,552,934
45192,raymyers,,20,5,16,21
45193,Facepunch,,18,144,12,156
45194,coc,,43,26,40,66
45195,DavidDuke,,39,1,2,3
45196,syn-,,6,1,1,2
45197,furry8,,0,757,805,1562
45198,lagomorph,,10,5,4,9
45199,Oculus,,20,3,1,4
45200,RyGuyX,,22,1,1,2
45201,chetansastry,,40,3,5,8
45202,wtjones,,19,54,107,161
45203,jscipione,,20,3,2,5
45204,coachz,,1,3,6,9
45205,libertariangenius,,13,1,4,5
45206,MrTea,,12,1,12,13
45207,LukeHoersten,,20,11,4,15
45208,iSpeakMyMind,,31,9,19,28
45209,jamess,,20,1,1,2
45210,findyourownpath,,13,15,12,27
45211,wbendick,,20,206,86,292
45212,Chimpelol,,31,25,26,51
45213,svdasein,,31,11,18,29
45214,MrCalifornia,,4,279,144,423
45215,jlt6666,,20,2,7,9
45216,kindoblue,,18,5,1,6
45217,r3publik,,19,1,2,3
45218,shazzam,,5,37,59,96
45219,poortiming,,13,38,14,52
45220,anotherusername2,,30,8,10,18
45221,redbo,,20,48,66,114
45222,mrmacdude,,12,1,1,2
45223,redb2112,,31,6,4,10
45224,Boner,,0,3,3,6
45225,Raithlin,,42,49,3,52
45226,kloidster,,1,1,1,2
45227,rymaster,,13,13,5,18
45228,TheOnlyInvictus,,0,12,16,28
45229,TunnelingHorror,,1,11,1,12
45230,AMerrickanGirl,,35,2161,2121,4282
45231,SassyPants,,22,1,1,2
45232,equark,,33,4,4,8
45233,deckone,,42,4,4,8
45234,wootup,,6,192,54,246
45235,BillC,,20,1,1,2
45236,corporatehuman,,19,59,52,111
45237,nugwin,,14,1,4,5
45238,ajslamka,,43,3,7,10
45239,blinkin,,19,535,108,643
45240,ddfreedom,,13,159,259,418
45241,muneeeeeb,,16,2,1,3
45242,sedeas,,31,1,1,2
45243,anonymous_hero,,20,66,120,186
45244,livingimpaired,,1,385,233,618
45245,heya,,19,1,1,2
45246,madcow44820,,19,67,115,182
45247,prockcore,,20,357,372,729
45248,SummerGlau,,13,25,13,38
45249,graysilver,,18,33,34,67
45250,niks1101,,22,3,4,7
45251,VerbalRadiation,,1,10,9,19
45252,bewareofratnesh,,13,10,3,13
45253,luffs,,31,26,15,41
45254,harrybozack,,1,132,154,286
45255,casspa,,5,29,13,42
45256,mrpitt,,36,1,3,4
45257,greenanji,,18,17,30,47
45258,PstScrpt,,20,1,5,6
45259,kibbutz,,22,6,9,15
45260,radient,,22,3,4,7
45261,cxp,,20,1,1,2
45262,jehiah,,22,2,1,3
45263,tmn4,,17,18,11,29
45264,freun989,,21,2,3,5
45265,oumerisha,,19,7,4,11
45266,bccThis,,29,7,20,27
45267,lda,,13,5,1,6
45268,eddy_42,,20,3,3,6
45269,umbrae,,20,130,194,324
45270,jesskat,,18,49,108,157
45271,dedalist,,16,16,6,22
45272,skippy,,20,12,20,32
45273,randomcharacters123,,1,6,35,41
45274,GreetingsADM,,32,4,3,7
45275,savedarfurcoalition,,42,2,1,3
45276,BurnTees,,5,159,192,351
45277,KernelViolator,,18,2,10,12
45278,addie25,,13,322,60,382
45279,Santos_L_Halper,,18,146,204,350
45280,skx,,22,2,6,8
45281,retsoced,,31,1,2,3
45282,SkaakS,,8,5,1,6
45283,darceygrey,,40,74,11,85
45284,pbaehr,,13,2,3,5
45285,binary,,1,77,56,133
45286,flavanol,,5,4,6,10
45287,WhereIsCheney,,43,1,2,3
45288,MaverickDesign,,0,33,1,34
45289,planetmatt,,1,24,43,67
45290,unreal0500,,19,2,1,3
45291,skorpan,,20,8,23,31
45292,balachthon,,20,9,15,24
45293,adsk,,18,1,1,2
45294,ator_fighting_eagle,,20,46,56,102
45295,daRoach,,18,81,153,234
45296,witt,,31,68,68,136
45297,AnotherGeek,,30,3,2,5
45298,mzitt11,,42,5,1,6
45299,Adumbrations,,20,12,12,24
45300,amitch56,,34,82,67,149
45301,dcatts,,17,9,15,24
45302,ivdkleyn,,20,37,12,49
45303,sriraminhell,,18,16,5,21
45304,chicagojacobs,,5,2,1,3
45305,vitummedicinus,,43,433,243,676
45306,CaptainMidnight,,13,26,12,38
45307,destino,,13,1,1,2
45308,explodingwumpus,,1,1,4,5
45309,Illah,,18,189,161,350
45310,msdesireeg,,23,741,949,1690
45311,freeyourcrt,,19,15,12,27
45312,silout,,9,116,68,184
45313,workroom,,43,199,229,428
45314,PatonLewis,,0,14,28,42
45315,juggrnaut,,20,1,1,2
45316,obsidian468,,18,363,507,870
45317,jal648,,20,3,2,5
45318,ratbert,,8,40,74,114
45319,cloud4197,,18,136,251,387
45320,Richeh,,22,631,1046,1677
45321,dabizi,,17,299,438,737
45322,rbnfsh,,12,74,56,130
45323,drshortyd,,0,2,8,10
45324,argggh,,20,7,9,16
45325,knuckboy,,18,7,24,31
45326,Whoopsii,,1,2,1,3
45327,Steve9852,,22,14,10,24
45328,Prozn,,12,14,16,30
45329,vacantmentality,,1,1,1,2
45330,curlytree,,16,6,3,9
45331,asdyt,,22,2,5,7
45332,glickman,,20,1,1,2
45333,gnarled,,34,1,5,6
45334,anescient,,34,530,658,1188
45335,uiopzxcv,,14,2,4,6
45336,kschaller,,2,4,6,10
45337,used2digg,,43,78,81,159
45338,DarkJesus,,20,1,2,3
45339,astonished,,13,9,1,10
45340,euccastro,,20,6,10,16
45341,asfhgfa,,4,4,6,10
45342,l2daless,,42,9,23,32
45343,ikazuchi,,13,4,3,7
45344,JaySherman,,31,3,3,6
45345,yuropeen,,32,117,52,169
45346,champs,,19,19,2,21
45347,NullAndVoid,,32,2,2,4
45348,nastynafki,,13,5,4,9
45349,Sparkles,,19,6,10,16
45350,AngryDuck,,13,30,23,53
45351,chunkypunkyboy,,30,32,47,79
45352,Gadianton,,4,5,10,15
45353,rvt,,2,7,1,8
45354,traviserickson,,43,2,4,6
45355,Mommar,,18,2,1,3
45356,tomrwest15,,18,1,1,2
45357,occelot,,5,40,21,61
45358,KaZaDuum,,23,2,1,3
45359,gumitdead,,23,1,2,3
45360,Danceswithwires,,19,15,25,40
45361,OneAndOnlySnob,,20,254,363,617
45362,fuf,,1,58,67,125
45363,Soniji,,19,248,4,252
45364,StevenHodson,,8,49,1,50
45365,alanp,,8,8,2,10
45366,DoctorSlump,,20,2,5,7
45367,tom83,,1,6,10,16
45368,NoahSwayne,,13,101,24,125
45369,holysocks,,5,301,424,725
45370,steady_str,,18,21,40,61
45371,zcbyrnes,,22,1,1,2
45372,berne,,20,3,2,5
45373,hokkos,,20,92,90,182
45374,Pootzen,,18,13,7,20
45375,p_o,,18,3,5,8
45376,haiduz,,31,451,511,962
45377,O7Z,,43,25,8,33
45378,leoca77,,9,1,2,3
45379,cricketbones,,30,16,19,35
45380,moriquendo,,19,814,823,1637
45381,K_Rambo34,,6,1,2,3
45382,Aminmadani,,31,4,2,6
45383,intelex,,20,21,23,44
45384,LuciusTheAss,,31,8,9,17
45385,Lumarin,,22,99,143,242
45386,kidford,,12,115,189,304
45387,truocchio,,19,2,7,9
45388,Corgana,,18,56,31,87
45389,littlealbatross,,19,61,158,219
45390,breaume,,1,4,2,6
45391,patrickvannypan,,33,3,2,5
45392,rayban68,,13,17,45,62
45393,mavroprovato,,4,3,2,5
45394,reddig,,18,1,1,2
45395,Solima,,32,24,20,44
45396,gordo4s,,5,4,27,31
45397,tempname,,13,5,8,13
45398,feckinCunght,,19,84,40,124
45399,biffbobsen,,18,64,125,189
45400,johnriven,,8,3,4,7
45401,Rob,,5,88,10,98
45402,willfe,,19,50,84,134
45403,dev09,,12,2,3,5
45404,AStarr,,43,2,5,7
45405,Tokkii,,22,63,108,171
45406,xTRUMANx,,22,631,584,1215
45407,mouseinahaze,,13,8,11,19
45408,absolutelytrue,,5,21,16,37
45409,PellePeloton,,19,7,3,10
45410,hig,,29,7,12,19
45411,windchyme50,,13,5,9,14
45412,woodlawn,,18,1,2,3
45413,freehunter,,18,89,135,224
45414,tom_cruise_is_TIGHT,,43,5,8,13
45415,simonmar,,20,16,3,19
45416,dewmugg,,42,3,1,4
45417,bntly,,1,19,19,38
45418,libroll,,19,7,6,13
45419,mmsullivan,,22,7,5,12
45420,nobamama,,31,71,48,119
45421,pdross1,,13,1,6,7
45422,JoeKirk,,18,6,6,12
45423,shortyjacobs,,22,12,17,29
45424,sylvie1,,18,2,1,3
45425,RAc163,,32,25,2,27
45426,oniTony,,20,104,27,131
45427,semafor,,18,25,37,62
45428,gondomwing,,13,11,5,16
45429,trbeaber,,19,33,58,91
45430,mayobutter,,20,79,66,145
45431,tetuphenay,,22,9,5,14
45432,penguinv,,13,43,87,130
45433,throop77,,19,181,320,501
45434,RexManningDay,,32,630,1146,1776
45435,anko_painting,,20,6,3,9
45436,fahcredit,,14,33,34,67
45437,CanadianNinja,,30,115,125,240
45438,Hate,,19,13,15,28
45439,IAmNotBigL,,13,1,6,7
45440,mrtdot,,18,4,8,12
45441,fryman,,1,81,116,197
45442,meatsack,,1,26,33,59
45443,cedelson,,13,279,172,451
45444,DMBT,,13,9,1,10
45445,Rickr00ler,,13,1,1,2
45446,hosiawak,,20,4,1,5
45447,Eleglac,,43,93,125,218
45448,LanternBearer,,13,542,1286,1828
45449,iscander,,19,1,2,3
45450,mbiggs,,22,1,1,2
45451,Justanothercoverup,,19,285,15,300
45452,gfryesc,,13,43,51,94
45453,groby,,20,40,74,114
45454,jemroc,,20,5,9,14
45455,ben4evah,,22,16,22,38
45456,casta,,20,3,3,6
45457,renauldo56,,31,10,6,16
45458,redditer041,,14,6,4,10
45459,ipearx,,12,7,13,20
45460,graciosa,,6,16,18,34
45461,matzero,,27,1,2,3
45462,PurpleMan,,18,35,6,41
45463,mrhungry,,42,6,8,14
45464,clarknova9,,18,4,3,7
45465,rickracer777,,13,26,32,58
45466,onetruejp,,19,328,536,864
45467,mickythec,,19,1,1,2
45468,Outrigger8,,18,5,4,9
45469,jotho,,19,1,1,2
45470,FordJano,,9,40,90,130
45471,paperwasp,,13,212,22,234
45472,neosapiens,,43,1,2,3
45473,Duncan_Idaho,,34,58,116,174
45474,daleharvey,,20,14,23,37
45475,bitdiddle,,20,1,7,8
45476,webster1,,1,95,15,110
45477,ravenbladex,,23,3,2,5
45478,crispee,,20,25,24,49
45479,readerofreddit,,18,1,1,2
45480,nekteknik,,18,1,7,8
45481,benad,,20,1,1,2
45482,bloaded,,5,7,11,18
45483,elvisthepelvis,,1,4,2,6
45484,yy633013,,18,1,3,4
45485,kengruven,,20,1,4,5
45486,wooptoo,,18,4,14,18
45487,ekahsan,,13,1,1,2
45488,hatevalyum,,22,7,2,9
45489,jdk,,32,132,178,310
45490,pyromonkey,,19,2,4,6
45491,Ravenaru,,13,12,29,41
45492,blackestblue,,34,5,7,12
45493,snifty,,32,428,540,968
45494,vagmi,,20,33,7,40
45495,tornadic,,18,37,2,39
45496,skevimc,,13,13,23,36
45497,gridbug,,42,58,30,88
45498,Kolibri,,20,187,269,456
45499,nathanlaw,,13,3,9,12
45500,TAKESTHINGSTOOFAR,,18,1,1,2
45501,amatriain,,20,13,22,35
45502,Odd_Bloke,,20,66,27,93
45503,Hovertruck,,22,85,126,211
45504,holmeszk,,36,7,2,9
45505,raldi,,1,476,361,837
45506,kai7162,,13,1,1,2
45507,bburg,,43,18,22,40
45508,jppowerstroke,,13,1,1,2
45509,unrulymob,,19,2,3,5
45510,RATM,,19,12,6,18
45511,mbcharbonneau,,18,2,3,5
45512,Ford42,,19,10,18,28
45513,gaze,,20,15,15,30
45514,anthropoid,,20,12,20,32
45515,ot2,,20,8,25,33
45516,Spiritglue,,1,3,3,6
45517,StiflyStiferson,,13,3,16,19
45518,JPOnion,,32,288,476,764
45519,klassik,,31,4,3,7
45520,terath,,20,5,8,13
45521,kovu,,14,1,1,2
45522,jjquave,,29,147,138,285
45523,Arjibuh,,19,87,123,210
45524,oherrala,,20,47,2,49
45525,GrouchoRedditor,,3,4,2,6
45526,amila,,22,52,15,67
45527,twine,,13,30,26,56
45528,fwork,,20,320,399,719
45529,msing,,1,32,65,97
45530,twinklestar,,34,261,16,277
45531,radix,,20,1,1,2
45532,facilis,,13,38,64,102
45533,kellogg,,5,34,33,67
45534,mrbo,,20,10,8,18
45535,akruvi,,31,92,100,192
45536,apotheon,,14,1000,928,1928
45537,flashman2006,,8,23,18,41
45538,SenorCardgage,,13,69,36,105
45539,infinitecat,,18,32,61,93
45540,bhb6790,,20,1,1,2
45541,allenizabeth,,13,470,587,1057
45542,baz,,42,7,23,30
45543,Gudranx,,32,5,5,10
45544,askhole,,41,3,3,6
45545,justsomeguy987,,19,10,16,26
45546,liamville,,7,54,76,130
45547,geniusfreak,,18,27,46,73
45548,Zaniac,,32,28,33,61
45549,phragmatic,,13,7,19,26
45550,photokeith,,18,435,432,867
45551,pholm,,19,120,132,252
45552,SomeBloke,,18,21,28,49
45553,nowarabx,,42,1,1,2
45554,jestopher,,0,11,32,43
45555,andrewsmith1986,,1,6,3,9
45556,RonPaulSucksDik4Coke,,43,1,6,7
45557,Parrot132,,4,1,1,2
45558,clintecker,,20,15,7,22
45559,grazny,,18,59,60,119
45560,stargazer858,,20,2,1,3
45561,guyusj,,42,1,2,3
45562,Nave,,27,10,9,19
45563,verb0ten,,1,166,174,340
45564,i_h8_r3dd1t,,36,410,439,849
45565,kubenzi,,13,68,78,146
45566,krawdizzle,,12,1,1,2
45567,ddrogba,,43,1,1,2
45568,lcmatt,,22,14,14,28
45569,El_Biffo,,30,3,2,5
45570,hellow4,,18,73,21,94
45571,Masapena,,4,16,35,51
45572,smrdka,,19,6,8,14
45573,lovelace,,20,1,1,2
45574,swimmerstud,,11,56,35,91
45575,spaghettiman,,18,3,4,7
45576,eebee,,13,1,4,5
45577,gusintemecula,,32,9,22,31
45578,jonathandclark,,13,1,1,2
45579,Mattie,,20,111,77,188
45580,saytheobvious,,20,3,1,4
45581,deephair,,32,46,3,49
45582,Kardlonoc,,43,893,1706,2599
45583,parcivale,,31,787,897,1684
45584,Killawatt,,19,49,103,152
45585,Duelist,,42,3,4,7
45586,likelystory,,13,7,7,14
45587,SirGrok,,31,3,1,4
45588,zeljana,,18,33,5,38
45589,gawainjones,,30,7,8,15
45590,fuji76,,18,13,3,16
45591,serpentjaguar,,31,495,750,1245
45592,ross456,,32,1,1,2
45593,wodha,,30,7,1,8
45594,sonicon,,42,54,96,150
45595,w43l,,22,1,8,9
45596,tdyer,,43,1,1,2
45597,patrickjst,,16,1,1,2
45598,Drulian,,13,33,31,64
45599,kjb877,,1,22,24,46
45600,gda,,13,77,168,245
45601,salvia_d,,30,731,214,945
45602,jjimmy,,18,1,1,2
45603,IvoJacome,,8,2,2,4
45604,sstomek,,23,2,1,3
45605,goodtower,,13,3,3,6
45606,theory_of_everything,,1,3,11,14
45607,nestoras,,1,14,40,54
45608,fyl799,,34,4,4,8
45609,r44s,,20,3,1,4
45610,nsrivast,,20,40,21,61
45611,Stijn,,31,23,16,39
45612,pawnstorm,,6,19,28,47
45613,kbaribeau,,20,1,3,4
45614,kngspook,,20,1,3,4
45615,Barleyman,,18,4,1,5
45616,zdiv,,8,2,1,3
45617,soulpurpose,,1,9,5,14
45618,dwdyer,,20,4,7,11
45619,narpas,,32,53,119,172
45620,wstein,,20,6,8,14
45621,halvfet,,31,1,1,2
45622,detonatenz,,43,21,26,47
45623,ahmadamaj,,0,4,5,9
45624,muumuuuu,,4,2,1,3
45625,wes1,,19,4,3,7
45626,lordnuri,,13,3,11,14
45627,jupaneanu,,5,1385,41,1426
45628,sschudel,,18,4,15,19
45629,Goondick,,13,4,3,7
45630,xkaupx,,32,5,10,15
45631,FamousPerson,,13,4,5,9
45632,tizenkotoko,,0,35,73,108
45633,maggit,,20,65,49,114
45634,newsbaby,,8,4,4,8
45635,lonebear,,5,2,2,4
45636,frankofbos,,13,42,4,46
45637,zubinmadon,,11,257,249,506
45638,notyouravgjoel,,20,16,23,39
45639,BarristaEnFlambe,,3,20,32,52
45640,Nagarjuna3,,19,3,10,13
45641,Mr_Splashypants,,20,1,1,2
45642,REDDIT_MAN_98_points,,20,1,4,5
45643,unclesaamm,,34,3,3,6
45644,elliotb,,34,1,1,2
45645,christocracy,,20,5,12,17
45646,FreeRadical08,,11,48,36,84
45647,myv,,13,2,3,5
45648,Mycolostomybagleaked,,18,262,234,496
45649,drgreg911,,14,3,2,5
45650,PsychoGod,,43,44,66,110
45651,thelmajanemax,,33,6,4,10
45652,nitwitty,,16,1,1,2
45653,ctronci,,18,5,3,8
45654,drtchock,,18,19,24,43
45655,soar,,1,246,583,829
45656,thaddio,,13,4,5,9
45657,tpark,,34,23,27,50
45658,johnb647,,11,1,3,4
45659,starboogie,,19,26,7,33
45660,leanny,,36,2,1,3
45661,nextofpumpkin,,20,952,1225,2177
45662,kanned,,43,12,14,26
45663,DRPSET,,19,2,1,3
45664,dapperdan,,42,23,26,49
45665,trave,,13,51,84,135
45666,random_words,,13,4,4,8
45667,joethepeacock,,1,127,46,173
45668,WitchKing,,43,1,1,2
45669,pull_the_other_one,,6,15,20,35
45670,nominolo,,20,62,71,133
45671,adt,,18,16,25,41
45672,NeimanJ,,19,102,14,116
45673,new_bedlam,,1,159,235,394
45674,romke,,29,4,3,7
45675,tratari,,18,8,15,23
45676,mekarank,,0,1,1,2
45677,freedomgoose,,26,1,4,5
45678,thrain2,,1,2,3,5
45679,agoldin,,31,9,17,26
45680,temp12345,,20,3,2,5
45681,graha,,42,17,2,19
45682,ericisshort,,18,2,3,5
45683,FeedMePlease,,0,153,303,456
45684,donjaime,,20,18,17,35
45685,MilkMoney,,18,68,13,81
45686,Okitaz,,18,167,62,229
45687,Kixie,,18,2,3,5
45688,tuigdoilgheas,,13,2,5,7
45689,Lythic,,1,1,1,2
45690,rtb,,32,17,18,35
45691,alpinesol,,12,50,29,79
45692,destraht,,20,3,2,5
45693,taleril,,22,6,6,12
45694,addeleon,,1,13,20,33
45695,ciano,,18,3,11,14
45696,kerritaylor85,,13,12,2,14
45697,ih8linux,,18,7,8,15
45698,lern_too_spel,,19,52,50,102
45699,ChrisTheCat,,26,2,1,3
45700,b0b157,,18,1,7,8
45701,taylorfate,,29,1,1,2
45702,j0rge,,18,23,1,24
45703,andreiradudan,,5,20,4,24
45704,Fluid_Mechanics,,18,7,12,19
45705,JonBuoy,,1,11,2,13
45706,metroid23,,18,8,6,14
45707,popthatcorn,,20,26,4,30
45708,dion_dock,,20,1,1,2
45709,zoltan2357,,8,3,3,6
45710,useless_idiot,,19,213,259,472
45711,eikenberry,,20,20,17,37
45712,jftuga,,33,1,2,3
45713,johnpickens,,31,19,27,46
45714,Temp3st,,20,20,24,44
45715,MrBadAdvice,,5,1,1,2
45716,paulhuts,,20,3,3,6
45717,jakepoz,,32,2,4,6
45718,hyperfusion,,34,4,4,8
45719,sloppy,,19,2,19,21
45720,akumasun,,13,23,47,70
45721,Super-King,,1,6,2,8
45722,tamarind2,,36,3,1,4
45723,Awperator,,3,38,33,71
45724,Thomas_Dolby,,43,20,36,56
45725,ratchet,,36,2,2,4
45726,teeyee,,13,72,1,73
45727,asgromo,,4,10,9,19
45728,orangesunshine,,31,5,6,11
45729,oso45,,18,4,6,10
45730,t0t0r0,,22,2,1,3
45731,Mickay2541,,18,1,1,2
45732,collinT,,32,1,1,2
45733,LogicalTingle,,12,2,5,7
45734,wauter,,43,8,8,16
45735,campingcar,,20,23,16,39
45736,harrybalsick,,19,7,8,15
45737,tommyroo,,19,15,23,38
45738,pwnghis_khan,,6,8,9,17
45739,lolalivia,,13,48,54,102
45740,guru,,20,89,5,94
45741,rainer511,,13,5,7,12
45742,5656d5656dv56,,29,1,1,2
45743,yters,,20,46,46,92
45744,progoz,,18,1,2,3
45745,danielstoner,,20,54,9,63
45746,accelerape,,18,4,2,6
45747,timesink,,20,4,6,10
45748,mattelmore,,18,2,2,4
45749,DutchAnon,,1,4,2,6
45750,UncleLiberal,,18,16,28,44
45751,joachimb,,22,2,1,3
45752,TheAngryToaster,,1,1,2,3
45753,gumjo,,31,14,26,40
45754,missty,,0,8,4,12
45755,michael_dorfman,,20,2,4,6
45756,reddit_god,,19,37,50,87
45757,Paqza,,0,42,66,108
45758,chunky_bacon,,17,724,1685,2409
45759,nokiili,,19,4,3,7
45760,mattstreet,,22,2,3,5
45761,mrbrownstone,,18,3,5,8
45762,garnet13ajg,,19,189,298,487
45763,jcapote,,20,27,27,54
45764,fleecerobot,,1,7,2,9
45765,sunev,,13,9,3,12
45766,petrilli,,20,26,23,49
45767,george_dubya,,1,1,1,2
45768,WordReich,,18,5,15,20
45769,skay,,43,223,255,478
45770,tdsfp,,18,51,1,52
45771,Baked,,0,1,1,2
45772,zemookmook,,20,7,13,20
45773,dagraybehl,,13,9,9,18
45774,durendal,,18,1,2,3
45775,BillyBlight,,13,3,4,7
45776,markhp2,,1,4,1,5
45777,ramdac,,30,12,30,42
45778,Dred,,18,175,215,390
45779,neogohan,,32,66,54,120
45780,slimwiththetiltedbri,,19,83,99,182
45781,Autotrappic,,18,68,103,171
45782,jacbo,,19,2,5,7
45783,lex0r,,31,7,13,20
45784,psychometry,,19,968,1193,2161
45785,NamelessForce,,31,3,4,7
45786,nivvis,,35,1,2,3
45787,Atman00,,18,1,4,5
45788,Fauropitotto,,18,247,417,664
45789,murl56,,13,24,31,55
45790,badfeng,,31,10,7,17
45791,polarbear128,,36,19,26,45
45792,mjhkid,,32,65,31,96
45793,bennypowers,,31,1,1,2
45794,d415,,8,2,6,8
45795,random5328238052583,,20,14,14,28
45796,OctopusRex,,31,50,58,108
45797,DLMSweet,,1,2,9,11
45798,krazykrumz3,,13,2,1,3
45799,MikeSeth,,31,1027,1102,2129
45800,3049843098,,33,2,1,3
45801,aaron114,,5,5,3,8
45802,aeroeri,,1,14,23,37
45803,kuromimi,,40,2,4,6
45804,TrollinAintEasy,,10,1,2,3
45805,Fyurstart3r,,38,3,2,5
45806,xaco,,18,44,71,115
45807,scraptabulous,,31,1,5,6
45808,bostonpaul,,31,2,1,3
45809,themadthinker,,0,145,50,195
45810,nightmarchers,,32,5,8,13
45811,BellicoseBaby,,34,31,40,71
45812,toba,,20,13,36,49
45813,brycon,,1,10,14,24
45814,satirewagon,,20,1,1,2
45815,jedaro,,12,15,26,41
45816,dancingqueen,,20,1,1,2
45817,winterkoninkje,,20,28,11,39
45818,fundudeme,,13,15,9,24
45819,adiggconvert,,13,43,51,94
45820,vastrightwing,,13,23,30,53
45821,annalatrina,,1,82,57,139
45822,infraspace,,42,13,25,38
45823,frigo,,30,18,12,30
45824,rmyeid,,20,11,2,13
45825,ghdiel,,13,240,204,444
45826,destructure,,19,1,3,4
45827,zombiecohagen,,6,2,3,5
45828,rubbleman,,18,1,1,2
45829,soreff,,43,16,27,43
45830,allscoop,,18,37,1,38
45831,cookiemonsterism,,22,16,31,47
45832,oopsydaisy,,19,5,9,14
45833,anarchistica,,32,396,626,1022
45834,defproc,,22,440,713,1153
45835,Wadsworth,,19,104,122,226
45836,mkdir,,6,9,12,21
45837,WorstCoderEver,,18,30,31,61
45838,duncanmak,,20,3,4,7
45839,trans_canada,,43,13,15,28
45840,javaroast,,1,1,1,2
45841,dannyhw,,18,26,20,46
45842,vulpes,,34,27,21,48
45843,Wraith,,19,40,77,117
45844,phatmikey,,30,32,37,69
45845,notian,,42,14,13,27
45846,limit2012,,6,1,1,2
45847,jellyfishes,,18,42,37,79
45848,rubymaverick,,20,7,2,9
45849,abcmanu,,32,77,10,87
45850,poopsix,,32,70,101,171
45851,live52,,36,315,595,910
45852,kaddar,,43,2,11,13
45853,imissthe1980s,,13,26,22,48
45854,ed19,,18,101,146,247
45855,bwahaha,,43,64,98,162
45856,armooo,,20,1,1,2
45857,enfuego96,,5,3,9,12
45858,edheil,,20,51,61,112
45859,bully12v,,43,9,9,18
45860,davel_jonez,,34,5,9,14
45861,ChillyBill12,,13,2,3,5
45862,Borgesandme,,1,10,13,23
45863,rollingRook,,18,64,12,76
45864,enjoythis,,22,21,27,48
45865,dt07red,,0,17,52,69
45866,ladydoctorofminds,,13,37,31,68
45867,Michael_Bolton,,18,1,1,2
45868,lazybug,,39,1,1,2
45869,aussie_bob,,22,603,581,1184
45870,kingofpenguins,,20,5,4,9
45871,jeannaimard,,30,481,656,1137
45872,josephgrossberg,,20,3,4,7
45873,infraredflower,,4,7,3,10
45874,cybernet,,5,5,2,7
45875,mythic,,20,128,137,265
45876,Ch1mpy,,22,66,76,142
45877,kagemusha,,19,70,97,167
45878,notParanoid,,13,87,179,266
45879,dagfari,,22,347,492,839
45880,mbrowne,,31,160,252,412
45881,JeffTHEroosteR,,6,1,3,4
45882,watcher,,13,336,80,416
45883,dmilor,,20,48,43,91
45884,paulydidntdoit,,18,1,3,4
45885,redsoxchic,,37,5,5,10
45886,Philiosophe,,3,36,44,80
45887,hk_newbie,,22,3,5,8
45888,flyingscauncher,,1,66,36,102
45889,vjdc,,20,1,1,2
45890,Iainzor,,1,5,14,19
45891,disljenko,,18,20,2,22
45892,needsmoarlulz,,22,131,128,259
45893,chadsworkPC,,8,1,1,2
45894,Deimorz,,20,1,3,4
45895,melito,,20,3,1,4
45896,mudgen,,20,60,14,74
45897,mc_,,13,2,1,3
45898,sakashvilli,,18,3,8,11
45899,Djatha,,30,18,25,43
45900,ivor,,18,9,10,19
45901,darjen,,19,354,415,769
45902,hippiefahrzeug,,12,1,3,4
45903,quark,,20,4,6,10
45904,The_Real_NSA,,1,1,1,2
45905,draicone,,20,14,6,20
45906,malignantz,,20,1,3,4
45907,amoeba,,20,71,136,207
45908,sfw,,10,4,2,6
45909,aredditgirl,,18,3,2,5
45910,cousinmeril,,39,2,6,8
45911,tulioz,,34,4,1,5
45912,nobleexperiment,,0,38,48,86
45913,TwoDeuces,,4,1,2,3
45914,birdFEEDER,,34,4,3,7
45915,webappsec,,34,7,1,8
45916,Shorties,,22,8,13,21
45917,tincansandtwine,,18,29,30,59
45918,starkravingblah,,19,100,10,110
45919,brelind,,20,8,4,12
45920,metsman913,,31,4,3,7
45921,note2self,,18,4,11,15
45922,capnrob,,32,6,4,10
45923,AezZea,,13,2,2,4
45924,ShitOnRickard5,,5,41,71,112
45925,robert314,,18,4,1,5
45926,alumi,,14,6,9,15
45927,jcenters,,3,26,32,58
45928,omt,,18,13,6,19
45929,gbeier,,43,8,8,16
45930,mariastella,,20,2,4,6
45931,audio-logical,,18,2,10,12
45932,absurdlyobfuscated,,22,2,4,6
45933,TrojanMan,,4,1,2,3
45934,LaszloKv,,29,57,70,127
45935,clarkismyname,,1,20,9,29
45936,kagreenie1,,13,2,5,7
45937,dmpayton,,20,12,14,26
45938,phenoch,,22,1,1,2
45939,ninevolt,,1,12,33,45
45940,chalva,,20,3,2,5
45941,fschofield,,13,1,1,2
45942,joelrw,,19,449,82,531
45943,MaskOfTheSun,,1,18,11,29
45944,oes3,,19,13,2,15
45945,RAS1398,,19,94,197,291
45946,badhill,,1,12,3,15
45947,jangobugsy,,11,23,32,55
45948,eggshen,,30,5,15,20
45949,Ender15,,18,110,153,263
45950,wise_monty,,0,86,1,87
45951,sonofabitch,,31,21,20,41
45952,OmegaChicken,,43,3,1,4
45953,jonsonroth,,5,28,6,34
45954,Tillermo,,30,1,6,7
45955,macknitwell,,1,12,21,33
45956,SmallCranes,,20,2,1,3
45957,TheFalseOswalds,,13,27,6,33
45958,oliwer,,20,18,30,48
45959,rswinkler,,18,2,3,5
45960,scex,,0,6,10,16
45961,thearthur,,20,5,10,15
45962,HRP,,1,4,1,5
45963,redditer006,,13,3,4,7
45964,mactac,,18,240,15,255
45965,xeon1,,18,70,7,77
45966,Applemacbookpro,,5,20,34,54
45967,oldgregg,,20,1,1,2
45968,mmmChicken,,34,12,17,29
45969,ronnie_paul,,19,6,6,12
45970,cheaa,,19,1,2,3
45971,belhamster,,1,39,3,42
45972,plasteredlyric,,1,14,22,36
45973,memebreather,,10,6,20,26
45974,lethalman,,20,81,28,109
45975,uvadave,,12,17,16,33
45976,SpiderCross,,29,7,2,9
45977,joblesspirate,,11,12,23,35
45978,dndnd,,31,10,6,16
45979,GarageMc,,9,119,196,315
45980,meijin,,20,36,6,42
45981,sigbjorn,,20,4,2,6
45982,EdgerErnst,,13,446,114,560
45983,dotnetperls,,20,1,2,3
45984,rlilly,,22,10,1,11
45985,market_hacker,,8,1,3,4
45986,Walls,,18,34,35,69
45987,BigGrayBeast,,0,1,1,2
45988,stardust2000,,13,63,10,73
45989,dobbs_studio,,18,1,1,2
45990,klystron,,15,5,12,17
45991,ProximaC,,41,992,1542,2534
45992,chopchop,,15,176,54,230
45993,dougmcvay,,4,15,1,16
45994,edgarde,,13,31,73,104
45995,dullyouth,,19,1,3,4
45996,jfgelinas,,0,2,1,3
45997,joejonson,,42,3,1,4
45998,travist120,,13,23,1,24
45999,squidgee,,6,10,12,22
46000,cwright,,34,213,8,221
46001,nouseforanickname,,1,18,7,25
46002,mortgage-foreclosure,,19,24,21,45
46003,a2800276,,13,7,8,15
46004,dyrenh,,18,26,41,67
46005,theproductguy,,14,2,1,3
46006,efs,,8,6,2,8
46007,kellysmith,,4,61,72,133
46008,Valency,,34,18,7,25
46009,powersurge,,13,22,16,38
46010,mk_ultra,,19,3,1,4
46011,nulltype0,,43,1,1,2
46012,RepoOne,,3,3,3,6
46013,Zlik1987,,13,2,2,4
46014,MasterSparky,,5,5,2,7
46015,unewsman01,,13,5,9,14
46016,grammarstasi,,30,1,1,2
46017,dswingley,,34,25,2,27
46018,fakeleft,,20,7,31,38
46019,geeksaresexy,,42,1,2,3
46020,NSFR,,11,8,25,33
46021,reckless8594,,1,40,39,79
46022,akx,,8,4,4,8
46023,elperdedor,,20,1,1,2
46024,jfm3,,20,17,12,29
46025,ecochildsplay,,34,88,13,101
46026,bjsalami,,30,8,13,21
46027,froggy3262,,34,54,3,57
46028,lizarb,,18,943,25,968
46029,dizzo72,,12,2,1,3
46030,keck,,11,73,120,193
46031,nshunter,,20,69,48,117
46032,Bones423,,0,1,4,5
46033,pchiusano,,20,103,22,125
46034,number6,,30,478,1054,1532
46035,bassalt,,30,156,51,207
46036,go_pstop,,18,3,1,4
46037,memecat,,22,1,1,2
46038,ghhardy,,19,3,3,6
46039,Geordie_LaFarge,,18,167,271,438
46040,surrient,,1,2,3,5
46041,gameguy56,,31,180,290,470
46042,obb,,19,26,42,68
46043,badkins79,,31,7,5,12
46044,JayBlRD,,18,99,170,269
46045,jeshkah,,18,6,7,13
46046,Isamoor,,35,5,3,8
46047,beager,,30,72,97,169
46048,katanasun,,43,1,1,2
46049,owo,,18,83,43,126
46050,krunk7,,31,1,1,2
46051,barryqq,,16,4,1,5
46052,whitesilence,,12,2,2,4
46053,BoogerPresley,,19,7,16,23
46054,jon,,20,14,4,18
46055,gtttssyd,,15,6,10,16
46056,bastardo,,43,115,210,325
46057,freerein,,34,5,6,11
46058,pinguis,,1,17,27,44
46059,epithet,,34,36,71,107
46060,s1l1c0n3,,4,2,2,4
46061,mimiro,,8,3,2,5
46062,bprajapa,,18,1,7,8
46063,alastormoody,,13,11,13,24
46064,BrendanSheehan,,19,205,411,616
46065,incubii,,20,6,9,15
46066,bageloid,,42,38,64,102
46067,diggitySC,,19,28,5,33
46068,PussySnatcher,,19,174,209,383
46069,bitdamaged,,20,26,33,59
46070,rkirkpatrick,,1,5,6,11
46071,drhmd124,,29,1,1,2
46072,kewlsites,,18,1,1,2
46073,inefekt,,18,30,33,63
46074,Owan,,18,14,32,46
46075,Sumguy42,,32,1,3,4
46076,ControlSix,,1,22,47,69
46077,antoinedurr,,8,1,2,3
46078,entropic,,1,52,133,185
46079,skilian,,11,2,5,7
46080,RussWellen,,19,76,4,80
46081,lintonkewsijohnson,,34,11,10,21
46082,quintessential,,18,5,6,11
46083,frankhinton,,19,1,4,5
46084,Joe_Clarks_Lawyer,,14,1,2,3
46085,erasmosis,,18,30,59,89
46086,bgutz,,1,3,3,6
46087,kksm19820117,,20,25,9,34
46088,martyf,,27,71,51,122
46089,smashey,,13,52,103,155
46090,FlorentG,,18,55,27,82
46091,Alphaman88,,0,64,119,183
46092,Noink,,43,143,94,237
46093,Faldane,,19,3,1,4
46094,runeinalya,,1,24,60,84
46095,huffer,,0,21,23,44
46096,greeenpro,,18,1,2,3
46097,EFG,,16,870,788,1658
46098,Ndel,,19,19,13,32
46099,jak2yak,,32,6,1,7
46100,WATERISRUNBYTHEGOVT,,32,4,3,7
46101,nelsongauthier,,18,16,9,25
46102,123412341234,,18,16,72,88
46103,louisvillegeek,,20,4,3,7
46104,Gargan,,1,1,2,3
46105,swimsfast99,,13,5,3,8
46106,eyenetics,,1,2,5,7
46107,glparramatta,,13,116,5,121
46108,sskkrajak,,13,1,1,2
46109,i_am_nicky_haflinger,,18,3,4,7
46110,cyangcn,,20,20,5,25
46111,pimpness525,,41,4,2,6
46112,thequux,,20,5,17,22
46113,sippindrank,,13,4,29,33
46114,hherbzilla,,13,17,14,31
46115,firepoiboy,,13,5,2,7
46116,ghettopia,,18,21,43,64
46117,biomath,,5,8,1,9
46118,kikaluca,,18,5,9,14
46119,dietermacht,,39,1,2,3
46120,mwilke,,6,158,211,369
46121,silvestre,,20,61,8,69
46122,Mighterbump,,43,1,1,2
46123,dboyd,,30,14,13,27
46124,exhiled,,34,1,2,3
46125,protothomas,,4,16,7,23
46126,suplicant,,18,18,1,19
46127,the4iron,,19,6,11,17
46128,reventlov,,20,14,25,39
46129,interhuss,,6,7,3,10
46130,bd31,,6,50,52,102
46131,AnotherLurker,,19,5,7,12
46132,jjwitty,,30,2,1,3
46133,twoboysathome,,30,1,1,2
46134,BrunoX,,13,1,2,3
46135,crapuser1963,,36,4,4,8
46136,styless,,32,6,12,18
46137,json684,,9,1,5,6
46138,everynamewastaken,,43,18,23,41
46139,barackoblogger,,19,373,43,416
46140,uberamd,,20,323,271,594
46141,foxyphoenix,,18,4,2,6
46142,808blogger,,2,5,4,9
46143,2008_Man,,5,1,2,3
46144,inkyimp,,5,1,1,2
46145,bcc,,3,1,1,2
46146,createanew,,36,2,1,3
46147,PsyanideInk,,18,9,10,19
46148,viraptor,,20,93,65,158
46149,jozwiakjohn,,20,2,2,4
46150,0xdefec8,,19,86,68,154
46151,type102,,30,7,23,30
46152,anti_dentite,,0,49,48,97
46153,antirez,,20,142,127,269
46154,thesubmitter,,20,10,3,13
46155,ronpaulsux,,19,1,2,3
46156,unsaneroot,,13,1,3,4
46157,borramakot,,8,16,26,42
46158,yourpopquizkid,,1,131,144,275
46159,fearimas,,20,66,24,90
46160,abhik,,20,62,101,163
46161,dlsspy,,20,244,332,576
46162,kevin61,,19,2,1,3
46163,hello,,19,11,22,33
46164,imaverick,,20,1,3,4
46165,broucks,,10,1,1,2
46166,segrev,,1,11,11,22
46167,LeChuck,,1,364,226,590
46168,Xoya,,18,10,10,20
46169,meatgrinder,,20,3,3,6
46170,danima,,18,1,1,2
46171,GPnZPl,,19,74,72,146
46172,zoomzoom83,,15,1028,808,1836
46173,Mutton,,12,10,8,18
46174,IrishJoe,,13,389,792,1181
46175,shatterly,,5,54,75,129
46176,historycycles,,30,43,5,48
46177,factcheck,,32,1,1,2
46178,Moschops,,21,2,4,6
46179,doesnotunderstand,,18,3,3,6
46180,noaliasneeded,,31,1,1,2
46181,silyputdy,,20,2,5,7
46182,NewWorldOrder,,19,1,4,5
46183,mark-e-mark,,36,4,9,13
46184,butlertd,,34,48,59,107
46185,weneedsound,,28,2,2,4
46186,tornadohead,,1,16,12,28
46187,masnevets,,1,12,5,17
46188,waxxie,,43,1,1,2
46189,no_you_didnt,,34,1,1,2
46190,headchecked,,0,3,5,8
46191,trolldownmodmetohell,,13,125,11,136
46192,Mr_Zero,,13,335,369,704
46193,ginstrom,,20,7,10,17
46194,evolve236,,31,2,3,5
46195,SquirrelyWhirly,,39,2,4,6
46196,alanmagid,,26,1,1,2
46197,SolarBear,,20,9,20,29
46198,Disturbia,,31,1,1,2
46199,Bort74,,15,5,5,10
46200,petresq,,18,1,1,2
46201,unicornologist,,1,7,17,24
46202,shirizvi,,21,3,2,5
46203,tesseracter,,18,258,412,670
46204,diecast,,30,77,156,233
46205,hyprkd,,20,3,2,5
46206,soyko,,1,36,59,95
46207,HenkPoley,,20,204,450,654
46208,cowpunk52,,13,54,15,69
46209,DownVotesMakeMeHorny,,18,8,5,13
46210,shawnofthedead,,20,19,21,40
46211,ssj4megaman,,17,1,1,2
46212,jayunit,,20,11,14,25
46213,haihaibai,,4,1,2,3
46214,shimamoto,,1,15,22,37
46215,jwl23,,13,1,1,2
46216,jwbernier2,,1,29,28,57
46217,foible,,18,1,9,10
46218,ice101a,,19,2,2,4
46219,Lawen,,22,1,1,2
46220,doublethink,,20,4,1,5
46221,vcxz1,,18,12,24,36
46222,messup000,,18,6,2,8
46223,sakri,,18,181,92,273
46224,ThatSomaliGuy,,22,8,10,18
46225,Yeroc,,18,1,3,4
46226,ghost11,,31,5,4,9
46227,shacklefordrusty,,14,10,6,16
46228,JonGretar,,12,6,13,19
46229,ykaw97,,0,1,1,2
46230,sideshowian,,30,30,12,42
46231,spacemeat,,19,2,1,3
46232,athorpedo,,43,64,137,201
46233,bifftradwell,,43,10,22,32
46234,severedcross,,20,22,14,36
46235,bleidl,,20,1,1,2
46236,janus303,,4,12,1,13
46237,atatat,,1,21,20,41
46238,cainpitt,,42,14,12,26
46239,Uncle-Bob,,18,19,18,37
46240,alright,,22,1,1,2
46241,naveloc,,19,2,1,3
46242,kombitwen,,27,2,1,3
46243,agentdcooper,,29,5,4,9
46244,MonicaShi,,19,313,5,318
46245,smitty22,,31,82,104,186
46246,whatthehell9,,5,14,17,31
46247,ezran,,20,16,3,19
46248,winzippy,,1,28,16,44
46249,PermaSolutions,,13,28,3,31
46250,dcowboy,,19,2,4,6
46251,celticeric,,0,48,83,131
46252,mormagli,,18,4,13,17
46253,jogloran,,20,13,22,35
46254,Thinksforfun,,1,372,213,585
46255,SagaLhan,,22,8,7,15
46256,nerdland,,18,1,2,3
46257,y_gingras,,20,28,23,51
46258,sdlee,,43,7,9,16
46259,malloc,,22,155,265,420
46260,spyd3rweb,,13,115,250,365
46261,technomancy,,20,80,147,227
46262,IcedPenguin,,20,1,1,2
46263,tsuru,,20,27,24,51
46264,ByronMackelroy,,19,4,3,7
46265,Hargrove,,35,3,1,4
46266,-_-,,20,79,123,202
46267,grandericca,,20,2,1,3
46268,aesova,,1,2,10,12
46269,cadr,,20,10,22,32
46270,cjjsteele,,31,7,4,11
46271,nobodyman,,10,4,4,8
46272,soakes,,32,22,34,56
46273,sinisterduck,,14,2,1,3
46274,playeren,,19,17,39,56
46275,jimgaudet,,13,10,3,13
46276,stephengeorge,,19,2,7,9
46277,squerl,,42,10,9,19
46278,the_slowpoke,,43,23,32,55
46279,mwittlief,,13,1,1,2
46280,tomonly,,34,51,23,74
46281,crumbsmashT,,18,1,1,2
46282,kdfrawg,,5,4,8,12
46283,ChunkyLaguna,,20,15,35,50
46284,come_down_david,,26,2,1,3
46285,HenryCruz,,13,53,2,55
46286,philhassey,,20,9,4,13
46287,antisense,,4,50,8,58
46288,simonk,,42,5,4,9
46289,sendmefunnystuff,,5,4,4,8
46290,jollywhitegiant,,0,6,9,15
46291,PaulAtreides,,34,1,1,2
46292,musered,,1,1,1,2
46293,metalmoon,,19,33,42,75
46294,biggsuccess,,14,1,1,2
46295,zenrenity,,3,24,12,36
46296,wintheday,,42,8,5,13
46297,jmail69,,19,427,787,1214
46298,UrbanDEV,,18,4,21,25
46299,bradfitz,,20,16,19,35
46300,zzoomzzoomzzoom,,18,8,2,10
46301,f0nd004u,,43,274,444,718
46302,joshcarter,,20,1,3,4
46303,spinlock,,10,190,298,488
46304,justinlilly,,20,6,2,8
46305,wearevotingyes,,13,66,7,73
46306,Manthem,,18,15,1,16
46307,rushmc1,,20,5,5,10
46308,rdicker,,31,79,83,162
46309,jemminger,,18,167,245,412
46310,trasputin,,22,12,19,31
46311,MattyH,,43,63,27,90
46312,FatesUrinal,,43,7,12,19
46313,sharjeel,,20,6,1,7
46314,roguetue,,1,13,14,27
46315,jabber,,19,2,3,5
46316,hikarudo,,20,1,1,2
46317,jeremy,,20,7,15,22
46318,LissaJ,,34,1,3,4
46319,goggwah,,15,2,2,4
46320,Riman34,,19,51,117,168
46321,colcob,,3,140,159,299
46322,FeloniaChampagne,,13,208,352,560
46323,endoverender,,1,3,7,10
46324,allahuakbar79,,18,758,288,1046
46325,knsmr,,19,5,4,9
46326,mab98122,,6,4,10,14
46327,cleverkid,,38,168,342,510
46328,vilnius,,43,4,4,8
46329,HCACAC,,22,1,1,2
46330,JackAcid,,0,1,2,3
46331,bubasmith,,20,2,1,3
46332,khavark,,5,9,5,14
46333,chriscox,,0,4,6,10
46334,chadmill3r,,32,24,30,54
46335,Benzona,,5,260,318,578
46336,mcavoy76,,20,1,1,2
46337,bandolier,,34,273,90,363
46338,cskozmo,,12,3,3,6
46339,bsdfish,,20,12,8,20
46340,fix3r,,20,3,8,11
46341,jml94,,0,209,65,274
46342,phreadom,,19,14,8,22
46343,dali,,5,4,3,7
46344,mousegrade,,20,1,1,2
46345,Tribecallednick,,10,2,1,3
46346,incodwetrust,,31,3,5,8
46347,bsitty,,18,5,5,10
46348,astroturf,,18,31,51,82
46349,JQSauvage,,31,7,11,18
46350,fishstickz,,1,58,1,59
46351,translurker,,20,5,3,8
46352,selfstarter,,2,5,2,7
46353,cpuenvy,,19,1,1,2
46354,FANGO,,10,566,677,1243
46355,aldarion,,20,16,28,44
46356,dimgn,,20,1,2,3
46357,TylerBlue,,25,3,6,9
46358,groug,,18,9,25,34
46359,Pyroman82,,34,1,1,2
46360,imfat,,18,23,17,40
46361,izzycat,,20,174,292,466
46362,csgordon,,20,2,6,8
46363,kookoobear,,19,8,3,11
46364,mpeters13,,43,5,4,9
46365,Riemann,,20,2,4,6
46366,KJEveryday,,18,25,23,48
46367,masonlee,,13,4,6,10
46368,libinpan,,20,2,1,3
46369,Yashkir,,20,16,15,31
46370,STE_V_P,,1,1,3,4
46371,msadgrove,,13,1,4,5
46372,Useless,,19,81,132,213
46373,bostich,,29,3,3,6
46374,JoeTheProgrammer,,20,23,36,59
46375,nfinite79,,18,7,19,26
46376,DukunSakti,,13,30,5,35
46377,pippy,,18,62,76,138
46378,bonafidebob,,32,2,1,3
46379,HigheR,,27,3,3,6
46380,theanimation,,35,78,47,125
46381,toasterweasel,,18,41,62,103
46382,whobutsb,,43,2,8,10
46383,petervk,,20,1,2,3
46384,AMACTASTIC55k,,18,51,81,132
46385,tungsten,,1,42,93,135
46386,boyfarrell,,20,5,8,13
46387,fruitbaticus,,1,30,25,55
46388,Politico,,13,5,8,13
46389,cdub,,18,79,127,206
46390,fatgirls,,13,1,2,3
46391,chrysb,,19,327,13,340
46392,jamiiecb,,20,4,8,12
46393,DKS,,43,23,20,43
46394,Hecks,,36,4,7,11
46395,tonyclifton,,0,51,57,108
46396,rdewalt,,43,38,48,86
46397,cputney,,20,3,5,8
46398,pygstasis,,18,2,3,5
46399,matiasklein,,43,383,2,385
46400,mattyandco,,1,3,5,8
46401,r3c1pr0city,,18,2,2,4
46402,repiret,,20,66,110,176
46403,gxti_,,13,2,1,3
46404,omgosh,,43,95,123,218
46405,Greasy,,18,247,46,293
46406,Jethrokill,,12,55,64,119
46407,ovoutland,,1,86,139,225
46408,MKE1138,,18,4,3,7
46409,smelendez,,19,17,19,36
46410,barcodez,,0,130,51,181
46411,bcroq,,18,17,1,18
46412,jessinamercy,,18,2,2,4
46413,UnitedModerate,,13,105,105,210
46414,igfoo,,20,14,1,15
46415,chux52,,19,8,18,26
46416,jjb123,,42,53,45,98
46417,leddit669,,19,3,6,9
46418,mistyriver,,30,64,107,171
46419,IDrinkYourMilkshake,,13,2,1,3
46420,thequantumflux,,13,6,26,32
46421,the_sheeple_waker,,6,1,1,2
46422,etaoin,,36,1,1,2
46423,iceman989,,32,2,1,3
46424,Laughsatyou,,13,5,11,16
46425,Stingo,,13,219,2,221
46426,nwow,,18,2,4,6
46427,jalada,,20,5,4,9
46428,gnarly,,31,1,1,2
46429,dexter1,,22,9,6,15
46430,pxa270,,13,68,22,90
46431,StarkRavingChad,,22,53,56,109
46432,modigitz,,13,2,2,4
46433,thevarsity,,5,2,2,4
46434,Newtrino,,1,7,9,16
46435,kolas,,5,1,1,2
46436,DarkDIscordian,,31,5,8,13
46437,LeBain,,5,1,1,2
46438,hugthevegan,,19,6,7,13
46439,BobbleBobble,,13,9,5,14
46440,srikanthmeenakshi,,19,33,6,39
46441,thethorn,,18,7,4,11
46442,iso3200,,32,5,4,9
46443,johnbrownks,,19,40,2,42
46444,golyadkin,,13,25,67,92
46445,lemming,,1,209,370,579
46446,xeren,,1,1,3,4
46447,Pootananny,,32,1,1,2
46448,polebridge,,31,6,2,8
46449,reddittookme,,13,75,129,204
46450,naughtymonkey69,,18,38,54,92
46451,wolfzero,,22,424,668,1092
46452,rabbiccu,,1,6,11,17
46453,yellowjacketcoder,,3,50,52,102
46454,pedomorphic,,13,13,26,39
46455,fadi420,,43,13,6,19
46456,jimma,,43,2,3,5
46457,SamuelDr,,20,16,24,40
46458,triedntrue,,43,2,4,6
46459,chrisclan1903,,1,1,9,10
46460,Epetaizana,,18,48,65,113
46461,EyesBlu,,12,1,1,2
46462,iscariotwon,,18,34,44,78
46463,nonnymoose,,18,5,1,6
46464,APOCALYPTICFUCKFEST,,34,7,20,27
46465,hotwingbias,,16,957,405,1362
46466,darntastic,,22,137,154,291
46467,wuzzard,,20,20,21,41
46468,themisanthrope,,1,262,362,624
46469,cuj0,,18,4,8,12
46470,alalal,,13,4,8,12
46471,whao,,16,22,18,40
46472,v01c30fr3a50n,,13,6,11,17
46473,TheHobo42,,43,1,3,4
46474,Redmushroom,,5,41,50,91
46475,dagro,,1,1,1,2
46476,jester02k,,30,3,10,13
46477,sibilant-ess,,43,93,164,257
46478,zoziw,,0,33,21,54
46479,sethg,,20,39,69,108
46480,jrettin08,,13,1,1,2
46481,jtra,,20,30,29,59
46482,Davisourus,,22,108,94,202
46483,ChrisOz,,4,1,5,6
46484,corinney,,32,6,4,10
46485,waveringhobbit,,0,33,31,64
46486,dugb,,3,3,1,4
46487,JimXugle,,8,90,144,234
46488,bradle,,18,2,8,10
46489,rapope001,,19,7,9,16
46490,bob11235,,19,22,55,77
46491,shoombabi,,43,189,210,399
46492,markovnikov,,21,6,3,9
46493,dminor9,,18,2,4,6
46494,williadc,,32,8,20,28
46495,pastordan,,39,2,1,3
46496,zj5u3n3,,13,20,18,38
46497,sonanz,,43,1,7,8
46498,rabidfurby,,14,4,4,8
46499,dreman,,18,79,29,108
46500,zushiba,,18,10,25,35
46501,carpart,,18,5,3,8
46502,LolitaChiquita,,20,1,1,2
46503,notlad,,32,1,1,2
46504,mohitgupta,,26,2,1,3
46505,virga,,1,38,22,60
46506,mike73737,,18,1,1,2
46507,rxchatters,,19,4,7,11
46508,panicbombs,,18,19,15,34
46509,Whim,,19,12,12,24
46510,lectrick,,32,438,709,1147
46511,MegaManSE,,22,6,5,11
46512,lordcrimmeh,,13,1,4,5
46513,the87boy,,22,5,6,11
46514,trachea,,31,25,22,47
46515,redcsh,,34,2,1,3
46516,fantasticFlan,,42,34,69,103
46517,Grimalkin,,34,1177,841,2018
46518,crazyhippyguy,,30,2,1,3
46519,DogtorEvil,,13,12,15,27
46520,erdie721,,19,103,27,130
46521,tomdoggett,,13,13,21,34
46522,email,,34,100,128,228
46523,kija,,30,3,7,10
46524,voyagerfan5761,,1,44,53,97
46525,mfryc,,30,2,6,8
46526,nerdduer,,0,1,1,2
46527,dnindza,,13,10,12,22
46528,octalespresso,,13,54,123,177
46529,ignore_me,,13,8,44,52
46530,annieface,,0,9,17,26
46531,trymelolr,,0,17,1,18
46532,saldane,,30,1,1,2
46533,forgetu,,19,83,18,101
46534,md81544,,20,41,76,117
46535,jgallagher721,,42,1,1,2
46536,jester340,,13,1,2,3
46537,theinsectgod,,32,1,2,3
46538,LoadPuller,,18,30,137,167
46539,0point,,27,12,18,30
46540,d0_ob,,6,304,337,641
46541,darthdaddy,,1,21,6,27
46542,BrickSalad,,31,433,756,1189
46543,aucourant,,32,4,5,9
46544,WasabiBomb,,6,9,3,12
46545,gfarfl,,20,4,3,7
46546,harry321,,18,48,55,103
46547,videzlamer,,13,14,10,24
46548,ramdaskm,,13,19,42,61
46549,qrios,,17,39,32,71
46550,redafa,,20,5,8,13
46551,zoweee,,13,17,36,53
46552,chicagosnafu,,20,1,1,2
46553,fcanas,,18,22,41,63
46554,frankidadio,,13,7,9,16
46555,crazyfist,,18,15,17,32
46556,Exit,,1,8,13,21
46557,Eijin,,3,279,421,700
46558,nihil161,,19,11,16,27
46559,WorcesterM,,19,60,134,194
46560,ezrydn,,4,1,1,2
46561,rrubin5,,19,1,1,2
46562,krystyin,,13,2,1,3
46563,dcoutts,,20,17,29,46
46564,Phibbsy,,13,3,12,15
46565,coblenis,,30,1,1,2
46566,inrelief,,2,15,29,44
46567,Amberkins,,3,1,1,2
46568,neatopat,,29,153,113,266
46569,but_I_eated_it,,1,31,25,56
46570,bigtech,,1,165,231,396
46571,gezgin,,34,135,28,163
46572,danmuz,,20,1,1,2
46573,kirkland,,1,14,15,29
46574,throwaway,,19,222,310,532
46575,lazed_and_confused,,17,154,90,244
46576,notmynormalaccount,,18,5,2,7
46577,AnyColourYouLike,,20,4,2,6
46578,DearSergio,,1,6,6,12
46579,narziss,,20,1,3,4
46580,logan_capaldo,,20,202,365,567
46581,Angry_Grammarian,,31,33,25,58
46582,05caniffa,,1,1,6,7
46583,kevinh243432,,13,3,4,7
46584,semi_colon,,1,227,146,373
46585,sri1025,,20,37,3,40
46586,stephenflanagan,,20,4,6,10
46587,hbop,,6,14,16,30
46588,craig12,,14,3,4,7
46589,dudermcgavin,,20,4,4,8
46590,srikanth1k,,11,11,29,40
46591,gimpy454,,20,5,8,13
46592,jerryF,,13,69,171,240
46593,an_exscientologist,,31,5,14,19
46594,Svelmoe,,19,4,4,8
46595,jtbrubaker,,20,3,3,6
46596,IAMIAM,,19,26,5,31
46597,nokia123,,43,6,3,9
46598,ambrose6969,,0,2,1,3
46599,dabhaid,,4,90,79,169
46600,freerider,,7,61,34,95
46601,gtfbfan,,5,1,3,4
46602,_pi,,20,86,122,208
46603,mattowings,,5,1,4,5
46604,leek,,18,68,50,118
46605,ikon,,27,6,14,20
46606,mattucf,,20,15,30,45
46607,codeman122281,,34,1,1,2
46608,nkathman,,15,2,2,4
46609,creiht,,20,24,8,32
46610,netshade,,20,2,3,5
46611,johnkicks,,0,2,5,7
46612,slurpme,,42,606,982,1588
46613,dsol,,19,44,46,90
46614,loicl,,17,6,20,26
46615,nerdalert,,0,1,3,4
46616,taoofthe777,,9,3,1,4
46617,subterfu9e,,22,1,1,2
46618,docsavage96,,13,172,422,594
46619,alapanacran,,0,260,1,261
46620,frederich,,32,2,5,7
46621,thehellandback,,31,237,38,275
46622,MagicWishMonkey,,19,155,190,345
46623,beatmaster23,,43,7,6,13
46624,dokkah,,13,4,3,7
46625,newsbulletin,,13,98,67,165
46626,eggertm,,20,12,23,35
46627,zimbu,,13,6,7,13
46628,souledge,,20,2,2,4
46629,jasonn,,13,5,10,15
46630,Skolanthropy,,13,3,9,12
46631,Lindsjam,,4,6,4,10
46632,tgbanks,,18,37,1,38
46633,kelsey_leigh,,30,38,44,82
46634,OdinYgg,,1,15,18,33
46635,jdetc,,13,1,1,2
46636,hector_villalobos,,20,53,5,58
46637,therna4,,31,31,41,72
46638,psycop,,19,11,58,69
46639,josiah,,20,6,2,8
46640,guruz,,10,1,1,2
46641,bagoftricks,,19,8,8,16
46642,vennatorr,,5,3,9,12
46643,tgoff,,26,9,17,26
46644,Puntas13,,13,57,95,152
46645,reelactor,,0,5,6,11
46646,barbear3,,20,103,8,111
46647,aranach,,13,5,17,22
46648,nramenta,,20,5,9,14
46649,acidmoose,,16,2,1,3
46650,fliffr,,11,2,5,7
46651,michaelreddit,,20,1,2,3
46652,bobbykyn,,18,60,121,181
46653,heptadecagram,,20,222,301,523
46654,fishpillow,,18,5,14,19
46655,debtfreerevolution,,19,7,3,10
46656,mikelieman,,19,26,54,80
46657,wynand,,20,2,4,6
46658,tbaker13,,13,16,1,17
46659,cooleyandy,,3,1,6,7
46660,plancton,,42,1,2,3
46661,modix,,19,28,40,68
46662,snowboarder04,,18,1,3,4
46663,kmgraba,,32,12,19,31
46664,aal,,20,3,2,5
46665,John_SIDNEY_McCain,,31,2,1,3
46666,reelectnoone,,13,22,4,26
46667,rats99ass,,30,483,255,738
46668,tqless,,34,3,7,10
46669,URanINSTRUMENT,,13,1,3,4
46670,spuur,,20,193,270,463
46671,ilovegays,,35,2,1,3
46672,random007,,43,1,1,2
46673,inept,,0,17,36,53
46674,congofriends,,1,2,2,4
46675,Jofeshenry,,42,16,8,24
46676,nypen,,20,23,30,53
46677,muzthe42nd,,20,54,51,105
46678,zygotene,,13,1,1,2
46679,proudcanadianeh,,1,468,229,697
46680,sadboy,,34,5,13,18
46681,MrRed,,16,2,6,8
46682,robroe,,11,3,3,6
46683,fixxxer,,31,1,1,2
46684,metagame,,43,4,2,6
46685,regulati0n,,42,1,1,2
46686,stevehl42,,13,4,3,7
46687,Jafishman,,13,2,1,3
46688,jugalator,,43,867,1091,1958
46689,crazy_horce,,19,27,36,63
46690,LOLTEHINTARWEB,,43,47,99,146
46691,rgladwell,,14,11,11,22
46692,innerpenguin,,34,107,53,160
46693,j4ded,,18,6,11,17
46694,fuhkinglou,,18,2,2,4
46695,Linkerator,,22,1,1,2
46696,Bobwise,,1,288,215,503
46697,itsmeront,,20,17,3,20
46698,hobbs,,9,1,1,2
46699,dalziel,,15,184,30,214
46700,crucifi3d,,5,1,2,3
46701,LizaP,,13,16,27,43
46702,lemmycaution,,34,1,1,2
46703,mikkom,,7,267,268,535
46704,availle,,22,6,5,11
46705,NMom,,31,27,1,28
46706,axemachine,,13,1,4,5
46707,ASUSasquatch,,42,1,1,2
46708,AskBitterman,,43,61,5,66
46709,JTPalm,,18,74,11,85
46710,daggity,,18,219,329,548
46711,performance,,31,71,112,183
46712,ChainsawRadio,,18,25,41,66
46713,paulsondan,,34,1,2,3
46714,cvrc,,1,3,12,15
46715,kevev,,13,10,16,26
46716,sanguivor,,22,14,3,17
46717,larryobrien,,20,3,3,6
46718,vaginator,,31,17,9,26
46719,omfgninja,,1,843,563,1406
46720,bombtea,,1,1,1,2
46721,Sarmacid,,1,2,3,5
46722,JimmyE,,43,3,1,4
46723,mobyhead,,4,1,2,3
46724,cschneid,,20,263,427,690
46725,alan-dean,,20,3,4,7
46726,oxowowmom,,11,4,3,7
46727,tzigane,,4,15,6,21
46728,jfcshow,,18,2,2,4
46729,kohno214,,36,1,3,4
46730,Lodoss,,19,19,20,39
46731,semperfido,,19,2,8,10
46732,lllurker,,18,2,3,5
46733,ThatsSoLana,,18,70,113,183
46734,wolfsktaag,,12,8,12,20
46735,winstonsmithgo,,3,7,1,8
46736,Anachronox0666,,1,121,45,166
46737,grantbee,,1,1,3,4
46738,everyone_is_a_robot,,18,27,60,87
46739,Admiral_Obvious,,31,1,1,2
46740,titolaser,,6,7,10,17
46741,gbills,,32,1,1,2
46742,mattevans,,43,388,24,412
46743,mobiuschic42,,18,49,73,122
46744,hdcs,,13,50,90,140
46745,Speff,,42,42,57,99
46746,LuciWiz,,20,2,3,5
46747,wormfist,,20,7,11,18
46748,obiefernandez,,20,7,2,9
46749,FREEFREEFREE,,42,7,5,12
46750,GregorCZ,,1,165,161,326
46751,Ssquared22,,5,6,6,12
46752,crnflke,,20,4,8,12
46753,Billiam1975,,13,535,376,911
46754,piratetelecast,,34,157,176,333
46755,gtg409y,,0,5,6,11
46756,pennyfx,,32,181,55,236
46757,JayyMan,,34,4,5,9
46758,myddrn,,18,114,180,294
46759,Captain-Ironic,,14,2,5,7
46760,tobsn,,32,57,26,83
46761,domesticmouse,,29,1,2,3
46762,anelson,,20,2,1,3
46763,madmoose,,20,5,9,14
46764,bnikolictech,,20,13,5,18
46765,jjmichaud,,13,40,15,55
46766,colleenmarystone,,16,2,1,3
46767,IsotopeOrange,,42,1,2,3
46768,GrandMoffTarkin,,30,10,8,18
46769,inigo_montoya,,19,33,59,92
46770,vr19976,,5,3,2,5
46771,restriction,,19,1,3,4
46772,7aylor,,1,101,143,244
46773,HughJass,,34,13,15,28
46774,sputz,,18,88,79,167
46775,fierarul,,20,84,99,183
46776,planet808,,12,2,1,3
46777,solson,,19,102,8,110
46778,dmaclean,,13,1,1,2
46779,karlhungus03,,19,2,1,3
46780,bloohurry,,13,2,3,5
46781,maxwalker,,4,1,3,4
46782,Bavaron,,32,6,4,10
46783,ooorrr,,29,1,2,3
46784,imreddiru,,33,1,1,2
46785,liberty4all,,43,119,94,213
46786,null_vector,,20,18,29,47
46787,chaoticsynergy,,20,2,3,5
46788,ressu,,20,2,3,5
46789,ooboo111,,12,2,1,3
46790,redsquirrel,,12,3,1,4
46791,besst,,12,9,31,40
46792,lukasmach,,1,24,21,45
46793,ryan7575,,18,32,31,63
46794,fsadfasdfsa,,4,1,2,3
46795,DanRisinger,,13,5,3,8
46796,t3rmv3locity,,13,1,1,2
46797,mpgilmore,,20,2,2,4
46798,tazer,,3,5,3,8
46799,peterzero,,15,14,11,25
46800,NotFake,,13,2,8,10
46801,rer0tsaz,,20,25,36,61
46802,nzeeshan,,17,757,442,1199
46803,hikingisfun,,5,65,34,99
46804,-Borfo-,,13,24,42,66
46805,OpenMIKE,,20,1,7,8
46806,drinksnapple,,1,1,1,2
46807,actionscripture,,11,16,20,36
46808,hewhodoes,,31,2,7,9
46809,boat,,36,5,9,14
46810,garye9695,,22,1,1,2
46811,malph,,34,1,1,2
46812,Saydrah,,39,2848,1033,3881
46813,aludwin,,6,24,45,69
46814,askspike,,13,3,2,5
46815,arjung,,18,18,16,34
46816,yuh,,19,181,131,312
46817,everclearbeer,,29,1,1,2
46818,hiffy,,20,418,550,968
46819,roxet,,13,23,19,42
46820,o25667,,20,2,4,6
46821,mikaelstaldal,,20,19,25,44
46822,starchild718,,34,1,1,2
46823,guillebravo6,,5,534,82,616
46824,SND_Crow,,42,268,384,652
46825,RockFromDot,,13,81,38,119
46826,thisracetodie,,13,4,5,9
46827,Starch,,1,213,230,443
46828,katowich,,34,1,1,2
46829,ElDiablo909,,6,1,1,2
46830,GeneralChaos,,1,6,4,10
46831,goodhairsE,,22,1,1,2
46832,HiDigger,,34,1,2,3
46833,wastelands,,13,222,229,451
46834,slantysideways,,22,5,6,11
46835,valnour,,20,3,6,9
46836,badgerboy,,34,10,1,11
46837,BannerBearer,,13,55,132,187
46838,tchesko,,18,1,1,2
46839,brentlewiis,,18,3,1,4
46840,monkeybird,,30,49,96,145
46841,gloopyest,,10,3,3,6
46842,schmendrick,,29,76,110,186
46843,denver38,,22,88,85,173
46844,wizpig64,,1,4,4,8
46845,peggyblah,,13,51,97,148
46846,negatroyd,,0,1,1,2
46847,dermdoc,,5,6,11,17
46848,opqdonut,,20,1,2,3
46849,socioblogo,,19,3,6,9
46850,jburksme,,18,4,6,10
46851,zora666,,19,7,11,18
46852,sitemarker,,20,4,1,5
46853,molasse,,43,15,14,29
46854,The_LORD,,22,5,8,13
46855,Calvin_the_Bold,,17,137,114,251
46856,trentrez,,43,16,15,31
46857,Set_it_right,,1,38,39,77
46858,oddmanout,,16,1146,1370,2516
46859,IQue,,1,93,55,148
46860,Ron_Epp,,18,20,41,61
46861,hngovr,,13,10,41,51
46862,HankTavish,,30,6,10,16
46863,creative4w3,,0,2,5,7
46864,patrycja1,,13,1,1,2
46865,Muggi,,14,6,4,10
46866,chetg,,43,2,11,13
46867,kalazar,,32,310,338,648
46868,greaterking,,6,2,1,3
46869,Ajju,,19,124,95,219
46870,teval,,20,174,207,381
46871,chrxs,,0,106,98,204
46872,adoarns,,13,70,97,167
46873,EggnogAssassin,,0,54,52,106
46874,balazsbela,,20,13,24,37
46875,RageX,,32,9,10,19
46876,Spanglegluppet,,1,582,382,964
46877,protell,,18,492,83,575
46878,billawesome,,22,15,2,17
46879,reenymal,,31,11,1,12
46880,vamosscorcho,,43,58,77,135
46881,pdebie,,20,1,1,2
46882,kldf,,18,1,1,2
46883,jimjimbay,,19,10,7,17
46884,greeen_,,1,22,21,43
46885,psec,,43,58,4,62
46886,lilmissgenius200,,18,2,6,8
46887,forming,,29,12,32,44
46888,pooslinger,,32,6,3,9
46889,daysi,,19,567,874,1441
46890,nitroy2k,,13,4,1,5
46891,erikmack,,20,17,19,36
46892,IAteUrMama,,18,42,9,51
46893,elector69,,30,1,1,2
46894,franktank2008,,13,1,1,2
46895,Barttd,,0,4,3,7
46896,steveuk51,,27,10,3,13
46897,packetguy,,22,115,274,389
46898,_neutrino,,19,3,3,6
46899,timewarp,,42,364,504,868
46900,btakita,,20,43,47,90
46901,ringm,,22,89,129,218
46902,Grakiko,,18,83,182,265
46903,tflo729,,18,1,1,2
46904,nazi-cop,,10,1,2,3
46905,chiarafox,,36,8,2,10
46906,amfortas,,20,1,3,4
46907,jadertots,,31,1,1,2
46908,tehl3x,,18,12,10,22
46909,kinetics,,17,12,39,51
46910,guy231,,13,62,126,188
46911,stuntant,,18,3,2,5
46912,swampsparrow,,18,5508,1008,6516
46913,leonard_koan,,1,78,65,143
46914,un-mercy,,4,1,1,2
46915,mizled,,1,32,8,40
46916,CerpinTaxt101,,6,1,1,2
46917,onoj,,19,1,2,3
46918,youjani,,19,2,2,4
46919,lani,,20,37,150,187
46920,disposable,,18,1,4,5
46921,silentjudas,,13,3,3,6
46922,nporiord,,22,1,1,2
46923,spin0,,30,1,1,2
46924,ideonode,,22,355,333,688
46925,eightballart,,39,1,1,2
46926,wackoman,,18,26,37,63
46927,dean16,,30,17,11,28
46928,dingobongo,,20,2,4,6
46929,grigri,,20,22,37,59
46930,brotherxiao,,20,3,3,6
46931,pavel_lishin,,5,1259,1620,2879
46932,harrycary,,42,1,2,3
46933,danboh6,,19,2,4,6
46934,Ninjazn,,18,1,11,12
46935,space_cowboy,,13,17,22,39
46936,danvk,,20,6,10,16
46937,lelechuck,,26,140,178,318
46938,xyzzy9000,,18,1,3,4
46939,codejunki,,10,21,13,34
46940,marky125,,19,8,16,24
46941,ardil,,43,24,44,68
46942,asragov,,31,6,5,11
46943,Pangloss09,,32,12,11,23
46944,Neuroscoot,,13,64,128,192
46945,redlantern,,20,18,15,33
46946,mike_carmichael,,9,2,3,5
46947,niki78,,20,4,3,7
46948,ether_reddit,,30,35,61,96
46949,rjst01,,15,11,11,22
46950,conceptkid,,19,1,2,3
46951,flickchic,,19,40,7,47
46952,Nacky,,13,1,2,3
46953,Eecks,,42,7,11,18
46954,JenM,,18,155,176,331
46955,robhutten,,43,84,75,159
46956,qghy2,,12,3,1,4
46957,Geee,,10,4,2,6
46958,Seiesnalli,,29,2,3,5
46959,rubielred,,25,1,3,4
46960,beedude,,18,1,1,2
46961,Tman158,,13,84,2,86
46962,SoleilR,,20,1,1,2
46963,max999,,32,1,1,2
46964,dkordik,,13,46,43,89
46965,whoreallyreallycares,,22,229,105,334
46966,dora_explorer,,1,397,656,1053
46967,g2petter,,22,223,172,395
46968,Philluminati,,20,822,1047,1869
46969,fatlus,,1,2,4,6
46970,kitschpatrol,,33,1,1,2
46971,08ronpaul08,,19,26,19,45
46972,moopie,,20,12,24,36
46973,ziadbc,,6,8,3,11
46974,CliffClaven,,0,9,15,24
46975,metaspore,,19,6,6,12
46976,shmi,,12,238,273,511
46977,fathed,,34,47,80,127
46978,lmao,,30,2,1,3
46979,garbonauta,,0,2,2,4
46980,Moofed,,10,5,5,10
46981,jrandom,,20,200,340,540
46982,mynameisharsha,,1,19,14,33
46983,atomicpuffball,,19,172,93,265
46984,SpankMyMetroid,,22,1,1,2
46985,SpungoMcBungo,,22,75,51,126
46986,neuro99,,18,4,7,11
46987,inarsla,,34,6,8,14
46988,rosconotorigina,,13,14,46,60
46989,klassica,,18,61,10,71
46990,D43513393R,,13,17,7,24
46991,LightSpeed,,21,2,2,4
46992,falsedichotomy,,4,1,1,2
46993,Dauntless,,31,230,182,412
46994,rosetta_stoned,,31,10,16,26
46995,choad,,32,104,100,204
46996,zha4fh,,18,1,1,2
46997,november5th,,3,11,9,20
46998,charmless,,20,4,9,13
46999,mmmweed,,7,9,5,14
47000,bobbyz,,19,6,4,10
47001,LouBrishus,,16,1,1,2
47002,PSPNiels,,32,1,1,2
47003,StrangeQuark,,1,96,96,192
47004,josuesalazar,,15,1,1,2
47005,musicman827,,1,3,1,4
47006,rosimom,,1,1,1,2
47007,arsgeek,,40,341,32,373
47008,smackfu,,20,193,269,462
47009,silarulz,,20,5,2,7
47010,TiengAnh,,13,3,10,13
47011,wats8976,,32,110,109,219
47012,plumby,,1,205,310,515
47013,shawnshine,,13,3,3,6
47014,Gareth321,,31,31,32,63
47015,grammar_corrector,,17,7,7,14
47016,Purpperp,,19,1,1,2
47017,Wellsy,,18,7,9,16
47018,Rendeiro,,32,7,4,11
47019,webguy88,,19,5,5,10
47020,frayjoker,,20,11,14,25
47021,lachiemx,,18,267,400,667
47022,monolar,,20,53,99,152
47023,clifthered,,20,20,7,27
47024,djbelieve,,20,2,4,6
47025,TooCold,,10,3,6,9
47026,omphaloskepsis,,31,2,5,7
47027,kindler,,14,2,2,4
47028,42omle,,1,462,418,880
47029,omnipotent1,,20,8,10,18
47030,cc81,,20,462,437,899
47031,letsdothisagain,,19,360,191,551
47032,ergomnemonicism,,13,21,27,48
47033,Dead_Horse,,19,3,6,9
47034,Coolmac,,0,43,14,57
47035,frantk,,1,142,191,333
47036,Stu8912,,13,11,5,16
47037,carcinogen,,13,23,25,48
47038,tom2275,,13,5,5,10
47039,dugr,,22,7,12,19
47040,dexo,,20,1,1,2
47041,Nash13,,31,43,59,102
47042,thetaxman,,13,21,6,27
47043,ClayDavis,,3,1,1,2
47044,konryd,,20,1,1,2
47045,volatile_vixen,,13,15,11,26
47046,Gipetto,,1,3,6,9
47047,danh,,20,43,1,44
47048,nmintt,,19,12,15,27
47049,sythe,,12,11,22,33
47050,MJG2007,,14,1,3,4
47051,vsiva68,,18,1,1,2
47052,petir,,13,3,2,5
47053,maximelt,,20,10,2,12
47054,jonxblaze,,34,185,22,207
47055,aikibiades,,34,1,1,2
47056,blackbrrr,,20,84,69,153
47057,blubberfest,,22,141,118,259
47058,motox16,,17,1,1,2
47059,constitutionranger,,19,62,129,191
47060,jpkutner,,36,38,26,64
47061,tayssir,,20,38,54,92
47062,pbaseball24,,22,3,1,4
47063,SlowMotionWalter,,18,25,66,91
47064,busybeth105,,13,3,14,17
47065,brisywisy,,29,63,65,128
47066,beeforchicken,,18,4,2,6
47067,your-god,,11,2,5,7
47068,xarahfos,,1,1,1,2
47069,SergantSubtle,,18,4,6,10
47070,wedgiey1,,4,126,78,204
47071,positron98,,18,11,6,17
47072,Citizen_McCain,,6,1,1,2
47073,GinnyCu2,,30,1,1,2
47074,yuthe,,13,1,2,3
47075,mazzlemizzle,,31,6,1,7
47076,burkha,,41,1,2,3
47077,agaelebe,,20,4,1,5
47078,Damrey,,19,91,78,169
47079,geocar,,20,196,293,489
47080,Demiurge11,,30,85,78,163
47081,nelsormensch,,22,26,22,48
47082,tdh,,5,7,1,8
47083,Authenticating,,36,1,1,2
47084,Sibilantjoe,,18,8,22,30
47085,maven911,,14,39,19,58
47086,masked_interrupt,,31,57,48,105
47087,mindplunge,,43,1,1,2
47088,remotedevice,,43,51,55,106
47089,modelman,,20,1,1,2
47090,EpicDragon,,13,4,2,6
47091,oiccool,,13,29,14,43
47092,Captain_Underpants,,12,3,5,8
47093,badbatz,,20,2,1,3
47094,Kingvash,,1,1,5,6
47095,MMarquit,,13,78,11,89
47096,Breadhook,,1,20,25,45
47097,mtxblau,,22,151,213,364
47098,domjuandotcom,,13,6,1,7
47099,palmyra,,42,16,7,23
47100,god_made_molesters,,18,1,1,2
47101,hyperbad,,27,1,2,3
47102,cisasteelersfan,,18,2,4,6
47103,procrastinator65,,11,3,1,4
47104,GrammarIsForNazis,,43,75,150,225
47105,VACO,,19,5,8,13
47106,starmatt,,18,2,1,3
47107,Tarustwins,,5,4,1,5
47108,ohemeffgee,,42,284,251,535
47109,BarryOontheDownLow,,19,2,1,3
47110,beam,,20,2,5,7
47111,jbrowley,,18,9,24,33
47112,ristin,,13,923,1564,2487
47113,karmaVS,,10,18,34,52
47114,wuzzup,,18,70,83,153
47115,eldenbishop,,20,6,14,20
47116,gleemie,,32,103,73,176
47117,mrsnorris,,18,3,3,6
47118,internet_badass,,18,34,20,54
47119,xoexohexox,,35,4,7,11
47120,ladytomorrow,,18,92,107,199
47121,christianjb,,41,686,682,1368
47122,j0hnsd,,19,650,1471,2121
47123,Emanresu435,,39,2,2,4
47124,60secs,,29,142,219,361
47125,himeraz,,18,5,17,22
47126,mikefairbank,,19,4,2,6
47127,fenny69,,18,26,55,81
47128,trevxenemy,,18,175,24,199
47129,yogiri,,7,9,12,21
47130,nCn,,32,10,39,49
47131,jimmytree,,5,1,3,4
47132,garflesnarfle,,9,2,2,4
47133,isjhe,,18,6,3,9
47134,shoota,,13,3,3,6
47135,RP-on-AF1,,29,65,104,169
47136,l00ky,,13,27,1,28
47137,fleebo,,41,2,1,3
47138,narancs,,20,42,40,82
47139,sir_francis_drake,,29,2,2,4
47140,twister6284,,0,55,68,123
47141,timedancer,,20,1,3,4
47142,jezmck,,22,406,499,905
47143,CaptainPicard,,20,4,2,6
47144,humpmonkey,,36,14,28,42
47145,nonrecursive,,20,45,37,82
47146,Palamer,,19,2,2,4
47147,WendyLRogers,,31,81,56,137
47148,swampfarmer,,34,20,70,90
47149,Dirvid,,34,2,1,3
47150,tofusimon,,1,50,22,72
47151,othermike,,20,1,1,2
47152,fukgod,,19,7,16,23
47153,ech230,,0,2,4,6
47154,ehsu,,28,3,1,4
47155,Benjamin_Sisko,,42,2,1,3
47156,Disliked,,22,51,26,77
47157,gburri,,20,5,7,12
47158,entitysix,,18,3,6,9
47159,steenacakes,,14,2,2,4
47160,mocgbr,,7,1,3,4
47161,sexaddictdude,,20,4,1,5
47162,h07r0d,,30,6,5,11
47163,thornist,,20,44,47,91
47164,knom,,22,9,3,12
47165,kking254,,13,13,29,42
47166,ranten,,13,3,2,5
47167,drewantarctic,,13,200,366,566
47168,catbert,,1,3,5,8
47169,lcg019,,20,1,1,2
47170,Gargot,,19,17,4,21
47171,verytres,,1,43,2,45
47172,devlavaca,,19,4,11,15
47173,Motherhead,,19,70,47,117
47174,gehsty,,18,2,3,5
47175,Element_22,,31,45,47,92
47176,fozzymandias,,18,268,296,564
47177,stuartlea1,,20,3,2,5
47178,OsamaReilly,,36,2,4,6
47179,e40,,14,233,270,503
47180,jbert,,20,259,342,601
47181,rast3r,,35,17,13,30
47182,BryantJB,,18,2,2,4
47183,slight,,4,2,2,4
47184,futurestate,,18,70,199,269
47185,sosueme,,43,103,154,257
47186,amgine,,11,2,4,6
47187,paperclip,,43,2,6,8
47188,________________,,43,21,22,43
47189,nate48,,21,3,5,8
47190,glocalization,,18,2,2,4
47191,saffron,,5,5,5,10
47192,Mithel,,43,38,70,108
47193,metl_lord,,0,17,24,41
47194,Wayside,,19,341,225,566
47195,filthgrinder,,18,2,8,10
47196,crackamacka,,18,1,5,6
47197,tlynn,,34,12,10,22
47198,lookatmypeepee,,13,35,91,126
47199,papa_nato,,20,1,2,3
47200,antonova,,34,1,1,2
47201,theatrus,,20,71,98,169
47202,pyxis,,1,35,63,98
47203,blood_ninja,,43,1,2,3
47204,dhuff,,1,1,1,2
47205,mdesjardins,,19,1,1,2
47206,lektran,,43,12,21,33
47207,stinkypete9,,13,2,2,4
47208,robbiedance8,,19,1,3,4
47209,Ulvund,,18,207,25,232
47210,ewingpatriarch,,31,8,3,11
47211,ubuwalker31,,31,106,95,201
47212,koldewyse,,7,257,59,316
47213,reasonableBeing,,19,3,11,14
47214,yendi,,5,1,3,4
47215,STOP_HAMMERTIME,,19,33,45,78
47216,MrDerk,,18,8,7,15
47217,pacheco,,43,1,2,3
47218,ataraxia,,12,101,27,128
47219,birlinn,,13,50,106,156
47220,doitlive,,0,6,4,10
47221,derwisch,,20,103,177,280
47222,mtaylor769,,18,18,37,55
47223,luccid,,4,14,3,17
47224,hobbes19,,18,7,33,40
47225,stevemegson,,20,13,7,20
47226,exposing_feminism,,31,1,1,2
47227,walnutmon,,18,4,1,5
47228,silenoz357,,4,8,18,26
47229,AK47blues,,1,263,285,548
47230,UKDave,,5,134,23,157
47231,Syini666,,13,14,12,26
47232,brenoKHAKI,,25,2,2,4
47233,kraegm,,32,1,2,3
47234,bremsstrahlung,,30,4,5,9
47235,bsanford,,31,3,2,5
47236,readerszone,,4,92,1,93
47237,theknife,,20,1,1,2
47238,rossyhyndman,,19,1,1,2
47239,weave2k0,,29,2,3,5
47240,loch_raven,,31,4,1,5
47241,alternity,,18,7,59,66
47242,CFHQYH,,1,59,143,202
47243,Leo_Tolstoy,,22,2,1,3
47244,M_Rock,,0,246,76,322
47245,mazin,,20,10,8,18
47246,Mooker,,1,20,5,25
47247,inotropin,,1,1,1,2
47248,charlier,,17,2,4,6
47249,5-4-3-2-1-bang,,18,110,151,261
47250,rboymtj,,18,241,141,382
47251,chimpish,,43,1,7,8
47252,geldedus,,29,15,8,23
47253,policyHaxor,,39,10,2,12
47254,Mmil09,,20,1,3,4
47255,roidberg,,6,12,47,59
47256,derkaas,,31,140,194,334
47257,kovak,,20,1,5,6
47258,conradofs,,31,4,3,7
47259,lolpicard,,19,44,68,112
47260,dakk12,,34,133,85,218
47261,mthmchris,,19,249,238,487
47262,pb77,,34,1,3,4
47263,mattheww,,18,1,1,2
47264,lhadlum,,0,5,15,20
47265,meester-burns,,18,1,2,3
47266,Snes91,,31,1,1,2
47267,djnoha,,19,2,3,5
47268,snorque,,36,4,5,9
47269,swansonc,,18,27,15,42
47270,addit,,19,4,22,26
47271,joshr137,,1,18,42,60
47272,evariste,,20,30,32,62
47273,smithandjohnson,,20,20,2,22
47274,samfoo,,32,33,31,64
47275,bgoetz,,19,4,5,9
47276,calebegg,,32,1,2,3
47277,harryballsagna,,18,710,1101,1811
47278,BikeShmuck,,1,1,1,2
47279,thepulse,,31,1,1,2
47280,tmmmandm,,18,1,3,4
47281,Maxwell_S_Mart,,20,64,77,141
47282,TerriblePoet,,5,10,25,35
47283,gepardcv,,20,10,3,13
47284,liquidtension,,18,33,47,80
47285,kkreddit,,31,3,1,4
47286,andrev,,20,14,5,19
47287,profburnz,,18,7,8,15
47288,SpaceMonitor,,43,94,154,248
47289,shastafir,,13,4,12,16
47290,Avarith,,18,2,5,7
47291,dami2550,,3,13,18,31
47292,serjean,,43,2,1,3
47293,stroptek,,13,101,49,150
47294,IheartDaRegion,,1,35,67,102
47295,mattv212232,,13,33,51,84
47296,grumdrig,,20,6,11,17
47297,avalanche142,,0,5,1,6
47298,quartermann,,18,32,51,83
47299,l1ghtning,,43,13,35,48
47300,nalfien,,1,103,58,161
47301,joshbudde,,5,13,6,19
47302,CreepyKid,,10,1,1,2
47303,cheetah007,,19,70,7,77
47304,MattFaus,,43,1,1,2
47305,kevinkr,,34,9,20,29
47306,BlueOrange,,13,44,17,61
47307,vaporstun,,8,1,2,3
47308,cocoaeyes,,34,2,9,11
47309,RaldisPuppet,,19,32,40,72
47310,rushouse,,1,37,21,58
47311,jadero,,20,35,55,90
47312,vikramkeskar,,42,4,4,8
47313,pocketreviews,,18,70,71,141
47314,brool,,20,4,16,20
47315,Nimmy,,20,1,1,2
47316,makepizzanotwar,,4,1,1,2
47317,Deadbolt11,,18,1,1,2
47318,australasia,,15,56,61,117
47319,cphuntington97,,17,59,71,130
47320,nem,,20,1,1,2
47321,abigalerogers,,13,2,4,6
47322,irishomac,,30,1,1,2
47323,jeremyfirth,,32,18,28,46
47324,damiensith,,0,2,2,4
47325,flycrg,,22,117,195,312
47326,Flavour666,,5,11,15,26
47327,idunnoanything,,1,1,1,2
47328,brianwc,,32,60,11,71
47329,itzmattu,,0,8,5,13
47330,gilimas,,13,1,1,2
47331,FrankHope,,31,22,23,45
47332,sqrt7744,,31,8,13,21
47333,__jim__,,20,4,6,10
47334,raharu,,20,12,20,32
47335,sangoma,,18,48,66,114
47336,growinglotus,,4,642,885,1527
47337,naich,,20,37,40,77
47338,stevvooe,,20,38,47,85
47339,jimbo_jones,,1,95,141,236
47340,subspacer,,19,24,34,58
47341,dumnbunny,,20,22,38,60
47342,jfaith,,31,1,2,3
47343,hyp3r,,17,29,38,67
47344,vadimm,,31,254,80,334
47345,gimmeit,,41,1,1,2
47346,ENRICOs,,13,440,558,998
47347,rex5249,,19,57,116,173
47348,107reasonswhy,,18,4,5,9
47349,joshj,,18,7,9,16
47350,IlIl,,19,7,3,10
47351,littlewolfen,,43,1,10,11
47352,mikeflynn,,0,1,3,4
47353,reverendfrag4,,4,799,1139,1938
47354,Neo991lb,,12,1,2,3
47355,Kristi_beauty,,3,1,1,2
47356,daretelayam,,31,86,79,165
47357,HandsomeRuss,,34,13,13,26
47358,yinzhen,,36,50,52,102
47359,taxman23,,13,10,4,14
47360,rbernet,,20,1,1,2
47361,tomp2,,17,1,1,2
47362,SalsaShark,,42,1,2,3
47363,chillywilly,,22,1,1,2
47364,00RAH,,31,6,4,10
47365,wkcochran123,,10,1,4,5
47366,avagoyle,,39,11,10,21
47367,nopenogod,,13,131,101,232
47368,shiz3,,19,44,3,47
47369,nappingkitteh,,0,13,13,26
47370,protoypeangel,,43,1,1,2
47371,cricket6689,,29,3,5,8
47372,Fjolle,,32,6,8,14
47373,nusuth,,31,96,165,261
47374,sanantonian,,19,1,2,3
47375,badlyspawnedboy,,42,8,19,27
47376,dlowy1766,,33,4,1,5
47377,harow,,31,79,115,194
47378,foole,,12,28,47,75
47379,cow4263,,19,3,10,13
47380,AttackingHobo,,42,697,796,1493
47381,maths,,20,5,3,8
47382,daybreaker,,3,61,68,129
47383,Lisbeth8,,5,1,1,2
47384,phantomtails,,13,27,17,44
47385,Icantremembermypass,,31,13,12,25
47386,Donut,,19,6,8,14
47387,BlakeStone,,36,1,2,3
47388,Kattborste,,42,17,24,41
47389,goonmaster,,43,78,70,148
47390,bentley,,22,50,32,82
47391,darkael,,3,15,16,31
47392,majek04,,20,56,11,67
47393,beprogress,,13,1,7,8
47394,leachja,,21,47,52,99
47395,harbeas,,13,68,129,197
47396,mattbond1970,,18,1,1,2
47397,eto_samoe,,43,4,1,5
47398,Jojje22,,29,27,28,55
47399,JustACat,,43,2,3,5
47400,JC513,,3,21,27,48
47401,blarghhh,,41,1,3,4
47402,misterbeebeebee,,20,4,4,8
47403,jacobmile,,13,1,1,2
47404,tfaing,,13,21,5,26
47405,Hedgehog2006,,13,395,161,556
47406,hpp,,29,2,1,3
47407,sabailos,,12,1,1,2
47408,AlienCoder,,20,34,6,40
47409,staticz,,23,1,1,2
47410,definitivre,,34,1,1,2
47411,witness142,,34,11,4,15
47412,bertramredneck,,19,137,513,650
47413,Broadway,,18,1,2,3
47414,nickatnite101,,1,274,383,657
47415,zero1234,,19,1,1,2
47416,taleinat,,23,3,2,5
47417,WorldWebIII,,19,21,5,26
47418,adam23,,33,1,1,2
47419,championbeginner,,18,1,4,5
47420,xhhux,,1,92,175,267
47421,nitrogen76,,31,9,5,14
47422,redeyeblog,,19,5,1,6
47423,Wensleydale,,32,169,256,425
47424,trny3,,13,18,17,35
47425,alexjordan,,20,2,1,3
47426,D4wn0ff473,,18,9,18,27
47427,sheepforwheat,,18,62,38,100
47428,DeadlyCouncil,,42,1,3,4
47429,somebodyscoming,,27,7,1,8
47430,raklar,,30,1,5,6
47431,definitelynot,,43,129,6,135
47432,greendestiny,,15,35,42,77
47433,FunkyHat112,,31,77,123,200
47434,cindyvinea,,30,2,1,3
47435,deb1961,,18,2,4,6
47436,j_shanks,,43,17,27,44
47437,anarchoanarchist,,29,4,2,6
47438,Madalina13,,18,71,1,72
47439,MadMastaZ,,43,1,2,3
47440,VikingLumberjack,,16,1,4,5
47441,mizake,,22,20,43,63
47442,gumuz,,20,70,5,75
47443,stwice,,30,1,6,7
47444,courane,,43,91,23,114
47445,eternal512,,43,11,24,35
47446,vspazv,,18,7,23,30
47447,traxxas,,20,124,145,269
47448,eyabs,,12,14,5,19
47449,astrolabe,,13,96,80,176
47450,waugsqueke,,19,5,3,8
47451,probablycorey,,20,54,35,89
47452,madgrafx,,13,35,53,88
47453,quaff,,0,6,6,12
47454,Rianur,,22,1,2,3
47455,peruytu,,32,1,1,2
47456,intronink,,1,4,11,15
47457,tsoo,,41,3,5,8
47458,quasimongo,,19,14,35,49
47459,tuli,,31,27,63,90
47460,cogburn,,6,2,3,5
47461,euphoriajoca,,18,197,28,225
47462,SenaMarie,,13,74,106,180
47463,DarkQuest,,20,26,38,64
47464,aredridel,,16,1,2,3
47465,AgnesScottie,,32,13,13,26
47466,fireandicefuel,,43,10,7,17
47467,impomatic,,43,1,1,2
47468,Tphile,,43,18,30,48
47469,JShap,,34,17,5,22
47470,CaptainPigfucker,,22,11,12,23
47471,JebusJuice,,4,7,5,12
47472,scooticery,,19,24,21,45
47473,free_man,,19,162,131,293
47474,NoodleMan,,19,153,9,162
47475,cusbard,,1,5,21,26
47476,ubrayj02,,19,82,125,207
47477,mypasswordismom,,39,3,2,5
47478,colinbg,,27,2,3,5
47479,LarryLard,,20,154,226,380
47480,Bittermike,,13,15,6,21
47481,vlooming,,13,1,9,10
47482,porcupinetree69,,6,10,8,18
47483,Benana,,1,1,3,4
47484,ReallyPissedOff,,0,12,18,30
47485,djn,,43,4,23,27
47486,beel24,,1,6,5,11
47487,mxhyway,,12,6,4,10
47488,r00k,,20,76,8,84
47489,neutronbob,,20,183,60,243
47490,photoduder,,0,1,1,2
47491,AshtonKoocher,,13,6,6,12
47492,cre,,20,1,1,2
47493,infodivaMLIS,,13,448,35,483
47494,yakineko,,1,1,1,2
47495,JudyD,,21,1,1,2
47496,mykodacon,,1,2,2,4
47497,antonulrich,,4,165,199,364
47498,andreweff,,22,4,7,11
47499,tnv,,20,2,1,3
47500,Beanbones,,34,9,5,14
47501,amazingdisgrace,,42,3,2,5
47502,plucas,,13,16,24,40
47503,ZexMarquies01,,17,3,1,4
47504,blinkofaneye,,13,6,2,8
47505,bromanct,,13,34,29,63
47506,apartition,,36,1,1,2
47507,tehfink,,30,10,20,30
47508,IamJAX,,6,1,1,2
47509,zzbzq,,32,64,97,161
47510,macemillion,,18,4,4,8
47511,centinall,,20,247,299,546
47512,JizzGargler,,0,9,4,13
47513,wroscoe,,32,1,1,2
47514,aaargh,,13,19,56,75
47515,mephi_s,,20,5,3,8
47516,Ghozt,,43,71,7,78
47517,briggsb,,18,119,2,121
47518,starbork,,19,397,255,652
47519,ArtlessDodger,,1,22,31,53
47520,mpierre,,30,68,158,226
47521,AlanInVancouverBC,,19,1,4,5
47522,NSFW,,22,4,5,9
47523,jvining3,,0,9,4,13
47524,Cpt_Picard,,1,1,1,2
47525,moreoriginalthanthat,,20,71,136,207
47526,flyingfredcurry,,43,42,117,159
47527,nimms,,20,3,4,7
47528,ky13,,36,1,1,2
47529,Slayer714,,13,27,48,75
47530,notomniscient,,20,2,1,3
47531,davidbau,,8,2,2,4
47532,memesterbater,,42,7,3,10
47533,Chisaku,,42,58,78,136
47534,urkeee,,18,18,9,27
47535,dnc,,1,18,50,68
47536,robcrocker,,34,82,97,179
47537,drblue,,20,4,8,12
47538,oscarmg,,12,20,15,35
47539,mcalliph,,1,1,1,2
47540,jtputnam,,13,7,1,8
47541,Moon1234,,18,70,123,193
47542,goltrpoat,,20,37,59,96
47543,definition,,18,18,28,46
47544,cafiend,,34,25,39,64
47545,fng,,43,1,1,2
47546,crayoner,,19,3,2,5
47547,mattryan50,,18,10,7,17
47548,ViennaSoysage,,20,1,1,2
47549,jkh77,,1,70,157,227
47550,surgeandoj,,13,2,16,18
47551,Sibelius,,18,60,152,212
47552,hengels,,19,8,6,14
47553,fastlanefast,,5,7,2,9
47554,wozza96,,15,54,112,166
47555,GranDaddy,,19,226,157,383
47556,Cand1date,,30,210,375,585
47557,endustry,,19,9,19,28
47558,raxor1331,,14,2,2,4
47559,paulofmandown,,42,57,108,165
47560,gigamike,,43,8,2,10
47561,dsl_man,,20,90,138,228
47562,flyfisher,,13,1,1,2
47563,alecrose,,3,34,28,62
47564,reconbot,,20,57,75,132
47565,Depafro,,32,13,16,29
47566,Poot_N_Tate,,19,367,208,575
47567,killeryugi,,3,1,3,4
47568,coldsoup,,31,2,2,4
47569,Kuonji,,18,4,5,9
47570,JTM,,1,1,1,2
47571,inan2917,,43,8,8,16
47572,anawolken,,28,14,16,30
47573,crammy,,4,1,1,2
47574,DamonClifford,,6,3,5,8
47575,cionide,,18,5,9,14
47576,nixuselevenswang,,1,2,1,3
47577,InternalAffairs,,22,1,1,2
47578,assratio,,18,51,71,122
47579,danielh_,,18,1,4,5
47580,glatts,,35,111,165,276
47581,jonno2007,,20,2,3,5
47582,MattDamon,,35,1,3,4
47583,podppl,,3,3,5,8
47584,CharlesnMambo,,18,2,5,7
47585,delvach,,22,50,98,148
47586,Cockstr,,22,1,1,2
47587,In_R_Tic_U_L8,,31,10,14,24
47588,gdogfunkyfresh,,32,3,4,7
47589,foobarbazquux,,20,14,2,16
47590,Traveler2112,,18,2,8,10
47591,tommytallarico,,13,1,1,2
47592,cmarrs85,,18,1,1,2
47593,chaddles,,15,91,219,310
47594,operandyohtweeeeeeee,,12,3,4,7
47595,johankool,,1,2,4,6
47596,hohead,,34,24,16,40
47597,anonjoe,,32,5,7,12
47598,ORSM,,1,2,3,5
47599,Silverfuel,,39,1,2,3
47600,cj5,,19,32,51,83
47601,BuddhaJ,,22,16,7,23
47602,yodelie,,18,4,3,7
47603,AmberinaDawn,,0,11,30,41
47604,hpr122i,,20,11,30,41
47605,lawtree,,18,2,3,5
47606,evilblade,,20,3,2,5
47607,fun1ne,,19,330,646,976
47608,no_I_dont_think_so,,6,1,3,4
47609,shantm79,,18,174,216,390
47610,jeezfrk,,32,7,7,14
47611,Pedrobss,,13,1,1,2
47612,slamare247,,17,370,615,985
47613,invise,,43,1,1,2
47614,IkoIkoComic,,22,649,797,1446
47615,The10thNazgul,,6,3,10,13
47616,Favourite,,42,115,130,245
47617,BrianNowhere,,13,243,234,477
47618,fuckingThingSucks,,22,1,1,2
47619,911WasntAnOutsideJob,,19,5,15,20
47620,poe9514,,11,1,1,2
47621,yorkydee,,19,20,77,97
47622,davepeck,,20,25,26,51
47623,AmericaX,,20,5,1,6
47624,smryan,,20,1,1,2
47625,timtim2021,,18,6,9,15
47626,mean7gene,,30,20,15,35
47627,thekid42,,0,2,4,6
47628,queztone,,34,2,4,6
47629,redbat,,0,12,13,25
47630,gurugirl,,13,13,10,23
47631,fland033,,30,1,3,4
47632,villan,,10,1,1,2
47633,SlorLUVR99,,22,6,13,19
47634,treelemon,,19,2,2,4
47635,ethornquist,,13,1,2,3
47636,Lazarus176,,13,5,2,7
47637,DrGirlfriend,,31,82,88,170
47638,morphet,,0,36,22,58
47639,theclasp,,30,4,2,6
47640,TheNanny612,,5,7,17,24
47641,apeweek,,17,144,222,366
47642,genneth,,15,1,2,3
47643,racc0on7,,13,45,71,116
47644,alban987,,34,7,3,10
47645,wireframejesus,,18,1,5,6
47646,achterlijk,,20,3,7,10
47647,RandoM_ChancE,,39,2,2,4
47648,l0l,,43,102,145,247
47649,air0day,,20,56,4,60
47650,spitzanator,,34,51,57,108
47651,PissedOff2008,,18,50,96,146
47652,escapeartist,,13,97,281,378
47653,rocor,,18,14,31,45
47654,allthegoodonestaken,,34,9,7,16
47655,mcchrischuck,,18,25,7,32
47656,pmb,,20,21,8,29
47657,thecrumb,,20,1,1,2
47658,SenorJason,,31,4,6,10
47659,leppie,,20,96,139,235
47660,xmay,,13,3,8,11
47661,Hwee,,20,6,8,14
47662,kitakhyber,,18,14,20,34
47663,picoligance,,20,16,13,29
47664,thomas_h,,12,2,1,3
47665,bolognium,,13,33,55,88
47666,Zum_Horizont,,0,4,13,17
47667,aristofon,,1,12,16,28
47668,oliw,,19,15,6,21
47669,GenghisJuan,,1,2,5,7
47670,bawheid,,18,72,119,191
47671,crash86,,13,38,55,93
47672,scummyatty,,10,4,2,6
47673,reddjake,,32,29,31,60
47674,JustJonny,,32,578,1012,1590
47675,Crazy_Horse,,3,31,40,71
47676,kborah,,26,1,1,2
47677,YaoPau,,19,155,189,344
47678,funparko,,18,6,1,7
47679,FreddieFreeloader,,13,1,1,2
47680,phalnax,,13,6,3,9
47681,stewisgross,,20,1,1,2
47682,thecitizens911,,13,22,44,66
47683,Bzelm1021,,27,1,1,2
47684,marssaxman,,20,1,1,2
47685,regularstrength,,19,1,1,2
47686,Coqui,,19,2,1,3
47687,babblefrog,,10,25,54,79
47688,asdfzxcvzxcv,,20,6,7,13
47689,SingerSirCoda,,19,66,95,161
47690,grin23,,32,8,17,25
47691,phrackattack,,6,1,1,2
47692,pantherdash,,19,12,19,31
47693,JCMichel,,31,4,1,5
47694,teromajusa,,20,6,3,9
47695,jtraub,,20,5,3,8
47696,holywood,,16,1,4,5
47697,severedfragile,,13,771,520,1291
47698,ThaneEichenauer,,36,10,5,15
47699,buss,,20,44,17,61
47700,JEFF_IS_FAKE,,30,1,2,3
47701,kawai,,22,19,25,44
47702,jlivni,,20,1,1,2
47703,squidont,,20,5,6,11
47704,TheLord,,43,3,11,14
47705,eugenejen,,27,3,5,8
47706,paktopia,,1,2,4,6
47707,pdongen,,18,41,46,87
47708,boblet_squared,,30,2,1,3
47709,wanklerotaryengine,,19,1,8,9
47710,theoscheiner,,32,7,12,19
47711,spubass,,18,7,11,18
47712,fractalorc,,18,6,4,10
47713,mypostsweredeleted,,21,1,1,2
47714,callamack,,19,20,4,24
47715,Speechless83,,22,2,1,3
47716,bushdid911,,18,3,3,6
47717,Raff001,,34,1,3,4
47718,thekidsunited,,43,1,10,11
47719,redditmoniker,,31,12,21,33
47720,wotomo,,22,7,3,10
47721,kleffy,,19,438,242,680
47722,Araucaria,,29,18,24,42
47723,bradlauster,,18,3,4,7
47724,barnaby-jones,,13,11,25,36
47725,tmdg,,16,2,2,4
47726,trazor,,32,17,3,20
47727,AdonalFoyle,,13,3,5,8
47728,efox,,43,40,5,45
47729,closetchef,,12,11,18,29
47730,JackSeoul,,20,6,9,15
47731,beefer,,30,1,3,4
47732,schmuckle,,22,2,3,5
47733,temp1010101,,0,3,2,5
47734,ttt8701,,34,1,2,3
47735,chromespi,,31,5,6,11
47736,patterned,,18,11,16,27
47737,lagged,,18,2,3,5
47738,piki,,20,1,2,3
47739,Seefor,,31,263,330,593
47740,trianglechoke,,31,11,4,15
47741,shitcovereddick,,20,456,933,1389
47742,sccordova,,8,3,2,5
47743,GGAllin,,38,5,1,6
47744,wangchong,,13,386,15,401
47745,nowwithbleach,,5,1,1,2
47746,Salti,,19,8,9,17
47747,sysop073,,20,122,275,397
47748,karirhy,,19,1,6,7
47749,ianfine,,4,1,1,2
47750,procrastitron,,20,119,182,301
47751,michaelra,,18,7,2,9
47752,huxrules,,17,2,2,4
47753,sevenoftoine,,40,2,1,3
47754,wallaman2005,,6,2,2,4
47755,Lighioana,,43,29,21,50
47756,aprilchild,,20,6,5,11
47757,andkore,,19,43,55,98
47758,drmohundro,,20,1,4,5
47759,btbalance,,13,5,9,14
47760,amixxima,,19,2,3,5
47761,-Oleg-,,5,1,2,3
47762,chewbaccawasawookie,,20,2,7,9
47763,straatfiter,,31,1,2,3
47764,b1ffw3bst3r,,35,1,4,5
47765,Publius82,,13,59,173,232
47766,proudpuki,,19,4,2,6
47767,scottbruin,,1,164,191,355
47768,vitalAscension,,13,1,8,9
47769,deadflagblues,,19,9,12,21
47770,joshcandoit4,,1,28,50,78
47771,hitek1,,19,3,1,4
47772,rickytickytappy,,13,132,225,357
47773,shudmeyer,,13,23,33,56
47774,dustyBin23,,36,145,154,299
47775,tellyousomeday,,20,1,1,2
47776,bburton,,5,2,1,3
47777,mysticreddit,,11,94,135,229
47778,drawkbox,,20,248,436,684
47779,badjoke33,,18,495,767,1262
47780,buddychrist,,13,5,9,14
47781,tsiolkovsky,,20,41,1,42
47782,yarc,,1,2,1,3
47783,jaywalker32,,32,13,37,50
47784,llimllib,,20,1730,513,2243
47785,joojoo,,19,5,8,13
47786,ibisum,,3,277,430,707
47787,kraetos,,32,46,49,95
47788,hanlect,,20,1,6,7
47789,Doug_Vitale,,5,10,8,18
47790,unkorrupted,,19,309,414,723
47791,shzad,,15,1,2,3
47792,jiphex,,20,13,9,22
47793,Hidas462,,32,10,15,25
47794,jamescoleuk,,19,5,6,11
47795,bobmatnyc,,13,18,20,38
47796,DanCorb,,32,47,10,57
47797,dogb60,,19,1,1,2
47798,Xiphorian,,20,533,475,1008
47799,bobdobolina,,42,13,22,35
47800,TruFunkSoulja,,31,1,2,3
47801,ebauman,,13,10,8,18
47802,konrad_,,34,2,2,4
47803,ligniteman,,31,7,11,18
47804,Doomdoomkittydoom,,32,378,951,1329
47805,ryoping,,35,2,4,6
47806,adaminc,,30,403,737,1140
47807,hedberg12,,43,2,4,6
47808,Professor-Farnsworth,,23,3,2,5
47809,robby1066,,6,1,3,4
47810,mojoey,,32,1,2,3
47811,mctink,,34,1,1,2
47812,jeffd,,20,3,1,4
47813,spintriae,,18,39,52,91
47814,Meme_Police,,40,19,7,26
47815,sammy_dumpster,,0,29,51,80
47816,IQRange,,13,95,69,164
47817,mistaxe,,9,1,1,2
47818,slurmsMcKenzie,,0,29,1,30
47819,Rocky_Raccoon,,13,2,6,8
47820,sese68,,34,2,1,3
47821,youareafraud,,13,53,40,93
47822,svaha,,1,13,29,42
47823,Querencia,,3,1,2,3
47824,black_bart_II,,0,2,1,3
47825,sotopheavy,,19,206,397,603
47826,uep,,20,357,495,852
47827,laggedreaction,,43,4,7,11
47828,fareedy,,18,75,109,184
47829,hofo,,13,28,42,70
47830,1787,,19,16,48,64
47831,187ninjuh,,1,13,13,26
47832,behavedave,,31,1,1,2
47833,redninja2000,,12,33,35,68
47834,drspanklebum,,18,80,78,158
47835,GManPCTT,,1,4,2,6
47836,tyllyn,,12,11,2,13
47837,yoyop,,19,9,2,11
47838,Transtrollist,,32,2,1,3
47839,ReaverXai,,18,69,50,119
47840,imonreddit,,18,131,66,197
47841,royalpineapple,,1,16,39,55
47842,lanceatherton,,18,311,2,313
47843,creeky,,5,1,1,2
47844,jlandrith,,32,1,1,2
47845,cyrusdh,,31,388,334,722
47846,garymich,,34,6,6,12
47847,darsee,,22,2,1,3
47848,horndude77,,20,5,7,12
47849,YarvinTheFish,,13,1,7,8
47850,Hourglass,,14,1,1,2
47851,johnmcgary,,4,2,1,3
47852,bakagaigin,,13,2,2,4
47853,guder,,18,33,25,58
47854,treberif,,43,2,2,4
47855,mnordhoff,,20,4,9,13
47856,Cybermaster,,19,1,2,3
47857,woohoo47,,1,53,81,134
47858,jladams,,1,87,23,110
47859,ketralnis,,20,1105,694,1799
47860,saiftk,,0,24,20,44
47861,uriel,,31,1017,1120,2137
47862,dhnaranjo,,5,2,5,7
47863,proobert,,20,1,2,3
47864,banjomike,,5,7,13,20
47865,kscrimsher,,19,28,97,125
47866,namlinh,,8,16,5,21
47867,DamienWind,,18,254,352,606
47868,shortbusgeek,,13,17,4,21
47869,twomonkeysayoyo,,18,11,17,28
47870,terribad,,9,1,1,2
47871,Quaro,,13,128,25,153
47872,yagni,,22,11,9,20
47873,napoleongold,,13,5,10,15
47874,lordatlas,,31,16,3,19
47875,mostapha,,20,8,7,15
47876,keepITliberal,,1,2,1,3
47877,ajopaul,,18,25,15,40
47878,TheLocoYoko,,29,82,86,168
47879,farlizzle,,21,1,1,2
47880,dnm,,20,128,172,300
47881,durdn,,20,31,4,35
47882,Baghdad_Bob,,31,1,5,6
47883,meltman,,1,41,27,68
47884,sundowntg,,18,3,2,5
47885,bayleo,,22,108,115,223
47886,becked,,14,3,3,6
47887,breddy,,20,167,150,317
47888,netsearcher,,20,165,239,404
47889,hollywoodjane,,18,2,4,6
47890,Cygal,,20,31,3,34
47891,joojie,,22,5,7,12
47892,rogozjin,,19,279,37,316
47893,seddu,,41,15,2,17
47894,zaatar,,20,11,4,15
47895,grosskur,,20,8,7,15
47896,johnnyneverdies,,18,7,19,26
47897,PDLan,,13,3,3,6
47898,gotbock,,32,20,13,33
47899,Sinudeity,,0,5,11,16
47900,aacool,,22,11,1,12
47901,ClanPanda,,19,350,277,627
47902,onedinio,,19,1,5,6
47903,ronito,,42,76,18,94
47904,gdi22,,30,1,2,3
47905,DkkD,,30,1,4,5
47906,mementori,,6,2,3,5
47907,smokeshack,,1,99,115,214
47908,xturmn8r,,1,6,11,17
47909,michaeltherobot,,20,8,2,10
47910,trumpy303,,34,85,1,86
47911,kryptkpr,,1,29,35,64
47912,SammyDaSlug,,20,2,2,4
47913,tic,,20,40,54,94
47914,pixel105,,13,52,88,140
47915,tyrsson,,19,86,128,214
47916,pricees,,13,2,3,5
47917,theyareallcrooks,,13,1,1,2
47918,androo87,,5,15,15,30
47919,dsmyte,,30,109,117,226
47920,AFairJudgement,,18,5,8,13
47921,stumblingblock,,13,2,3,5
47922,Shambles,,13,20,42,62
47923,Rhycore,,32,1,1,2
47924,bacchus101,,8,94,136,230
47925,tyler,,0,4,7,11
47926,dailyrorschach,,0,14,15,29
47927,ikonoclasm,,32,59,88,147
47928,Quote,,34,1,2,3
47929,theodicy,,0,128,154,282
47930,armitages,,31,9,3,12
47931,Connels,,31,27,21,48
47932,vinyl_,,20,12,13,25
47933,waahuli,,32,5,7,12
47934,dsdsds,,13,20,47,67
47935,daddyc00l,,20,26,42,68
47936,tpate,,43,13,4,17
47937,jje,,31,4,1,5
47938,wzpgsr,,31,3,13,16
47939,gabe_,,13,1,2,3
47940,Brian,,20,105,169,274
47941,webspell,,5,1,2,3
47942,endecotp,,20,3,3,6
47943,pnin,,22,1,6,7
47944,nothanksimjewish,,16,3,2,5
47945,sliverman,,18,17,5,22
47946,returno,,19,2,7,9
47947,XTA,,1,4,10,14
47948,jakec,,32,3,2,5
47949,CognitoErgoSum,,19,10,20,30
47950,absurdobot,,19,11,17,28
47951,curtisb,,20,74,33,107
47952,hellodarshan,,18,93,8,101
47953,akula_akula,,32,9,17,26
47954,Hellshock,,22,4,8,12
47955,cheech26,,12,1,2,3
47956,robotevil,,9,573,432,1005
47957,euklides,,19,98,92,190
47958,avsportland,,13,2,2,4
47959,kleptofphnica20093,,31,18,20,38
47960,forkqueue,,34,16,18,34
47961,ninja_zombie,,19,616,420,1036
47962,WardOnTheWeb,,20,7,18,25
47963,pootedesu,,18,37,79,116
47964,joncash,,6,368,322,690
47965,cows,,20,14,9,23
47966,perplex79,,20,6,4,10
47967,mourning,,2,2,1,3
47968,crwoodman,,13,3,4,7
47969,ianmccurdy,,1,27,55,82
47970,martinjlogan,,18,1,1,2
47971,jcgregorio,,20,7,5,12
47972,Sophocles,,0,20,17,37
47973,copkiller,,16,2,1,3
47974,hober,,20,125,6,131
47975,noetic,,31,4,5,9
47976,wpjmurray,,28,3,2,5
47977,dom085,,34,18,31,49
47978,JasonPeck,,5,1,1,2
47979,Saunawombat,,34,2,3,5
47980,sdwrage,,11,3,1,4
47981,fallinup,,13,18,23,41
47982,jdubs333,,19,62,72,134
47983,Damien666,,43,2,2,4
47984,mineson,,0,2,2,4
47985,democrattotheend,,19,2,2,4
47986,hoosier45678,,20,17,34,51
47987,Buck_Malibu,,13,736,713,1449
47988,benito78,,5,1,2,3
47989,sugarape,,31,2,2,4
47990,wabbiteh,,22,19,15,34
47991,theseitz,,18,8,32,40
47992,Reddit_Police,,22,1,1,2
47993,CashOverAss,,13,6,5,11
47994,squashbelly,,4,28,47,75
47995,classicresort,,29,2,2,4
47996,allenshillfarm,,19,2,2,4
47997,shapedbyregret,,19,35,47,82
47998,dogten,,36,2,1,3
47999,safety_inspector,,31,1,1,2
48000,astralbody,,13,3,4,7
48001,Ghostline,,32,11,13,24
48002,IanMcGreene,,16,2,2,4
48003,drillpalin,,18,83,7,90
48004,hopstar,,18,169,251,420
48005,kwade,,13,36,27,63
48006,meuc,,4,2,1,3
48007,dln,,18,13,12,25
48008,infamousjre,,9,2,4,6
48009,ifm1989,,19,13,25,38
48010,Plasmatica,,12,178,169,347
48011,paigematter,,19,21,39,60
48012,shoc,,18,83,79,162
48013,xkcdsucks,,12,1,2,3
48014,sooner577,,19,2,1,3
48015,capi10,,5,3,4,7
48016,teilo,,20,2,2,4
48017,JasonFalls,,5,5,6,11
48018,IHP,,13,3,4,7
48019,CAPS_LOCK,,1,1,1,2
48020,cj23creh,,18,31,37,68
48021,mowza214,,19,1,3,4
48022,greyfade,,20,1,6,7
48023,billndotnet,,18,1,2,3
48024,chrismr,,32,76,85,161
48025,physivic,,13,12,36,48
48026,caydieu,,18,14,19,33
48027,md304,,1,91,40,131
48028,rmeddy,,1,1,1,2
48029,beautiful_noise,,18,83,52,135
48030,xkcd,,22,414,211,625
48031,HowTheWestWasOne,,32,8,13,21
48032,petedawes,,5,12,21,33
48033,bigt0128,,19,22,23,45
48034,Thorolac,,18,16,8,24
48035,chradcliffe,,14,3,1,4
48036,defjamz,,0,1,3,4
48037,rez410,,0,8,2,10
48038,cripwark,,32,8,8,16
48039,Digitalburn,,18,8,8,16
48040,TheCheat,,19,5,6,11
48041,PoorLeno,,32,49,60,109
48042,eredicator,,13,1,4,5
48043,Joe_Six-Pack,,13,14,16,30
48044,NJalien,,30,3,6,9
48045,BerserkerVoter,,13,1,1,2
48046,liquen,,20,60,1,61
48047,kordath,,22,10,3,13
48048,anicol,,31,1,1,2
48049,serpent,,20,8,8,16
48050,positivepnl,,20,1,1,2
48051,newmejersey,,20,1,2,3
48052,meehawl,,5,7,10,17
48053,GNG,,20,4,2,6
48054,O1O1O1,,20,3,7,10
48055,jilseng4,,13,75,161,236
48056,gshark27,,13,23,25,48
48057,zamolxis,,20,7,9,16
48058,gabriellocke,,43,30,58,88
48059,catguy,,18,12,20,32
48060,JPM,,34,29,40,69
48061,chiefmonkey,,18,171,208,379
48062,onthestairs,,20,6,2,8
48063,gubernatorialism,,18,2,4,6
48064,ahimsaplease,,19,39,8,47
48065,ickysticky,,31,3,2,5
48066,YME1280,,18,9,9,18
48067,rubinlinux,,18,12,7,19
48068,elendae,,18,40,12,52
48069,TEMPESTWIND,,2,2,1,3
48070,djrollsroyce,,0,145,15,160
48071,bakineggs,,0,1,1,2
48072,melaos,,20,5,8,13
48073,tmart,,31,10,2,12
48074,dRedN,,8,1,1,2
48075,LestroCliche,,13,80,17,97
48076,semajblue,,25,1,3,4
48077,MrSpoilers,,43,2,5,7
48078,twinklestar2007,,19,15,23,38
48079,posterchild,,13,25,67,92
48080,emailyourbuddy,,32,7,28,35
48081,jarotar,,1,182,102,284
48082,Takteek,,20,130,142,272
48083,greenrd,,20,578,687,1265
48084,donjoe0,,13,1,1,2
48085,diadem,,18,48,58,106
48086,aloysiusf,,42,2,3,5
48087,l0pr0file,,0,19,19,38
48088,neonsphinx,,1,41,57,98
48089,arxch126,,18,2,7,9
48090,boost,,1,2,4,6
48091,rsb62188,,19,1,1,2
48092,rjb138,,13,1,1,2
48093,lechero,,0,3,3,6
48094,catfishjenkins,,13,67,31,98
48095,karlk79,,13,1,1,2
48096,moonhoaxcoznostarpix,,34,9,19,28
48097,dude59,,13,2,2,4
48098,perpetualdoubt,,1,126,61,187
48099,m1st3rAn0nym0us,,12,1,1,2
48100,asdfdrum,,1,2,6,8
48101,kalramly,,34,3,2,5
48102,zeepee,,32,1,2,3
48103,aydiosmio,,6,3,1,4
48104,hottytoddy99,,19,30,50,80
48105,dragonandante,,42,33,75,108
48106,brainflake,,19,14,2,16
48107,pogla,,20,2,3,5
48108,pmg2007,,5,61,14,75
48109,Altras,,13,276,48,324
48110,beanland,,18,13,11,24
48111,ns2103,,12,19,50,69
48112,PopeyeDoyle,,19,25,40,65
48113,bluetrust,,1,47,65,112
48114,Enigme,,14,1,2,3
48115,crazymunch,,43,327,286,613
48116,WantonDistraction,,19,60,41,101
48117,ArmchairActivist,,19,16,23,39
48118,DEATHANGELBABY,,14,1,1,2
48119,gregburd,,32,2,1,3
48120,omaca,,13,26,25,51
48121,dododge,,20,31,100,131
48122,vonadler,,31,84,117,201
48123,aloeveraone,,13,32,36,68
48124,flynth99,,31,75,96,171
48125,beseecheth,,32,1,3,4
48126,dadood,,12,1,1,2
48127,aww,,6,1,3,4
48128,tritium6,,29,311,456,767
48129,WaterDragon,,19,419,691,1110
48130,lucid_point,,18,8,15,23
48131,dvm,,5,2,3,5
48132,abhijithg,,20,1,2,3
48133,swisha_beatz,,8,16,51,67
48134,reddmaher,,19,102,10,112
48135,jabby81,,36,7,10,17
48136,drguildo,,20,153,87,240
48137,antmanguitar,,18,12,24,36
48138,makis,,3,13,24,37
48139,azuriel,,20,120,16,136
48140,Mrmunchies,,5,3,6,9
48141,electricfoxx,,13,105,168,273
48142,no9,,18,10,13,23
48143,lpew,,31,5,6,11
48144,denidzo,,32,46,74,120
48145,routeflap,,42,2,2,4
48146,oursland,,20,62,69,131
48147,mousemaker,,5,1,1,2
48148,mrbravo,,19,1,1,2
48149,skerit,,32,159,213,372
48150,scorpiond,,22,1,1,2
48151,OneRudeComment,,30,1,1,2
48152,__Jesus__,,30,2,3,5
48153,travisu,,19,2,3,5
48154,wardley,,13,70,2,72
48155,umbepo,,43,9,4,13
48156,Jcrafton,,29,1,1,2
48157,ixid,,32,320,431,751
48158,mayorOFcrawford,,13,8,6,14
48159,NPT,,29,1,1,2
48160,newswiseguy,,13,1,1,2
48161,adresaklumea,,5,23,28,51
48162,smittten,,32,1,1,2
48163,singleposter,,32,2,29,31
48164,bloodguard,,3,35,65,100
48165,michael123,,13,170,16,186
48166,dangermouse,,8,2,1,3
48167,nosophorus,,20,1,3,4
48168,monoboyzmom,,18,1,2,3
48169,Alliance,,19,6,8,14
48170,fofightmeto,,0,29,8,37
48171,edithsan,,5,14,16,30
48172,xChosen1x,,8,8,14,22
48173,madbeans,,22,3,2,5
48174,bsmntbombdood,,10,4,10,14
48175,freqhz,,30,1,12,13
48176,BillionFace,,34,14,10,24
48177,Setu_Aus,,43,31,37,68
48178,jeff666,,0,14,34,48
48179,J-Ro,,19,2752,262,3014
48180,pyrelite,,1,2,1,3
48181,trivial,,19,683,787,1470
48182,catastrophic,,20,6,10,16
48183,liferebootdotcom,,27,1,1,2
48184,hadaka,,31,30,37,67
48185,VnlaThndr775,,19,99,245,344
48186,b1indsamurai,,34,47,2,49
48187,imonitor,,13,4,2,6
48188,McGuirk,,0,247,299,546
48189,sasmith,,31,3,4,7
48190,isohead,,20,26,15,41
48191,dontbejack,,43,147,278,425
48192,allscan,,19,3,4,7
48193,tbone28,,20,13,15,28
48194,feverish,,4,3,5,8
48195,samf,,19,27,32,59
48196,motookimura,,30,2,1,3
48197,eldiablito,,18,2,4,6
48198,prefsaver,,19,66,113,179
48199,jhorsley3,,34,2,1,3
48200,nullynull,,12,53,225,278
48201,junkytrunks,,18,27,42,69
48202,frezned,,23,11,13,24
48203,chimchim321,,13,2,7,9
48204,emrikol,,43,11,7,18
48205,paulkallol,,18,158,43,201
48206,psly4mne,,18,1,8,9
48207,MrJoeSmith2,,32,13,10,23
48208,Cloroxxorzz,,0,1,8,9
48209,Mattcwu,,4,4,11,15
48210,macaddictg4,,10,31,18,49
48211,RobKohr,,19,2,1,3
48212,cardinality_zero,,32,6,19,25
48213,Presuminged,,29,3,3,6
48214,FreeMcKilt,,13,38,12,50
48215,Biohacker,,19,36,1,37
48216,brunt2,,31,961,1555,2516
48217,rodolfos,,31,3,2,5
48218,kupaka,,43,2,10,12
48219,jsj1971,,20,175,8,183
48220,Doctor_Evil,,22,4,8,12
48221,black2night,,20,10,3,13
48222,notgod,,22,1,1,2
48223,meara,,22,23,8,31
48224,mipadi,,20,169,153,322
48225,priapism,,13,1,1,2
48226,ianmack,,17,1,1,2
48227,Oldeyes,,0,5,6,11
48228,seekerOfLight,,18,4,1,5
48229,oxymor00n,,20,25,3,28
48230,coollettuce,,1,287,248,535
48231,Phrag,,19,160,294,454
48232,Ajenthavoc,,22,83,126,209
48233,jtjin,,1,51,74,125
48234,baadshahfk,,31,227,87,314
48235,ralf1,,0,12,19,31
48236,vapourizethis,,30,14,24,38
48237,rmwb,,22,2,7,9
48238,gum11,,18,52,69,121
48239,bob73,,19,1,4,5
48240,ShipOffFools,,1,4,12,16
48241,rodarmor,,43,19,8,27
48242,r121,,22,58,95,153
48243,b33rgy,,20,8,9,17
48244,watchmesuck,,18,9,12,21
48245,heapoverflowbm,,13,1,1,2
48246,KevP,,32,15,10,25
48247,wimpel,,43,1,2,3
48248,MisplacedKarma,,15,2,1,3
48249,Leeroy_Jewkins,,29,6,9,15
48250,xasper8,,42,14,32,46
48251,individual61,,18,36,59,95
48252,mrpoopypantss,,6,15,4,19
48253,valkyrie123,,13,41,64,105
48254,clintmemo,,6,23,28,51
48255,RedRightHand,,1,4,6,10
48256,gnubian,,6,2,3,5
48257,fredgarvin,,14,1,2,3
48258,wernerpm,,17,1,5,6
48259,zweistein,,20,6,11,17
48260,thinkalone,,1,11,28,39
48261,ForestFelineSage,,39,2,2,4
48262,masterofsockpuppets,,6,1,1,2
48263,MrFoo42,,20,4,1,5
48264,elblanco,,20,28,85,113
48265,covidiu,,20,16,25,41
48266,wbonner,,0,124,18,142
48267,magicdonkey1,,13,13,1,14
48268,renosaz,,13,68,75,143
48269,Dark-Dx,,22,966,1812,2778
48270,Caiocow,,22,15,31,46
48271,suckerpunch,,21,5,4,9
48272,couchlock,,22,9,12,21
48273,rushtomsawyer,,0,3,1,4
48274,Mark4483,,41,3,5,8
48275,Pradico,,5,10,8,18
48276,beachchair,,20,44,61,105
48277,jonx_rainer,,18,80,90,170
48278,Roknine,,43,17,10,27
48279,wwabc,,13,1098,1172,2270
48280,steve93,,19,135,231,366
48281,joe_fishfish,,31,56,66,122
48282,assteroid,,0,269,369,638
48283,llama-lime,,20,67,68,135
48284,lamaw,,13,13,3,16
48285,flaurens,,18,1,1,2
48286,nitramk,,20,78,131,209
48287,johnfredcee,,20,33,32,65
48288,karly_marxinogue,,29,2,5,7
48289,Btrash,,34,1,2,3
48290,unimatrixzero,,31,12,13,25
48291,powlette,,1,92,21,113
48292,Ajaxxx,,29,1,4,5
48293,rivers_,,1,3,4,7
48294,in_the_event,,13,45,19,64
48295,og_sandiego,,18,167,28,195
48296,bobbyfiend,,13,29,75,104
48297,Splatterh0use,,18,38,114,152
48298,manelvf,,1,2,1,3
48299,selfishselfcentered,,7,36,64,100
48300,maven007,,12,1,3,4
48301,Circa_Lucid,,33,2,7,9
48302,jigglesworth,,20,1,1,2
48303,stvspl,,1,204,418,622
48304,pintong,,18,98,115,213
48305,liminaltimes,,19,384,592,976
48306,Shrimps,,31,1,1,2
48307,FuryofThor86,,31,3,1,4
48308,djtedman111,,13,1,1,2
48309,MasonM,,20,51,50,101
48310,riecon,,20,1,5,6
48311,AlphaWolf,,19,3,7,10
48312,arfrank,,43,2,2,4
48313,inandjo,,16,2,1,3
48314,obie25,,40,5,1,6
48315,AccountPolice,,22,5,12,17
48316,jl008h,,32,1,1,2
48317,XtaI,,22,2,2,4
48318,Kellymaya,,19,61,41,102
48319,obelisk45,,32,27,42,69
48320,jrdorkin,,13,4,1,5
48321,witty_username,,19,57,15,72
48322,Formaldehyde,,18,37,34,71
48323,indu_san,,42,30,84,114
48324,joe_archer,,19,44,52,96
48325,jayathecat,,1,19,13,32
48326,Inuyasha44720,,19,1,1,2
48327,djphibes,,1,5,15,20
48328,dfuse,,18,87,169,256
48329,p0dg3s,,1,1,1,2
48330,magilla,,19,45,2,47
48331,jfischer,,20,4,8,12
48332,dropd2na,,1,6,2,8
48333,freddya,,34,6,2,8
48334,foco2001,,26,3,7,10
48335,kieranelby,,20,20,32,52
48336,sane_middle,,31,15,14,29
48337,P33KAJ3W,,42,8,24,32
48338,collision,,22,16,13,29
48339,vomjom,,20,13,13,26
48340,hatfield42,,13,15,23,38
48341,ygrof,,4,3,1,4
48342,devonian,,40,1,1,2
48343,fuglystick,,18,155,325,480
48344,shebangdotat,,20,81,101,182
48345,Indeed,,13,41,15,56
48346,Portlander,,18,147,166,313
48347,Toolazy2work,,19,3,2,5
48348,popeyoni,,22,1,4,5
48349,taitbp,,39,16,10,26
48350,b0dhi,,20,35,77,112
48351,atothek302,,19,29,13,42
48352,Twidget831,,18,1,2,3
48353,aumana,,0,11,17,28
48354,shermint,,12,2,3,5
48355,madzor,,22,2,3,5
48356,bobconan,,13,45,40,85
48357,crmaki,,19,105,127,232
48358,chupi,,8,1,5,6
48359,CodeFreak,,5,3,13,16
48360,emilyquinn,,19,50,9,59
48361,pejo,,20,1,2,3
48362,d6chung,,1,23,14,37
48363,wickedsteve,,32,223,364,587
48364,CounterCointelPro,,10,3,6,9
48365,Indyhouse,,19,553,213,766
48366,muffinmix,,18,27,77,104
48367,fredrikj,,20,43,62,105
48368,korjagun,,20,99,121,220
48369,FaberfoX,,14,1,2,3
48370,Shmurk,,20,50,75,125
48371,Hukeshy,,31,86,88,174
48372,smulloni,,31,1,1,2
48373,MarketUrbanism,,11,2,5,7
48374,Murple,,30,11,27,38
48375,loudasthesun,,1,401,161,562
48376,weasel925,,13,23,40,63
48377,esotic,,20,1,1,2
48378,gyfcms,,18,27,58,85
48379,Ayavaron,,1,59,91,150
48380,bandman614,,20,100,150,250
48381,moyly,,12,2,5,7
48382,jofer,,13,7,4,11
48383,qwe1234,,20,248,354,602
48384,mint_jelly,,18,3,10,13
48385,rmss,,43,5,2,7
48386,vowels,,22,6,7,13
48387,cgibbard,,20,151,269,420
48388,lazzeri,,18,155,131,286
48389,intergalacticninja,,1,1,1,2
48390,illusio,,6,1,1,2
48391,Knucklecallus,,17,3,3,6
48392,compostellas,,20,1,1,2
48393,Boobjob4u,,1,1,5,6
48394,iros,,13,2,2,4
48395,CaptainCharisma,,13,14,49,63
48396,abc2013,,13,19,20,39
48397,mike_dark,,13,104,303,407
48398,umibozu,,42,254,246,500
48399,pacsurf,,13,6,9,15
48400,emag,,20,64,135,199
48401,zeptillian,,0,1,1,2
48402,particle,,3,24,23,47
48403,RickHendershot,,5,2,1,3
48404,PresElectObama,,22,2,1,3
48405,sleet,,20,6,10,16
48406,melindapresto,,30,2,2,4
48407,d280z,,18,8,5,13
48408,greatgregg,,18,15,14,29
48409,unsatisfactory,,18,2,4,6
48410,Wickity,,18,2,4,6
48411,stankytofu,,18,12,1,13
48412,jackolythe,,18,5,11,16
48413,Clark76,,20,29,49,78
48414,pmezher,,43,5,2,7
48415,drjuandekon,,19,36,3,39
48416,AnythingApplied,,18,30,63,93
48417,pheinz,,20,2,2,4
48418,iceman_,,20,9,11,20
48419,entheogenic,,13,2,5,7
48420,welcometotheinternet,,6,3,4,7
48421,Grue,,20,649,903,1552
48422,Protophobic,,18,215,227,442
48423,SnowFire,,18,2,10,12
48424,blackhatzen,,13,9,1,10
48425,jeeg,,18,15,4,19
48426,wary,,19,5,14,19
48427,ChristianBk,,26,2,6,8
48428,neverender,,22,40,25,65
48429,jdpowers,,29,14,7,21
48430,SaeedArtist,,34,21,2,23
48431,gtllama,,18,2,5,7
48432,feureau,,18,11,20,31
48433,mikhon,,20,2,1,3
48434,alexacto,,18,24,55,79
48435,helpsfo,,19,2,3,5
48436,frog52,,42,1,2,3
48437,steppenwolf86,,31,33,75,108
48438,srgmpdns,,1,13,16,29
48439,mitsuhiko,,20,118,148,266
48440,Chalain,,20,1,1,2
48441,boffo,,20,17,11,28
48442,joseph177,,18,98,243,341
48443,drjanek,,20,14,24,38
48444,fkkker,,1,2,2,4
48445,burny97236,,0,3,8,11
48446,elizinthemorning,,4,106,114,220
48447,antpuncher,,4,5,4,9
48448,dugbybugby,,1,2,3,5
48449,Massif,,32,13,13,26
48450,Anktech,,13,1,1,2
48451,jamesishere,,0,154,22,176
48452,mlgoss,,43,198,281,479
48453,ineedmoresleep,,31,31,29,60
48454,Khendroc,,13,356,779,1135
48455,daftnebula,,18,2,4,6
48456,rrenaud,,20,60,47,107
48457,pedo2,,19,3,3,6
48458,jrj,,20,4,5,9
48459,chubs66,,32,77,145,222
48460,reneky,,32,49,9,58
48461,thinkbeforedo,,12,6,7,13
48462,eldormilon,,5,6,12,18
48463,AtheistMedicineMan69,,42,1,1,2
48464,raimesh,,20,1,5,6
48465,bali-song,,31,12,15,27
48466,lrpiccolo,,31,33,22,55
48467,Zoltair,,18,23,37,60
48468,Orangutan,,13,1436,551,1987
48469,fadmmatt,,20,4,11,15
48470,GeneralMaximus,,20,15,1,16
48471,humpaaacactus,,8,9,18,27
48472,beeker,,10,3,6,9
48473,philsci,,20,1,2,3
48474,kendrahwithanh,,1,29,41,70
48475,optiman,,22,3,3,6
48476,thorrx,,22,11,17,28
48477,Garetht,,18,2,5,7
48478,brandiene,,22,2,6,8
48479,cpverne,,1,1,1,2
48480,gooby,,4,1,1,2
48481,vanillashake,,19,2,4,6
48482,essjay24,,9,1,3,4
48483,Hechus,,20,4,2,6
48484,brianh2244,,13,1,1,2
48485,neoronin,,43,3200,110,3310
48486,sh1bb,,20,1,1,2
48487,wkinney,,20,2,1,3
48488,dserfaty,,18,2,7,9
48489,mayherz,,13,2,2,4
48490,starrydynamo,,29,4,7,11
48491,thedward,,20,37,49,86
48492,martythemaniak,,1,10,18,28
48493,CWmike,,23,252,3,255
48494,imcnoshain,,19,2,1,3
48495,btfh,,29,5,7,12
48496,nedw,,18,10,14,24
48497,ezkl,,7,32,11,43
48498,pwnagebrotice,,18,6,5,11
48499,comand,,1,16,17,33
48500,chocdrop,,39,3,2,5
