Id,Label,timeset,modularity_class,indegree,outdegree,Degree
0,DrMonkeyLove,,1,183,283,466
1,democritus,,1,7,6,13
2,sileegranny,,1,9,15,24
3,paulocoelho,,1,8,2,10
4,antichrist,,1,322,114,436
5,arrezzo,,1,1,9,10
6,JayGodse,,1,1,1,2
7,soniabegonia,,1,30,43,73
8,cinnamongreen,,1,6,23,29
9,inforte,,1,32,6,38
10,johnself,,1,142,144,286
11,lazyliberal,,1,2,3,5
12,alouise,,1,3,2,5
13,illiterature,,1,10,8,18
14,theghoul,,1,58,65,123
15,esobelle,,1,2,5,7
16,roadtoreality,,1,2,5,7
17,HelenLove,,1,1,2,3
18,waterbabies3,,1,21,26,47
19,JanneVee,,1,63,78,141
20,StaceyTheGirl,,1,30,44,74
21,pstone,,1,9,15,24
22,rachkovsky,,1,3,2,5
23,shiftkey,,1,16,23,39
24,poppafuze,,1,20,40,60
25,Softcode,,1,1,1,2
26,maek,,1,1,3,4
27,villy,,1,1,7,8
28,PurpleDingo,,1,43,79,122
29,junaru,,1,47,68,115
30,MetaStockTools,,1,3,4,7
31,sirg3,,1,1,9,10
32,mgcmrkr,,1,11,10,21
33,paullyjunge,,1,6,8,14
34,sholynaty,,1,27,24,51
35,qbproger,,1,23,24,47
36,2424,,1,99,146,245
37,psiber,,1,24,7,31
38,malcolmbastien,,1,1,2,3
39,tekp2,,1,1,1,2
40,philgibbins,,1,1,1,2
41,BOOYAKASHAA,,1,1,2,3
42,landylord,,1,4,1,5
43,zobdos,,1,25,46,71
44,tomasarson,,1,1,1,2
45,OutcastKnight,,1,3,7,10
46,netizenbane,,1,4,8,12
47,robertrade,,1,4,3,7
48,mjc4y,,1,1,5,6
49,pointee,,1,1,1,2
50,Makido,,1,4,6,10
51,slapshot,,1,176,138,314
52,lavilas,,1,30,45,75
53,brian_jaress,,1,25,39,64
54,gresham,,1,22,4,26
55,goolies,,1,1,5,6
56,pjabrennan,,1,1,2,3
57,parappayo,,1,1,2,3
58,knorby,,1,20,36,56
59,namdas,,1,12,2,14
60,factor0,,1,5,11,16
61,NewJersey,,1,1,3,4
62,emresaglam,,1,26,42,68
63,gosidracer,,1,4,4,8
64,hotmailfan,,1,13,12,25
65,karma__whore,,1,1,1,2
66,danielnapierski,,1,2,4,6
67,machrider,,1,244,361,605
68,kumaram16,,1,282,16,298
69,jmcwright,,1,8,14,22
70,Gersh54,,1,83,63,146
71,IanSteph,,1,20,55,75
72,mph11,,1,3,2,5
73,IncrediblyWrongMan,,1,1,1,2
74,steinmb,,1,14,22,36
75,alexs,,1,313,332,645
76,kkoozzz,,1,3,3,6
77,maryhunt,,1,5,7,12
78,benuntu,,1,15,25,40
79,beckermt,,1,672,1109,1781
80,engtech,,1,20,3,23
81,OMG_my_BABY,,1,20,67,87
82,nicodaemos,,1,10,12,22
83,mattmac55,,1,4,1,5
84,jailbeta,,1,45,1,46
85,silencergroup,,1,613,635,1248
86,lordasrael,,1,3,3,6
87,SixtoMercedes,,1,8,23,31
88,smackmestoopid,,1,5,10,15
89,databus,,1,4,6,10
90,demon_hunter,,1,1,2,3
91,captnanonymous,,1,1,1,2
92,gimeit,,1,314,407,721
93,soul1239,,1,17,20,37
94,gruven,,1,122,1,123
95,akshayxyz,,1,3,7,10
96,DPhil,,1,235,5,240
97,scerevisme,,1,3,3,6
98,fdgonthier,,1,8,3,11
99,opzori,,1,1,2,3
100,acharlwood,,1,1,2,3
101,Triscuit,,1,1,1,2
102,spartman,,1,1,3,4
103,milksop,,1,19,18,37
104,jryde3031,,1,40,17,57
105,bentlegen,,1,6,1,7
106,miguel9614,,1,13,10,23
107,trim17,,1,33,32,65
108,MarkEst1973,,1,2,3,5
109,menolikey,,1,98,143,241
110,poolplyr27,,1,2,1,3
111,csl,,1,95,53,148
112,buddav,,1,2,6,8
113,ThisIsNotYourMango,,1,3,1,4
114,munan,,1,25,109,134
115,Slango,,1,1,14,15
116,wwarner,,1,3,1,4
117,jdhore1,,1,5,11,16
118,tekkou,,1,7,8,15
119,JHallam,,1,18,2,20
120,locuester,,1,45,30,75
121,akhavr,,1,1,1,2
122,spankbot,,1,2,2,4
123,Kiram,,1,143,32,175
124,babasave,,1,1,1,2
125,darklotus,,1,1,1,2
126,aubradley84,,1,3,2,5
127,CorporalClegg68,,1,24,33,57
128,foldsworkthatway,,1,1,1,2
129,bwana914,,1,3,1,4
130,aarohanb,,1,2,1,3
131,squarehappy,,1,35,55,90
132,farnsey,,1,4,7,11
133,hypn0toad,,1,2,4,6
134,mitcjm,,1,21,18,39
135,adamv,,1,117,204,321
136,DonEvenTryDude,,1,1,2,3
137,brownb2,,1,12,12,24
138,Eviljoe,,1,6,13,19
139,burkadurka,,1,32,48,80
140,xerogod,,1,157,290,447
141,PFinn,,1,9,7,16
142,ours,,1,336,786,1122
143,lkap13,,1,3,4,7
144,ozzilee,,1,121,88,209
145,metalchick666,,1,2,7,9
146,abcd156,,1,1,1,2
147,alznto,,1,2,2,4
148,mjg58,,1,1,2,3
149,Polyrhythm,,1,8,23,31
150,akadit,,1,13,1,14
151,Claymation,,1,20,2,22
152,kkoo,,1,1,1,2
153,ketjapo,,1,9,1,10
154,nhavar,,1,14,38,52
155,cdaniel1,,1,19,8,27
156,ih8dems,,1,2,2,4
157,tomtermite,,1,11,12,23
158,nu303,,1,6,2,8
159,Pussy_Magnet,,1,111,82,193
160,jizzlies,,1,20,106,126
161,SelmaBouvier,,1,8,6,14
162,hypnofrog,,1,11,20,31
163,godawgs7,,1,10,4,14
164,socks,,1,526,361,887
165,hs4x,,1,1468,1743,3211
166,keikun17,,1,184,39,223
167,scruffy1,,1,3,1,4
168,twomashi,,1,22,21,43
169,martinvanburen,,1,4,3,7
170,spiegel101,,1,1,1,2
171,Captain,,1,19,26,45
172,biledemon85,,1,3,7,10
173,10923829038,,1,2,4,6
174,randomd00d,,1,9,13,22
175,badonkadonk,,1,5,3,8
176,zoba,,1,11,11,22
177,snoofwho,,1,2,4,6
178,svero6,,1,9,9,18
179,gerran,,1,112,54,166
180,Doeke,,1,279,331,610
181,consumer,,1,3,6,9
182,masterfap,,1,8,18,26
183,citricking,,1,6,8,14
184,GetToTheKarateChoppa,,1,828,914,1742
185,DDragon,,1,1,1,2
186,cyanblue,,1,3,2,5
187,sidartha,,1,39,9,48
188,DukeOfZhou,,1,21,63,84
189,rmbjspd,,1,38,18,56
190,designerbay,,1,79,30,109
191,LiLaBell,,1,1,2,3
192,waspinator,,1,1,7,8
193,loruz,,1,20,30,50
194,geekboysf,,1,16,33,49
195,puto,,1,4,12,16
196,excoriator,,1,15,11,26
197,kragshot,,1,110,203,313
198,g8or8de,,1,1,6,7
199,deadmantizwalking,,1,379,810,1189
200,dondiscounto,,1,10,14,24
201,Crito,,1,140,221,361
202,makemearedcape,,1,103,99,202
203,raganwald,,1,256,110,366
204,shiro,,1,6,13,19
205,drjekel_mrhyde,,1,2,6,8
206,diffraction,,1,98,83,181
207,babsglaxo,,1,1,3,4
208,AbVag,,1,47,84,131
209,23049873409,,1,2,1,3
210,megiston,,1,8,1,9
211,DavidCaruso,,1,27,17,44
212,Alpha_Chimp,,1,17,42,59
213,bnelson,,1,47,54,101
214,markfoster24,,1,124,16,140
215,briannagriffin,,1,26,18,44
216,dsandler,,1,177,213,390
217,christiangoldberg,,1,1,1,2
218,dspeyer,,1,9,9,18
219,gyruss,,1,27,4,31
220,idono,,1,26,17,43
221,thesals,,1,1,2,3
222,superwinky,,1,102,181,283
223,tyllwin,,1,1,1,2
224,GiantBatFart,,1,650,64,714
225,thedkl,,1,6,7,13
226,sork,,1,8,8,16
227,Celt,,1,1,1,2
228,DragonMist,,1,2,4,6
229,000zero,,1,1,1,2
230,audj,,1,6,5,11
231,symbioticintheory,,1,21,35,56
232,rod_von_hugenstein,,1,4,2,6
233,satha92,,1,12,25,37
234,fetiere,,1,3,1,4
235,nutzzzz,,1,8,19,27
236,justinasaurusrex,,1,1,1,2
237,kukkuzejt,,1,11,7,18
238,scylla,,1,297,177,474
239,JWEIS87,,1,24,61,85
240,scottv,,1,2,4,6
241,jordanhowe56,,1,16,10,26
242,geiger253,,1,211,281,492
243,ificanbefrank,,1,6,11,17
244,Uncle_Erik,,1,12,12,24
245,dbldn,,1,5,5,10
246,kahi,,1,6,7,13
247,cl191,,1,13,5,18
248,orSKAsm,,1,62,27,89
249,allenmunroe,,1,16,11,27
250,monesy,,1,187,498,685
251,jasonb,,1,21,1,22
252,mamid,,1,21,27,48
253,FigBug,,1,9,3,12
254,adazzle,,1,22,34,56
255,Carlos_Slim,,1,1,1,2
256,sucksatperl,,1,2,1,3
257,inigo_montoya_,,1,2,2,4
258,ttul,,1,4,5,9
259,cezar,,1,116,235,351
260,caljza,,1,1,1,2
261,HathNoro,,1,5,8,13
262,TechStuff,,1,6,16,22
263,phlllpy,,1,3,2,5
264,moobyseviltwin,,1,31,61,92
265,bordeau,,1,1,1,2
266,kvilla,,1,7,16,23
267,NakedTonyDanza,,1,508,472,980
268,charleyface,,1,25,60,85
269,Blnd2Spll,,1,210,38,248
270,SlippyZ,,1,1,1,2
271,denyde,,1,1,1,2
272,bl00dninja,,1,5,9,14
273,eleni_h,,1,1,2,3
274,typo180,,1,109,141,250
275,lagartoflojo,,1,1,1,2
276,cameron_penn,,1,2,1,3
277,lickyfy,,1,233,16,249
278,pigwolley,,1,2,4,6
279,lrknapp,,1,32,16,48
280,tunah,,1,92,195,287
281,j3ffr3y,,1,43,12,55
282,NightChaos,,1,1,1,2
283,dill0n,,1,22,10,32
284,luigi96,,1,1,1,2
285,me2i81,,1,64,101,165
286,davecardwell,,1,3,5,8
287,bordlin,,1,35,1,36
288,nickshel81,,1,1,3,4
289,_shift,,1,14,23,37
290,SpaceCaesar,,1,54,7,61
291,evabin,,1,295,4,299
292,benb24,,1,14,3,17
293,lentil,,1,2,3,5
294,chibigoten,,1,11,9,20
295,AdamTReineke,,1,27,14,41
296,NJScorpio,,1,191,70,261
297,fishwert,,1,7,8,15
298,robisbell,,1,33,71,104
299,ixampl,,1,5,5,10
300,s2b,,1,1,1,2
301,DecodedFromSpace,,1,5,12,17
302,neave,,1,6,1,7
303,absoluteskeptic,,1,23,27,50
304,alphabeat,,1,1713,1434,3147
305,falcojr,,1,8,17,25
306,pornking,,1,2,1,3
307,kamaelian,,1,2,5,7
308,idealsorstrategy,,1,4,2,6
309,camgnostic,,1,40,44,84
310,ducky3tjh,,1,47,2,49
311,Waylander1970,,1,6,3,9
312,AlonzoFyfe,,1,1,5,6
313,aieee,,1,12,11,23
314,LapsedPacifist,,1,293,809,1102
315,nocam,,1,1,6,7
316,rawrz,,1,4,2,6
317,mdoddr,,1,158,234,392
318,exponent,,1,5,2,7
319,egibson,,1,83,41,124
320,algernon_inc,,1,1,1,2
321,noisydissonance,,1,12,14,26
322,inputnamehere,,1,23,21,44
323,mvonballmo,,1,49,55,104
324,z3niMAGiNE,,1,2,1,3
325,Sle,,1,401,729,1130
326,rrabbit,,1,10,12,22
327,Morrac,,1,2,3,5
328,TheEighties,,1,1,1,2
329,teamonkey,,1,39,23,62
330,amijot,,1,69,20,89
331,koko775,,1,34,42,76
332,twopoint718,,1,42,66,108
333,pyro2927,,1,209,240,449
334,jackcrow,,1,9,10,19
335,b34nz,,1,1567,1759,3326
336,nsfx,,1,8,2,10
337,birdmanx35,,1,69,5,74
338,chris789,,1,1127,17,1144
339,rocksteady,,1,6,2,8
340,hejog,,1,92,146,238
341,nafai,,1,14,26,40
342,mancunian,,1,112,183,295
343,alfadana,,1,1,3,4
344,lyric6a,,1,47,32,79
345,swytz,,1,2,8,10
346,bis,,1,3,7,10
347,I_R_BABOON,,1,3,1,4
348,crackron,,1,7,16,23
349,appleaday,,1,170,84,254
350,popechunk,,1,7,8,15
351,wvhillbilly,,1,3,1,4
352,CapslockSpamLover,,1,1,1,2
353,muyuu,,1,51,90,141
354,WendyThomas,,1,147,23,170
355,copyland1,,1,1,1,2
356,ncod,,1,13,19,32
357,rubes68,,1,1,1,2
358,garyp714,,1,2213,1409,3622
359,drpgq,,1,3,7,10
360,Mantaar,,1,66,57,123
361,gjahnke,,1,2,1,3
362,flyinggnome,,1,71,116,187
363,TerrorBanana,,1,27,46,73
364,clankboomsteam,,1,3,4,7
365,Master_Kush,,1,4,4,8
366,smart33,,1,11,4,15
367,mattbc,,1,4,5,9
368,hadashi,,1,25,43,68
369,radiofloyd,,1,37,2,39
370,onecartel,,1,5,13,18
371,mueller2004,,1,4,3,7
372,FaceCake,,1,1,2,3
373,noahbk,,1,3,4,7
374,dactylic,,1,1,1,2
375,id10tjoeuser,,1,44,43,87
376,The_Gage,,1,16,21,37
377,vanzan,,1,358,315,673
378,blackmouth,,1,2,2,4
379,doctabu,,1,64,63,127
380,andrewlinn,,1,50,34,84
381,FatBanker,,1,2,7,9
382,lanewin,,1,2,1,3
383,washi,,1,5,5,10
384,hgunited,,1,2,1,3
385,MphsBlues,,1,9,19,28
386,bubblepeak,,1,12,7,19
387,WHITEvsBLACK,,1,3,4,7
388,matthcx,,1,1,1,2
389,untitled1,,1,39,6,45
390,Hilko,,1,97,186,283
391,zacdenver,,1,347,990,1337
392,talatfakhri007,,1,51,16,67
393,micahville,,1,2,7,9
394,fimblo,,1,19,22,41
395,djinsomniac,,1,25,42,67
396,guntharg,,1,1,1,2
397,magnerash,,1,1,1,2
398,toml,,1,14,15,29
399,upchuk,,1,613,49,662
400,sewiv,,1,54,60,114
401,inspire,,1,50,31,81
402,teetow,,1,66,117,183
403,brerrabbit,,1,1,6,7
404,aristus,,1,16,6,22
405,TheNonReligiousPope,,1,331,553,884
406,mery1,,1,9,14,23
407,dupeduperson,,1,64,10,74
408,markedtrees,,1,224,368,592
409,deftmatt,,1,1,2,3
410,RMTV,,1,1,2,3
411,graciouspatty,,1,4,9,13
412,Scariot,,1,3,9,12
413,jhart3,,1,15,15,30
414,dehue,,1,7,6,13
415,limi,,1,6,11,17
416,bishopazrael,,1,38,26,64
417,fnord123,,1,496,564,1060
418,kingchiron,,1,56,67,123
419,oh_hello,,1,1,1,2
420,treezequeen,,1,1,1,2
421,wrangler1390,,1,4,5,9
422,random2927350238,,1,28,26,54
423,crypticgeek,,1,1,2,3
424,killa7,,1,2,4,6
425,AVISINGH,,1,26,33,59
426,theotherspectacle,,1,2,2,4
427,snakespm,,1,15,10,25
428,chaunymony,,1,67,71,138
429,eznet,,1,1,6,7
430,rondogfy,,1,2,2,4
431,eliot99,,1,61,68,129
432,saintflibble,,1,1,1,2
433,wowbagger,,1,19,32,51
434,WerewolvesRancheros,,1,160,265,425
435,furby1234,,1,3,1,4
436,jaybeehere954,,1,1,2,3
437,mrreddit,,1,14,19,33
438,snowmizuh,,1,9,8,17
439,trebnoj,,1,16,10,26
440,plexux,,1,6,1,7
441,sadisticmidget,,1,5,10,15
442,masonba,,1,92,29,121
443,Kerguidou,,1,27,18,45
444,_Sarah_Palin_,,1,2,1,3
445,random523075097253,,1,1,1,2
446,STDOUBT,,1,70,91,161
447,Michael_Jackson,,1,4,4,8
448,natebmiller,,1,2,3,5
449,Wo1ke,,1,780,967,1747
450,dannyapplesauce,,1,55,73,128
451,2ndGuardsTankArmy,,1,132,161,293
452,GoodyUK,,1,668,8,676
453,skinner696,,1,72,19,91
454,glitch83,,1,19,33,52
455,johnland,,1,29,34,63
456,ch4os1337,,1,5,9,14
457,itx,,1,6,1,7
458,msiekkinen,,1,172,56,228
459,nihilite,,1,270,367,637
460,kruetz,,1,7,12,19
461,MrMasterplan,,1,2,5,7
462,kly,,1,20,26,46
463,realmojo,,1,25,3,28
464,theoneupdownstairs,,1,1,5,6
465,out_of_memory,,1,2,2,4
466,method77,,1,12,19,31
467,turbofisk,,1,47,70,117
468,initnull,,1,22,2,24
469,harley96,,1,2,2,4
470,lequack,,1,8,11,19
471,readergirl,,1,95,124,219
472,datamyte,,1,2,6,8
473,AngryBadger,,1,94,99,193
474,adal-cft,,1,1,4,5
475,endosquid,,1,4,3,7
476,notasockpuppet,,1,1,1,2
477,phildawes,,1,6,6,12
478,cigr,,1,251,63,314
479,pyrefyre,,1,10,9,19
480,werther,,1,30,40,70
481,mrm52,,1,21,4,25
482,scottys0,,1,2,1,3
483,rez0,,1,7,14,21
484,mrmoneda,,1,1,1,2
485,rainmanjam,,1,16,34,50
486,5-4-3-2-1,,1,4,2,6
487,CountSessine,,1,18,9,27
488,turf1600,,1,1,1,2
489,firexq,,1,5,5,10
490,angelwild327,,1,4,4,8
491,autopilot,,1,4,4,8
492,grepthis,,1,3,4,7
493,onehand,,1,34,79,113
494,gaur,,1,5,2,7
495,popfly10,,1,8,8,16
496,KipBond,,1,105,124,229
497,RickyP,,1,707,944,1651
498,ckup619,,1,6,2,8
499,ozsynergy,,1,10,12,22
500,urimyknife,,1,2,1,3
501,hatcat,,1,126,224,350
502,giboyeux,,1,2,2,4
503,Gadfly222,,1,6,8,14
504,VelvetElvis,,1,386,353,739
505,FloGiston,,1,149,294,443
506,Jey_Lux,,1,18,35,53
507,BenjaminFranklin,,1,9,5,14
508,DSLJohn,,1,183,124,307
509,1100,,1,237,471,708
510,Sargos,,1,81,43,124
511,mnotme,,1,419,150,569
512,patched,,1,7,1,8
513,Ferretbot,,1,31,38,69
514,Phonicsey,,1,234,29,263
515,ghiotion,,1,29,29,58
516,bashar1209,,1,26,36,62
517,cskinned,,1,2,5,7
518,freshhawk,,1,17,23,40
519,jeremy_degroot,,1,81,90,171
520,jezebean,,1,16,7,23
521,pthatcher,,1,9,11,20
522,sullivat,,1,2,1,3
523,kbob,,1,20,17,37
524,ih8mondays,,1,15,20,35
525,whoami24601,,1,20,1,21
526,cartooncorpse,,1,647,1588,2235
527,gaaaah,,1,1,3,4
528,qedanne,,1,26,8,34
529,NeoName,,1,1,1,2
530,quuxly,,1,13,22,35
531,rubenshakkamacher,,1,107,208,315
532,mrpeenut24,,1,439,364,803
533,grrlychck,,1,2,2,4
534,IStateTheObvious,,1,67,82,149
535,tinyfoot,,1,2,1,3
536,epicgeek,,1,368,490,858
537,nbuster,,1,45,44,89
538,klackty,,1,19,27,46
539,holyboot,,1,32,3,35
540,boringlove,,1,44,77,121
541,elocbej,,1,28,7,35
542,nunyabidness,,1,1,1,2
543,Seele,,1,340,446,786
544,subinf,,1,17,36,53
545,texan01,,1,2,7,9
546,gravlax,,1,1,2,3
547,7of7,,1,13,8,21
548,monkeySpibb,,1,15,12,27
549,dronebee,,1,8,3,11
550,bvimo,,1,36,91,127
551,motts,,1,4,4,8
552,SerdarArgic,,1,3,2,5
553,hiramp,,1,2,1,3
554,CockerRabbit,,1,1,1,2
555,doctor_shim,,1,123,239,362
556,emptycircles,,1,2,3,5
557,senorcool,,1,1,5,6
558,spitonmars,,1,12,10,22
559,ImNotWhoISayIAm,,1,4,3,7
560,GodTheFather,,1,5,9,14
561,dontmodmedownbro,,1,3,2,5
562,certifiablepsycho,,1,59,36,95
563,daev,,1,126,65,191
564,Ruskerdax,,1,7,8,15
565,amjadanwar,,1,2,1,3
566,dorsey,,1,66,22,88
567,gjaulwes,,1,7,14,21
568,3n7r0py,,1,518,130,648
569,josefek,,1,13,12,25
570,goodgoblin,,1,4,5,9
571,myndas,,1,16,12,28
572,gentlefood3,,1,3,2,5
573,redditer008,,1,3,4,7
574,sanbikinoraion,,1,63,77,140
575,LuckyLion,,1,7,6,13
576,vegan__zombie,,1,2,2,4
577,madonix,,1,284,10,294
578,mr2,,1,8,3,11
579,smans,,1,10,7,17
580,walbold,,1,2,1,3
581,yzeone,,1,6,2,8
582,wabberjockey,,1,33,46,79
583,11eleven11,,1,3,6,9
584,dottieroot,,1,3,1,4
585,monstermunch,,1,226,185,411
586,wjeconsultant,,1,27,5,32
587,amos_olson,,1,22,16,38
588,bangles,,1,49,72,121
589,y0haN,,1,22,28,50
590,elmayimbe,,1,2,8,10
591,Faluzure,,1,3,7,10
592,selstice,,1,17,31,48
593,Xodmoe,,1,13,18,31
594,StarvingAfricanChild,,1,14,10,24
595,mocharain,,1,6,2,8
596,oldjimsteele,,1,33,35,68
597,TopOBopYop,,1,1,4,5
598,orbhota,,1,307,567,874
599,fungstyle,,1,1,3,4
600,wideawakewesley,,1,1,5,6
601,afoo42,,1,74,24,98
602,alicereddit,,1,4,13,17
603,davodrums,,1,285,105,390
604,akoltek,,1,1,1,2
605,lavendula13,,1,394,887,1281
606,pedropants,,1,6,5,11
607,syphondex,,1,1,1,2
608,elmicha,,1,4,10,14
609,shackilj2,,1,1,2,3
610,jpark,,1,118,105,223
611,jeremed,,1,1,2,3
612,jazzyjaffa,,1,14,15,29
613,Grantismo,,1,10,13,23
614,KangOl,,1,15,11,26
615,underthelinux,,1,190,242,432
616,Ehran,,1,38,95,133
617,N432SEAN,,1,3,4,7
618,crunchynaan,,1,2,1,3
619,johndoesnt,,1,3,5,8
620,mikethomas84,,1,18,3,21
621,ckwop,,1,72,44,116
622,mhudson,,1,1,1,2
623,toona03,,1,1,3,4
624,fionawallace,,1,13,31,44
625,Eiii333,,1,229,279,508
626,0ddb411,,1,12,4,16
627,alteran1,,1,33,49,82
628,hummir,,1,23,8,31
629,Trucoto,,1,7,11,18
630,zerogirl,,1,7,6,13
631,slaur,,1,410,150,560
632,juventuscadillac,,1,23,19,42
633,eketros,,1,2,3,5
634,vertexoflife,,1,5,5,10
635,CommodoreGuff,,1,10,9,19
636,celsy,,1,1,2,3
637,Kallahan11,,1,26,61,87
638,fdkxjskdkle,,1,24,13,37
639,fdsads13s,,1,1,1,2
640,mystikphish,,1,6,7,13
641,trutru,,1,73,70,143
642,hamilmyemil,,1,3,4,7
643,KuroiDegu,,1,2,2,4
644,MeanStreak,,1,26,47,73
645,laverabe,,1,18,29,47
646,cicadabug,,1,3,1,4
647,sudo_cmd,,1,10,11,21
648,loumf,,1,33,39,72
649,StevieDee,,1,1,6,7
650,david_bowie,,1,3,2,5
651,SnowLeopard,,1,111,97,208
652,missRose,,1,56,39,95
653,rua2006,,1,3,1,4
654,repotorp,,1,4,8,12
655,digitalhijinks,,1,35,77,112
656,weezerfan,,1,2,5,7
657,reflorance,,1,1,1,2
658,collinwilliams,,1,111,12,123
659,r42,,1,13,24,37
660,padfoot7,,1,179,139,318
661,lilkatana,,1,14,12,26
662,sblanky,,1,2,1,3
663,Sauwan,,1,616,176,792
664,death_eater,,1,5,4,9
665,yeahjim,,1,3,11,14
666,gmsc,,1,27,14,41
667,Rastid,,1,216,219,435
668,puss,,1,139,42,181
669,bcardarella,,1,15,21,36
670,Santa_Clause,,1,4,3,7
671,mcvoy,,1,2,1,3
672,watts,,1,31,41,72
673,ehird,,1,358,496,854
674,laudinum,,1,44,74,118
675,sliksvelte,,1,3,3,6
676,nimbusnacho,,1,322,322,644
677,ciph3r,,1,1,1,2
678,jouwuitvaart,,1,7,3,10
679,devotee,,1,1,2,3
680,DCAdams,,1,4,8,12
681,obdurak,,1,379,294,673
682,CapRuger,,1,2,3,5
683,duklapragueawaykit,,1,12,8,20
684,thetreat,,1,245,198,443
685,JimboBob,,1,5,6,11
686,brg99,,1,2,1,3
687,iwadon,,1,1,4,5
688,ContentWithOurDecay,,1,316,773,1089
689,whit537,,1,8,4,12
690,QuesoPantera,,1,216,166,382
691,tene,,1,12,12,24
692,clickonthenat,,1,7,19,26
693,xii,,1,54,71,125
694,sniurkst,,1,1,2,3
695,ozzymet7,,1,44,21,65
696,kikaerter,,1,237,448,685
697,pohart,,1,31,72,103
698,keenemaverick,,1,165,197,362
699,Efflux,,1,39,38,77
700,foxbat,,1,163,112,275
701,Timbit42,,1,6,2,8
702,dopplerdog,,1,301,373,674
703,PigglyWiggly,,1,8,1,9
704,eris_amazing,,1,12,21,33
705,alexo05,,1,16,1,17
706,robingrrl,,1,10,11,21
707,fuckbuddy,,1,369,542,911
708,leode,,1,2,2,4
709,xianz,,1,5,7,12
710,sodillen,,1,1,3,4
711,ozymandiask,,1,5,3,8
712,2speed,,1,3,3,6
713,Ms_Bungle,,1,1,1,2
714,rememberingtiger,,1,20,1,21
715,rory007,,1,1,1,2
716,KingLeonidas,,1,1,1,2
717,03495803598,,1,8,7,15
718,DeePsix,,1,17,22,39
719,danstar,,1,1,1,2
720,IHUsol,,1,21,14,35
721,nevesis,,1,483,618,1101
722,Getalookatthis,,1,1,2,3
723,Contractionator,,1,7,7,14
724,vegasmacguy,,1,1,2,3
725,Niggers_Are_Stupid,,1,1,3,4
726,stringerbell,,1,225,291,516
727,stever1975,,1,3,7,10
728,TooStoop,,1,4,4,8
729,cameronoremac,,1,13,9,22
730,blarmystoned,,1,35,6,41
731,DJZ,,1,5,13,18
732,sente,,1,4,6,10
733,ItzVektor,,1,21,66,87
734,Plummit1,,1,2,5,7
735,FarmerBorn,,1,2,4,6
736,lunchladydoris2,,1,216,345,561
737,xoil13,,1,12,9,21
738,dsknsl,,1,2,1,3
739,camdenz,,1,7,4,11
740,m1kael,,1,51,52,103
741,ObamaKerryJr,,1,8,8,16
742,Seekin,,1,52,62,114
743,JohnnyMax,,1,1,1,2
744,KayEss,,1,40,52,92
745,longlivereddit,,1,42,1,43
746,negatiiv,,1,1,9,10
747,calis,,1,235,309,544
748,anti_1337,,1,3,7,10
749,ipeev,,1,297,262,559
750,Michael_Ian_Black,,1,5,1,6
751,jailbreak,,1,10,9,19
752,peter_norths_child,,1,269,86,355
753,scofus,,1,105,132,237
754,NukeAJewForAllah,,1,1,2,3
755,speaker219,,1,35,48,83
756,LusciousChaos,,1,3,2,5
757,dat529,,1,13,13,26
758,snapetom,,1,14,7,21
759,pbrettb,,1,1,6,7
760,coderjoe,,1,9,20,29
761,gir99,,1,22,15,37
762,alekseyportland,,1,1,1,2
763,lamb2theslaughter,,1,1,3,4
764,michaelGregoire,,1,10,21,31
765,novatexboard,,1,3,1,4
766,jakfrost,,1,2,4,6
767,ilovestuff,,1,1,1,2
768,FuzzyLogick,,1,69,193,262
769,saritate,,1,3,3,6
770,Hewus,,1,36,29,65
771,Guanxinet,,1,10,10,20
772,JonathanEllis,,1,2,4,6
773,fusebox13,,1,7,14,21
774,brondsem,,1,1,1,2
775,psignosis,,1,124,111,235
776,mdot,,1,3,4,7
777,abzde,,1,15,20,35
778,riddle_duck,,1,15,24,39
779,treo700P,,1,2,10,12
780,JustinZ,,1,3,8,11
781,mindspike,,1,10,4,14
782,DearBurt,,1,205,315,520
783,ngcazz,,1,111,251,362
784,warpdragon,,1,2,1,3
785,steveysjs,,1,1,7,8
786,TTDaVeTT,,1,1,1,2
787,paran0ide,,1,53,2,55
788,Rupan,,1,1,1,2
789,clintisiceman,,1,302,430,732
790,deadwisdom,,1,162,154,316
791,ComplexEmergency,,1,33,74,107
792,sta_n_sane,,1,16,41,57
793,csmiths,,1,6,10,16
794,whitegirlhere,,1,1,1,2
795,crescendolls,,1,1,5,6
796,poeir,,1,210,245,455
797,Allectus,,1,79,94,173
798,MiguelPT,,1,6,1,7
799,ikoss,,1,18,37,55
800,the_sparrow,,1,164,14,178
801,distirot,,1,4,4,8
802,lookingiswrong,,1,82,115,197
803,UloPe,,1,13,14,27
804,aroris,,1,9,4,13
805,ryanh42,,1,4,11,15
806,Enoxice,,1,209,315,524
807,monjurul,,1,1,2,3
808,tsunamisteve,,1,6,5,11
809,damienkhunter,,1,6,2,8
810,thebigguy62,,1,7,8,15
811,gorillamime,,1,14,6,20
812,waxo,,1,2,1,3
813,diziak,,1,4,5,9
814,dtelad11,,1,65,36,101
815,jack_proletariat,,1,1,1,2
816,mhd,,1,223,192,415
817,robstah,,1,1,2,3
818,burstgoof,,1,2,1,3
819,mvalente,,1,9,4,13
820,CarbonFiberUnderwear,,1,4,2,6
821,rssjunkie,,1,2,4,6
822,gamkiyaarov,,1,7,17,24
823,paulnomad,,1,39,9,48
824,LaptopLogic,,1,3,4,7
825,shackett,,1,2,4,6
826,Neoncow,,1,275,565,840
827,Mattbot5000,,1,2,4,6
828,walkindude,,1,1,1,2
829,tempestbrewer,,1,1,1,2
830,lani0,,1,2,27,29
831,igneus,,1,4,2,6
832,Churn,,1,329,350,679
833,jw4wywna,,1,1,1,2
834,WindowsVistaOutreach,,1,12,1,13
835,dunit01,,1,1,2,3
836,WisenUp,,1,129,189,318
837,mattshields,,1,2,6,8
838,stop___grammar_time,,1,36,42,78
839,ngileadi,,1,2,2,4
840,DiffeeOnline,,1,41,3,44
841,mehwoot,,1,14,12,26
842,milinz,,1,2,1,3
843,kthakar,,1,12,10,22
844,cyince,,1,86,89,175
845,dilap,,1,11,13,24
846,kbio89,,1,1,2,3
847,natalieorphan,,1,1,2,3
848,vit1701,,1,3,5,8
849,johnthedrunk,,1,183,315,498
850,Pxorp,,1,384,416,800
851,lyte,,1,5,4,9
852,my_pw_is_1234,,1,21,26,47
853,ex-stasis,,1,16,13,29
854,wageslave,,1,1113,1258,2371
855,jomynow,,1,50,32,82
856,Redpin,,1,8,18,26
857,ekizz,,1,120,95,215
858,Ysolde,,1,5,11,16
859,gwenny,,1,2,3,5
860,Crash-D,,1,1,2,3
861,PissPoorLogic,,1,8,6,14
862,random5280752309725,,1,7,4,11
863,CiRU5,,1,4,4,8
864,jasonmc,,1,5,3,8
865,ritar_hylon,,1,1,1,2
866,maefly2,,1,133,87,220
867,stu9000,,1,13,21,34
868,dlgdyer,,1,6,5,11
869,8bitsince86,,1,2,2,4
870,Zoethor2,,1,19,44,63
871,migsho,,1,1,2,3
872,bugninja,,1,77,32,109
873,glowinthedark,,1,102,149,251
874,cbre88x,,1,1,1,2
875,simc,,1,12,1,13
876,jaystile,,1,5,1,6
877,shan4350,,1,4,15,19
878,squarehipster,,1,5,5,10
879,kthakore,,1,8,4,12
880,spiffypants,,1,4,7,11
881,darmstrong,,1,2,2,4
882,clina83,,1,1,2,3
883,YJ2k2,,1,70,67,137
884,rivy,,1,19,62,81
885,campbe79,,1,30,27,57
886,fortunado,,1,1,1,2
887,ctraganos,,1,8,6,14
888,hrj,,1,1,3,4
889,justafed,,1,3,2,5
890,FokkeNews,,1,609,1013,1622
891,tanjuska,,1,7,3,10
892,bonecows,,1,2,5,7
893,Hubso,,1,595,674,1269
894,dav,,1,2,7,9
895,bluefish29,,1,4,1,5
896,math0ne,,1,7,5,12
897,AccordionGuy,,1,6,4,10
898,mash5,,1,48,10,58
899,earscoolbreeze,,1,14,36,50
900,Jedidiah,,1,6,9,15
901,greenmt,,1,3,4,7
902,rockintom99,,1,1,2,3
903,dhibbit,,1,248,266,514
904,aberrant,,1,159,139,298
905,Father_Pleger,,1,1,1,2
906,lilhurt38,,1,1,3,4
907,BloodJunkie,,1,233,6,239
908,num42,,1,1,1,2
909,TheRealStick,,1,139,5,144
910,RonBarrackMcCain,,1,1,1,2
911,Zaxxis,,1,40,44,84
912,svonnah,,1,91,98,189
913,bone,,1,10,10,20
914,almafa,,1,10,11,21
915,dbsmoker,,1,195,460,655
916,jamongkad,,1,6,8,14
917,lebski88,,1,125,183,308
918,lilmul123,,1,257,80,337
919,Laburno,,1,1,3,4
920,jryde303,,1,12,5,17
921,hjklqa,,1,2,3,5
922,sassansanei,,1,22,21,43
923,built,,1,3,6,9
924,bcropper,,1,1,1,2
925,gnit,,1,3,6,9
926,farktronix,,1,4,6,10
927,damagingd,,1,17,4,21
928,thegayestmanalive,,1,2,1,3
929,stoobe,,1,24,10,34
930,icantbemoreoriginal,,1,1,2,3
931,schallau,,1,9,11,20
932,chrozz,,1,36,101,137
933,vsizikov,,1,3,4,7
934,flutie,,1,2,4,6
935,internet_enthusiast,,1,3,8,11
936,nordicwinter,,1,39,65,104
937,magv,,1,31,40,71
938,dac69,,1,1,8,9
939,bobobo,,1,73,163,236
940,speedkissdrink,,1,2,1,3
941,karlhungis,,1,1,1,2
942,ragingkenbo,,1,264,115,379
943,cadillacvandal,,1,1,1,2
944,karth95,,1,2,1,3
945,seanm27,,1,225,325,550
946,shalaby,,1,14,20,34
947,WurzelGummidge,,1,55,63,118
948,SPINKTRONIX,,1,2,4,6
949,inthesky,,1,23,34,57
950,RayWestsWife,,1,1,1,2
951,brsmnky007,,1,12,9,21
952,karlb,,1,1,3,4
953,mindvault,,1,37,51,88
954,srtor,,1,8,37,45
955,piz0wn,,1,1,2,3
956,DIYromania,,1,162,149,311
957,brains1919,,1,1,1,2
958,vegasdoesvegas,,1,11,24,35
959,raqm,,1,22,1,23
960,mdolon,,1,11,8,19
961,a1phanumeric,,1,61,72,133
962,Felz,,1,8,13,21
963,saidwhat,,1,13,10,23
964,frugalgeek,,1,2,1,3
965,breals,,1,7,9,16
966,cliks,,1,221,1,222
967,banjaxed,,1,33,25,58
968,huerequeque,,1,33,84,117
969,kordless,,1,97,117,214
970,JEdwardFuck,,1,2,3,5
971,Ensynoptic,,1,5,13,18
972,mbot01,,1,5,10,15
973,btacoder,,1,16,8,24
974,gotekix,,1,24,32,56
975,bookwyrm,,1,10,14,24
976,tokyomonster,,1,2,4,6
977,nfiedel,,1,4,5,9
978,spaniardforMcCain,,1,3,2,5
979,extant,,1,3,8,11
980,qruokgs,,1,6,3,9
981,Jadedseeker,,1,1,1,2
982,rushtrack,,1,27,22,49
983,kooshball,,1,7,4,11
984,skaman607,,1,6,9,15
985,troll666,,1,25,48,73
986,cheysuli,,1,80,122,202
987,gschizas,,1,107,129,236
988,Visconti,,1,70,11,81
989,Tkeo,,1,1,1,2
990,roodammy44,,1,3,10,13
991,natey90210,,1,4,2,6
992,handick,,1,18,1,19
993,orip,,1,10,10,20
994,SolidEnder,,1,1,3,4
995,fvf,,1,29,51,80
996,hilbert,,1,149,12,161
997,beataya,,1,1,2,3
998,bloopsie,,1,2,12,14
999,lavistadad,,1,15,26,41
1000,alanlewis,,1,24,27,51
1001,music-box-love,,1,8,6,14
1002,seanpercival,,1,1,1,2
1003,AdamJacobMuller,,1,1,2,3
1004,braq24,,1,14,2,16
1005,woowah,,1,50,17,67
1006,rhymevigilante,,1,1,2,3
1007,arthurrr,,1,5,9,14
1008,jasenlee,,1,93,201,294
1009,midloviking,,1,1,1,2
1010,7oby,,1,4575,3476,8051
1011,davida_usa,,1,506,218,724
1012,kmand,,1,18,18,36
1013,X-Destruction,,1,6,14,20
1014,bloghog,,1,1,1,2
1015,drys,,1,1,2,3
1016,flawless_knockoff,,1,15,17,32
1017,gary_ragel,,1,2,2,4
1018,hectorhector,,1,181,213,394
1019,canonicalform,,1,14,27,41
1020,funkygreenthing,,1,9,17,26
1021,badlittoboy,,1,1,1,2
1022,rickardg,,1,3,3,6
1023,jdrama83,,1,118,117,235
1024,battlebarge,,1,1,1,2
1025,thingsofinterest,,1,4,5,9
1026,lambright,,1,3,14,17
1027,dohastmich,,1,11,17,28
1028,jkerwin,,1,194,212,406
1029,bulletsvshumans,,1,115,157,272
1030,mikesalsa100,,1,1,1,2
1031,IkoIkoComic2,,1,4,1,5
1032,Decon,,1,12,21,33
1033,massiveone,,1,1,1,2
1034,socash,,1,1,1,2
1035,missingpersonator,,1,13,13,26
1036,slade311,,1,1,1,2
1037,demonllama,,1,1,1,2
1038,flydog,,1,13,13,26
1039,webnrrd2k,,1,206,480,686
1040,bmm6o,,1,2,5,7
1041,ClientNine,,1,2,3,5
1042,reegmo,,1,1,2,3
1043,lowingae,,1,5,6,11
1044,dutchkabuki,,1,1,1,2
1045,markvand,,1,923,289,1212
1046,wpgbrownie,,1,113,55,168
1047,dkamkar,,1,10,1,11
1048,irancrude,,1,1,1,2
1049,abey,,1,2,1,3
1050,texasf,,1,13,14,27
1051,eleventruth,,1,2,6,8
1052,guns-14,,1,1,3,4
1053,pigalien,,1,3,8,11
1054,prolificsage,,1,34,92,126
1055,Joke_Criminal,,1,3,3,6
1056,johnnymccain,,1,1,2,3
1057,iamthespoke,,1,2,8,10
1058,ethan103,,1,1,1,2
1059,Joeeezee,,1,2,3,5
1060,Ricapar,,1,8,9,17
1061,badjedi,,1,1,1,2
1062,keithj,,1,7,13,20
1063,freibooter,,1,7,8,15
1064,paganini,,1,15,14,29
1065,brnews,,1,3,4,7
1066,sensiable,,1,58,14,72
1067,mg1313,,1,5,5,10
1068,christophersisk,,1,15,1,16
1069,electricsheep14,,1,7,18,25
1070,lodossheros,,1,7,14,21
1071,Duke999R,,1,8,17,25
1072,yike5,,1,2,1,3
1073,TheKingofEngland,,1,2,3,5
1074,smap,,1,5,10,15
1075,dixi,,1,49,5,54
1076,bothari2,,1,1,3,4
1077,bunny4e,,1,20,23,43
1078,telesphore4,,1,3,4,7
1079,gulpadoodle,,1,8,11,19
1080,northsidebill,,1,1,1,2
1081,draxter,,1,12,4,16
1082,lizhenry,,1,5,1,6
1083,ps6000,,1,24,11,35
1084,thorstadt,,1,1,1,2
1085,uhk,,1,26,2,28
1086,mr1337,,1,12,22,34
1087,breach_of_etiquette,,1,91,30,121
1088,50clint,,1,1,1,2
1089,timmyrich,,1,18,34,52
1090,mahdroo,,1,6,7,13
1091,batsbyfiresidebright,,1,11,15,26
1092,Floodzie,,1,59,24,83
1093,deadtime,,1,3,7,10
1094,pingkai,,1,3,3,6
1095,kettlecorn,,1,2,1,3
1096,mrWolf,,1,3,1,4
1097,backbowls,,1,15,19,34
1098,belovedkid,,1,36,34,70
1099,timo1023,,1,108,83,191
1100,Scoo,,1,10,17,27
1101,topgear55,,1,1,3,4
1102,Kalvin,,1,39,47,86
1103,BlackFlag,,1,26,26,52
1104,JohnMcCain,,1,20,27,47
1105,mdonahoe,,1,16,34,50
1106,danastasi,,1,15,24,39
1107,fr0chu,,1,24,13,37
1108,prognost,,1,15,26,41
1109,jlebrech,,1,2,2,4
1110,trippppp,,1,2,4,6
1111,MainlandX,,1,214,295,509
1112,Rawkit77,,1,76,5,81
1113,asciimo,,1,5,4,9
1114,AliasHandler,,1,1638,672,2310
1115,Ronin_301,,1,5,12,17
1116,Fiserfully,,1,63,78,141
1117,eldub,,1,79,115,194
1118,aragon127,,1,175,245,420
1119,qlinux,,1,1,1,2
1120,david,,1,95,161,256
1121,Stever89,,1,5,7,12
1122,tweaqslug,,1,18,31,49
1123,georgefrick,,1,159,275,434
1124,jpdemers,,1,401,723,1124
1125,joker123456,,1,4,7,11
1126,lesigh,,1,15,15,30
1127,zen53,,1,35,10,45
1128,sbbath,,1,9,25,34
1129,xmashatstand,,1,18,47,65
1130,Lukifer,,1,216,224,440
1131,farts,,1,4,3,7
1132,halmcelroy,,1,3,8,11
1133,jaie,,1,2,4,6
1134,klownthekiller,,1,2,8,10
1135,mrstrictling,,1,3,1,4
1136,carfey,,1,7,12,19
1137,Dubkiller,,1,8,18,26
1138,jessicaC,,1,12,3,15
1139,pldgnoauthority,,1,136,29,165
1140,joshosaur,,1,1,1,2
1141,myheaditches,,1,148,199,347
1142,maybemorris,,1,1,1,2
1143,theoryofevrythng,,1,44,109,153
1144,xiaomiao,,1,1,1,2
1145,SlyRax,,1,1,1,2
1146,Tugger,,1,2,1,3
1147,bloodrosey,,1,81,85,166
1148,xavierromin,,1,2,7,9
1149,jxmac,,1,25,73,98
1150,gruntbug,,1,4,1,5
1151,not-smart,,1,1,1,2
1152,hackmiester,,1,1,1,2
1153,walkingpeas,,1,4,4,8
1154,nztim,,1,5,1,6
1155,avinash,,1,3,2,5
1156,wilwith1l,,1,54,138,192
1157,strano,,1,6,1,7
1158,ojii-san,,1,13,12,25
1159,munky_g,,1,107,305,412
1160,mrIvan,,1,3,1,4
1161,humorfreak,,1,4,3,7
1162,amoore,,1,62,44,106
1163,AngryProfessor,,1,16,12,28
1164,lars_,,1,86,83,169
1165,edkopp4,,1,40,77,117
1166,monsieurlee,,1,37,25,62
1167,tooooobs,,1,36,45,81
1168,Thepher,,1,148,324,472
1169,WheeeeThePeople,,1,10,16,26
1170,arkoner,,1,14,7,21
1171,bjorgen,,1,6,2,8
1172,guntotingliberal,,1,482,532,1014
1173,frankwit,,1,8,1,9
1174,idlepeon,,1,50,59,109
1175,Roosta,,1,65,42,107
1176,hampusl,,1,3,5,8
1177,gobama99,,1,40,48,88
1178,quirk,,1,2,6,8
1179,aaronblohowiak,,1,2,6,8
1180,patt,,1,123,131,254
1181,pap3rw8,,1,35,6,41
1182,topheavy_burnsides,,1,5,11,16
1183,kahrn,,1,11,9,20
1184,lobotomir,,1,38,42,80
1185,morner,,1,316,345,661
1186,srgerm,,1,10,17,27
1187,PumpyChowdown,,1,15,47,62
1188,jonnybfromcle,,1,93,144,237
1189,chaosfarmer,,1,2,1,3
1190,HRHLizi2,,1,1,1,2
1191,a7244270,,1,1,9,10
1192,heathen13,,1,11,11,22
1193,keano,,1,1,2,3
1194,Limoner32,,1,36,11,47
1195,ballsoflakes,,1,2,5,7
1196,na_confederation,,1,9,9,18
1197,sphivo,,1,1,2,3
1198,ilikebbq,,1,79,110,189
1199,canuckmoose,,1,1,4,5
1200,bitchmac,,1,1,1,2
1201,preved,,1,20,14,34
1202,numbato,,1,5,7,12
1203,jackass15,,1,1,1,2
1204,bluetiger,,1,1,3,4
1205,bluestorm,,1,11,18,29
1206,NoControl,,1,1036,1709,2745
1207,fueltank,,1,2,3,5
1208,seany,,1,63,55,118
1209,residual,,1,3,7,10
1210,bigpook,,1,84,134,218
1211,caisersoze,,1,41,4,45
1212,fm909,,1,17,44,61
1213,mwaller,,1,7,9,16
1214,kl116004,,1,13,8,21
1215,artiface,,1,114,201,315
1216,Zendo,,1,1,1,2
1217,peteru,,1,65,50,115
1218,miken1157,,1,2,4,6
1219,predication3,,1,5,3,8
1220,lt_k,,1,2,2,4
1221,rockss65,,1,18,3,21
1222,kleinbl00,,1,330,385,715
1223,kubrickfan799,,1,5,9,14
1224,qubitsu,,1,18,2,20
1225,strwrsxprt,,1,1,2,3
1226,lnxaddct,,1,4,6,10
1227,hixsonj,,1,7,7,14
1228,HK-47,,1,3,2,5
1229,jc13,,1,2,1,3
1230,spangborn,,1,4,3,7
1231,ladibug31480,,1,4,1,5
1232,kiwistem,,1,1,3,4
1233,tiff_seattle,,1,50,51,101
1234,crapuser639,,1,2,3,5
1235,weenaak,,1,1,1,2
1236,wash67,,1,8,6,14
1237,madcowtricks,,1,2,1,3
1238,Ridcully,,1,4,2,6
1239,eOgas,,1,523,809,1332
1240,CamelToeElvis,,1,9,23,32
1241,mebb,,1,72,4,76
1242,supercap,,1,4,9,13
1243,Irishdsf,,1,76,16,92
1244,ianakori,,1,1,1,2
1245,FrogDickTheSecond,,1,1,3,4
1246,ayrnieu,,1,789,1026,1815
1247,boldo,,1,4,1,5
1248,foolsville,,1,1,1,2
1249,computer_hacker,,1,2,1,3
1250,Kinax,,1,1,2,3
1251,Etchii,,1,107,212,319
1252,onecelledcreature,,1,44,86,130
1253,Mignon,,1,9,22,31
1254,nolimitdomains,,1,5,1,6
1255,lassahnjs,,1,6,3,9
1256,Terribly,,1,1,3,4
1257,Jenry,,1,225,23,248
1258,swedishjames,,1,3,11,14
1259,alkoholik,,1,68,32,100
1260,latrov,,1,86,43,129
1261,wikipedia_guy,,1,6,4,10
1262,JohnTesh,,1,8,12,20
1263,nkteam,,1,55,10,65
1264,peterbuldge,,1,1,7,8
1265,psychonumber1,,1,3,3,6
1266,THE_END_OF_THE_WORLD,,1,2,2,4
1267,b-schroeder,,1,1,1,2
1268,erokar,,1,14,14,28
1269,lensfocus,,1,1,2,3
1270,dhess,,1,3,4,7
1271,vang3lis,,1,23,21,44
1272,ringzero,,1,39,29,68
1273,fresh_custard,,1,1,1,2
1274,hazexp,,1,13,15,28
1275,fueledbyrage,,1,1,1,2
1276,GiddyMonkey,,1,15,35,50
1277,Sucks2BU,,1,88,4,92
1278,All24,,1,74,91,165
1279,jeremybscott,,1,35,40,75
1280,Shawn1141,,1,1,2,3
1281,cactushair,,1,92,2,94
1282,peter_b123,,1,45,151,196
1283,RaspberryTang,,1,341,211,552
1284,latent,,1,2,1,3
1285,kencleanair,,1,2,2,4
1286,necrecious,,1,57,63,120
1287,kle216,,1,75,10,85
1288,nO0b,,1,7,15,22
1289,yuletide,,1,17,1,18
1290,masteroftheuniverse,,1,18,46,64
1291,Monotonousblob,,1,2,5,7
1292,fairbeauty1,,1,1,3,4
1293,sustydev,,1,9,9,18
1294,McHuff,,1,51,138,189
1295,Kook_Leto,,1,4,9,13
1296,hudsonheckyl,,1,3,5,8
1297,Fallout911,,1,12,44,56
1298,wmoxam,,1,24,44,68
1299,dave,,1,355,334,689
1300,bsmeteronhigh,,1,24,49,73
1301,heffsta,,1,145,50,195
1302,orlandosflorida,,1,1,1,2
1303,Sixark,,1,81,1,82
1304,Lamaocan,,1,1,1,2
1305,rense,,1,17,23,40
1306,shizzy0,,1,302,412,714
1307,Rincewind_nl,,1,2,4,6
1308,sine_nomen,,1,9,1,10
1309,etherkiller,,1,20,26,46
1310,oblivion19,,1,5,2,7
1311,HappyHarry,,1,1,1,2
1312,txlonghorn_02,,1,8,11,19
1313,absolutsyd,,1,59,211,270
1314,Mystic11,,1,8,14,22
1315,beerinhand,,1,10,5,15
1316,hilla02,,1,4,4,8
1317,jarv,,1,5,2,7
1318,reallyoldguy,,1,3,2,5
1319,awag22,,1,107,186,293
1320,snowballs,,1,13,14,27
1321,etoleb,,1,12,3,15
1322,Inquisition,,1,105,182,287
1323,a1icey,,1,47,86,133
1324,Gennocid,,1,4,1,5
1325,UniqueUsername,,1,13,29,42
1326,ImNotaGDspammer,,1,1,1,2
1327,freryetw,,1,2,2,4
1328,cohesion,,1,149,119,268
1329,PyroMyrmidon,,1,17,40,57
1330,dbeaart,,1,1,5,6
1331,homeless,,1,3,7,10
1332,evanspw,,1,3,2,5
1333,fubo,,1,317,369,686
1334,fearnloathing,,1,25,66,91
1335,ercax,,1,6,22,28
1336,demic,,1,3,3,6
1337,FellowConspirator,,1,117,100,217
1338,3rdfoundation,,1,97,95,192
1339,ubergeek09,,1,2,14,16
1340,TheNessman,,1,2,3,5
1341,plasmon,,1,69,106,175
1342,jedman,,1,4,2,6
1343,csimpkins,,1,5,3,8
1344,citizen1nsn,,1,17,33,50
1345,ahy1,,1,27,6,33
1346,tridium,,1,69,52,121
1347,viota,,1,17,50,67
1348,wwwwho,,1,3,8,11
1349,stephenv,,1,139,198,337
1350,solid-one-love,,1,22,25,47
1351,coolslug,,1,12,5,17
1352,T_C,,1,7,4,11
1353,prasoc,,1,20,48,68
1354,Jwinky,,1,13,10,23
1355,ismokeluckystrike,,1,9,21,30
1356,fsniper,,1,1,1,2
1357,cl4rk3,,1,13,8,21
1358,jaiden0,,1,1,1,2
1359,Allein,,1,1,2,3
1360,ericatha,,1,61,79,140
1361,Mistress_Dee,,1,1,1,2
1362,KirinDave,,1,19,11,30
1363,winstonfahrenheit,,1,9,27,36
1364,solust,,1,29,35,64
1365,SHIT_YEAH,,1,2,2,4
1366,ha1f,,1,8,5,13
1367,pinkbiff,,1,4,12,16
1368,just4this,,1,352,511,863
1369,KruncH,,1,4,10,14
1370,mark445,,1,523,441,964
1371,wilef,,1,1,1,2
1372,leadingzero,,1,1,1,2
1373,zacthecuch,,1,2,1,3
1374,woty,,1,1,1,2
1375,lanceusa,,1,40,5,45
1376,ande1352,,1,3,5,8
1377,mynameinyourblood,,1,48,57,105
1378,JimEngland,,1,8,6,14
1379,OfficerTandy,,1,4,7,11
1380,reddittidder,,1,15,39,54
1381,roxy317,,1,2,2,4
1382,trickster_brat,,1,1,1,2
1383,plubiuz,,1,35,9,44
1384,pmendoza,,1,1,1,2
1385,ZMoney,,1,7,4,11
1386,SarahLee,,1,1077,251,1328
1387,jbstjohn,,1,152,262,414
1388,enpth,,1,1,1,2
1389,techmaniac,,1,9,39,48
1390,a_dog,,1,3,1,4
1391,wagadugo,,1,25,35,60
1392,tubaplayer,,1,2,1,3
1393,Spammi,,1,1,1,2
1394,dunderjeep,,1,2,3,5
1395,wscottfuller,,1,1,4,5
1396,cgarvie,,1,4,5,9
1397,Aerek,,1,64,105,169
1398,GreatBigThing,,1,94,179,273
1399,Detroiter7,,1,2,2,4
1400,muffinman,,1,87,155,242
1401,carpetbowl,,1,42,128,170
1402,pdaddyo,,1,42,34,76
1403,DCScrap,,1,968,29,997
1404,Dzazter,,1,282,409,691
1405,neoyoda,,1,2,1,3
1406,asleepsheeple,,1,3,2,5
1407,TheFrigginArchitect,,1,2,2,4
1408,xasey,,1,10,13,23
1409,Achorny,,1,6,6,12
1410,itspitpat,,1,24,19,43
1411,k4_pacific,,1,300,356,656
1412,mindslight,,1,348,550,898
1413,captainamericaballs,,1,17,34,51
1414,Redditor-in-Chief,,1,6,8,14
1415,workpsyche,,1,4,1,5
1416,mvbma,,1,264,291,555
1417,dryice,,1,778,809,1587
1418,memmek2k,,1,1,1,2
1419,potatogun,,1,126,250,376
1420,mowza,,1,413,675,1088
1421,ctiberius,,1,179,131,310
1422,Lotr1212,,1,15,10,25
1423,kennyidaho,,1,18,30,48
1424,wednesdayjx,,1,23,74,97
1425,grizzledoldster,,1,3,1,4
1426,marblestatus,,1,1,3,4
1427,seanomenon,,1,46,87,133
1428,BBTKnowMore,,1,9,1,10
1429,vizard5,,1,13,10,23
1430,drewjr,,1,22,3,25
1431,benreesman,,1,3,1,4
1432,daveinacave,,1,16,28,44
1433,foreclo2,,1,5,1,6
1434,eggo,,1,106,114,220
1435,ntennies,,1,5,1,6
1436,C4C7Ll5,,1,1,2,3
1437,annabelle919,,1,4,1,5
1438,denkers,,1,1,1,2
1439,themysteriousx,,1,2,3,5
1440,zedority,,1,128,65,193
1441,flipz4,,1,2,7,9
1442,thehomeskillet,,1,10,11,21
1443,phylk,,1,3,9,12
1444,zone,,1,53,21,74
1445,chunhan,,0,1,1,2
1446,jairedmiluhr,,1,1,1,2
1447,lobby,,1,2,2,4
1448,Mythrilfan,,1,739,1001,1740
1449,lator,,1,1,2,3
1450,SocialismFTW,,1,2,3,5
1451,steve70638,,1,46,43,89
1452,sundaryourfriend,,1,58,37,95
1453,tuxrules,,1,1,1,2
1454,cameronj,,1,7,5,12
1455,Lythos,,1,5,3,8
1456,jellicle88,,1,25,56,81
1457,hereticam,,1,7,1,8
1458,johnkrukslovechild,,1,22,16,38
1459,Nickfury101,,1,7,4,11
1460,zurich0371,,1,76,11,87
1461,sammyo,,1,13,28,41
1462,Thulsa790,,1,8,14,22
1463,foundring,,1,3,5,8
1464,Prog,,1,3,3,6
1465,jnk,,1,126,175,301
1466,eyebee,,1,6,14,20
1467,Metatron,,1,19,27,46
1468,kermuj,,1,19,9,28
1469,dreambucket,,1,29,51,80
1470,jr20,,1,3,1,4
1471,Dipsomaniac,,1,3,8,11
1472,godlesspinko,,1,728,791,1519
1473,RobertPaulsen,,1,205,381,586
1474,joshu,,1,15,14,29
1475,DoctorVenkman,,1,34,35,69
1476,pencilo,,1,3,8,11
1477,ShroomAngel,,1,2,10,12
1478,Stern1,,1,5,7,12
1479,julialopez,,1,1,4,5
1480,Sisinono,,1,6,7,13
1481,Asgeir,,1,7,6,13
1482,timotheo,,1,2,4,6
1483,guille_hoardings,,1,2,3,5
1484,ljl430,,1,64,15,79
1485,crazybrit,,1,6,13,19
1486,NickCatal,,1,62,115,177
1487,chipnaan,,1,9,8,17
1488,IM_A_REPTILIAN,,1,157,12,169
1489,keshavkhera,,1,17,3,20
1490,oilisfordummies,,1,16,18,34
1491,multi,,1,297,9,306
1492,adragons,,1,57,40,97
1493,thomaschau,,1,2,1,3
1494,tmd,,1,2,4,6
1495,cryblood,,1,72,64,136
1496,diego_moita,,1,4,5,9
1497,shatteredverve,,1,5,5,10
1498,liketolaugh,,1,14,1,15
1499,Gholas,,1,27,18,45
1500,sl123,,1,8,1,9
1501,mtrainor79,,1,7,2,9
1502,jumbalo,,1,17,34,51
1503,stuarthalloway,,1,3,3,6
1504,davidjang,,1,1,1,2
1505,sushruta,,1,65,100,165
1506,0ctane,,1,7,9,16
1507,HurricaneDITKA,,1,3,10,13
1508,To6oP,,1,15,9,24
1509,linkgirl,,1,423,369,792
1510,chroniq,,1,107,57,164
1511,XJXRXVX,,1,84,130,214
1512,vangelos,,1,12,5,17
1513,orthey,,1,21,19,40
1514,troygilbert,,1,5,3,8
1515,cashikami,,1,5,6,11
1516,naringas,,1,40,81,121
1517,dsplabs,,1,10,6,16
1518,Old_School_Patriot,,1,11,9,20
1519,zenn,,1,1,1,2
1520,Demostheneez,,1,85,136,221
1521,iamdink,,1,4,9,13
1522,kjiutr6,,1,1,2,3
1523,cizzop,,1,6,15,21
1524,realdeal99,,1,21,8,29
1525,Guybrush_Threepwood,,1,200,269,469
1526,Oswego,,1,1,1,2
1527,LilGator,,1,65,93,158
1528,blackartdepot,,1,2,2,4
1529,skinnydog777,,1,1,1,2
1530,elimtevir,,1,22,63,85
1531,halax,,1,1,6,7
1532,runehog,,1,1,1,2
1533,reader123,,1,38,3,41
1534,kimad,,1,43,50,93
1535,skarpio,,1,1,1,2
1536,crosstan,,1,7,8,15
1537,Roxinos,,1,231,274,505
1538,toadfoot,,1,7,7,14
1539,skycheng,,1,241,5,246
1540,aranazo,,1,37,62,99
1541,radoslav87,,1,36,70,106
1542,offat9,,1,327,230,557
1543,d41d8cd98f00b204e980,,1,51,62,113
1544,p1mrx,,1,64,98,162
1545,peterpawan,,1,8,6,14
1546,stubble,,1,174,301,475
1547,pdox,,1,5,7,12
1548,pikaboy259,,1,166,253,419
1549,edheaded,,1,20,3,23
1550,confus,,1,46,75,121
1551,McCainisLying,,1,3,1,4
1552,memsisthefuture,,1,387,632,1019
1553,gbacon,,1,802,857,1659
1554,pbraham,,1,1,1,2
1555,glomek,,1,65,75,140
1556,zengonzo,,1,9,15,24
1557,torv,,1,1,2,3
1558,viciouspictures,,1,124,72,196
1559,larsarus,,1,1,3,4
1560,wildeye,,1,190,313,503
1561,Shana4Liberty,,1,166,9,175
1562,the_champion_of_meh,,1,4,7,11
1563,xxNovaNN,,1,2,3,5
1564,elimisteve,,1,8,3,11
1565,flyingwok,,1,4,5,9
1566,slickmax,,1,1,2,3
1567,dilibau,,1,10,4,14
1568,samuraisam,,1,5,19,24
1569,dodgepong,,1,5,4,9
1570,Prohibitoid,,1,2,2,4
1571,pl0nk,,1,17,22,39
1572,mrbubblesort,,1,45,4,49
1573,GetToTheKarateChoppo,,1,1,1,2
1574,wtfitsjared,,1,9,11,20
1575,Capacitor,,1,1,1,2
1576,beanmosheen,,1,28,65,93
1577,c0mputar,,1,15,10,25
1578,EtherCJ,,1,83,160,243
1579,mckimberley,,1,6,2,8
1580,Gunde,,1,2,7,9
1581,st_gulik,,1,607,932,1539
1582,chinasmith,,1,28,15,43
1583,SuperDuperNNasdf2,,1,3,12,15
1584,Arramol,,1,2,8,10
1585,steven807,,1,9,7,16
1586,themoemoth,,1,2,2,4
1587,sasquatchsucca,,1,15,25,40
1588,davidluxury,,1,6,7,13
1589,PjDrolet,,1,1,4,5
1590,jairzinho,,1,4,19,23
1591,gor56,,1,33,57,90
1592,lurk-n-go,,1,1,1,2
1593,Kojak4,,1,1,1,2
1594,heathn,,1,1,1,2
1595,ttoyooka,,1,52,48,100
1596,TheMorningWoody,,1,12,1,13
1597,fv__,,1,6,2,8
1598,kangarooman,,1,1,2,3
1599,pbz,,1,4,4,8
1600,curlymo,,1,2,14,16
1601,robotman,,1,50,62,112
1602,Yappahgo,,1,4,6,10
1603,thethinktank,,1,1,1,2
1604,backside,,1,2,3,5
1605,big000000,,1,1,10,11
1606,littlejohn68,,1,1,1,2
1607,lawrencem49,,1,1,3,4
1608,thax,,1,310,378,688
1609,quietinhere,,1,1,1,2
1610,SerpentJoe,,1,27,39,66
1611,vkny88,,1,14,5,19
1612,hangonasec,,1,3,2,5
1613,Capitain_Blob,,1,24,23,47
1614,wbeavis,,1,347,473,820
1615,adamwisky,,1,9,5,14
1616,subsumption,,1,1,1,2
1617,monkeyboyhero,,1,4,1,5
1618,jawknee530i,,1,371,533,904
1619,blkangel,,1,41,49,90
1620,fbk,,1,17,27,44
1621,CharlesBronson,,1,1,3,4
1622,jaysin420,,1,2,2,4
1623,bunjamins,,1,2,2,4
1624,dpirotte,,1,2,2,4
1625,xtassin,,1,16,15,31
1626,sarah_p,,1,1,1,2
1627,stilljosh,,1,2,2,4
1628,brokenladder,,1,3,8,11
1629,NadsatBrat,,1,649,1016,1665
1630,scottintx,,1,1,2,3
1631,blatherman,,1,2,4,6
1632,LiquidHAL,,1,71,67,138
1633,Sako13,,1,10,7,17
1634,ditdah,,1,4,4,8
1635,tphyahoo,,1,86,110,196
1636,saladmander,,1,1,1,2
1637,doxiegrl1,,1,246,370,616
1638,trokker,,1,2,2,4
1639,BobRoss,,1,2,6,8
1640,hobowine,,1,2,1,3
1641,redbits,,1,28,54,82
1642,fatty1380,,1,3,1,4
1643,njbartlett,,1,6,11,17
1644,scottc42,,1,36,14,50
1645,dixie_recht,,1,3,18,21
1646,subfrowns,,1,2,4,6
1647,trisw,,1,1,1,2
1648,kevintmckay,,1,4,3,7
1649,tia-marie,,1,112,40,152
1650,metallicabreath,,1,25,33,58
1651,diggrox,,1,21,26,47
1652,Bonzidave,,1,72,117,189
1653,somedorkygam3r,,1,15,1,16
1654,socialarchetype,,1,2,2,4
1655,kdubbfive,,1,1,1,2
1656,Biso,,1,2,4,6
1657,stlnjv,,1,235,169,404
1658,jpworld,,1,3,1,4
1659,binarybandit92,,1,18,19,37
1660,dwbenfield,,1,1,3,4
1661,Kiltec,,1,9,6,15
1662,Pirate_Angel,,1,3,9,12
1663,antirock,,1,4,4,8
1664,thenumba1negro,,1,24,27,51
1665,bscald0,,1,87,33,120
1666,Nisuz,,1,3,12,15
1667,q4all,,1,3,1,4
1668,ChrisRathman,,1,25,40,65
1669,omegaworks,,1,24,39,63
1670,abominator,,1,1,2,3
1671,tootie,,1,360,379,739
1672,TuxedoMax,,1,10,27,37
1673,Z11,,1,1,6,7
1674,spectacle,,1,6,7,13
1675,815was_a_lost_plane,,1,3,2,5
1676,QuotidianTorture,,1,2,3,5
1677,brlewis,,1,27,10,37
1678,fredfoobar,,1,36,36,72
1679,rickrollbountydoit,,1,5,5,10
1680,BushIsThe12thCylon,,1,123,221,344
1681,PeterRabbit456,,1,257,300,557
1682,ishseminal,,1,57,19,76
1683,mtappenden,,1,5,9,14
1684,mrstickman,,1,3,17,20
1685,jasontstein,,1,3,2,5
1686,kgrandia,,1,67,6,73
1687,outofbandii,,1,14,18,32
1688,niiiick,,1,2,2,4
1689,alehbye,,1,12,24,36
1690,velco,,1,22,23,45
1691,jpricher,,1,38,100,138
1692,ewwwwwwwwwwwwwwwwwww,,1,9,18,27
1693,rodbegbie,,1,6,10,16
1694,mongo_the_tiny,,1,1,2,3
1695,secretjohnson,,1,2,1,3
1696,plasmafire,,1,857,230,1087
1697,bellemae,,1,2,1,3
1698,colombiansmile,,1,1,2,3
1699,artost,,1,16,7,23
1700,LalaBristow,,1,2,6,8
1701,gutter,,1,6,1,7
1702,conundri,,1,180,323,503
1703,willdonovan,,1,1,1,2
1704,readerbeedj,,1,23,19,42
1705,shaman66,,1,7,28,35
1706,cooliegodsend,,1,17,16,33
1707,polexa,,1,33,34,67
1708,dafones,,1,73,111,184
1709,MrKittyKat,,1,1,1,2
1710,xternal,,1,40,86,126
1711,k-anon,,1,4,5,9
1712,govenator,,1,9,24,33
1713,steezus,,1,4,5,9
1714,kissmygrits,,1,23,34,57
1715,shortflood,,1,3,6,9
1716,CalibreneGuru,,1,2,2,4
1717,hungryhungryhippo,,1,154,174,328
1718,monogatari,,1,5,3,8
1719,alextalaat,,1,36,1,37
1720,argily,,1,73,75,148
1721,Radica1Faith,,1,12,14,26
1722,taikutsu,,1,2,8,10
1723,misses_the_point,,1,1,3,4
1724,eakius,,1,99,150,249
1725,Francky,,1,1,1,2
1726,SnoodDude,,1,1,1,2
1727,tcpip4lyfe,,1,458,428,886
1728,benkentaust,,1,7,3,10
1729,airless_microwave,,1,1,1,2
1730,Syphor,,1,1,9,10
1731,some101,,1,5,1,6
1732,toofishes,,1,3,3,6
1733,BuboTitan,,1,176,152,328
1734,late_at_nine,,1,10,12,22
1735,stepcut251,,1,7,20,27
1736,cjcarino,,1,45,2,47
1737,aurispector,,1,42,40,82
1738,kissinger,,1,7,15,22
1739,raofwumfs,,1,75,175,250
1740,Luntic,,1,19,3,22
1741,AlexPeake,,1,2,2,4
1742,hunululisjuys,,1,11,3,14
1743,javallone,,1,3,5,8
1744,blowback,,1,207,368,575
1745,ianesque,,1,2,4,6
1746,kenyabob,,1,35,8,43
1747,spaceman,,1,42,29,71
1748,gastlygem,,1,1,2,3
1749,Acglaphotis,,1,149,244,393
1750,ivoryball,,1,8,8,16
1751,wenfri,,1,13,12,25
1752,NeoTrot,,1,22,14,36
1753,67tim07crews11,,1,7,9,16
1754,notasaon,,1,255,363,618
1755,kgemini22,,1,1,1,2
1756,mikez31,,1,1,2,3
1757,masonium,,1,10,8,18
1758,daschan,,1,2,2,4
1759,oneiryn,,1,18,22,40
1760,jsomers,,1,4,3,7
1761,jo-lilore,,1,326,2,328
1762,ElvisKitagawa,,1,35,5,40
1763,aDancingHobo,,1,1,1,2
1764,joejag,,1,2,2,4
1765,PhenomenJan,,1,19,28,47
1766,scottieboy,,1,2,2,4
1767,mtheaded1159,,1,23,1,24
1768,sgtpeppers,,1,29,55,84
1769,evildead,,1,117,22,139
1770,cabrian,,1,3,10,13
1771,Nightowl7777,,1,6,12,18
1772,szeiger,,1,9,11,20
1773,AndrewBenton,,1,131,139,270
1774,johnaman,,1,160,44,204
1775,elsup,,1,2,1,3
1776,Lionhearted,,1,79,7,86
1777,GreeNova,,1,1,2,3
1778,Bloodlustt,,1,526,955,1481
1779,ThisISAgentSmith,,1,2,1,3
1780,jalamabob,,1,2,1,3
1781,morbidfriends,,1,26,35,61
1782,masterofshadows,,1,5,9,14
1783,fwporretto,,1,116,171,287
1784,mkultra42,,1,60,6,66
1785,futureheaded,,1,1,5,6
1786,bugcoder,,1,18,11,29
1787,Sirened,,1,12,2,14
1788,antneon,,1,8,3,11
1789,dtardif,,1,101,193,294
1790,reformed_digger,,1,1,1,2
1791,thereddgunn,,1,8,18,26
1792,zacwhite,,1,5,11,16
1793,phleef,,1,42,29,71
1794,RudyGiuliani,,1,535,45,580
1795,sardaukar,,1,10,10,20
1796,todm,,1,1,1,2
1797,ausfahrt,,1,2,4,6
1798,messer,,1,2,10,12
1799,rakkar,,1,13,6,19
1800,supaflyrmg,,1,95,132,227
1801,kbntly,,1,10,13,23
1802,yungJoc,,1,79,132,211
1803,tahpot,,1,8,1,9
1804,garygnu,,1,55,86,141
1805,prefixmag,,1,2,1,3
1806,Stemp,,1,2,1,3
1807,scrumbud,,1,56,37,93
1808,jegan414,,1,23,3,26
1809,BOFH139,,1,50,88,138
1810,boyreporter,,1,6,17,23
1811,zanglin,,1,5,3,8
1812,memevirus,,1,13,10,23
1813,ptorrone,,1,2,2,4
1814,petekmit,,1,6,2,8
1815,Morgmeat,,1,1,3,4
1816,RazzleFrazzle,,1,32,4,36
1817,WombatBob,,1,4,2,6
1818,mrjoshzombie,,1,9,17,26
1819,heyrey,,1,69,97,166
1820,huggles,,1,1,2,3
1821,cheeeeese,,1,8,13,21
1822,dark79,,1,1,1,2
1823,countingthedays,,1,52,101,153
1824,srich001,,1,1,1,2
1825,manchaugog,,1,13,28,41
1826,Halaster,,1,8,11,19
1827,vtecno_geek,,1,3,6,9
1828,wulfen,,1,2,2,4
1829,kindablue,,1,31,1,32
1830,lookslikethatsjailb8,,1,7,10,17
1831,intelslick,,1,435,60,495
1832,discreet,,1,2,3,5
1833,Sixteenbit,,1,15,33,48
1834,__pino__,,1,2,1,3
1835,san00bie,,1,206,211,417
1836,nevare,,1,32,50,82
1837,calanya,,1,4,1,5
1838,ecoconservant,,1,6,2,8
1839,sour_dave,,1,8,6,14
1840,dasony,,1,26,40,66
1841,kstar,,1,12,23,35
1842,tlongg81,,1,2,1,3
1843,n0name,,1,1,1,2
1844,mathrick,,1,69,110,179
1845,Doc_Lee,,1,56,85,141
1846,walkman,,1,11,15,26
1847,HubbleTelescope,,1,1,1,2
1848,YouFail,,1,6,5,11
1849,jthomasmoore,,1,6,14,20
1850,newbill123,,1,123,210,333
1851,Guessed,,1,1,2,3
1852,andybigs,,1,569,29,598
1853,brainwashed,,1,6,13,19
1854,scottdeto,,1,5,1,6
1855,OsakaWilson,,1,317,599,916
1856,brijeshnairan,,1,19,9,28
1857,Jim_in_Buffalo,,1,155,264,419
1858,duruq,,1,94,132,226
1859,mspmac,,1,1,5,6
1860,daledinkler,,1,592,494,1086
1861,davelog,,1,4,15,19
1862,typographics,,1,28,12,40
1863,karen1,,1,6,4,10
1864,gorillamaski,,1,8,3,11
1865,cain141,,1,3,2,5
1866,deanfearce,,1,5,3,8
1867,yayyay,,1,1,1,2
1868,darwin57,,1,1,1,2
1869,haseman,,1,138,33,171
1870,twocent,,1,37,50,87
1871,Groat,,1,34,18,52
1872,jbscott,,1,19,38,57
1873,prodaea,,1,2,7,9
1874,radhruin,,1,432,226,658
1875,qtoo,,1,192,29,221
1876,shann,,1,1,1,2
1877,mysn607,,1,1,1,2
1878,MadScientist420,,1,684,690,1374
1879,unusable,,1,1,1,2
1880,laughingwater,,1,2,18,20
1881,violetnightshade,,1,30,58,88
1882,justgeekin,,1,6,3,9
1883,deeringc,,1,10,12,22
1884,cloudsdrive,,1,1,7,8
1885,hatedigg,,1,8,19,27
1886,behooved,,1,17,23,40
1887,chandelirious,,1,1,1,2
1888,mangoboy,,1,1,3,4
1889,pede83,,1,1,3,4
1890,mudsonjar,,1,8,3,11
1891,Kaelosian,,1,1,1,2
1892,mrhymer,,1,7,5,12
1893,_unxzst_,,1,118,19,137
1894,deafbybeheading,,1,11,26,37
1895,bradeeoh,,1,1,2,3
1896,TriciaMcMillan,,1,2,2,4
1897,gnugnu,,1,2,2,4
1898,stormid,,1,6,10,16
1899,Sophophilic,,1,1,3,4
1900,Stonecipher,,1,83,7,90
1901,boe2,,1,19,62,81
1902,historyisaweapon,,1,5,3,8
1903,chriseaker,,1,2,1,3
1904,ctheory,,1,34,43,77
1905,tdiman,,1,13,12,25
1906,whynotsmile,,1,1,3,4
1907,vega1,,1,14,3,17
1908,timrink,,1,3,5,8
1909,SirSie,,1,1,2,3
1910,samwitt1984,,1,5,16,21
1911,dubski,,1,1,2,3
1912,ruetama,,1,2,1,3
1913,Exist_To_Resist,,1,1,2,3
1914,myrthe,,1,2,2,4
1915,nooblar,,1,25,29,54
1916,vashman,,1,37,51,88
1917,D-Bo,,1,9,3,12
1918,Betmenko,,1,7,1,8
1919,DonSlice,,1,58,35,93
1920,Arguron,,1,80,109,189
1921,clruss,,1,11,27,38
1922,aik,,1,34,44,78
1923,d3ns,,1,39,71,110
1924,NoSurrender,,1,2,5,7
1925,swisscreme,,1,58,39,97
1926,zosimus,,1,2,1,3
1927,ochs,,1,34,27,61
1928,Rostasky,,1,4,6,10
1929,Toothjunkie,,1,1,1,2
1930,nanaki,,1,2,6,8
1931,zeeta6,,1,93,137,230
1932,sirrach,,1,1,2,3
1933,AdjectiveNounNumber,,1,18,10,28
1934,forsaken,,1,4,4,8
1935,greenascanbe,,1,860,158,1018
1936,thevanishedlady,,1,31,51,82
1937,sreguera,,1,2,4,6
1938,crutch,,1,46,42,88
1939,thetrek,,1,1,1,2
1940,mwwilliams,,1,339,280,619
1941,mhunt346,,1,7,5,12
1942,tomel,,1,113,232,345
1943,09amw,,1,1,3,4
1944,frakilk,,1,20,17,37
1945,BudgingMidget,,1,2,3,5
1946,x00x11,,1,1,1,2
1947,GhostWithToast,,1,210,97,307
1948,sixtyten,,1,11,23,34
1949,kemiller,,1,24,23,47
1950,tecknopuppy,,1,3,4,7
1951,DEA_Officer,,1,1,1,2
1952,neighbor78,,1,1,1,2
1953,JimDabell,,1,212,256,468
1954,qwzx,,1,1,2,3
1955,mikemol,,1,131,92,223
1956,baraqiyal,,1,14,12,26
1957,bagge,,1,21,33,54
1958,BuffaloTimesN,,1,2,4,6
1959,dama9ed,,1,4,8,12
1960,dakatabri,,1,51,50,101
1961,ParanoidVet,,1,5,1,6
1962,redundor,,1,7,7,14
1963,flightlessbird,,1,49,25,74
1964,diamondchild,,1,8,5,13
1965,daelstorm,,1,6,6,12
1966,glide1,,1,22,27,49
1967,clickmagnet,,1,101,147,248
1968,mcho19,,1,2,8,10
1969,saparatus,,1,11,8,19
1970,galimi,,1,28,66,94
1971,gibsonan,,1,1,1,2
1972,amishengineer,,1,82,162,244
1973,phetrs,,1,1,2,3
1974,pettyjesus,,1,32,36,68
1975,DaveBr,,1,2,3,5
1976,Oak,,1,252,502,754
1977,CampusTour,,1,697,921,1618
1978,scubabbl,,1,9,20,29
1979,ramunenke,,1,39,64,103
1980,hellotim,,1,3,4,7
1981,tehroflmaoer,,1,3,5,8
1982,digitalxn3,,1,1,1,2
1983,barrettvogel,,1,20,17,37
1984,crashingthrough,,1,9,13,22
1985,luce7,,1,58,76,134
1986,aajkl,,1,8,1,9
1987,MoBe,,1,38,77,115
1988,josefk,,1,2,4,6
1989,wonderhat,,1,64,80,144
1990,giantfez,,1,3,3,6
1991,spaceman0,,1,82,28,110
1992,eh123abc,,1,2,1,3
1993,gmn17,,1,2,4,6
1994,mactaggart,,1,27,62,89
1995,everyonesacritic,,1,13,2,15
1996,osiris99,,1,120,132,252
1997,HotSmegma,,1,11,34,45
1998,_eight,,1,2,2,4
1999,dpgtfc,,1,183,333,516
2000,DoktorJ,,1,6,10,16
2001,impactguy,,1,185,1,186
2002,BaronVonBeefstrong,,1,1,1,2
2003,ruediger,,1,8,1,9
2004,whtevn,,1,45,68,113
2005,iiB,,1,26,22,48
2006,chris_radcliff,,1,4,12,16
2007,zBard,,1,79,103,182
2008,westenskow,,1,1,4,5
2009,dawg,,1,47,44,91
2010,easelmen,,1,10,1,11
2011,erinhiggins,,1,8,6,14
2012,chexmex222,,1,1,3,4
2013,someweirdsin,,1,2,8,10
2014,mustafaDeref,,1,1,1,2
2015,rpm087,,1,3,7,10
2016,danderson42,,1,2,5,7
2017,DaringYoungMan,,1,1,2,3
2018,cyanide,,1,14,11,25
2019,rexhamilton,,1,1,3,4
2020,swagohome,,1,724,859,1583
2021,heyadayo,,1,1,1,2
2022,nickem,,1,16,34,50
2023,d0minique,,1,11,17,28
2024,jusooho,,1,48,66,114
2025,hammudi,,1,36,5,41
2026,PSIAII,,1,5,5,10
2027,hiddentiger,,1,1,1,2
2028,DerMetzgermeister,,1,21,22,43
2029,0drew0,,1,49,84,133
2030,ariatorus,,1,1,2,3
2031,california_roll,,1,1,1,2
2032,satayboy,,1,10,12,22
2033,w000t,,1,86,81,167
2034,orabox,,1,56,70,126
2035,billgordon,,1,1,3,4
2036,defendthyself,,1,20,4,24
2037,casaubon,,1,258,218,476
2038,sdraz,,1,130,99,229
2039,orange_abc99,,1,1,1,2
2040,reddworm,,1,3,2,5
2041,mxaz,,1,2,5,7
2042,BradNerderman,,1,15,4,19
2043,laufwerkfehler,,1,7,35,42
2044,billbacon,,1,462,772,1234
2045,Masi,,1,506,110,616
2046,mcarlin2,,1,8,5,13
2047,mafen,,1,2,2,4
2048,infectedroot,,1,31,30,61
2049,Saitek,,1,4,8,12
2050,jrd2828,,1,11,15,26
2051,nerdoncall,,1,18,17,35
2052,walen,,1,13,14,27
2053,joeshlub,,1,34,47,81
2054,engwar,,1,89,119,208
2055,pissedofftwice,,1,1,1,2
2056,minium,,1,1,7,8
2057,rustyiron,,1,6,8,14
2058,PHermas,,1,14,49,63
2059,Daemmerung,,1,11,20,31
2060,beforetimetherewasme,,1,210,75,285
2061,LGBTnews,,1,7,1,8
2062,chabreck,,1,81,120,201
2063,atticus,,1,9,7,16
2064,kylman5000,,1,10,14,24
2065,truthhurts28,,1,2,3,5
2066,hatrickon,,1,6,3,9
2067,amjithr,,1,1,1,2
2068,therealtman,,1,9,6,15
2069,l-rs2,,1,60,96,156
2070,bad_at_puns,,1,9,9,18
2071,RalfN,,1,457,697,1154
2072,BiffBaxter,,1,6,1,7
2073,iarenuu,,1,11,2,13
2074,jev,,1,1,3,4
2075,IntnsRed,,1,157,101,258
2076,Bobiloco,,1,8,3,11
2077,vmas,,1,465,221,686
2078,rafiss,,1,10,4,14
2079,handjor,,1,3,1,4
2080,kristyntx,,1,8,11,19
2081,kkenn,,1,8,9,17
2082,smazsyr,,1,561,5,566
2083,pink_vicky,,1,26,4,30
2084,berenthemortal,,1,1,2,3
2085,kevinliebrock,,1,16,10,26
2086,BobbyTables,,1,3,5,8
2087,dgorley,,1,23,3,26
2088,redelfairy,,1,1,1,2
2089,goghi,,1,94,1,95
2090,ramen,,1,40,32,72
2091,crizznaig,,1,1,2,3
2092,steve43,,1,5,5,10
2093,Assumer,,1,1,2,3
2094,theoodone,,1,2,2,4
2095,Gibbwake,,1,453,414,867
2096,dualboot,,1,3,8,11
2097,lobido,,1,116,337,453
2098,sokercap,,1,9,2,11
2099,DrDutch,,1,3,5,8
2100,bornholtz,,1,18,18,36
2101,technopriestess,,1,1,2,3
2102,Mortikhi,,1,552,444,996
2103,epicRelic,,1,730,734,1464
2104,newsfrommars,,1,14,3,17
2105,ts4z,,1,2,1,3
2106,aayers,,1,1,2,3
2107,aped69,,1,1,1,2
2108,stormo,,1,2,1,3
2109,bobzibub,,1,124,210,334
2110,octoquake,,1,14,15,29
2111,Dunce,,1,22,39,61
2112,GottaGetMyFix,,1,7,5,12
2113,sexymuff69,,1,42,69,111
2114,sammyc,,1,17,24,41
2115,Rickler,,1,210,284,494
2116,twosents,,1,1,2,3
2117,tsunam,,1,40,5,45
2118,aaaahoy,,1,95,21,116
2119,julan,,1,6,7,13
2120,whatisthis8,,1,51,35,86
2121,theboyracer99,,1,283,290,573
2122,SpaceManY3k,,1,4,8,12
2123,srpatterson,,1,21,1,22
2124,stinger_,,1,20,40,60
2125,whatwedo,,1,791,1136,1927
2126,theduckchaser,,1,4,9,13
2127,boesman,,1,23,23,46
2128,vilerman,,1,29,1,30
2129,LauraJane,,1,13,15,28
2130,dushan42,,1,2,3,5
2131,dry_answer,,1,1,8,9
2132,shotinthedark21,,1,72,29,101
2133,em500,,1,21,29,50
2134,mihnealucian,,1,8,10,18
2135,Schrodie,,1,3,12,15
2136,gogogo,,1,17,36,53
2137,x00x,,1,10,19,29
2138,DCDave,,1,4,4,8
2139,andygood,,1,122,213,335
2140,thehighercritic,,1,66,111,177
2141,jackdied,,1,1,2,3
2142,moopanda,,1,3,1,4
2143,nelsonscheung,,1,108,178,286
2144,blinking81,,1,5,3,8
2145,enkara,,1,4,1,5
2146,king3vbo,,1,1,2,3
2147,kiwifish,,1,26,35,61
2148,meigwilym,,1,14,34,48
2149,pipegrep,,1,39,35,74
2150,chelslp,,1,7,9,16
2151,ximxam,,1,9,31,40
2152,UnderGod,,1,6,3,9
2153,fooboo,,1,2,1,3
2154,AmyGrace,,1,21,35,56
2155,bgtees,,1,19,13,32
2156,TheHardWay,,1,48,31,79
2157,zebragoat,,1,1,3,4
2158,pandoraslove,,1,4,2,6
2159,allrum,,1,40,7,47
2160,a_mother,,1,2,1,3
2161,mikemongo,,1,38,3,41
2162,FadedReality,,1,37,42,79
2163,foobazbar,,1,3,4,7
2164,moush,,1,234,553,787
2165,ScornForSega,,1,427,426,853
2166,chaosopher,,1,10,6,16
2167,humpcunian,,1,4,2,6
2168,Stepbasin,,1,34,3,37
2169,mookid,,1,1,1,2
2170,podobuzz,,1,15,15,30
2171,kdavidson,,1,1,1,2
2172,maggiet,,1,8,15,23
2173,warsawpact,,1,18,36,54
2174,sleepingcow,,1,13,13,26
2175,g1c9,,1,79,11,90
2176,sourdiesel12,,1,70,33,103
2177,MontegoBarbados,,1,41,57,98
2178,AlterEgo96,,1,4,4,8
2179,maennes,,1,3,8,11
2180,brizal,,1,2,1,3
2181,TaxExempt,,1,49,40,89
2182,shellacked,,1,2,3,5
2183,jmeasley,,1,280,1,281
2184,kiyonisis,,1,4,4,8
2185,DarkShikari,,1,136,102,238
2186,kaelan_,,1,21,13,34
2187,NSCoder,,1,3,5,8
2188,hessian,,1,59,58,117
2189,kurt165749,,1,6,12,18
2190,nads,,1,15,33,48
2191,techhstuff,,1,2,2,4
2192,malavel,,1,436,501,937
2193,greenelf,,1,1,3,4
2194,taciturnman3,,1,1,1,2
2195,srini91,,1,22,17,39
2196,earstwiley,,1,12,24,36
2197,rovot,,1,1,4,5
2198,slappywhyte,,1,109,47,156
2199,superfurryanimals,,1,22,22,44
2200,ddwoske,,1,5,6,11
2201,flash357,,1,3,7,10
2202,shokk,,1,76,190,266
2203,sluchee,,1,2,2,4
2204,lolbang,,1,89,102,191
2205,valjean,,1,3,4,7
2206,scackmanta,,1,1,1,2
2207,sob062571,,1,143,33,176
2208,CanYouRead,,1,1,1,2
2209,derxob,,1,1,1,2
2210,nikkomega,,1,20,24,44
2211,marko34,,1,75,43,118
2212,The-Cold-Truth,,1,21,14,35
2213,flyingfox,,1,34,49,83
2214,kanigsson,,1,1,2,3
2215,xjacklynx,,1,4,3,7
2216,scblock,,1,4,7,11
2217,hammerzeit,,1,11,23,34
2218,tarafitz,,1,1,1,2
2219,ratherawesome,,1,36,40,76
2220,N080dy,,1,2,1,3
2221,Nopis10,,1,4,10,14
2222,RogersLeap,,1,6,3,9
2223,barrietoronto,,1,2,1,3
2224,mariopazi,,1,22,3,25
2225,reversekilled,,1,10,17,27
2226,wha22,,1,21,33,54
2227,quietmonkey,,1,11,15,26
2228,minnend,,1,3,2,5
2229,xdrunkagainx,,1,31,18,49
2230,POKEMONE,,1,95,109,204
2231,doot,,1,45,54,99
2232,rmalheiro,,1,6,9,15
2233,cslewisster,,1,2,3,5
2234,jabab,,1,8,14,22
2235,SIMPLEMODEL,,1,2,4,6
2236,The_Gobbler,,1,16,31,47
2237,Nailz75253,,1,5,4,9
2238,frankenstrat,,1,20,2,22
2239,yangmao,,0,4,1,5
2240,Mineralwater,,1,231,497,728
2241,paulswhite,,1,1,5,6
2242,lingeek,,1,2,3,5
2243,Stinky107,,1,1,1,2
2244,grifon1981,,1,7,5,12
2245,bgutierrez,,1,12,4,16
2246,harsenal,,1,1,1,2
2247,rzax2,,1,15,7,22
2248,oneirist,,1,3,1,4
2249,boycottthesimpsons,,1,7,21,28
2250,wrong_verb,,1,5,6,11
2251,kaiserbun,,1,2,2,4
2252,mcphat,,1,1,1,2
2253,bkibbey,,1,5,1,6
2254,orchestra,,1,41,29,70
2255,imquez,,1,132,184,316
2256,LynnByrne,,1,2,1,3
2257,ethanji,,1,5,4,9
2258,MakiNavaja,,1,24,34,58
2259,pisceandelusions,,1,1,1,2
2260,fotd42,,1,4,4,8
2261,i0110110,,1,1,1,2
2262,ender_wiggin,,1,94,10,104
2263,Roger_the_Shrubber,,1,1,1,2
2264,10111111101111110110,,1,3,1,4
2265,zedvaint,,1,67,87,154
2266,GTroy,,1,1,1,2
2267,pascha,,1,260,321,581
2268,brey,,1,19,5,24
2269,AlisonWiley,,1,2,4,6
2270,SirFoxx,,1,5,10,15
2271,linuxrules,,1,8,21,29
2272,ObamDsntCarAbtWhtPpl,,1,23,32,55
2273,JeffDaiell,,1,4,3,7
2274,jmgregory,,1,19,18,37
2275,frequency528,,1,45,52,97
2276,Daesleepr0,,1,11,37,48
2277,scienceguy8m,,1,16,1,17
2278,airdrumma,,1,3,6,9
2279,spiritjoy,,1,9,8,17
2280,banker,,1,2,1,3
2281,indeh,,1,14,18,32
2282,mpg1453,,1,6,1,7
2283,DarthMacgyver,,1,7,6,13
2284,thatguyryan,,1,19,21,40
2285,Caraes_Naur,,1,259,371,630
2286,LiberalDemocrat,,1,88,170,258
2287,DrBrian,,1,227,390,617
2288,SharkUW,,1,27,38,65
2289,rdtiii,,1,11,9,20
2290,Boojum,,1,52,100,152
2291,hometownmarkup,,1,2,4,6
2292,csb92376,,1,10,10,20
2293,justoman,,1,12,12,24
2294,catch23,,1,279,366,645
2295,nairn,,1,2,5,7
2296,fooka,,1,139,2,141
2297,frankenfurter,,1,25,19,44
2298,arcadefiery,,1,85,58,143
2299,fun2sail,,1,43,15,58
2300,numpy,,1,1,6,7
2301,TheSighGuy,,1,4,1,5
2302,gnathon,,1,131,161,292
2303,NaK,,1,28,42,70
2304,batterseapower,,1,14,11,25
2305,ch33sehead,,1,46,85,131
2306,damagednoob,,1,49,20,69
2307,justinmeister,,1,113,112,225
2308,stephenodonnell,,1,6,1,7
2309,googlepeakoil,,1,17,40,57
2310,howwedoit08,,1,1,2,3
2311,kingrooster,,1,68,77,145
2312,issacg,,1,1,2,3
2313,gwoade,,1,3,3,6
2314,zefalt,,1,4,5,9
2315,redkevin,,1,6,2,8
2316,kickstand,,1,389,632,1021
2317,davedarwin,,1,56,21,77
2318,shortshire,,1,3,5,8
2319,aDk_,,1,2,1,3
2320,shaurz,,1,346,590,936
2321,JHackamack,,1,4,1,5
2322,1kHz,,1,13,3,16
2323,blahbah,,1,7,3,10
2324,joebeeson,,1,1,1,2
2325,jabberwocky2k,,1,1,8,9
2326,akinoyeshua,,1,73,166,239
2327,CarolLastNameRetract,,1,1,2,3
2328,Emphasiser,,1,47,59,106
2329,Tgg161,,1,18,16,34
2330,DrunkenAsshole,,1,270,436,706
2331,Xi_Heather,,1,1,1,2
2332,rieux,,1,282,421,703
2333,lunaisgay,,1,2,1,3
2334,canb88,,1,1,1,2
2335,maasanova,,1,4,2,6
2336,shortsightedsid,,1,20,32,52
2337,pjamieson,,1,1,1,2
2338,DanDixon,,1,16,8,24
2339,pockets576,,1,5,2,7
2340,quotidian,,1,2,5,7
2341,sanfranman,,1,52,110,162
2342,Avielus,,1,7,9,16
2343,DeRien,,1,16,9,25
2344,spanishfranks,,1,16,19,35
2345,yomama10,,1,2,1,3
2346,onlylove,,1,1,2,3
2347,Nimbokwezer,,1,57,93,150
2348,Chris_Gammell,,1,27,15,42
2349,caseye,,1,1,1,2
2350,mitama,,1,1,1,2
2351,avonsfive,,1,1,1,2
2352,johnwallis42,,1,173,429,602
2353,cbroberts,,1,247,230,477
2354,springy,,1,12,12,24
2355,NotJohnWayne,,1,1,1,2
2356,_black,,1,513,112,625
2357,kidwei,,1,1,2,3
2358,fairlyodd,,1,60,47,107
2359,imaredditalien,,1,13,9,22
2360,Ressotami,,1,4,1,5
2361,arabascato,,1,5,6,11
2362,NolanVoid,,1,34,63,97
2363,ayradv,,1,3,1,4
2364,MDGeist,,1,4,10,14
2365,slemmons,,1,13,16,29
2366,badave,,1,55,72,127
2367,gleapsite,,1,83,136,219
2368,ruppinwedle,,1,11,10,21
2369,randynavara,,1,1,2,3
2370,SonOfDenny,,1,107,55,162
2371,knightwhosaysni,,1,6,11,17
2372,NoUseForAName,,1,6,3,9
2373,pimple,,1,5,3,8
2374,flazz,,1,28,35,63
2375,peediddie,,1,12,27,39
2376,forzaruler,,1,95,88,183
2377,poots,,1,19,28,47
2378,ITJ,,1,1,1,2
2379,cypherpunk,,1,1,4,5
2380,kyle8ch,,1,1,1,2
2381,NMW,,1,56,67,123
2382,saffir,,1,137,146,283
2383,ampersand100,,1,3,4,7
2384,garageguru,,1,27,36,63
2385,philipnelson,,1,2,1,3
2386,jennekat17,,1,23,36,59
2387,cortlandjim,,1,3,4,7
2388,hazmatzz,,1,17,2,19
2389,cuddles666,,1,286,311,597
2390,meta-joke-explainer,,1,2,2,4
2391,thethirdi,,1,115,46,161
2392,poorwhitetrash,,1,15,46,61
2393,cohortq,,1,21,23,44
2394,babsies,,1,3,1,4
2395,DrLegoHari,,1,119,20,139
2396,gromgull,,1,27,24,51
2397,savutano,,1,37,86,123
2398,wretcheddawn,,1,6,15,21
2399,anon500,,1,1,1,2
2400,closetgeekshow,,1,88,143,231
2401,mfw,,1,1,2,3
2402,drhelcel,,1,1,2,3
2403,tocano,,1,4,1,5
2404,superportal,,1,1,1,2
2405,jontce,,1,2,1,3
2406,SlowX,,1,1,1,2
2407,mikeobe,,1,4,10,14
2408,freexe,,1,315,417,732
2409,goon12,,1,13,6,19
2410,xbudex,,1,1,4,5
2411,TonyReaves,,1,87,79,166
2412,shridhar,,1,1,3,4
2413,openeyed,,1,3,7,10
2414,nonono2,,1,18,20,38
2415,MPinsky,,1,6,7,13
2416,sustainedkrunk,,1,1,1,2
2417,andrewwise,,1,66,1,67
2418,fatcockmike,,1,2,7,9
2419,mcbob58,,1,9,52,61
2420,prettycreatures,,1,1,4,5
2421,TimeIsTissue,,1,3,7,10
2422,Captain_Science,,1,1,4,5
2423,gsg,,1,81,129,210
2424,gmanolatos,,1,7,1,8
2425,WillH,,1,3,9,12
2426,Ethan,,1,3,2,5
2427,welaaahh,,1,1,1,2
2428,dodus,,1,397,757,1154
2429,sorakiu,,1,18,22,40
2430,jesseeme,,1,293,59,352
2431,Garathon,,1,24,72,96
2432,rube203,,1,2,4,6
2433,TheBowerbird,,1,183,250,433
2434,lincolnp,,1,1,1,2
2435,ReiToei,,1,329,455,784
2436,kamikasei,,1,18,27,45
2437,fudditi,,1,1,1,2
2438,SecDef,,1,91,209,300
2439,AliBabaHimself,,1,1,1,2
2440,rayhan314,,1,8,14,22
2441,Slowbro,,1,8,4,12
2442,cyfdecyf,,1,1,2,3
2443,mbanana,,1,189,168,357
2444,punkgeek,,1,173,133,306
2445,archonon,,1,3,1,4
2446,reisender,,1,3,8,11
2447,McNally,,1,5,10,15
2448,Chevron,,1,3,6,9
2449,abrownpearn,,1,1,1,2
2450,golgote,,1,1,3,4
2451,RiceBallAttack,,1,20,3,23
2452,beast_in_black,,1,33,78,111
2453,eggmanx3,,1,1,2,3
2454,especkman,,1,6,16,22
2455,faceless1_14,,1,87,35,122
2456,ciudadcentral,,1,7,4,11
2457,flashkiller,,1,3,3,6
2458,jrdche,,1,63,5,68
2459,didnt_read_article,,1,4,2,6
2460,fangs,,1,1,1,2
2461,CarolynAB,,1,8,4,12
2462,writeman4450,,1,1,1,2
2463,politicalbath,,1,5,3,8
2464,woadwarrior,,1,27,42,69
2465,rlvis,,1,3,3,6
2466,thinkingserious,,1,35,8,43
2467,litebox,,1,20,25,45
2468,cidreflux,,1,6,1,7
2469,AmericaFYeah,,1,12,21,33
2470,shar1,,1,1,1,2
2471,olegv40,,1,59,25,84
2472,itscoming,,1,23,38,61
2473,chrissa,,1,16,27,43
2474,CableNewsie,,1,9,4,13
2475,robotnewyork,,1,1,5,6
2476,Aborted_Fetus_Eero,,1,3,3,6
2477,Etan,,1,35,77,112
2478,nooneelse,,1,303,601,904
2479,fuliginosus,,1,85,68,153
2480,cenderis,,1,1,5,6
2481,luckyfish,,1,2,2,4
2482,AROSSA,,1,5,14,19
2483,erikd,,1,86,70,156
2484,Anonyxmouse,,1,4,1,5
2485,kpagiamtzis,,1,2,1,3
2486,geebower,,1,2,10,12
2487,shazbaz,,1,100,166,266
2488,icdapoakr,,1,27,57,84
2489,mrfrostee,,1,2,1,3
2490,whiskeyjack,,1,17,12,29
2491,devlinrose,,1,10,3,13
2492,carlEdwards,,1,2,5,7
2493,big_nah,,1,11,6,17
2494,fzzzy,,1,6,18,24
2495,speedmx1,,1,13,4,17
2496,keeto,,1,1,1,2
2497,bokin,,1,52,130,182
2498,benjamin_button,,1,1,4,5
2499,annihilist,,1,10,6,16
2500,socialdude,,1,2,1,3
2501,fatlester,,1,13,18,31
2502,RaepRaepRaep,,1,100,69,169
2503,synae,,1,61,157,218
2504,sTigre,,1,10,15,25
2505,Silent_Paws,,1,69,73,142
2506,mlibbrecht,,1,3,3,6
2507,red22,,1,1,1,2
2508,BasketCase,,1,68,65,133
2509,pervezalammzn,,1,3,3,6
2510,jomama,,1,198,381,579
2511,galets,,1,1,5,6
2512,davidoc,,1,6,5,11
2513,robotsdoingphysics,,1,65,80,145
2514,Delslayer,,1,22,35,57
2515,JGailor,,1,32,37,69
2516,oldenglishbastard,,1,2,3,5
2517,smellycoat,,1,33,29,62
2518,MoonDogLeft,,1,3,1,4
2519,issacsullivan,,1,57,94,151
2520,Prozen,,1,9,6,15
2521,p3k,,1,30,44,74
2522,reddy4luv,,1,4,20,24
2523,giggity,,1,25,44,69
2524,Izdoy,,1,11,25,36
2525,pleasedeleteme,,1,2,3,5
2526,gerp,,1,42,67,109
2527,andralex,,1,16,15,31
2528,King_Canute,,1,103,119,222
2529,miyakohouou,,1,499,538,1037
2530,trevorx2500,,1,15,40,55
2531,treyethan,,1,1,2,3
2532,raouldukeesq,,1,869,1244,2113
2533,Dennis_im_30,,1,2,3,5
2534,sdsdsdsdsd,,1,212,195,407
2535,Zero_Dogg,,1,1,1,2
2536,StuffMaster,,1,16,27,43
2537,wingzeromkii,,1,7,10,17
2538,thelastkey,,1,14,12,26
2539,Dr_Schrodinger,,1,86,113,199
2540,comatose_kid,,1,2,1,3
2541,circletimessquare,,1,67,83,150
2542,troubledwine,,1,47,36,83
2543,gaiseric,,1,25,12,37
2544,floatingorb,,1,1,2,3
2545,FlatTownRunner,,1,1,1,2
2546,Batduck,,1,2,1,3
2547,transcendent,,1,47,81,128
2548,Sleepytime,,1,19,10,29
2549,fernandotakai,,1,13,17,30
2550,elliottc,,1,118,3,121
2551,PanglossAlberta,,1,48,87,135
2552,jwrey,,1,2,1,3
2553,drob003,,1,3,1,4
2554,anusrape,,1,73,33,106
2555,Forevamackin487,,1,1,3,4
2556,donewithdigg,,1,1,2,3
2557,gvfordo,,1,100,16,116
2558,mash3,,1,54,22,76
2559,afokenr,,1,27,17,44
2560,redditcanhelpme,,1,6,5,11
2561,s34hunt,,1,4,3,7
2562,bmbufalo,,1,1,2,3
2563,gasolino,,1,1,1,2
2564,ghettoleet,,1,24,26,50
2565,xoe,,1,6,8,14
2566,originalplankster,,1,3,8,11
2567,ish2189,,1,9,21,30
2568,antispork,,1,2,1,3
2569,leoburg,,1,5,4,9
2570,dccrowe,,1,7,1,8
2571,dirtyoldtown,,1,3,6,9
2572,pje,,1,17,32,49
2573,jaybee2,,1,131,267,398
2574,rbilsbor,,1,3,2,5
2575,thatswhatyouget,,1,74,96,170
2576,Prepaidguy,,1,5,7,12
2577,Jesus-H-Christ,,1,17,8,25
2578,giggzy,,1,1,3,4
2579,stevo1984,,1,11,6,17
2580,mecurdius,,1,8,9,17
2581,nathanj,,1,1,4,5
2582,lordjebus,,1,239,169,408
2583,kingsal,,1,3,7,10
2584,dessmond,,1,3,10,13
2585,slackinfux,,1,142,369,511
2586,gnewf,,1,2,4,6
2587,houdini,,1,23,53,76
2588,b_moore49,,1,2,2,4
2589,kevans2,,1,5,11,16
2590,streambag,,1,5,3,8
2591,filesalot,,1,288,352,640
2592,aim2free,,1,322,546,868
2593,Garage_Dragon,,1,7,2,9
2594,sajohnson,,1,7,8,15
2595,wyleslie,,1,14,25,39
2596,iheartartoo,,1,21,17,38
2597,malpensante,,1,2,8,10
2598,thechikinguy,,1,9,26,35
2599,sammamish,,1,6,1,7
2600,richy_rich,,1,2,1,3
2601,Stormwind_Edward,,1,5,6,11
2602,David_H,,1,65,40,105
2603,el0rg,,1,160,230,390
2604,ZhuangZ1,,1,1,1,2
2605,JohnnyCash,,1,6,1,7
2606,kevlarsuit,,1,8,9,17
2607,thespace,,1,45,68,113
2608,mellowmonk,,1,614,217,831
2609,donttaseme,,1,1191,1597,2788
2610,holyscience,,1,7,2,9
2611,RIAA_,,1,8,11,19
2612,PleaseBeSerious,,1,1,2,3
2613,boogh,,1,15,1,16
2614,gmoose,,1,2,14,16
2615,codeismightier,,1,8,4,12
2616,stankfrank,,1,1,1,2
2617,freya_b,,1,10,3,13
2618,Qwirk,,1,134,188,322
2619,whatismyoldpassword,,1,22,35,57
2620,Peregrination,,1,6,5,11
2621,PhillyJT,,1,2,1,3
2622,ecb29,,1,1,2,3
2623,notirk,,1,17,8,25
2624,CapnSupermarket,,1,3,8,11
2625,nemethee,,1,2,1,3
2626,brennus,,1,76,33,109
2627,ArtVandelay,,1,42,28,70
2628,retsknurt,,1,132,142,274
2629,argherna,,1,9,30,39
2630,bipedalshark,,1,11,7,18
2631,demebeu,,1,3,4,7
2632,dadavinci,,1,17,16,33
2633,buvljak,,1,72,4,76
2634,cbeck287,,1,353,570,923
2635,chicken001,,1,5,5,10
2636,fiv3isaliv3,,1,25,55,80
2637,ebbinghaus,,1,34,2,36
2638,boo97,,1,3,2,5
2639,andieh05,,1,6,3,9
2640,greyfinch,,1,19,10,29
2641,anachronic,,1,715,1092,1807
2642,ClockworkSparrow,,1,10,1,11
2643,theposthumousluger,,1,2,1,3
2644,NUDITY,,1,7,8,15
2645,omghax1337,,1,29,1,30
2646,mrmikewikowski,,1,157,17,174
2647,acfm,,1,57,22,79
2648,suradesign,,1,2,1,3
2649,robertos11,,1,205,7,212
2650,akuhn,,1,10,13,23
2651,thelmick,,1,9,13,22
2652,Astly2,,1,9,2,11
2653,dzhuang,,1,1,1,2
2654,SeBBBe,,1,34,57,91
2655,cheekyisgreat,,1,25,1,26
2656,HankHill,,1,2,3,5
2657,plehar,,1,23,48,71
2658,pitchik,,1,7,6,13
2659,Trundys,,1,3,2,5
2660,jwinter,,1,7,10,17
2661,raisondecalcul,,1,21,21,42
2662,Caffinated1,,1,1,3,4
2663,tttodayjunior,,1,11,3,14
2664,manualoverride,,1,3,4,7
2665,sgnlzo,,1,4,2,6
2666,HAL-9000,,1,1,2,3
2667,zombiereagan,,1,1,1,2
2668,dustball,,1,159,20,179
2669,Deficit5,,1,3,2,5
2670,AesopRock,,1,1,2,3
2671,begawk,,1,50,5,55
2672,hennell,,1,373,352,725
2673,Ultra200,,1,1,2,3
2674,mablo,,1,2,1,3
2675,jameswharam,,1,3,12,15
2676,spyguitar,,1,36,45,81
2677,scientologist2,,1,2012,764,2776
2678,headswine,,1,194,5,199
2679,emlot,,1,80,177,257
2680,nuajman,,1,3,1,4
2681,cerebrum,,1,47,46,93
2682,winetype,,1,2,1,3
2683,carvman,,1,5,1,6
2684,eternalegg,,1,2,1,3
2685,nihilo,,1,4,5,9
2686,yeu,,1,1,2,3
2687,robotbutler,,1,127,51,178
2688,Happy_Phantom,,1,6,38,44
2689,cGt2099,,1,6,2,8
2690,cyberpop,,1,14,28,42
2691,random5097325097235,,1,17,20,37
2692,CoachZed,,1,18,22,40
2693,somuch2see,,1,121,51,172
2694,hillscottc,,1,2,1,3
2695,MaLaCoiD,,1,19,15,34
2696,galactus,,1,16,1,17
2697,fearphage,,1,2,4,6
2698,someguy9,,1,1,9,10
2699,potsdarn,,1,2,1,3
2700,Apewithtools,,1,1,2,3
2701,vijitnair,,1,13,6,19
2702,spiffage,,1,7,18,25
2703,Ahnteis,,1,352,554,906
2704,JanieJones,,1,4,7,11
2705,etherghost,,1,14,21,35
2706,hrtattx,,1,287,223,510
2707,RespondsToMostReplys,,1,7,10,17
2708,tigeba,,1,2,3,5
2709,maniacnf,,1,62,115,177
2710,iceberg,,1,45,50,95
2711,fikustree,,1,46,94,140
2712,SeaweedWater,,1,7,1,8
2713,ajness,,1,10,14,24
2714,Trogdor420,,1,37,41,78
2715,pgquiles,,1,18,5,23
2716,iqisimportant,,1,3,2,5
2717,blehh,,1,1,2,3
2718,JustJulie,,1,2,2,4
2719,neur1,,1,5,9,14
2720,meor,,1,3,2,5
2721,notjfk,,1,4,3,7
2722,ebartels,,1,3,6,9
2723,brintoul,,1,243,465,708
2724,uberhanz,,1,5,14,19
2725,dekz,,1,2,2,4
2726,inDglass,,1,36,7,43
2727,sgt_pepper,,1,1,2,3
2728,Tuscarosa,,1,9,18,27
2729,awilke,,1,29,20,49
2730,rilliam,,1,1,1,2
2731,gnolnalla,,1,6,11,17
2732,super4pi,,1,8,1,9
2733,joelieberman,,1,7,9,16
2734,mrt181,,1,1,1,2
2735,Kaizyn,,1,45,43,88
2736,gauchopuro,,1,4,4,8
2737,LongInTheTooth,,1,13,11,24
2738,lukurdi,,1,1,2,3
2739,SparkyFox,,1,12,1,13
2740,Sabremesh,,1,345,508,853
2741,leeon,,1,4,3,7
2742,lawschoolbound,,1,4,9,13
2743,simontzu,,1,3,3,6
2744,troupe,,1,1,3,4
2745,misterov,,1,11,12,23
2746,kipi,,1,77,67,144
2747,DashingLeech,,1,271,252,523
2748,JustinCEO,,1,10,16,26
2749,marcstober,,1,6,2,8
2750,thedragon4453,,1,180,222,402
2751,cthulhu_forprez,,1,9,16,25
2752,PoopMcPooperson,,1,1,2,3
2753,skywagon,,1,2,3,5
2754,1917777,,1,241,311,552
2755,xiguo,,1,8,10,18
2756,domfosnz,,1,12,24,36
2757,jtrask,,1,2,6,8
2758,frost12,,1,3,2,5
2759,space_cadet00,,1,3,2,5
2760,aliasforspam,,1,46,19,65
2761,bendotc,,1,7,12,19
2762,pheen,,1,7,11,18
2763,landoncz,,1,2,3,5
2764,coldlizard,,1,24,17,41
2765,imnotauser,,1,21,50,71
2766,ninjatune,,1,137,12,149
2767,buZZRd,,1,60,117,177
2768,weare138,,1,8,7,15
2769,dorkyasian,,1,20,15,35
2770,atomictoaster,,1,81,58,139
2771,nmorse,,1,1,1,2
2772,mulcher,,1,81,167,248
2773,liminal,,1,5,1,6
2774,mcosta,,1,10,21,31
2775,Mordor,,1,87,136,223
2776,shastapete,,1,5,8,13
2777,kelvie,,1,81,128,209
2778,msoren,,1,1,3,4
2779,T3hTao,,1,2,3,5
2780,bagel702,,1,32,23,55
2781,friend2007,,1,62,1,63
2782,dumbdumbguy,,1,2,1,3
2783,nzodd,,1,1,7,8
2784,siljeal,,1,3,9,12
2785,blayne,,1,29,89,118
2786,asinglenet,,1,28,1,29
2787,ginowhitaker,,1,164,214,378
2788,ryanh29,,1,1130,972,2102
2789,luckysara,,1,6,4,10
2790,millstone,,1,605,593,1198
2791,skratchx,,1,4,12,16
2792,ambassadorofkwan,,1,13,18,31
2793,pygmyshrew,,1,20,44,64
2794,loquedesea,,1,8,14,22
2795,SkyFrostSalvo,,1,12,16,28
2796,alx1507,,1,6,8,14
2797,DTanner,,1,226,102,328
2798,wilsonp,,1,10,12,22
2799,darthmdh,,1,89,177,266
2800,brohemoth,,1,46,76,122
2801,phoeniks,,1,46,59,105
2802,cathiedsquared,,1,1,3,4
2803,gams,,1,1,1,2
2804,OrangePlus,,1,334,542,876
2805,michael2l,,1,1,4,5
2806,tezcat,,1,3,2,5
2807,doody,,1,412,693,1105
2808,jncamilo,,1,14,7,21
2809,MrWoohoo,,1,241,561,802
2810,PlacentaJuan,,1,3,4,7
2811,ShiningSnowFlake,,1,3,2,5
2812,antidrug_drug,,1,86,96,182
2813,saukrates,,1,8,9,17
2814,safe_q,,1,7,17,24
2815,jamesmhall76,,1,5,3,8
2816,noram256,,1,11,31,42
2817,reddit4Jesus,,1,2,1,3
2818,locodonkey,,1,2,1,3
2819,Demur,,1,3,4,7
2820,staiano,,1,490,722,1212
2821,carontheking,,1,59,1,60
2822,tubbo,,1,2,6,8
2823,drmaxpower,,1,172,312,484
2824,hadiwinata,,1,1,1,2
2825,cian,,1,4,2,6
2826,jfray2,,1,3,3,6
2827,myerscarpenter,,1,3,4,7
2828,billy_maize,,1,4,1,5
2829,Uchikoma,,1,7,1,8
2830,ramaesi,,1,10,13,23
2831,fearsofgun,,1,172,185,357
2832,IN_DA_BUTT,,1,27,10,37
2833,cptnlazer,,1,1059,44,1103
2834,pvtshoebox,,1,1,3,4
2835,benz8574,,1,135,21,156
2836,phunge,,1,3,2,5
2837,doyu,,1,1,1,2
2838,zeee,,1,2,3,5
2839,confirm,,1,4,5,9
2840,yaffytaffy,,1,1,1,2
2841,hairstyled676,,1,4,1,5
2842,gevander,,1,7,18,25
2843,mrqcho,,1,3,3,6
2844,kex,,1,1,2,3
2845,ssjjss,,1,95,72,167
2846,abhz79,,1,4,3,7
2847,ekmather,,1,29,79,108
2848,bockris,,1,41,28,69
2849,Fireball,,1,547,586,1133
2850,gashirasucksdick,,1,6,5,11
2851,mydodger,,1,112,143,255
2852,redreplicant,,1,211,220,431
2853,d0od,,1,80,88,168
2854,Pahjci,,1,2,1,3
2855,dmfdmf,,1,38,49,87
2856,megagurka,,1,1,1,2
2857,RagnarDanneskjold,,1,278,109,387
2858,dhawal,,1,2,5,7
2859,311ncubus,,1,2,8,10
2860,thomaslee,,1,7,12,19
2861,layman,,1,42,62,104
2862,honus,,1,99,165,264
2863,Aniceathiest,,1,1,3,4
2864,bazoople,,1,312,366,678
2865,itodd,,1,54,72,126
2866,jaminunit,,1,11,1,12
2867,MyCutePetPics,,1,4,14,18
2868,ynohoo,,1,97,142,239
2869,groove1880,,1,8,10,18
2870,morr0350,,1,15,27,42
2871,smokeboat,,1,25,32,57
2872,SFBrit,,1,2,1,3
2873,esubasi,,1,1,1,2
2874,xoxer,,1,9,20,29
2875,NJWilcats,,1,1,1,2
2876,Zenofex,,1,6,2,8
2877,joefish1984,,1,1,4,5
2878,jamesqua,,1,32,32,64
2879,Chrys,,1,2,1,3
2880,biggiesmells,,1,2,4,6
2881,Criffer,,1,23,41,64
2882,megalodon,,1,23,24,47
2883,feeboo,,1,98,135,233
2884,thee-ass,,4,4,8,12
2885,dylansylvester,,1,2,1,3
2886,perryc,,1,11,2,13
2887,pratik4newworld,,1,9,1,10
2888,dila813,,1,1,1,2
2889,bpiraeus,,1,57,86,143
2890,HairyHoudini,,1,1,2,3
2891,paleofuturist,,1,2,1,3
2892,g0taclue,,1,242,392,634
2893,BarryGoldwatersGhost,,1,5,6,11
2894,rws,,1,1,2,3
2895,lyaunzbe,,1,15,26,41
2896,ironkurton,,1,2,1,3
2897,bluelobster,,1,15,18,33
2898,apapitrat,,1,4,1,5
2899,MissSatan,,1,1,3,4
2900,value23,,1,1,1,2
2901,noknockers,,1,2,3,5
2902,NateNizzle,,1,2,3,5
2903,stopthelefty,,1,2,1,3
2904,elefantstn,,1,2,5,7
2905,Actius,,1,264,390,654
2906,chap1girl,,1,3,1,4
2907,hotfuzz86,,1,24,23,47
2908,rewirez5940,,1,124,40,164
2909,patrozoo,,1,8,28,36
2910,gplaya2323,,1,27,3,30
2911,myearsmyears,,1,101,8,109
2912,detroitsongbird,,1,3,1,4
2913,reddit983,,1,4,7,11
2914,lonbpl,,1,6,7,13
2915,Naptosis,,1,5,8,13
2916,clintschaff,,1,1,3,4
2917,bigeyedeer,,1,1,2,3
2918,blackdoor,,1,13,13,26
2919,mancxvi,,1,9,11,20
2920,stronglikedan,,1,362,567,929
2921,hsfrey,,1,327,429,756
2922,slsanity,,1,1,1,2
2923,noegoman100,,1,6,21,27
2924,waffl,,1,2,2,4
2925,Shawty_Lo,,1,5,4,9
2926,nashaw,,1,2,1,3
2927,dudeman1,,1,1,1,2
2928,swblacksheep,,1,3,4,7
2929,freelancelot,,1,1,1,2
2930,jaymancer,,1,2,4,6
2931,ariana333,,1,154,21,175
2932,Internet-Tough-Guy,,1,2,2,4
2933,cd6020,,1,133,230,363
2934,ckwing,,1,290,366,656
2935,jmorrowwork,,1,1,1,2
2936,chub79,,1,90,155,245
2937,Dikaiosyne,,1,6,14,20
2938,ronsta,,1,73,127,200
2939,andrewbirkett,,1,8,1,9
2940,thecookiemaker,,1,4,1,5
2941,nokturnal,,1,1,7,8
2942,buddha067,,1,1,2,3
2943,iuyterw,,1,1,1,2
2944,ironmonkey,,1,92,149,241
2945,moneyprinter,,1,610,812,1422
2946,ttarchal,,1,2,3,5
2947,ejp1082,,1,1771,686,2457
2948,neoumlaut,,1,2,2,4
2949,reddit-man-junior,,1,2,3,5
2950,sillythewilly,,1,2,2,4
2951,geeker87,,1,14,19,33
2952,Foxfulness,,1,5,6,11
2953,os10,,1,3,2,5
2954,nebogeo,,1,4,4,8
2955,scoops22,,1,13,9,22
2956,ShauRobi69652,,1,37,36,73
2957,DeltaEchoMike,,1,35,54,89
2958,femalenumber101,,1,1,14,15
2959,homegrown,,1,17,2,19
2960,E_mE,,1,2,2,4
2961,cockasaurus,,1,5,35,40
2962,mike_burck,,1,7,4,11
2963,takita787,,1,291,15,306
2964,RonPaulSpambot,,1,50,69,119
2965,nillawafer,,1,3,7,10
2966,triana_south,,1,4,27,31
2967,swight74,,1,34,28,62
2968,razeetg,,1,3,5,8
2969,N4N4KI,,1,15,10,25
2970,fontbase,,1,3,16,19
2971,willcode4beer,,1,38,21,59
2972,mfdba,,1,75,35,110
2973,Diode,,1,1,1,2
2974,Ac3,,1,34,69,103
2975,lucidvegas,,1,39,83,122
2976,Trinket,,1,12,3,15
2977,Juan234,,1,52,52,104
2978,qliedtke,,1,4,1,5
2979,plexxonic,,1,2,3,5
2980,asdfprou,,1,7,1,8
2981,upcguy,,1,4,6,10
2982,fauxXenophanes,,1,27,97,124
2983,pasht,,1,131,167,298
2984,reddi_vedder,,1,1,1,2
2985,dearmansoor,,1,134,10,144
2986,TheMop,,1,1,1,2
2987,harry3864,,1,2,13,15
2988,dedzone2k,,1,7,9,16
2989,LauraMars,,1,2,2,4
2990,daveydave,,1,39,57,96
2991,scoobynz,,1,4,4,8
2992,mikehayes19,,1,95,8,103
2993,etruscan,,1,94,111,205
2994,hangelinajolie,,1,1,1,2
2995,mrgee,,1,10,2,12
2996,wwgtam8,,1,3,3,6
2997,IAmCelery,,1,5,9,14
2998,lensflare,,1,1,2,3
2999,richarddixon,,1,2,7,9
3000,St3v3n777,,1,1,1,2
3001,haruspex,,1,24,32,56
3002,dontgoatsemebro,,1,366,655,1021
3003,fkrueger,,1,1,1,2
3004,mellowchimp,,1,6,11,17
3005,emullet,,1,7,12,19
3006,hydralisk,,1,104,100,204
3007,GunOfSod,,1,29,47,76
3008,mad1234,,1,8,6,14
3009,brownhound,,1,14,18,32
3010,chefjeremy,,1,1,1,2
3011,miramardesign,,1,2,1,3
3012,frazzled35,,1,3,1,4
3013,krayle,,1,8,1,9
3014,jpcx01,,1,7,5,12
3015,eclectro,,1,158,290,448
3016,stimuluspackage,,1,3,9,12
3017,jueskin,,1,5,7,12
3018,Basketbasket,,1,2,1,3
3019,jjj52,,1,2,1,3
3020,0gleth0rpe,,1,138,229,367
3021,schabot,,1,72,81,153
3022,angelahayden,,1,3,3,6
3023,wtfx20004,,1,11,22,33
3024,NoMoreREPUGS,,1,9,13,22
3025,barney54,,1,213,185,398
3026,jewlicious,,1,7,1,8
3027,hulio99,,1,114,163,277
3028,escherfan,,1,34,25,59
3029,benkapa,,1,5,8,13
3030,dodgyd55,,1,9,47,56
3031,hjfreyer,,1,2,3,5
3032,underdog45,,1,1,1,2
3033,irfanmp,,1,624,37,661
3034,chollida1,,1,128,190,318
3035,scheisse_adc,,1,11,19,30
3036,caracter_2,,1,7,2,9
3037,GrrlScientist,,1,432,11,443
3038,jeneni,,1,1,2,3
3039,spectrusery,,1,43,45,88
3040,master-chief,,1,111,34,145
3041,Jungo,,1,1,1,2
3042,arrdev7,,1,13,21,34
3043,Tw1zzler,,1,1,4,5
3044,karmakazi,,1,7,6,13
3045,milliganpierce,,1,63,78,141
3046,jaznova,,1,8,14,22
3047,masako9,,1,3,4,7
3048,titusthefox,,1,7,2,9
3049,yairchu,,1,174,375,549
3050,lapalam,,1,94,65,159
3051,tshelton,,1,2,2,4
3052,alexw,,1,7,12,19
3053,ExAm,,1,42,60,102
3054,zippppp,,1,10,15,25
3055,running_bowels,,1,1,1,2
3056,RightBleeding,,1,80,127,207
3057,mrmagoo,,1,1,2,3
3058,chrisgon,,1,7,1,8
3059,youtellme8,,1,1,1,2
3060,Pensador,,1,2,5,7
3061,bensussman,,1,1,6,7
3062,alacrity,,1,67,100,167
3063,bananahands,,1,8,12,20
3064,makenshi,,1,37,50,87
3065,rooshw,,1,81,90,171
3066,alhes,,1,2,3,5
3067,nineoclock,,1,131,238,369
3068,katyalaia,,1,3,1,4
3069,ucfmike,,1,10,1,11
3070,Tomasfoolery,,1,52,115,167
3071,iDaniel,,1,8,26,34
3072,lianos,,1,46,75,121
3073,drphil1066,,1,15,11,26
3074,sensor,,1,73,159,232
3075,mortenaa,,1,396,65,461
3076,sgnmac,,1,2,3,5
3077,gpmvdc,,1,2,3,5
3078,avibryant,,1,18,23,41
3079,jaycee2145,,1,1,1,2
3080,Thumperings,,1,292,596,888
3081,PeopleEatTastyAnimal,,1,123,203,326
3082,daxxxer,,1,3,7,10
3083,Liface,,1,2,1,3
3084,Nomaken,,1,2,7,9
3085,Energysync,,1,20,15,35
3086,edcrypt,,1,2,6,8
3087,gathersuccess,,1,1,1,2
3088,DoyleOwl,,1,10,13,23
3089,crenansen,,1,3,2,5
3090,yargaroo,,1,1,2,3
3091,thanksjerk,,1,45,55,100
3092,musicaldonkey,,1,12,25,37
3093,larrytheliquid,,1,3,3,6
3094,ctro82,,1,60,100,160
3095,XaosTX,,1,48,14,62
3096,twanvl,,1,23,30,53
3097,madefromcheese,,1,15,21,36
3098,sivoneall,,1,3,1,4
3099,willzager,,1,1,1,2
3100,tripleg,,1,266,561,827
3101,AoP,,1,397,362,759
3102,Learned_Handjob,,1,4,3,7
3103,GarbageDonkey,,1,1,4,5
3104,lysistrata,,1,34,38,72
3105,ewout,,1,1,1,2
3106,vanel,,1,4,3,7
3107,qqyh2,,1,5,4,9
3108,maineac,,1,135,129,264
3109,gonzabaleta,,1,1,1,2
3110,noblethrasher,,1,22,33,55
3111,platyperl,,1,41,51,92
3112,stunt_penguin,,1,369,628,997
3113,none1234,,1,36,54,90
3114,ThreadRuiner,,1,37,4,41
3115,Miglin,,1,4,12,16
3116,mbergesonjr,,1,19,2,21
3117,stephenthemay,,1,22,17,39
3118,BanX,,1,134,23,157
3119,falien,,1,2,5,7
3120,ladamesansmerci,,1,76,45,121
3121,Snatchbuckler,,1,6,13,19
3122,devindotcom,,1,2,9,11
3123,spidersfrommars,,1,15,14,29
3124,ebcak,,1,64,8,72
3125,lethalbeef,,1,21,30,51
3126,slark,,1,3,9,12
3127,sleepytree,,1,5,6,11
3128,hiker,,1,9,7,16
3129,smedley42,,1,41,121,162
3130,lespea,,1,176,246,422
3131,internuts_tough_gay,,1,2,7,9
3132,pr1mu5,,1,181,123,304
3133,rasterized,,1,6,5,11
3134,alexott,,1,1,3,4
3135,eyestosky,,1,6,3,9
3136,dundundunn,,1,11,13,24
3137,ssassi7,,1,204,128,332
3138,lvbronco,,1,2,1,3
3139,FlieGerFaUstMe262,,1,3,3,6
3140,tylerjames,,1,51,50,101
3141,Remember711,,1,45,97,142
3142,UpIn08,,1,78,51,129
3143,jaskew,,1,5,4,9
3144,right_behind_you,,1,34,35,69
3145,Baraq_Hussayni_Osama,,1,10,8,18
3146,BigJuiceMan,,1,8,12,20
3147,FamousSeamus,,1,8,1,9
3148,danratherfoe,,1,17,35,52
3149,r0x0r,,1,20,4,24
3150,Cappy-chan,,1,116,150,266
3151,delibaltas,,1,13,15,28
3152,sillyme,,1,8,19,27
3153,sjovaag,,1,12,22,34
3154,ZachSka87,,1,191,178,369
3155,thebigcheeze,,1,70,3,73
3156,jakobscudder,,1,2,1,3
3157,cnwb,,1,284,69,353
3158,trvr,,1,543,462,1005
3159,blindpilot,,1,15,16,31
3160,Buckbeak,,1,2,1,3
3161,bombat,,1,12,10,22
3162,TheGeneral,,1,51,89,140
3163,mybetterhalf,,1,22,49,71
3164,sadfaceman,,1,6,12,18
3165,rehpargotohp,,1,68,87,155
3166,Gatecrasher,,1,265,301,566
3167,washort,,1,194,270,464
3168,Joe091,,1,20,30,50
3169,optiontrader1138,,1,169,247,416
3170,vexx,,1,16,18,34
3171,Gmonkeylouie,,1,176,218,394
3172,justkeith,,1,10,17,27
3173,randy12,,1,3,3,6
3174,Alpha-Toxic,,1,29,26,55
3175,cliffm,,1,2,2,4
3176,chumpsucker,,1,6,10,16
3177,jackityjackyjackjack,,1,1,1,2
3178,pensword,,1,20,22,42
3179,apfelmus,,1,44,61,105
3180,USuckAss,,1,5,4,9
3181,xrobau,,1,61,81,142
3182,kallumama,,1,3,4,7
3183,Adrewmc,,1,189,441,630
3184,Street_Justice,,1,2,4,6
3185,ctallis,,1,4,1,5
3186,Jimmers1231,,1,187,143,330
3187,evilada,,1,233,182,415
3188,jimbo340,,1,7,7,14
3189,skullnibbler,,1,1,13,14
3190,schmick,,1,2,3,5
3191,scratchyNutz,,1,30,77,107
3192,dkeehn,,1,2,1,3
3193,cfbolz,,1,15,32,47
3194,chupame,,1,227,624,851
3195,mydiggisbig,,1,6,5,11
3196,arogal,,1,6,8,14
3197,nullchris,,1,1,2,3
3198,Kayin_Angel,,1,47,80,127
3199,reddawn2,,1,3,1,4
3200,StopTheWorld,,1,2,2,4
3201,johntitor,,1,1,1,2
3202,Poddo,,1,1,1,2
3203,selfthis,,1,35,34,69
3204,BigRodInPhilly,,1,2,1,3
3205,noseybonk,,1,1,1,2
3206,juststopit,,1,35,81,116
3207,pyegar,,1,23,2,25
3208,4th_reddit_account,,1,35,14,49
3209,notmynick,,1,4,1,5
3210,redditer027,,1,1,1,2
3211,megatrons07,,1,1,2,3
3212,Contron,,1,39,91,130
3213,trashly,,1,1,2,3
3214,demosthenes2010,,1,10,16,26
3215,tryp,,1,23,15,38
3216,underthesun,,1,32,17,49
3217,insanewriters,,1,79,29,108
3218,theoclast,,1,28,33,61
3219,laputan,,1,1,1,2
3220,AeroEngrAndMBA,,1,34,30,64
3221,henryk,,1,66,61,127
3222,moodswung,,1,8,12,20
3223,paygun,,1,30,42,72
3224,Bemfica,,1,1,1,2
3225,jjdmol,,1,217,312,529
3226,jaltena,,1,7,8,15
3227,Ringo48,,1,141,137,278
3228,tm82,,1,25,35,60
3229,stoosdood,,1,22,5,27
3230,GrandImperial,,1,10,10,20
3231,xnormajeanx,,1,253,227,480
3232,yesno305,,1,1,1,2
3233,resurge,,1,14,21,35
3234,Dillenger69,,1,234,464,698
3235,JaggedOne,,1,143,146,289
3236,aceoage,,1,1,9,10
3237,Pewpewarrows,,1,1,1,2
3238,banditski,,1,217,209,426
3239,sbsb27,,1,48,55,103
3240,alteredboy,,1,3,3,6
3241,battamer,,1,1,1,2
3242,lxstwrt,,1,15,1,16
3243,barbosaurus,,1,16,33,49
3244,Paperthin,,1,42,31,73
3245,cowboybebop,,1,1,1,2
3246,SamMcreedy,,1,1,2,3
3247,alex4nder,,1,26,23,49
3248,Swaddle,,1,1,1,2
3249,narcoleptic,,1,3,2,5
3250,sjbildermann,,1,19,32,51
3251,sjs,,1,417,822,1239
3252,tigerlily1770,,1,1,1,2
3253,RonPauI,,1,2,2,4
3254,benvolio_otter,,1,5,14,19
3255,saveferris,,1,39,51,90
3256,metawhat,,1,49,48,97
3257,fedaykin3dfx,,1,42,50,92
3258,JohnBoyRed,,1,1,3,4
3259,azdesign,,1,1,2,3
3260,naturebeau,,1,1,1,2
3261,ViperStrike085,,1,56,59,115
3262,BobKelsoCox,,1,2,1,3
3263,bubol,,1,3,3,6
3264,river-wind,,1,26,56,82
3265,fdisc0,,1,110,50,160
3266,arnoooooo,,1,48,122,170
3267,kofman,,1,2,2,4
3268,DougsNews,,1,89,31,120
3269,ookaay,,1,1,2,3
3270,bonsaitree,,1,1,2,3
3271,narwhal,,1,1,3,4
3272,itsinthebook,,1,2,3,5
3273,hotweiss,,1,64,89,153
3274,MasterScrat,,1,200,77,277
3275,alloashley,,1,5,2,7
3276,spen,,1,2,2,4
3277,forkystick,,1,2,7,9
3278,ygduf,,1,47,98,145
3279,optical,,1,74,183,257
3280,cbucket,,1,59,140,199
3281,low_key,,1,3,4,7
3282,sexdiary,,1,4,4,8
3283,maringa,,1,3,3,6
3284,MattVortex,,1,2,3,5
3285,chriton227,,1,1,1,2
3286,BrotherSeamus,,1,170,280,450
3287,kathrynmac,,1,19,34,53
3288,chapati,,1,6,3,9
3289,vgatsby,,1,8,16,24
3290,infiity,,1,1,4,5
3291,bassvocal,,1,38,59,97
3292,vandesande,,1,1,1,2
3293,thagsimmons,,1,33,64,97
3294,anon_for_this_time,,1,49,2,51
3295,saachi,,1,16,42,58
3296,mdeckert,,1,134,226,360
3297,eslav,,1,33,9,42
3298,RedPS,,1,93,39,132
3299,dMage,,1,22,28,50
3300,Fishav,,1,24,6,30
3301,shabda,,1,38,15,53
3302,tokenirishman,,1,1,1,2
3303,eatpizza,,1,1,8,9
3304,Captain_Ligature,,1,96,148,244
3305,alhernan,,1,2,1,3
3306,CaptGeek,,1,1,1,2
3307,diogames,,1,711,1127,1838
3308,mikexstudios,,1,9,12,21
3309,vansrikanth,,1,3,3,6
3310,deedee55,,1,27,47,74
3311,normanmehmeh,,1,10,4,14
3312,goodluckngoodnight,,1,4,2,6
3313,Lothy,,4,6,7,13
3314,GOPDogVomit,,1,57,74,131
3315,jerepjohnson,,1,14,11,25
3316,mcj,,1,42,50,92
3317,linton300,,1,61,6,67
3318,hamsealer,,1,1,1,2
3319,basic0,,1,161,136,297
3320,mkomo,,1,1,1,2
3321,bill_the_lizard,,1,5,12,17
3322,brianobush,,1,5,5,10
3323,cweaver,,1,563,862,1425
3324,redrover,,1,214,368,582
3325,scottmweaver,,1,1,1,2
3326,elTito,,1,2,6,8
3327,huginn,,1,262,322,584
3328,ilganeli,,1,2,3,5
3329,godskitchen,,1,68,41,109
3330,enterrupt,,1,1,18,19
3331,momerath,,1,41,49,90
3332,notm3tosay,,1,1,1,2
3333,the_incoherent_puppy,,1,1,3,4
3334,Chris7mas,,1,42,1,43
3335,cahuenga,,1,373,7,380
3336,tautologies,,1,3,2,5
3337,pkhagah,,1,8,9,17
3338,te_anau,,1,16,52,68
3339,perezhiltonadsucks,,1,11,23,34
3340,timbernerslee,,1,2,2,4
3341,BlitzCraig,,1,83,7,90
3342,bojangles69,,1,41,46,87
3343,TheNinthDoctor,,1,1,2,3
3344,TheFreshPrince,,1,1,1,2
3345,GorillaJ,,1,27,42,69
3346,nubtard,,1,2,5,7
3347,jdharper,,1,23,18,41
3348,maczer,,1,1,2,3
3349,Mezzanine,,1,11,57,68
3350,dwalthour,,1,15,11,26
3351,edmccaffrey,,1,35,63,98
3352,LycanElite,,1,24,43,67
3353,ekow2kn3,,1,6,15,21
3354,hairstyleee,,1,1,1,2
3355,stomach_cancer,,1,1,1,2
3356,hoodafukru,,1,29,23,52
3357,handsoffme,,1,36,36,72
3358,popefelix,,1,23,32,55
3359,thesweetness,,1,5,1,6
3360,Varnu,,1,7,4,11
3361,bushisaterrorist,,1,54,62,116
3362,omegaxm,,1,15,5,20
3363,giantrobot,,1,10,18,28
3364,StaticSignal,,1,5,6,11
3365,lhimalcolm,,1,12,15,27
3366,neobob,,1,6,16,22
3367,jbarnosky,,1,62,77,139
3368,bgovern,,1,100,117,217
3369,peoplehater,,1,26,39,65
3370,helgim,,1,1,5,6
3371,AlbertSchweitzer,,1,2,3,5
3372,kylegetsspam,,1,175,94,269
3373,CRUISECONTROLLER,,1,106,282,388
3374,gandhikahn,,1,22,30,52
3375,jonas_24,,1,1,1,2
3376,kensway,,1,3,1,4
3377,athelred,,1,1,1,2
3378,mr_gadget,,1,7,5,12
3379,quirkyfemme,,1,9,2,11
3380,3legcat,,1,13,14,27
3381,bmhatfield,,1,6,1,7
3382,PharmacistMike,,1,1,4,5
3383,renegadeofunk,,1,17,10,27
3384,uniteduntied,,1,4,2,6
3385,funktio,,1,26,22,48
3386,akabaka,,1,41,15,56
3387,ThomasPtacek,,1,204,204,408
3388,tobytroy,,1,27,32,59
3389,quadropelegit,,1,1,1,2
3390,weez09,,1,32,109,141
3391,kcin,,1,4,1,5
3392,daneatdirt,,1,14,20,34
3393,seba,,1,12,9,21
3394,bunyip,,1,33,33,66
3395,unic0rnz,,1,42,109,151
3396,sdragon,,1,2,2,4
3397,Lusy,,1,39,58,97
3398,danalb,,1,8,12,20
3399,SparxNet,,1,138,18,156
3400,GeneDoc,,1,1,1,2
3401,central_scrutinizer,,1,1,1,2
3402,zerothehero,,1,4,5,9
3403,tamb,,1,17,64,81
3404,taylortsides,,1,4,10,14
3405,ruscher,,1,3,2,5
3406,abramsv,,1,2,3,5
3407,cuerty,,1,1,4,5
3408,conorkirk,,1,4,7,11
3409,metzby,,1,91,82,173
3410,jodes,,1,347,282,629
3411,FrankBattaglia,,1,393,576,969
3412,coldwarrior,,1,374,541,915
3413,kojac,,1,10,3,13
3414,vkashen,,1,7,4,11
3415,psychoman365,,1,2,4,6
3416,fisch003,,1,4,7,11
3417,tizar,,1,7,4,11
3418,mocean,,1,2,5,7
3419,skeener,,1,37,115,152
3420,jmt123,,1,54,35,89
3421,georgeoscarbluth,,1,136,130,266
3422,sabrinag321,,1,8,9,17
3423,whitelightbrown,,1,54,43,97
3424,shawnvv,,1,19,6,25
3425,cyantific,,1,477,700,1177
3426,jasondigitized,,1,2,1,3
3427,ooohthatsnice,,1,3,2,5
3428,aeiou,,1,22,1,23
3429,waltz,,1,3,5,8
3430,kimrader,,1,6,5,11
3431,sjanssen,,1,50,65,115
3432,sadmep,,1,2,3,5
3433,jmillikin,,1,105,107,212
3434,LokiFoo,,1,1,2,3
3435,bytehead,,1,1,1,2
3436,startnowclickhere,,1,4,4,8
3437,zenspider,,1,34,27,61
3438,skylark9,,1,6,4,10
3439,kur1,,1,8,15,23
3440,pitstopper,,1,3,6,9
3441,Docktorno,,1,5,17,22
3442,shevegen,,1,2,9,11
3443,flamey,,1,33,5,38
3444,Uberg33k,,1,38,53,91
3445,LeviDon,,1,393,528,921
3446,behindblondiepark,,1,172,1,173
3447,zachalexander,,1,35,14,49
3448,missysue,,1,93,128,221
3449,UnionSoldier,,1,1,4,5
3450,I_Dont_Get_It,,1,1,3,4
3451,ToasTeh,,1,35,42,77
3452,codeblind,,1,23,53,76
3453,anth023,,1,1,1,2
3454,Burlapin,,1,636,382,1018
3455,eertognam,,1,5,6,11
3456,adoofus,,1,41,55,96
3457,booboopbedoop,,1,77,28,105
3458,neophrenologist,,1,17,20,37
3459,mcbambam,,1,15,18,33
3460,julenissen,,1,13,28,41
3461,SyncMoster,,1,2,3,5
3462,glblguy,,1,3,2,5
3463,spillz,,1,5,5,10
3464,pbradley,,1,121,254,375
3465,etor,,1,29,39,68
3466,Zeonix,,1,4,4,8
3467,lamontsf,,1,59,73,132
3468,DanHalen,,1,246,376,622
3469,wolfm79,,1,5,3,8
3470,normal1,,1,1,2,3
3471,itsourdecision,,1,2,1,3
3472,kitestramuort,,1,60,29,89
3473,DCGaymer,,1,87,205,292
3474,theEnzyteGuy,,1,16,23,39
3475,spangl,,1,1,1,2
3476,boardergeek,,1,10,1,11
3477,kuhllax24,,1,3,2,5
3478,hundredpercentjuice,,1,13,11,24
3479,sir-pinski,,1,3,7,10
3480,Anomander,,1,500,608,1108
3481,NotADoctor,,1,4,3,7
3482,mom-bot,,1,165,72,237
3483,civilians,,1,2,1,3
3484,gsf,,1,9,4,13
3485,petrasvilkas,,1,1,1,2
3486,jaggederest,,1,1062,1748,2810
3487,bevets,,1,7,6,13
3488,iiso,,1,1,2,3
3489,Godhelpus,,1,6,11,17
3490,licnyc,,1,36,40,76
3491,warrior007,,1,1,6,7
3492,bob_chinn,,1,1,1,2
3493,klasbas,,1,2,9,11
3494,patrissimo,,1,1,1,2
3495,RyanSmith,,1,46,58,104
3496,witten,,1,135,106,241
3497,ztay,,1,7,21,28
3498,psygurd,,1,2,5,7
3499,tronk,,1,10,15,25
3500,Captian_Oblivious,,1,36,23,59
3501,JoeSki42,,1,46,45,91
3502,cneemo,,1,3,5,8
3503,Mr_Shipwreck,,1,5,6,11
3504,ohashi,,1,3,1,4
3505,baconatedwaffle,,1,3,1,4
3506,wjyoung,,1,4,5,9
3507,AllSeeingMind,,1,1,1,2
3508,boodaa,,1,124,10,134
3509,rastan,,1,2,8,10
3510,ssflanders,,1,2,1,3
3511,freemti,,1,28,46,74
3512,oakium9,,1,2,2,4
3513,cr1swell,,1,59,101,160
3514,curt94,,1,1,3,4
3515,howaboutnow,,1,1,1,2
3516,Zombine,,1,44,70,114
3517,g33k,,1,5,9,14
3518,defigio,,1,1,2,3
3519,satori_moment,,1,14,27,41
3520,Anthem26,,1,11,20,31
3521,dallen,,1,137,187,324
3522,mythosmc,,1,2,11,13
3523,enricopulatzo,,1,2,2,4
3524,Rickasaurus,,1,9,4,13
3525,Her0savestheday,,1,3,120,123
3526,iveL,,1,4,11,15
3527,robsell,,1,1,2,3
3528,rhombusface,,1,1,3,4
3529,usr,,1,106,181,287
3530,HazeCore,,1,25,60,85
3531,brodieface,,1,2,10,12
3532,lighthoused,,1,1,1,2
3533,Tali99,,1,5,1,6
3534,ZimShady,,1,4,3,7
3535,khbryant,,4,4,2,6
3536,orblivion,,1,565,749,1314
3537,leftcoaster,,1,1,1,2
3538,digiterata,,1,18,18,36
3539,Action_Girl,,1,2,1,3
3540,UKUSA,,1,1,1,2
3541,clutterme,,1,6,2,8
3542,n1tw1t,,1,11,14,25
3543,cultofheather,,1,1,2,3
3544,PdxTu,,1,3,5,8
3545,lansen,,1,59,59,118
3546,gonecatfishin,,1,203,405,608
3547,executivemonkey,,1,641,982,1623
3548,unclenerd,,1,9,11,20
3549,majehire,,1,1,3,4
3550,SERIOUSCAT,,1,8,10,18
3551,arndiuz,,1,4,8,12
3552,muyoso,,1,110,88,198
3553,nixuseleven,,1,288,261,549
3554,frozenfire,,1,248,163,411
3555,blw121,,1,85,23,108
3556,obeyme,,1,1,1,2
3557,lattakia,,1,3,1,4
3558,VAGINAMAN,,1,3,6,9
3559,deadapostle,,1,2,5,7
3560,dsuarezv,,1,12,4,16
3561,Backhandzeus,,1,1,3,4
3562,miklosb,,1,3,3,6
3563,caddo07,,1,237,7,244
3564,mrcytizen,,1,7,12,19
3565,uberazzi,,1,118,23,141
3566,phaedrustc,,1,2,1,3
3567,moonballer,,1,73,57,130
3568,paulcynic,,1,74,6,80
3569,paralogical,,1,12,2,14
3570,perfeng702,,1,1,1,2
3571,MacBookForMe,,1,9,1,10
3572,shade73,,1,1,1,2
3573,joshuafkon,,1,3,1,4
3574,Unnat,,1,2,6,8
3575,Dawnfall,,1,5,8,13
3576,pearofducks,,1,1,1,2
3577,Janizzary,,1,1,2,3
3578,urmom,,1,3,6,9
3579,ChaosMotor,,1,141,260,401
3580,cymbalrush,,1,80,171,251
3581,werdtothenerd,,1,15,8,23
3582,found-it,,1,3,1,4
3583,zzt711,,1,10,18,28
3584,maxd,,1,274,372,646
3585,Tontomicon,,1,3,3,6
3586,roundeyeddog,,1,30,6,36
3587,bassmaster,,1,1,1,2
3588,waya1,,1,254,88,342
3589,rifleman_maynard,,1,7,10,17
3590,dodgyboat,,1,42,18,60
3591,Tuna-Fish2,,1,62,92,154
3592,wildwilly,,1,10,25,35
3593,sobe86,,1,14,10,24
3594,pretentiousdouchebag,,1,7,3,10
3595,Ramulus,,1,2,2,4
3596,fieldmouse,,1,2,1,3
3597,popcult,,1,663,60,723
3598,spot35,,1,192,308,500
3599,supersaw,,1,289,440,729
3600,Dzune,,1,3,5,8
3601,dip,,1,89,4,93
3602,Amish_Redditor,,1,2,3,5
3603,obamamama08,,1,6,2,8
3604,stephencelis,,1,9,20,29
3605,MysteriousCraic,,1,1,1,2
3606,rikbrown,,1,3,4,7
3607,RevLoveJoy,,1,148,165,313
3608,did_you_know_that,,1,12,14,26
3609,pind02,,1,29,30,59
3610,azzer,,1,2,1,3
3611,dpinkal,,1,2,1,3
3612,alexbear,,1,34,68,102
3613,placebo96799,,1,1,2,3
3614,vanyali,,1,5,12,17
3615,DarkFenix,,1,24,14,38
3616,whitecracker,,1,73,4,77
3617,rjray,,1,11,7,18
3618,TheGood,,1,236,509,745
3619,Shroomsoup,,1,92,120,212
3620,bildstein,,1,2,2,4
3621,Moebus,,1,3,2,5
3622,hhg,,1,1,2,3
3623,bobshush,,1,245,317,562
3624,Felugah,,1,19,30,49
3625,fakeplasticme,,1,86,106,192
3626,fuzzybassoon,,1,1,1,2
3627,facetheglue,,1,98,74,172
3628,karma_chameleon,,1,275,385,660
3629,slutshirt,,1,1,3,4
3630,eye_josh,,1,3,6,9
3631,losl,,1,43,54,97
3632,redscarab,,1,2,5,7
3633,Dongski,,1,3,4,7
3634,Arcen,,1,3,1,4
3635,DustyMuffin,,1,7,10,17
3636,TastesLikeChicken,,1,3,2,5
3637,wKen,,1,8,11,19
3638,kuwabara02,,1,10,7,17
3639,khayber,,1,279,425,704
3640,agent_orange,,1,5,3,8
3641,danpatsa,,1,6,5,11
3642,TheParanoidAndroid,,1,14,43,57
3643,fiftytwo,,1,1,1,2
3644,Phirazo,,1,27,21,48
3645,dooh,,1,2,16,18
3646,HenryTheMegalomanic,,1,4,1,5
3647,lounge_chair,,1,2,6,8
3648,tyeh26,,1,13,12,25
3649,kettal,,1,57,78,135
3650,trollforkarma,,1,8,7,15
3651,matty_b,,1,15,26,41
3652,timin,,1,1,2,3
3653,c0dep0et,,1,3,7,10
3654,garyteeth,,1,1,2,3
3655,madcaesar,,1,54,90,144
3656,darkry,,1,21,30,51
3657,danschu63,,1,2,7,9
3658,jlgkcghjdghj,,1,5,6,11
3659,gabaghoul,,1,1,1,2
3660,benhoyt,,1,223,50,273
3661,al420,,1,2,4,6
3662,parsa033,,1,7,3,10
3663,degustivespa,,1,18,34,52
3664,rocky79,,1,8,9,17
3665,joe_shmoe11111,,1,35,71,106
3666,tits_n_acidd,,1,7,11,18
3667,insert-meme,,1,190,351,541
3668,lateralus,,1,98,60,158
3669,frickinamazing,,1,15,10,25
3670,ClackAttack,,1,49,57,106
3671,xrokka,,1,1,1,2
3672,daveread,,1,42,66,108
3673,ptang,,1,1,2,3
3674,stlouisbrowns,,1,698,586,1284
3675,kabr,,1,11,14,25
3676,totobird357,,1,1,1,2
3677,Data_Storm,,1,2,7,9
3678,captainfwiffo,,1,50,68,118
3679,liu212,,1,2,1,3
3680,DrRobert,,1,11,16,27
3681,-funroll-loops,,1,1,1,2
3682,gocubs80,,1,8,12,20
3683,ninjaidd,,1,8,4,12
3684,BlackMarketer,,1,38,29,67
3685,rachelmc,,1,1,1,2
3686,Roark,,1,753,276,1029
3687,mentaldent,,1,2,13,15
3688,lunk,,1,60,68,128
3689,burnteternal,,1,11,9,20
3690,213435,,1,7,6,13
3691,digp,,1,1,1,2
3692,renderedpixel,,1,1,2,3
3693,scrapper,,1,133,184,317
3694,jmcqk6,,1,297,452,749
3695,baconfish,,1,20,41,61
3696,bonecrusher,,1,3,2,5
3697,davars,,1,3,6,9
3698,barakatbarakat,,1,14,20,34
3699,fakeplastic,,1,5,6,11
3700,JuanHughJorgan,,1,1,3,4
3701,Queenbee310,,1,1,3,4
3702,Hipgnosis,,1,35,86,121
3703,freed,,1,3,2,5
3704,username0000,,1,4,1,5
3705,inredditland,,1,1,1,2
3706,jeremytrash,,1,17,3,20
3707,Oleander,,1,32,32,64
3708,rbercian,,1,1,2,3
3709,BoggleBrain,,1,47,47,94
3710,cosmid,,1,182,322,504
3711,doubtingthomas,,1,56,81,137
3712,ohmohm,,1,12,17,29
3713,doctord,,1,1,2,3
3714,aliweb,,1,257,43,300
3715,kikonja,,1,385,46,431
3716,kit8642,,1,1,1,2
3717,wunderboy,,1,44,48,92
3718,ashdog137,,1,5,8,13
3719,2468ben,,1,4,10,14
3720,maggs,,1,1,1,2
3721,teyc,,1,90,128,218
3722,frogking,,1,473,1097,1570
3723,beza1e1,,1,372,279,651
3724,RiMiBe,,1,265,395,660
3725,evansims,,1,1,1,2
3726,Jmjonkman,,1,24,26,50
3727,PhullAdder,,1,1,2,3
3728,cosmosis,,1,2,1,3
3729,timothyjc,,1,33,26,59
3730,KelliBusey,,1,1,1,2
3731,ybad,,1,67,75,142
3732,rothgar24,,1,19,45,64
3733,butterscotch,,1,11,9,20
3734,cranus,,1,2,1,3
3735,rteyhdhgh,,1,6,5,11
3736,ScreamingSkull,,1,18,26,44
3737,thejapanesegeek,,1,8,5,13
3738,antfarmerbob,,1,1,1,2
3739,otiose321,,1,65,16,81
3740,donkey_lz,,1,3,6,9
3741,ryouba,,1,45,41,86
3742,zemoo,,1,4,2,6
3743,redpassport,,1,7,12,19
3744,orestes19,,1,6,9,15
3745,cefm,,1,694,1220,1914
3746,bustardy,,1,2,5,7
3747,zootm,,1,45,78,123
3748,synrb,,1,7,8,15
3749,cliche,,1,151,142,293
3750,ChewableFood,,1,6,9,15
3751,kubutulur,,1,233,451,684
3752,xdj,,1,26,79,105
3753,EeyoreTKC,,1,38,44,82
3754,stewie81,,1,2,2,4
3755,lobut,,1,203,319,522
3756,oddsouls,,1,92,148,240
3757,savetheconstitution,,1,2,1,3
3758,concini,,1,289,126,415
3759,hassanh21,,1,58,52,110
3760,t4k3n,,1,2,1,3
3761,sabut,,1,11,12,23
3762,toskius,,1,2,1,3
3763,tst1212,,1,5,8,13
3764,hoboy,,1,1,1,2
3765,CrAppleton,,1,1,1,2
3766,heheman3000,,1,1,1,2
3767,StrictlyPlatonic,,1,2,2,4
3768,tripa,,1,30,33,63
3769,bearythebear,,1,40,51,91
3770,wjackson,,1,22,35,57
3771,dividebyz3r0,,1,1,1,2
3772,Sabretooth,,1,6,7,13
3773,informatech,,1,7,8,15
3774,MegaMonkeyManExtreme,,1,5,23,28
3775,Obscuro,,1,3,4,7
3776,Kaessa,,1,72,134,206
3777,Jasn,,1,2,3,5
3778,badcop666,,1,3,2,5
3779,Stay521,,1,1,1,2
3780,andycwb,,1,3,1,4
3781,InternetHateMachin3,,1,43,62,105
3782,roadcoach,,1,1,1,2
3783,cwicket,,1,23,31,54
3784,Sharkyx,,1,233,29,262
3785,sethaldridge,,1,2,1,3
3786,hueypriest,,1,112,47,159
3787,alex_tokai,,1,1,1,2
3788,I_Am_Reason,,1,4,2,6
3789,moserware,,1,74,13,87
3790,nova20,,1,26,24,50
3791,tommycli,,1,21,28,49
3792,rabidgolffan,,1,1,1,2
3793,lemonge,,1,12,17,29
3794,arunmail,,1,1,1,2
3795,therapy,,1,460,605,1065
3796,gardensnake,,1,13,33,46
3797,arrogantworm,,1,1,2,3
3798,hillahilla,,1,20,21,41
3799,wordmunger,,1,2,2,4
3800,dillhole,,1,1,1,2
3801,Callahan121,,1,6,10,16
3802,candeewolf,,1,2,2,4
3803,smurphy,,1,1,1,2
3804,youchoose2,,1,79,229,308
3805,craigtechno,,1,2,1,3
3806,abdul15,,1,1,1,2
3807,Humels,,1,2,1,3
3808,epic_fail_guy,,1,218,234,452
3809,melp,,1,2,4,6
3810,jacastillo,,1,10,11,21
3811,Rick_Roll,,1,18,2,20
3812,Orange007,,1,10,7,17
3813,danstuken,,1,8,4,12
3814,nakp88d,,1,39,48,87
3815,namsilat,,1,106,16,122
3816,kefs,,1,1048,134,1182
3817,boredzo,,1,1004,1360,2364
3818,ErnestHemingway,,1,4,17,21
3819,joebeone,,1,1,2,3
3820,ashayh,,1,11,20,31
3821,ardenr,,1,50,78,128
3822,TimJBart,,1,77,14,91
3823,honeg,,1,191,369,560
3824,allyrx7,,1,4,4,8
3825,moosetime1230330,,1,1,2,3
3826,Epivalent,,1,1,3,4
3827,100pushups,,1,4,10,14
3828,zerofive1,,1,38,65,103
3829,vinsewah,,1,7,4,11
3830,IRBTGISRUNBYTHEGOVT,,1,1,1,2
3831,technosaur,,1,383,456,839
3832,BONUS_,,1,5,1,6
3833,netcmd,,1,17,15,32
3834,ronin712,,1,2,2,4
3835,f4k3pl4stic,,1,1,1,2
3836,slenderdog,,1,176,369,545
3837,mdikkema,,1,1,1,2
3838,mkmahar,,1,11,6,17
3839,ngl,,1,1,13,14
3840,borommakot,,1,1,4,5
3841,hissiliconsoul,,1,35,38,73
3842,Beem,,1,2,2,4
3843,TheNeoCity,,1,22,15,37
3844,uncbabie,,1,11,10,21
3845,kilven,,1,3,9,12
3846,skullduggery,,1,1,4,5
3847,salmacis,,1,20,16,36
3848,pssh99,,1,18,13,31
3849,FST,,1,113,196,309
3850,followvirgil,,1,141,32,173
3851,blobert,,1,42,66,108
3852,dssvo,,1,45,64,109
3853,Katie89,,1,7,6,13
3854,Sku,,1,45,36,81
3855,newgrl,,1,74,92,166
3856,Amblikai,,1,4,8,12
3857,ecalos,,1,4,16,20
3858,sanman,,1,8,7,15
3859,wiraqcza,,1,2,3,5
3860,blumby,,1,1,2,3
3861,fdat,,1,59,83,142
3862,Redkiteflying,,1,14,18,32
3863,jib,,1,344,518,862
3864,melvingant,,1,17,3,20
3865,MeenXo,,1,25,26,51
3866,gnat,,1,2,3,5
3867,booris,,1,4,4,8
3868,therve,,1,1,2,3
3869,laynehobby,,1,2,1,3
3870,orange_cat,,1,1,4,5
3871,Olduvai_Joe,,1,1,2,3
3872,asssphinctersayswhat,,1,2,2,4
3873,cybergen,,1,169,89,258
3874,darth_brooks,,1,144,199,343
3875,johnb,,1,206,200,406
3876,mossgard,,1,6,25,31
3877,daemen,,1,2,3,5
3878,underpantsgnome,,1,1,4,5
3879,Neikos,,1,9,20,29
3880,Jengu,,1,35,50,85
3881,TJHookor,,1,49,51,100
3882,blogger8888,,1,2,3,5
3883,apl,,1,1,3,4
3884,Boolean,,1,33,23,56
3885,pedromccarthy,,1,1,1,2
3886,satertek,,1,482,472,954
3887,GoatTnder,,1,42,15,57
3888,hags99,,1,1,1,2
3889,earthgirl46,,1,2,3,5
3890,scramer,,1,7,16,23
3891,ozyman,,1,10,26,36
3892,slf67,,1,65,56,121
3893,mr_w,,1,29,25,54
3894,enken,,1,2,2,4
3895,KDoggers,,1,1,1,2
3896,jeanfitzgerald,,1,70,121,191
3897,gvsteve,,1,674,684,1358
3898,alexf3ng,,1,1,2,3
3899,efrique,,1,23,3,26
3900,ManInFall,,1,1,3,4
3901,zmigliozzi,,1,163,288,451
3902,gthank,,1,866,169,1035
3903,piperatom,,1,6,13,19
3904,holyzomg,,1,5,3,8
3905,davejl,,1,138,30,168
3906,mickyg,,0,1,1,2
3907,javasucks,,1,261,496,757
3908,robotoast,,1,55,95,150
3909,benben_liu88,,0,1,1,2
3910,nomad_tavern,,1,1,1,2
3911,axord,,1,991,1949,2940
3912,aaslos,,1,11,2,13
3913,AngryRepublican,,1,271,420,691
3914,riomx,,1,5,1,6
3915,landshark,,1,2,4,6
3916,napoleonmonkey,,1,1,1,2
3917,AllGood,,1,85,71,156
3918,umairmalik,,1,2,2,4
3919,willyloman,,1,4,1,5
3920,charliepage,,1,15,3,18
3921,naltex,,1,23,40,63
3922,eljimador,,1,1,1,2
3923,ccutler69,,1,32,52,84
3924,bgraves,,1,7,6,13
3925,ubuntumaniac,,1,1,1,2
3926,mamasaige,,1,1,1,2
3927,d_i_z_z_y_k,,1,72,23,95
3928,gyanguru,,1,13,14,27
3929,Ryethe,,1,15,21,36
3930,YaYaLuvsCupcakes,,1,5,1,6
3931,amtb,,1,1,1,2
3932,NeoGeo,,1,3,1,4
3933,Shizlanski,,1,1,2,3
3934,urklan,,1,2,2,4
3935,hex,,1,82,86,168
3936,anonyreddit,,1,1,4,5
3937,twokie,,1,1,2,3
3938,jackband1t,,1,134,45,179
3939,User832,,1,6,6,12
3940,rbobic,,1,8,11,19
3941,iox,,1,1,2,3
3942,njzero,,1,39,73,112
3943,fuchsm2002,,1,1,1,2
3944,odinfire,,1,22,17,39
3945,adamc,,1,47,68,115
3946,cji,,1,4,6,10
3947,gles0000,,1,1,3,4
3948,Leprecon,,1,249,370,619
3949,pleasenodoitlive,,1,9,4,13
3950,eftrescue,,1,2,3,5
3951,alphakappa,,1,113,65,178
3952,epc123,,1,26,31,57
3953,kendetroit,,1,1,2,3
3954,NejimakiDori,,1,2,3,5
3955,MarshallBanana,,1,1320,1778,3098
3956,bobbysmith007,,1,53,89,142
3957,coldkodiak,,1,38,45,83
3958,tehdanish,,1,1,2,3
3959,orenbenkiki,,1,8,4,12
3960,dzer0,,1,28,40,68
3961,pdsull,,1,4,4,8
3962,Gnolfo,,1,6,2,8
3963,muffsquirt,,1,22,41,63
3964,pumpupthevolume,,1,141,135,276
3965,aleister,,1,2,2,4
3966,zbrock,,1,16,8,24
3967,TravisMc,,1,2,5,7
3968,frunt,,1,209,243,452
3969,cavedave,,1,1557,374,1931
3970,supajames,,1,20,21,41
3971,aewiel,,1,3,7,10
3972,lonjerpc,,1,146,160,306
3973,celebritythinspo,,1,14,4,18
3974,jspam,,1,61,32,93
3975,jasonpo,,1,25,29,54
3976,imagineapuddle,,1,26,19,45
3977,gq_bag,,1,7,6,13
3978,gribbit,,1,5,4,9
3979,ensignsteve,,1,5,29,34
3980,shopcat,,1,272,480,752
3981,insidious,,1,1,1,2
3982,argoff,,1,673,768,1441
3983,robbiefoster,,1,4,4,8
3984,gim69,,1,9,8,17
3985,huwr,,1,1,1,2
3986,hgielrehtaeh,,1,465,423,888
3987,Stange,,1,28,21,49
3988,wimpyanonymous,,1,3,1,4
3989,Rock42,,1,2,3,5
3990,brickbybrick,,1,7,8,15
3991,jeaguilar,,1,13,25,38
3992,watergeese,,1,154,106,260
3993,muthawenchez,,1,1,1,2
3994,gregwont,,1,1018,4,1022
3995,niia,,1,1,3,4
3996,adbachman,,1,4,6,10
3997,sinsio,,1,1,2,3
3998,CoastOfYemen,,1,69,41,110
3999,jaydoubleyou,,1,6,7,13
4000,JackRB,,1,1,2,3
4001,mvhughes,,1,11,20,31
4002,frap,,1,3,3,6
4003,VoteMcCain,,1,1,3,4
4004,melangeau,,1,5,4,9
4005,dereschai,,1,1,1,2
4006,Omikron,,1,1044,1044,2088
4007,omarsdroog,,1,1,2,3
4008,hypermog,,1,24,21,45
4009,uksydibasv,,1,99,55,154
4010,skionxb,,1,1267,27,1294
4011,nkm1981,,1,4,5,9
4012,barneystephens,,1,225,73,298
4013,steadyrock,,1,3,1,4
4014,variablast,,1,1,2,3
4015,reddy-kilowatt,,1,4,14,18
4016,SunriseProgrammer,,1,5,7,12
4017,dkj1953,,1,1,1,2
4018,erreon,,1,77,33,110
4019,Dr_Faustus,,1,12,11,23
4020,kefex,,1,109,54,163
4021,iIrishjon,,1,2,4,6
4022,bokepr,,1,1,1,2
4023,skoof,,1,3,3,6
4024,preilly,,1,2,3,5
4025,catfood,,1,3,3,6
4026,bluemeep,,1,24,28,52
4027,webfiend,,1,39,100,139
4028,apostleofhustle,,1,29,57,86
4029,kanakaishou,,1,69,119,188
4030,CaptainAdjective,,1,13,10,23
4031,jongala,,1,7,11,18
4032,SmurfyX,,1,31,51,82
4033,stjohns,,1,10,13,23
4034,VitaminH,,1,58,85,143
4035,wutzurproblem,,1,98,219,317
4036,minerva78,,1,22,21,43
4037,cammycam,,1,5,5,10
4038,zpincus,,1,6,9,15
4039,Soelle,,1,1,1,2
4040,DEPROGRAM_YOUR_MIND,,1,18,13,31
4041,Itarilde,,1,10,29,39
4042,Marmiteontoast,,1,2,4,6
4043,harley99,,1,2,4,6
4044,Andronicus,,1,1,1,2
4045,thequicksilver,,1,7,6,13
4046,redwinging,,1,3,6,9
4047,withnail,,1,3,1,4
4048,mtbkeg,,1,2,1,3
4049,yoda133113,,1,67,89,156
4050,crucialfelix,,1,123,149,272
4051,dangerous_eric,,1,6,1,7
4052,karmasux080130,,1,4,9,13
4053,leoh,,1,4,2,6
4054,lolmanzorz,,1,117,99,216
4055,inCider,,1,22,28,50
4056,lispy,,1,16,22,38
4057,SidDithers,,1,6,1,7
4058,bjrn,,1,23,7,30
4059,gummo,,1,1,2,3
4060,vmsmith,,1,7,5,12
4061,haterexterminator,,1,2,1,3
4062,SuperKing,,1,219,349,568
4063,veryhman,,1,18,1,19
4064,Arnfred,,1,17,15,32
4065,easyhistory,,1,187,386,573
4066,mnemone,,1,5,9,14
4067,frugaldutchman,,1,5,16,21
4068,bayblab,,1,1,1,2
4069,suyuri,,1,1,3,4
4070,blmurch,,1,79,171,250
4071,ntba,,1,1,1,2
4072,thewibbler,,1,13,8,21
4073,caguy,,1,1,1,2
4074,newsguy2005,,1,8,1,9
4075,mdavis11487,,1,4,8,12
4076,ateall,,1,2,1,3
4077,FatLoser,,1,54,9,63
4078,dereklyons,,1,8,11,19
4079,SaLted_peanUTs,,1,9,8,17
4080,rdmorley,,1,66,78,144
4081,kylestryker,,1,7,7,14
4082,Hess10,,1,1,1,2
4083,Shade00a00,,1,31,44,75
4084,mitoe,,1,155,95,250
4085,Timmetie,,1,95,124,219
4086,drmickhead,,1,6,9,15
4087,sonofagunn,,1,57,95,152
4088,ChrisToTheCenter,,1,32,3,35
4089,DrCrankenstein,,1,65,23,88
4090,bierhofff,,1,2,3,5
4091,rolex22,,1,11,18,29
4092,helly,,1,3,1,4
4093,plethorex,,1,109,143,252
4094,Carniv0re,,1,2,2,4
4095,wmacura,,1,12,6,18
4096,sunmaster13,,1,7,5,12
4097,themysteriousfuture,,1,14,19,33
4098,shitbird,,1,4,12,16
4099,chris1672,,1,2,1,3
4100,Carmilla5,,1,1,1,2
4101,theCore,,1,28,23,51
4102,Majupra,,1,1,3,4
4103,strolls,,1,334,441,775
4104,iansmith6,,1,1,1,2
4105,EamonR,,1,23,53,76
4106,purplegalaxy,,1,3,1,4
4107,ueberbobo,,1,2,8,10
4108,danc86,,1,3,5,8
4109,burntsac,,1,49,28,77
4110,freep2,,1,1,2,3
4111,Morikal,,1,1,1,2
4112,tuppertrenine,,1,3,1,4
4113,dubyas_my_hero,,1,71,120,191
4114,usurper2009,,1,93,20,113
4115,igad,,1,4,3,7
4116,zwrtwtr,,1,1,2,3
4117,NyteStarNyne,,1,11,17,28
4118,kynth,,1,1,4,5
4119,CuntPuntingIsAHOBBY,,1,1,2,3
4120,hectorwc,,1,211,320,531
4121,RedRaya,,1,131,53,184
4122,fortranran,,1,5,3,8
4123,justhadto,,1,58,104,162
4124,MetroSpy,,1,3,5,8
4125,climbon321,,1,205,64,269
4126,bdash,,1,98,92,190
4127,irishcocacola,,1,132,66,198
4128,thegooddoctor,,1,1,1,2
4129,AnotherTia,,1,1,1,2
4130,BravoLima,,1,1322,403,1725
4131,boxofjack,,1,1,4,5
4132,SLiPSTR34M,,1,2,2,4
4133,Mints,,1,20,14,34
4134,TruthMonger,,1,13,1,14
4135,SamSoBuff1215,,1,11,17,28
4136,Kaemack,,1,1,7,8
4137,Ravenkettle,,1,3,6,9
4138,chaosdude78,,1,1,6,7
4139,ahjones,,1,14,1,15
4140,dvogel,,1,86,94,180
4141,Wagnerius,,1,84,78,162
4142,giulianob,,1,17,38,55
4143,kulakovich,,1,1,1,2
4144,jdhawk,,1,6,4,10
4145,kmr62,,1,2,2,4
4146,GayEd,,1,53,57,110
4147,Cloud7659,,1,5,7,12
4148,aspinex,,1,38,6,44
4149,fellowette,,1,3,3,6
4150,boredatheist,,1,3,4,7
4151,Cait_Monster,,1,82,117,199
4152,adarshiscool,,1,29,47,76
4153,switch495,,1,10,12,22
4154,pestilence4hr,,1,39,39,78
4155,juan_mccain,,1,1,1,2
4156,nventit2,,1,34,1,35
4157,stims,,1,13,9,22
4158,redbean1,,1,2,1,3
4159,sgoadhouse,,1,6,2,8
4160,The_Cougar,,1,2,5,7
4161,modnar,,1,309,390,699
4162,Catana,,1,4,7,11
4163,otatop,,1,490,633,1123
4164,sirris,,1,2,1,3
4165,Slawekk,,1,1,1,2
4166,slate,,1,5,6,11
4167,heatmaster,,1,1,1,2
4168,lamerx,,1,20,49,69
4169,wackyvorlon,,1,235,191,426
4170,piggysmacks,,1,2,4,6
4171,godders,,1,19,27,46
4172,derio42,,1,1,1,2
4173,farlow,,1,20,35,55
4174,gossipmonkey,,1,85,5,90
4175,mindhacker,,1,21,19,40
4176,MicahFitch,,1,193,35,228
4177,jameslaw,,1,80,141,221
4178,pakacuda,,1,31,38,69
4179,shwaldo,,1,1,1,2
4180,musicisum,,1,79,127,206
4181,NowakFilms,,1,10,12,22
4182,brandf,,1,3,9,12
4183,arielh85,,1,228,2,230
4184,soulreaver,,1,20,4,24
4185,notaloop,,1,131,225,356
4186,ePurch,,1,2,4,6
4187,bluepepper,,1,20,34,54
4188,rrcjab,,1,1,1,2
4189,Oriard,,1,8,7,15
4190,senti2048,,1,21,18,39
4191,NewPeonSameAsOldPeon,,1,22,13,35
4192,luisbrudna,,1,67,11,78
4193,jixitar,,1,17,5,22
4194,metal_falsetto,,1,113,99,212
4195,cusiter67,,1,1,5,6
4196,casted,,1,87,11,98
4197,collinsc,,1,4,8,12
4198,Anonymoose2,,1,3,3,6
4199,chahn,,1,19,16,35
4200,rt702,,1,5,5,10
4201,glassie,,1,1,1,2
4202,KatfromCanada,,1,19,47,66
4203,fact,,1,19,21,40
4204,daniels220,,1,302,520,822
4205,antonivs,,1,132,211,343
4206,maxonemaxtwo,,1,7,7,14
4207,trav,,1,38,5,43
4208,sjwillis,,1,86,62,148
4209,glackk,,1,16,26,42
4210,chomputer,,1,6,16,22
4211,jbzd,,1,118,91,209
4212,IcanReddit,,1,3,3,6
4213,joshnunn,,1,3,3,6
4214,OnzeVader,,1,1,1,2
4215,tousdan,,1,2,1,3
4216,SkyMarshal,,1,273,420,693
4217,fprintf,,1,14,15,29
4218,tritchey,,1,2,1,3
4219,pornholio21,,1,29,11,40
4220,igwan,,1,3,3,6
4221,theosloexperience,,1,82,70,152
4222,the3secondrule,,1,8,9,17
4223,otisfresh,,1,10,12,22
4224,adamwhiles,,1,3,6,9
4225,SizzlingStapleCider,,1,53,35,88
4226,gorn2,,1,2,2,4
4227,wrightc,,1,1,1,2
4228,synapticon,,1,1,1,2
4229,JonhCarnol,,1,1,1,2
4230,zordac,,1,2,1,3
4231,MaxBro,,1,6,9,15
4232,nicholaides,,1,17,4,21
4233,wolfe1978nm,,1,13,21,34
4234,the-blimp,,1,1,1,2
4235,bfkelsey,,1,3,3,6
4236,mothslice,,1,2,1,3
4237,bfioca,,1,2,1,3
4238,scjohnson,,1,15,13,28
4239,deadfrank,,1,23,45,68
4240,mshade,,1,273,266,539
4241,tdieckman,,1,40,42,82
4242,Tyrus8,,1,1,2,3
4243,StevenLevithan,,1,29,18,47
4244,mattgifford,,1,1,1,2
4245,shabby47,,1,156,85,241
4246,brianchester666,,1,52,68,120
4247,tigerledoux13,,1,1,4,5
4248,simplydunn,,1,120,1,121
4249,issawiah,,1,2,2,4
4250,joaocosta,,1,3,1,4
4251,wingless,,1,2,3,5
4252,loonidood,,1,5,1,6
4253,timetraveller83,,1,4,5,9
4254,caroll245912,,1,1,1,2
4255,cfcamerica,,1,182,18,200
4256,shrednwail,,1,1,1,2
4257,monkeyman114,,1,550,1210,1760
4258,Troll-in-the-corner,,1,20,4,24
4259,radix42,,1,1,6,7
4260,Daveed,,1,11,25,36
4261,billin,,1,27,56,83
4262,feauxreal,,1,5,2,7
4263,Consensus,,1,6,8,14
4264,chelle84,,1,3,1,4
4265,wtfever,,1,8,9,17
4266,greengunner,,1,1,1,2
4267,badfish,,1,121,266,387
4268,Hoobam,,1,69,105,174
4269,imnotbillgates,,1,1,1,2
4270,adammcbomb,,1,2,15,17
4271,daamsie,,1,35,5,40
4272,laziz,,1,3,2,5
4273,tazmanian,,1,55,92,147
4274,katykat29,,1,10,13,23
4275,Blumbo,,1,44,64,108
4276,redthirtytwo,,1,17,29,46
4277,Chibi,,1,4,3,7
4278,yrqaay,,1,12,10,22
4279,sunshinerundown,,1,13,31,44
4280,Tatsu23456,,1,4,7,11
4281,nostupidquestions,,1,5,1,6
4282,amishius,,1,8,23,31
4283,crazybehind,,1,16,31,47
4284,musicalpeach,,1,9,11,20
4285,tszyn,,1,1,3,4
4286,Melvillian,,1,36,18,54
4287,riffito,,1,16,38,54
4288,mazing,,1,54,68,122
4289,sarahfrancesca,,1,456,335,791
4290,nof,,1,2,9,11
4291,achillesminor,,1,11,6,17
4292,patrickc,,1,1,1,2
4293,jardeon,,1,18,22,40
4294,missoulian,,1,5,6,11
4295,dru171,,1,6,15,21
4296,jerryjamesstone,,1,78,22,100
4297,dustin9797,,1,2,3,5
4298,alarumba,,1,66,106,172
4299,barnesnoble,,1,2,7,9
4300,khoury,,1,1077,1929,3006
4301,mocheeze,,1,2,5,7
4302,BMErdin,,1,94,166,260
4303,tonythewilson,,1,6,4,10
4304,strangedoctrines,,1,1,1,2
4305,myname3,,1,4,1,5
4306,skyo,,1,92,86,178
4307,vsundber,,1,1,2,3
4308,blackkettle,,1,66,85,151
4309,unptitdej,,1,8,8,16
4310,TheOneDM,,1,5,3,8
4311,Entintado,,1,4,7,11
4312,wizdum,,1,36,89,125
4313,BristolPalin,,1,76,118,194
4314,DrivebyGroper,,1,4,2,6
4315,lunamoon_girl,,1,14,21,35
4316,TerraFF,,1,9,20,29
4317,Irradiance,,1,97,31,128
4318,chefshaolin,,1,55,89,144
4319,Achara,,1,3,6,9
4320,live_free_or_die,,1,1,2,3
4321,monkeyx,,1,44,12,56
4322,vera123,,1,739,73,812
4323,911zionotroll,,1,2,2,4
4324,bluegene,,1,7,5,12
4325,Burkey,,1,19,25,44
4326,gbrudy16,,1,2,14,16
4327,doodahdei,,1,361,688,1049
4328,jstack,,1,11,27,38
4329,CygnusFTK,,1,147,165,312
4330,RetroRock,,1,671,104,775
4331,Tomboys2,,1,44,6,50
4332,Kafir,,1,40,56,96
4333,motang,,1,1267,37,1304
4334,users,,1,2,1,3
4335,concertmaps,,1,3,4,7
4336,xabi,,1,19,7,26
4337,jamarcus,,1,7,26,33
4338,cskaterun,,1,3,6,9
4339,augustallen,,1,3,7,10
4340,bluehorse00,,1,3,1,4
4341,jimdorey,,1,13,32,45
4342,xqtfmd,,1,27,39,66
4343,newbay,,1,3,4,7
4344,dsg123456789,,1,47,64,111
4345,annihilus813,,1,60,60,120
4346,ColdMountain,,1,3,5,8
4347,astorite,,1,6,13,19
4348,walterxraleigh,,1,2,3,5
4349,gpayet,,1,1,2,3
4350,aredash,,1,1,1,2
4351,ozmonster,,1,55,15,70
4352,psyker,,1,1,3,4
4353,gregmoskun,,1,50,139,189
4354,cellison,,1,5,2,7
4355,BigMax,,1,20,14,34
4356,Tbone139,,1,11,37,48
4357,ellaella,,1,573,365,938
4358,flawedai,,1,13,1,14
4359,CD7,,1,35,112,147
4360,bridgetroll,,1,2,2,4
4361,bugsland,,1,1,1,2
4362,lantech2,,1,24,50,74
4363,jbus,,1,15,19,34
4364,Dross,,1,2,6,8
4365,Twiin,,1,2,1,3
4366,sonar_un,,1,189,242,431
4367,flyspagmon,,1,67,40,107
4368,ilikeboobs,,1,1,2,3
4369,headius,,1,3,6,9
4370,greentriangle,,1,344,75,419
4371,highside,,1,5,8,13
4372,beeblez,,1,54,42,96
4373,mistersir,,1,3,7,10
4374,montypython1087,,1,1,8,9
4375,rednukleus,,1,331,583,914
4376,sinfulsamaritan,,1,97,10,107
4377,Yelly,,1,24,8,32
4378,philig,,1,3,7,10
4379,mbwahl,,1,2,2,4
4380,pietro,,1,15,34,49
4381,XoYo,,1,111,159,270
4382,vestus,,1,15,14,29
4383,spyder9,,1,2,1,3
4384,edelwater,,1,4,1,5
4385,omnic0n,,1,3,1,4
4386,robbyism,,1,2,5,7
4387,billabong,,1,5,14,19
4388,not-leet,,1,2,1,3
4389,rudylishious,,1,8,3,11
4390,RDS,,1,7,5,12
4391,Aloy,,1,16,22,38
4392,fisheggs,,1,18,23,41
4393,cpt_headshot,,1,2,3,5
4394,venir,,1,19,12,31
4395,thedangler,,1,10,6,16
4396,MrHat,,1,7,1,8
4397,tjperkins,,1,1,1,2
4398,BennyGreenberg,,1,1,1,2
4399,lutefisky,,1,25,55,80
4400,chrisrocks,,1,4,2,6
4401,1729,,1,75,104,179
4402,cam2009,,1,88,5,93
4403,markleno,,1,4,12,16
4404,beowulf,,1,79,83,162
4405,Humbert,,1,3,6,9
4406,svemirac,,1,4,3,7
4407,justinweiss,,1,14,7,21
4408,jcurtis34,,1,56,36,92
4409,ampsc2,,1,4,10,14
4410,itsme92,,1,58,67,125
4411,kiriel,,1,427,801,1228
4412,billrobertson42,,1,21,49,70
4413,OriginalSyn,,1,1176,1702,2878
4414,potterzot,,1,4,6,10
4415,butpolandsays,,1,1,1,2
4416,kmdudich,,1,13,40,53
4417,NO_NO_NO,,1,83,135,218
4418,JeremyFlint,,1,4,8,12
4419,ndawson89,,1,24,51,75
4420,werb001,,1,1,1,2
4421,Bleda,,1,1,2,3
4422,ArisOfAlaska,,1,94,38,132
4423,nudgedafudge,,1,6,2,8
4424,layjudge,,1,6,13,19
4425,KarmaReddits,,1,9,18,27
4426,DannyP72,,1,75,115,190
4427,mrim,,1,1,3,4
4428,Clemsanza,,1,4,17,21
4429,toseikai,,1,2,2,4
4430,aithnea,,1,23,7,30
4431,olbermannisadick,,1,1,1,2
4432,blackeyes,,1,382,480,862
4433,i_hate_turtles,,1,5,8,13
4434,thrandur,,1,3,5,8
4435,jberryman,,1,237,343,580
4436,Chev,,1,17,28,45
4437,slackwaresupport,,1,10,10,20
4438,nobahdi,,1,50,66,116
4439,markovich,,1,6,2,8
4440,thrills,,1,108,16,124
4441,dakana,,1,1,1,2
4442,demechman,,1,7,14,21
4443,gregorgede,,1,1,3,4
4444,UnincorporatedSnoCo,,1,66,85,151
4445,Sonarman,,1,117,47,164
4446,wronghead,,1,12,14,26
4447,fatinthemiddle,,1,1,1,2
4448,aero142,,1,9,5,14
4449,i_am_present,,1,1,2,3
4450,justinklin,,1,1,1,2
4451,dangerfingers,,1,4,6,10
4452,gmcbay,,1,29,34,63
4453,27182818284,,1,127,129,256
4454,danfan20,,1,36,23,59
4455,rammeh,,1,1,4,5
4456,sosixteen,,1,5,5,10
4457,gobacktodigg,,1,21,13,34
4458,ButtToucher,,1,1,1,2
4459,londonzoo,,1,726,406,1132
4460,rastafa,,1,1,4,5
4461,defenestrator,,1,132,156,288
4462,jsled,,1,14,13,27
4463,peteyH,,1,303,216,519
4464,unixsuperuser,,1,1,1,2
4465,Semantix,,1,4,5,9
4466,kandimar,,1,1,2,3
4467,MonkeyMachine,,1,8,13,21
4468,Petergibbons,,1,3,1,4
4469,markblei,,1,208,45,253
4470,lkirkw,,1,1,2,3
4471,markstoneman,,1,16,9,25
4472,darkreign,,1,178,196,374
4473,twowordz,,1,48,102,150
4474,yellowmix,,1,45,16,61
4475,cheesingballs,,1,2,2,4
4476,skotski,,1,12,20,32
4477,gaurax,,1,1,2,3
4478,soleus333,,1,7,2,9
4479,googlemaps,,1,2,3,5
4480,zenmasher,,1,32,36,68
4481,Lu-Tze,,1,51,69,120
4482,gidonyto,,1,1,1,2
4483,mulletmang,,1,42,34,76
4484,TwinSigma,,1,25,14,39
4485,elviscc0,,1,4,4,8
4486,Kojach,,1,10,10,20
4487,metacynic,,1,4,5,9
4488,fiddlosopher,,1,1,3,4
4489,johnnywantshismeme,,1,14,63,77
4490,hazridi,,1,1,2,3
4491,VinC,,1,43,51,94
4492,gonzogustav,,1,5,6,11
4493,ialsohaveadobro,,1,10,15,25
4494,netzwerkerin,,1,26,54,80
4495,Keawe12,,1,4,6,10
4496,Jomskylark,,1,28,24,52
4497,mindfvck,,1,46,6,52
4498,ralphc,,1,5,14,19
4499,keenacid,,1,2,1,3
4500,rdanays,,1,6,2,8
4501,pythagoruz,,1,9,20,29
4502,blong,,1,19,9,28
4503,Subdiver,,1,35,23,58
4504,kevlarbaboon,,1,280,220,500
4505,KillerAngel7,,1,228,322,550
4506,jacj,,1,121,175,296
4507,golov,,1,11,18,29
4508,ben_13,,1,1,1,2
4509,Len_Zefflin,,1,3,10,13
4510,liaohaohui,,1,6,7,13
4511,totallyawesome,,1,2,5,7
4512,OscarAlcala,,1,1,1,2
4513,OperativeSix,,1,5,4,9
4514,cartlidge,,1,2,6,8
4515,simplicity,,1,1,3,4
4516,wil2200,,1,770,784,1554
4517,theboone,,1,1,1,2
4518,Oshuma,,1,4,3,7
4519,Deinumite,,1,10,11,21
4520,stopping,,1,8,13,21
4521,mrpickles,,1,9,20,29
4522,anonymousy,,1,2,1,3
4523,bwoodall,,1,13,8,21
4524,DaDibbel,,1,371,903,1274
4525,joannavankovic,,1,1,1,2
4526,botnet,,1,12,23,35
4527,snarkyturtle,,1,125,92,217
4528,ars_moriendi,,1,60,48,108
4529,Holly_Golightly,,1,3,3,6
4530,ap0rnnstar,,1,4,4,8
4531,salpara,,1,147,167,314
4532,coroney,,1,2,2,4
4533,jblangworthy,,1,1,4,5
4534,Menagerie,,1,15,7,22
4535,joesb,,1,158,227,385
4536,sahaskatta,,1,1,1,2
4537,dart_throw,,1,2,1,3
4538,chillmandan,,1,142,166,308
4539,ArtStrom,,1,4,6,10
4540,weasel3d,,1,10,2,12
4541,KingofDerby,,1,37,59,96
4542,dannomac,,1,212,433,645
4543,cannedleech,,1,4,4,8
4544,tronbrain,,1,7,3,10
4545,fzfzfz,,1,67,119,186
4546,Bucketshred,,1,1,11,12
4547,ArabburnvictiM,,1,2,1,3
4548,SorryThereisnoGod,,1,2,2,4
4549,CoffeeandTV,,1,2,3,5
4550,Buddha24,,1,15,24,39
4551,die_asteroid_die,,1,1,1,2
4552,baddog76,,1,1,2,3
4553,ULJarad,,1,286,495,781
4554,mcscandalous,,1,26,1,27
4555,iosef,,1,5,3,8
4556,bonton_sean,,1,4,2,6
4557,troyjmorris,,1,1,4,5
4558,m_733,,1,84,111,195
4559,dawtcalm,,1,6,10,16
4560,rockhandsome,,1,1,12,13
4561,rottingflamingo,,1,2,2,4
4562,lostwolf,,1,11,45,56
4563,ntr0p3,,1,463,773,1236
4564,mmihevc,,1,2,2,4
4565,staxofmax,,1,15,21,36
4566,daemin,,1,91,64,155
4567,groutexpectations,,1,82,122,204
4568,felyduw,,1,8,3,11
4569,dougly,,1,56,92,148
4570,ModernDemagogue,,1,32,29,61
4571,SoPoOneO,,1,114,134,248
4572,Longabow,,1,2,1,3
4573,bit_wise,,1,3,1,4
4574,jimbelk,,1,6,4,10
4575,srilankan,,1,1,3,4
4576,lolhatz,,1,14,21,35
4577,moritsch,,1,1,2,3
4578,voldern,,1,1,2,3
4579,cantitoe,,1,29,41,70
4580,Mantraa,,1,2,2,4
4581,dikanst,,1,1,1,2
4582,pimo74,,1,22,35,57
4583,Harfatum,,1,2,4,6
4584,herorev,,1,17,26,43
4585,Mueritzer,,1,1,2,3
4586,Spazbot,,1,4,2,6
4587,locriology,,1,234,306,540
4588,formerfatguy,,1,3,9,12
4589,SylvanusUrban,,1,4,1,5
4590,boyan100,,1,6,5,11
4591,kathynic,,1,24,2,26
4592,Grapes,,1,33,9,42
4593,swimerman,,1,51,36,87
4594,interknot,,1,10,7,17
4595,ponchoboy,,1,133,159,292
4596,delta4zero,,1,105,195,300
4597,pusherforward,,1,1,5,6
4598,gonzone,,1,15,30,45
4599,cornerbodega,,1,3,4,7
4600,Pluth,,1,41,56,97
4601,croco,,1,3,6,9
4602,waterhammer,,1,1,2,3
4603,Synoptix,,1,175,229,404
4604,thor52879,,1,1,3,4
4605,mattsilv,,1,91,14,105
4606,chockZ,,1,7,8,15
4607,Flys007,,1,2,5,7
4608,salmangz,,1,2,2,4
4609,xwrxwrxwr,,1,3,1,4
4610,thepeopleschoice,,1,1,1,2
4611,gauthier,,1,2,8,10
4612,HumorousRebel,,1,21,32,53
4613,mhud,,1,5,2,7
4614,tsteele93,,1,2903,2195,5098
4615,jabjoe,,1,27,26,53
4616,bnardone,,1,15,16,31
4617,kommandarskye,,1,1,2,3
4618,glymor,,1,1,2,3
4619,sedaak,,1,47,80,127
4620,Wirehed,,1,67,88,155
4621,tomparker1,,1,2,1,3
4622,bananapeel,,1,100,180,280
4623,hongnanhai,,1,815,810,1625
4624,Count_Duccula,,1,2,7,9
4625,BinaryNinja,,1,15,23,38
4626,alsiu86,,1,1,1,2
4627,soporifery,,1,2,3,5
4628,Jarrod,,1,8,14,22
4629,MasterBob,,1,19,28,47
4630,snoaj,,1,8,24,32
4631,TheRiff,,1,398,785,1183
4632,spartanlonewolf,,1,6,9,15
4633,newsoracle,,1,1,1,2
4634,bd01177922,,1,4,10,14
4635,OddQuestionGirl,,1,86,59,145
4636,mharkness7,,1,1,2,3
4637,jfire6,,1,36,6,42
4638,Hupfinsgack,,1,6,6,12
4639,kreygD,,1,3,5,8
4640,sableenees,,1,25,35,60
4641,Parvan,,1,4,5,9
4642,wowthatscool,,1,1,1,2
4643,vsl,,1,160,247,407
4644,Jottor,,1,10,28,38
4645,astrange,,1,128,105,233
4646,graham_king,,1,40,3,43
4647,bobsmithhome,,1,9,37,46
4648,SenecaDoane,,1,73,98,171
4649,Mgapany,,1,43,30,73
4650,Kamekoozie,,1,31,123,154
4651,wu-wei,,1,6,9,15
4652,Godwin_wins,,1,16,13,29
4653,AliLaPointeTexasii,,1,2,3,5
4654,uberjohn,,1,1,1,2
4655,sandking,,1,22,21,43
4656,ncr100,,1,9,19,28
4657,nollem,,1,3,5,8
4658,dwarry,,1,3,3,6
4659,Isvara,,1,284,219,503
4660,rgarf,,1,91,12,103
4661,bijoy,,1,4,1,5
4662,schlag,,1,48,147,195
4663,unjust,,1,54,94,148
4664,michaelscott2,,1,1,1,2
4665,wolface,,1,9,7,16
4666,joshmaker,,1,1,4,5
4667,EnderMB,,1,28,18,46
4668,aspenbaloo,,1,24,63,87
4669,oduska,,1,110,93,203
4670,dmel4483,,1,9,6,15
4671,crankheckler,,1,5,6,11
4672,gIowingsheep,,1,436,53,489
4673,daveos,,1,3,3,6
4674,Cpunks,,1,4,8,12
4675,daguruvjt,,1,1,1,2
4676,fffish,,1,5,23,28
4677,biomedtechnology,,1,10,8,18
4678,suicidaldonut,,1,9,5,14
4679,toolee,,1,5,4,9
4680,covertcracker,,1,10,8,18
4681,Anti-Hippy,,1,23,3,26
4682,Yage2006,,1,7,27,34
4683,technomadic,,1,6,10,16
4684,misinterpreter,,1,2,5,7
4685,pmn8441,,1,152,158,310
4686,andrewry,,1,11,14,25
4687,v8engine,,1,2,1,3
4688,airlung,,1,2,3,5
4689,skipunk,,1,3,3,6
4690,setec_astronomy,,1,15,14,29
4691,mrgrieves,,1,2,2,4
4692,shining_fountain,,1,2,14,16
4693,cdimino,,1,3,6,9
4694,miamibfly,,1,1,1,2
4695,Call_For_Peace,,1,7,5,12
4696,Andrekosumn,,1,2,1,3
4697,JxE,,1,2,6,8
4698,GraphPaper,,1,2,1,3
4699,monkeu,,1,12,25,37
4700,cybernytrix,,1,8,11,19
4701,bobbymcgill,,1,10,1,11
4702,rzm61,,1,61,99,160
4703,nigy,,1,209,298,507
4704,nemof,,1,66,86,152
4705,sisternovena,,1,31,38,69
4706,Digger123,,1,66,97,163
4707,firefly5683,,1,202,137,339
4708,bschroed,,1,1,3,4
4709,asianavenger,,1,6,1,7
4710,boo27,,1,16,24,40
4711,cfvgcfvg,,1,136,150,286
4712,ynyny,,1,1,1,2
4713,bubba_mudd,,1,49,9,58
4714,Joyfuldemise,,1,8,14,22
4715,agentsully,,1,1,3,4
4716,AngelDustnBones,,1,3,6,9
4717,wiuara,,1,1,1,2
4718,GeeYouEye,,1,35,26,61
4719,cashto,,1,53,58,111
4720,fatcatholic,,1,66,91,157
4721,elendur,,1,1,1,2
4722,knexfreak111,,1,2,1,3
4723,pomerpants,,1,6,2,8
4724,BradDoenges,,1,1,1,2
4725,atheken,,1,14,28,42
4726,moredown,,1,21,4,25
4727,bonniejeanne,,1,9,4,13
4728,codeforkjeff,,1,2,1,3
4729,RedditAllMaker,,1,9,2,11
4730,Kiro,,1,7,14,21
4731,pediculus,,1,13,38,51
4732,ghyspran,,1,2,3,5
4733,spook327,,1,3,1,4
4734,jwk147,,1,1,3,4
4735,total_bruce,,1,8,2,10
4736,teamhot,,1,4,10,14
4737,rexo,,1,2,1,3
4738,MattL920,,1,53,81,134
4739,Metalwarrior,,1,29,8,37
4740,HappyEngineer,,1,17,36,53
4741,weemeglet,,1,10,15,25
4742,tthomps,,1,3,4,7
4743,he11odave,,1,5,8,13
4744,in_vitro,,1,13,33,46
4745,CaptainG0705,,1,19,75,94
4746,Masteyan,,1,8,5,13
4747,plinkplonk,,1,27,11,38
4748,test-explorer,,1,1,3,4
4749,dweej1,,1,11,28,39
4750,elusion54,,1,1,1,2
4751,xsidekick409,,1,94,130,224
4752,jstevoh,,1,3,1,4
4753,Rhoomba,,1,305,369,674
4754,airmas,,1,69,2,71
4755,insert_name,,1,7,13,20
4756,guither,,1,1,1,2
4757,Rude_Asshole,,1,14,9,23
4758,glasspenguin,,1,3,10,13
4759,heinrich66,,1,3,5,8
4760,cschaab,,1,5,10,15
4761,babblingdweeb,,1,14,33,47
4762,darkened,,1,242,153,395
4763,flibbertigibbit,,1,21,11,32
4764,seizureboy,,1,8,18,26
4765,Knots,,1,7,2,9
4766,scobro,,1,2,2,4
4767,random_comment,,1,1,1,2
4768,jayrot,,1,14,14,28
4769,ungood,,1,384,542,926
4770,rebelrogue995,,1,84,154,238
4771,pinkpackrat,,1,1,6,7
4772,nothingcool,,1,6,21,27
4773,stw,,1,21,20,41
4774,servertyp,,1,3,3,6
4775,davega7,,1,261,366,627
4776,chihsuanmen,,1,55,54,109
4777,SurrealEstate,,1,55,46,101
4778,dr_deep_sheet,,1,5,4,9
4779,cheenius,,1,3,1,4
4780,timestryder,,1,1,1,2
4781,MrFrankly,,1,102,90,192
4782,pretz,,1,62,114,176
4783,veganroofer,,1,1,1,2
4784,mokiligon,,1,1,1,2
4785,ux11,,1,1,2,3
4786,ThinkBeforeYouDie,,1,53,74,127
4787,xoomac,,1,3,1,4
4788,JoeFuckingSixPack,,1,1,3,4
4789,WhirlingVortex,,1,1081,59,1140
4790,evrae,,1,372,548,920
4791,codahale,,1,17,29,46
4792,MachoManRandySavage,,1,1,1,2
4793,creamyBasil,,1,37,4,41
4794,fivex,,1,2,2,4
4795,neogoblin,,1,21,20,41
4796,brodel2,,1,2,3,5
4797,Psy-Kosh,,1,475,883,1358
4798,jinsing,,1,4,9,13
4799,NewAmericanInsurgent,,1,4,5,9
4800,crimemastergogo,,1,2,4,6
4801,j3ffy,,1,13,3,16
4802,dkinmn,,1,252,376,628
4803,tardmrr,,1,17,14,31
4804,MaximumBob,,1,492,794,1286
4805,wicked82,,1,2,2,4
4806,leadera,,1,6,6,12
4807,erik_goldman,,1,3,3,6
4808,oxryly,,1,23,40,63
4809,yearone,,1,1,1,2
4810,cryforfiji,,1,37,31,68
4811,EDubs83,,1,45,32,77
4812,lucasrfl,,1,13,20,33
4813,boxofrain,,1,429,206,635
4814,wizalt,,1,1,1,2
4815,acey,,1,13,23,36
4816,thebamoor,,1,77,89,166
4817,oohay_email2004,,1,14,3,17
4818,stevepark,,1,2,1,3
4819,Buzz-Killington,,1,1,4,5
4820,quack,,1,503,805,1308
4821,LSDemon,,1,96,58,154
4822,Ibelieveitsbutter,,1,4,3,7
4823,jb3,,1,1,3,4
4824,Kaeinlya,,1,4,10,14
4825,grable,,1,18,35,53
4826,jzamor,,1,1,1,2
4827,bradspangler,,1,1,1,2
4828,qwertython,,1,10,18,28
4829,sigismundo,,1,5,8,13
4830,lazerdave,,1,42,46,88
4831,jeremy_spoken,,1,1,1,2
4832,phr,,1,2,5,7
4833,mikesmithie98,,1,3,4,7
4834,realityone,,1,4,4,8
4835,shamba,,4,11,6,17
4836,franck_B,,1,1,1,2
4837,vandelay,,1,2,3,5
4838,PirateMike,,1,5,9,14
4839,Dax420,,1,780,878,1658
4840,trencher,,1,4,4,8
4841,TheDizzleFoShizzle,,1,275,378,653
4842,jnicklas,,1,3,8,11
4843,Acrimonious,,1,1,6,7
4844,ommadon,,1,702,122,824
4845,bassvandijk,,1,1,2,3
4846,pedo,,1,5,4,9
4847,Canadianchris,,1,4,1,5
4848,katherineC,,1,1,3,4
4849,sanity,,1,108,56,164
4850,bryher1,,1,2,4,6
4851,bartwe,,1,95,113,208
4852,Cameroni,,1,1,4,5
4853,ffejnamhcab,,1,4,6,10
4854,pdecell,,1,1,3,4
4855,hypersonikk,,1,3,6,9
4856,ballagarba,,1,1,2,3
4857,letcha,,1,2,2,4
4858,KingOfFlan,,1,241,329,570
4859,pummer,,1,4,2,6
4860,ThirteenYearsOld,,1,1,1,2
4861,udha,,1,1,6,7
4862,rbackowski,,1,1,2,3
4863,banshee9s,,1,5,4,9
4864,CedricDaniels,,1,1,1,2
4865,lozierj,,1,80,92,172
4866,rossdub,,1,34,31,65
4867,mrz,,1,3,13,16
4868,yakyak,,1,144,53,197
4869,mekanicallyseperated,,1,111,202,313
4870,yutzish,,1,3,7,10
4871,greenwave87,,1,3,4,7
4872,eredhuin,,1,9,22,31
4873,pip3000,,1,49,39,88
4874,dikallman,,1,2,2,4
4875,mizer,,1,2,4,6
4876,gob,,1,37,80,117
4877,K1DUK,,1,15,23,38
4878,soooz,,1,1,1,2
4879,headfire,,1,165,259,424
4880,cdills,,1,55,91,146
4881,ShorttSirket,,1,39,29,68
4882,Shlufi,,1,19,16,35
4883,TWee,,1,5,2,7
4884,UglieJosh,,1,58,77,135
4885,GOJIMAN2012,,1,1,2,3
4886,jelos98,,1,1,1,2
4887,EtherGnat,,1,8,9,17
4888,kaoru77,,1,237,129,366
4889,cov,,1,574,891,1465
4890,Tranced0nline,,1,2,3,5
4891,henriq,,1,15,15,30
4892,ihatetotellyouthis,,1,1,1,2
4893,ff1959,,1,21,70,91
4894,uglypuppy,,1,1,1,2
4895,chemman,,1,8,2,10
4896,chipshot,,1,3,5,8
4897,antimatter3009,,1,26,38,64
4898,ellanana,,1,70,6,76
4899,nullgraph,,1,2,10,12
4900,FiReaNG3L,,1,93,9,102
4901,malibar,,1,3,3,6
4902,juicejuice,,1,1,1,2
4903,nasilyani,,1,1,2,3
4904,bertie_wooster,,1,33,39,72
4905,ehosca,,1,46,33,79
4906,bW9zc2Fk,,1,1,2,3
4907,Jason_Lee,,1,3,8,11
4908,wispygalaxy,,1,1,3,4
4909,wildjimbo,,1,102,16,118
4910,ayu_tsukimiya,,1,6,6,12
4911,delatiz,,1,158,11,169
4912,halcali,,1,1,2,3
4913,robu,,1,2,2,4
4914,zhezhijian,,1,6,5,11
4915,clark_kent,,1,4,6,10
4916,neandertal,,1,108,89,197
4917,anime_wars,,1,16,26,42
4918,protarchus,,1,14,13,27
4919,ThriftRomantic,,1,36,3,39
4920,highonzovirax,,1,16,34,50
4921,willjohnston,,1,693,48,741
4922,texascrow,,1,7,7,14
4923,pizi,,1,2,4,6
4924,pdileepa,,1,11,8,19
4925,Schooley02,,1,4,2,6
4926,sgtslut,,1,1,1,2
4927,nickieblue,,3,1,4,5
4928,w4y,,1,6,6,12
4929,monday,,1,19,50,69
4930,reveller,,1,63,98,161
4931,uselessdegree,,1,7,14,21
4932,ferrel,,1,2,2,4
4933,peteberg,,1,127,19,146
4934,gordigor,,1,5,11,16
4935,parker,,1,17,30,47
4936,hen,,1,153,61,214
4937,phillyLA,,1,97,22,119
4938,barake,,1,16,16,32
4939,ttfkam,,1,9,1,10
4940,HankWilliamsJr,,1,2,4,6
4941,diggensack,,1,1,3,4
4942,therunningcrow,,1,2,5,7
4943,anupakkihal,,1,485,78,563
4944,wow0088,,1,1,1,2
4945,Hume77,,1,2,1,3
4946,Bustachai,,1,3,2,5
4947,PacketScan,,1,61,145,206
4948,jdani,,1,5,11,16
4949,Schmallon,,1,4,6,10
4950,ogrechow,,1,14,9,23
4951,scubasteve377,,1,279,342,621
4952,tyrionlannister,,1,35,74,109
4953,PlatonicPimp,,1,303,496,799
4954,revealeddeception,,1,4,2,6
4955,blank89,,1,34,82,116
4956,aniya,,1,240,192,432
4957,soforth,,1,21,21,42
4958,wright3279,,1,2,1,3
4959,dacount,,1,10,21,31
4960,lordofsealand,,1,7,10,17
4961,idontwanttortfm,,1,15,34,49
4962,tyoungjr2005,,1,2,6,8
4963,ggypsy,,1,17,12,29
4964,SRB,,1,20,21,41
4965,darknyte,,1,10,11,21
4966,Yablan,,1,1,1,2
4967,gray_hat,,1,12,16,28
4968,iamprivate,,1,3,9,12
4969,dabradfo,,1,2,2,4
4970,insipid,,1,47,34,81
4971,mjferring,,1,9,4,13
4972,t1o0m,,1,7,6,13
4973,slickricks,,1,3,2,5
4974,rebolek,,1,30,58,88
4975,RPMiSO,,1,1,2,3
4976,ribsaregood,,1,24,2,26
4977,hamtastico,,1,1,1,2
4978,foolforlove,,1,6,4,10
4979,gawright,,1,5,3,8
4980,FaggyLiberalAss,,1,1,1,2
4981,shadowkeeper,,1,15,4,19
4982,AndTheHeroFai1s,,1,2,7,9
4983,Chryson,,1,20,21,41
4984,Alaric,,1,3,9,12
4985,ghostrunner,,1,4,3,7
4986,eloco,,1,26,29,55
4987,neptuno3,,1,11,15,26
4988,rucumu,,1,2,4,6
4989,eleete,,1,2,4,6
4990,JesusChrist,,1,9,10,19
4991,kablamo,,1,9,11,20
4992,uvaodu,,1,104,38,142
4993,NotPhil,,1,802,91,893
4994,csinser,,1,18,1,19
4995,techmoney,,1,31,41,72
4996,areyouforserious,,1,1,2,3
4997,jonesburg,,1,59,72,131
4998,orioleberd,,1,9,9,18
4999,degustisockpuppet,,1,136,137,273
5000,jimmydean,,1,3,6,9
5001,jerzguy,,1,3,4,7
5002,timewaves,,1,9,10,19
5003,sammysunset,,1,5,11,16
5004,NintendoNut,,1,3,2,5
5005,redditcredit,,1,1,1,2
5006,joejoe33,,1,7,7,14
5007,russelldb,,1,1,1,2
5008,blastradii,,1,66,34,100
5009,ezekiel,,1,73,147,220
5010,motdidr,,1,2,2,4
5011,mfaassen,,1,6,6,12
5012,RandomSuffix,,1,19,20,39
5013,beduinix,,1,9,17,26
5014,Creative_Username,,1,2,1,3
5015,thehigherlife,,1,23,48,71
5016,stevegebsta,,1,2,1,3
5017,name_withheld,,1,5,37,42
5018,toastah,,1,1,4,5
5019,cosmok,,1,2,4,6
5020,terkot,,1,1,3,4
5021,theont7,,1,3,1,4
5022,xyzabcd,,1,1,1,2
5023,kayabek,,1,1,1,2
5024,jcm267,,1,1,1,2
5025,cliffotn,,1,95,102,197
5026,AlSweigart,,1,96,66,162
5027,zombie_jesus,,1,1,3,4
5028,spi131313,,1,24,44,68
5029,mandaya,,1,10,17,27
5030,Mannex,,1,105,185,290
5031,Etropal,,1,29,21,50
5032,ketchuponmyketchup,,1,25,122,147
5033,ike6116,,1,100,106,206
5034,Wrathwilde,,1,82,44,126
5035,ferdinand,,1,374,623,997
5036,gwillyn,,1,15,17,32
5037,oblongski,,1,39,60,99
5038,kasser,,1,8,2,10
5039,dmalouf,,1,1,1,2
5040,psayre23,,1,8,6,14
5041,nkrasney,,1,3,2,5
5042,Eschew_Obfuscation,,1,11,18,29
5043,MacMan25,,1,1,1,2
5044,SAWOOL,,1,19,19,38
5045,JackDupp,,1,28,24,52
5046,corndog4,,1,10,18,28
5047,Nanite,,1,225,349,574
5048,somethinginteresting,,1,43,68,111
5049,RooflerOnTheFid,,1,10,33,43
5050,someguyorother,,1,1,1,2
5051,211_was_my_old_apt,,1,8,17,25
5052,lagerbhoy,,1,3,4,7
5053,Thatbul,,1,65,155,220
5054,stalin,,1,5,9,14
5055,Theantiloquax,,1,1,3,4
5056,br0ck,,1,2,6,8
5057,the_arpanet,,1,5,16,21
5058,henno,,1,6,6,12
5059,wikum,,1,33,21,54
5060,perverted_monk,,1,87,97,184
5061,ucslug,,1,5,12,17
5062,bubbagrub,,1,151,29,180
5063,afbase,,1,28,37,65
5064,archmichael,,1,14,27,41
5065,thegroom09,,1,1,4,5
5066,the_prey,,1,16,34,50
5067,shlinton,,1,26,28,54
5068,Skittilz,,1,21,38,59
5069,giga,,1,88,93,181
5070,Celtic_Toad,,1,5,16,21
5071,PossibleMat,,1,46,19,65
5072,howmuchmore,,1,87,145,232
5073,PongGod,,1,3,5,8
5074,Ateenager,,1,2,1,3
5075,father_of_svantuss,,1,2,1,3
5076,L320Y,,1,72,107,179
5077,eko23,,1,3,6,9
5078,TomOwens,,1,11,13,24
5079,ScrubbingBubbles,,1,1,1,2
5080,jinx81,,1,5,1,6
5081,bodo3000,,1,3,13,16
5082,sonorandragon,,1,3,3,6
5083,codyrioux,,1,6,6,12
5084,Merumeru,,1,3,7,10
5085,Sinusoid,,1,2,6,8
5086,Konradprojects,,1,1,3,4
5087,giunta13,,1,61,106,167
5088,johlstei,,1,9,11,20
5089,nebby,,1,9,12,21
5090,stevan_little,,1,30,26,56
5091,bastard_filling,,1,152,208,360
5092,younkint,,1,89,119,208
5093,vicoesco,,1,4,9,13
5094,megablast,,1,125,199,324
5095,ShardPhoenix,,1,5,5,10
5096,murdervillain,,1,51,2,53
5097,sdbillin,,1,7,8,15
5098,panuta,,1,1,13,14
5099,russellh,,1,188,324,512
5100,edwardkelly,,1,162,178,340
5101,neonnoodle,,1,98,166,264
5102,bobcats_mom,,1,1,1,2
5103,kibitzor,,1,69,105,174
5104,pxlpshr,,1,1,1,2
5105,tamarind,,1,1,7,8
5106,movi,,1,5,11,16
5107,acydlord,,1,8,12,20
5108,andyukguy,,1,32,42,74
5109,cos,,1,952,367,1319
5110,Routerbox,,1,12,21,33
5111,lusophiliac,,1,101,116,217
5112,xCooLMaN,,1,2,4,6
5113,professor_mc,,1,58,88,146
5114,Albuyeh,,1,108,33,141
5115,trevftw,,1,25,3,28
5116,Mobat555,,1,7,23,30
5117,cnildo,,1,1,7,8
5118,finallytalking,,1,2,1,3
5119,jrb,,1,109,186,295
5120,ImAGoddess,,1,1,3,4
5121,SwellJoe,,1,322,504,826
5122,dwchapin,,1,3,3,6
5123,cark,,1,11,9,20
5124,mjaviss,,1,5,6,11
5125,piplaw,,1,6,2,8
5126,bufsabre666,,1,61,136,197
5127,pepegg,,1,5,1,6
5128,dacat,,1,26,19,45
5129,Monkeyget,,1,230,99,329
5130,krartan,,1,7,9,16
5131,depleater,,1,224,357,581
5132,BenHicks,,1,1,1,2
5133,PaiTrakt,,1,60,23,83
5134,mosburger,,1,179,180,359
5135,mattmac1955,,1,3,6,9
5136,niobevulpes,,1,26,48,74
5137,vlcod,,1,126,8,134
5138,lerker,,1,4,2,6
5139,bobfunk,,1,2,4,6
5140,mabd,,1,61,113,174
5141,cafefort,,1,9,7,16
5142,PandemicSoul,,1,26,27,53
5143,workpost,,1,10,30,40
5144,Libcon,,1,14,1,15
5145,degalloman,,1,2,1,3
5146,wave_or_particle,,1,7,8,15
5147,joehoover,,1,1,1,2
5148,tims1979,,1,2,2,4
5149,20cc0,,1,1,7,8
5150,f4nt,,1,13,8,21
5151,ijkl,,1,33,23,56
5152,freddymusic,,1,1,1,2
5153,nimbo,,1,4,4,8
5154,TestForSarcoidosis,,1,1,4,5
5155,faassen,,1,25,39,64
5156,failsaurusrex,,1,8,16,24
5157,AstroZombieDC,,1,29,25,54
5158,Bill_OLiely,,1,5,4,9
5159,ADIDAS247,,1,59,50,109
5160,grubnasty,,1,2,5,7
5161,greenspikefrog,,1,10,38,48
5162,reverselookup,,1,100,183,283
5163,whineypdfuser,,1,4,2,6
5164,Chewbacca69,,1,9,17,26
5165,etty,,1,11,6,17
5166,mgorsuch,,1,20,6,26
5167,bmtri,,1,72,16,88
5168,interrobang,,1,2,2,4
5169,nothingtoseehere,,1,6,6,12
5170,tcgunner90,,1,8,6,14
5171,LazarusDubois,,1,98,143,241
5172,pwnerator,,1,1,2,3
5173,jeolmeun,,1,7,4,11
5174,MercyPolitics,,1,34,2,36
5175,slaizer,,1,60,57,117
5176,visualise,,1,4,5,9
5177,sutts,,1,2,2,4
5178,jonasb,,1,52,24,76
5179,massive_hair,,1,6,7,13
5180,Winkyboy,,1,2,6,8
5181,nemotux,,1,1,3,4
5182,BarrackObama,,1,1,1,2
5183,refreshthis,,1,79,86,165
5184,cloudwolf,,1,1,1,2
5185,niltermini,,1,57,60,117
5186,AAnastasio,,1,1,1,2
5187,tpaine,,1,3,3,6
5188,vanandrew,,1,15,18,33
5189,sbrown123,,1,342,438,780
5190,tozarslan,,1,4,4,8
5191,hotkurva,,1,11,12,23
5192,Kohonen,,1,18,12,30
5193,ialexi,,1,1,1,2
5194,kib,,1,22,16,38
5195,1000Steps,,1,232,346,578
5196,bigbadbrad,,1,7,9,16
5197,nathanaustralia,,1,27,6,33
5198,DrTom,,1,44,52,96
5199,MajorUnrelated,,1,1,3,4
5200,marknunney,,1,1,2,3
5201,OtherPointOfView,,1,23,15,38
5202,klhigg04,,1,1,1,2
5203,naturalethic,,1,24,62,86
5204,Mr_Confused,,1,6,9,15
5205,pbarmasher0,,1,63,23,86
5206,DpThought0,,1,11,14,25
5207,diggin01,,1,5,2,7
5208,amoebius,,1,11,24,35
5209,mummyhazelnut,,1,1,1,2
5210,reedsparks,,1,6,2,8
5211,ut2k4king,,1,10,14,24
5212,TheEnglishLanguage,,1,1,2,3
5213,_Pato,,1,1,3,4
5214,jimosa,,1,4,2,6
5215,clango,,1,101,21,122
5216,RichAromas,,1,13,26,39
5217,Boanerge,,1,6,8,14
5218,bosephus,,1,1,1,2
5219,S2S2S2S2S2,,1,634,265,899
5220,solarsavior,,1,96,137,233
5221,bstadil,,1,202,339,541
5222,W1GG1NS,,1,1,3,4
5223,aelfric,,1,3,9,12
5224,gmick,,1,742,1124,1866
5225,ubiformby,,1,1,1,2
5226,TheRandomGuy,,1,95,12,107
5227,parkerdaniel50,,1,1,1,2
5228,tigerinhouston,,1,2,5,7
5229,qrush,,1,285,5,290
5230,flange,,1,4,5,9
5231,thec,,1,7,10,17
5232,trains11tjc,,1,1,7,8
5233,datura22,,1,51,52,103
5234,busytigger,,1,489,742,1231
5235,david5678,,1,2,2,4
5236,slinky317,,1,438,536,974
5237,ch1ll1ng,,1,12,6,18
5238,gragland,,1,13,10,23
5239,hiimerik,,1,60,49,109
5240,skribe,,1,35,54,89
5241,pencilbox889,,1,4,4,8
5242,tokenbearcub,,1,33,40,73
5243,treets,,1,3,4,7
5244,silentOpen,,1,73,109,182
5245,mgilley,,1,4,9,13
5246,CLorinsky,,1,220,3,223
5247,cmdweb,,1,7,4,11
5248,Jees,,1,6,1,7
5249,aplusbi,,1,37,66,103
5250,djprince,,1,65,2,67
5251,baysiqq,,1,8,12,20
5252,up2nogud247,,1,1,1,2
5253,ramit,,1,10,8,18
5254,Disconnekted,,1,114,231,345
5255,kormgar,,1,5,7,12
5256,sohail_s,,1,5,6,11
5257,wergerver,,1,11,13,24
5258,DAS_DAS,,1,16,1,17
5259,goodbyejim,,1,72,77,149
5260,timbonicus,,1,11,10,21
5261,user5000,,1,8,4,12
5262,eldri,,1,19,17,36
5263,jaybol,,1,1022,127,1149
5264,jlroettger,,1,1,1,2
5265,one_shot_one_liberal,,1,2,1,3
5266,Tobyisspecial,,1,5,3,8
5267,BitterOldMan,,1,1,1,2
5268,scribe9999,,1,32,11,43
5269,RayWest,,1,463,694,1157
5270,magnus911,,1,8,4,12
5271,barichards,,1,29,43,72
5272,hellmarsh,,1,2,2,4
5273,dnp42,,1,21,28,49
5274,redditeering,,1,99,41,140
5275,liberal_one,,1,394,403,797
5276,chiwawamom,,1,42,49,91
5277,ishwarchand,,1,1,2,3
5278,erisdiscordia,,1,31,48,79
5279,craigalms,,1,3,7,10
5280,shd67,,1,22,17,39
5281,pal32,,1,6,6,12
5282,zappo,,1,78,10,88
5283,tarnin,,1,2,5,7
5284,captain_republican,,1,268,296,564
5285,Snappy386,,1,1,3,4
5286,godsgod,,1,1,2,3
5287,geneusutwerk,,1,23,25,48
5288,phoxybetsy,,1,24,4,28
5289,noconfidence,,1,3,3,6
5290,im_bozack,,1,4,6,10
5291,Stopher,,1,206,376,582
5292,christianwaton,,1,1,1,2
5293,maclure,,1,14,1,15
5294,shub,,1,474,687,1161
5295,bbbeans,,1,4,9,13
5296,gstuartj,,1,11,1,12
5297,USA_USuckAss,,1,2,2,4
5298,SinisterS2k,,1,1,1,2
5299,brhunter86,,1,2,1,3
5300,dlsmd,,1,4,5,9
5301,dustyfog,,1,61,11,72
5302,karl_max_is_my_hero,,1,2,2,4
5303,carpediem420,,1,47,26,73
5304,jankoM,,1,1,4,5
5305,alkasettheory,,1,1,1,2
5306,slippery,,1,9,6,15
5307,zombiekraken,,1,14,11,25
5308,harrydude,,1,28,35,63
5309,DestructiveDreaming,,1,86,42,128
5310,gc4life,,1,18,39,57
5311,suroburo,,1,2,3,5
5312,criminy,,1,97,181,278
5313,gth757e,,1,1,5,6
5314,inseptiv,,1,18,20,38
5315,lampiaio,,1,50,40,90
5316,Dirtstar,,1,15,24,39
5317,marilinda,,1,4,1,5
5318,gdmedia,,1,3,1,4
5319,instantdm,,1,52,41,93
5320,mrgordon,,1,3,4,7
5321,rimberry,,1,20,8,28
5322,kwismexer,,1,36,69,105
5323,fortybillion,,1,9,2,11
5324,jpzanetti,,1,202,71,273
5325,typical_american,,1,6,7,13
5326,bad_code,,1,12,12,24
5327,al_islaaaaaaaaaaaaam,,1,4,9,13
5328,gusza,,1,2,1,3
5329,sennii,,1,32,26,58
5330,spreri,,1,43,56,99
5331,Raidion,,1,42,49,91
5332,LostAbbott,,1,5,5,10
5333,davidlwdn,,1,1,8,9
5334,sniggins,,1,2,3,5
5335,syadasti,,1,28,25,53
5336,Sarcasticus,,1,11,6,17
5337,NoDude,,1,2,3,5
5338,xplrr,,1,3,11,14
5339,jackystan,,1,4,3,7
5340,lasvegasgamer,,1,1,2,3
5341,bitslayer,,1,21,25,46
5342,Bobsickle,,1,25,42,67
5343,seuhipocrita,,1,16,1,17
5344,iidestined,,1,4,16,20
5345,Gradius,,1,31,2,33
5346,ZEYTIN22,,1,1,1,2
5347,jasonmacs,,1,82,74,156
5348,zeteo,,1,48,22,70
5349,ztphn,,1,18,22,40
5350,chinger,,1,1,3,4
5351,ashibby86,,1,1,2,3
5352,Deoz,,1,1,1,2
5353,IhaveAIDS,,1,1,1,2
5354,Arawyn,,1,1,2,3
5355,iraq_vet,,1,2,1,3
5356,eclipsedev,,1,10,12,22
5357,p4c,,1,1,3,4
5358,threedian,,1,3,3,6
5359,qwe1234_,,1,1,1,2
5360,qulic68,,1,1,1,2
5361,mordred,,1,13,9,22
5362,academician,,1,105,139,244
5363,killick,,1,61,97,158
5364,spamdefender,,1,554,434,988
5365,graveler,,1,2,5,7
5366,j_johnso,,1,15,21,36
5367,ThirstyEar2,,1,7,6,13
5368,grow4road,,1,13,36,49
5369,jkeele9a,,1,1,1,2
5370,awice,,1,7,4,11
5371,BohmaJenkins,,1,13,10,23
5372,rigga,,1,2,2,4
5373,llm2010,,1,1,2,3
5374,Bigsby,,1,4,6,10
5375,johnw11,,1,1,2,3
5376,AlbinoOrangutan,,1,2,2,4
5377,slyf,,1,69,122,191
5378,Mariani,,1,15,16,31
5379,azzdafff,,1,1,4,5
5380,Stiltskins,,1,4,13,17
5381,C9H13NO3,,1,72,9,81
5382,magus,,1,1,2,3
5383,98493484,,1,1,2,3
5384,sep11insidejob,,1,55,75,130
5385,jvburnes,,1,1,5,6
5386,petdog,,1,3,3,6
5387,shilabula,,1,79,75,154
5388,forumdragon,,1,2,4,6
5389,astrab,,1,1,1,2
5390,FirthOfFifth,,1,1,1,2
5391,encinarus,,1,285,377,662
5392,cti97,,1,3,1,4
5393,maleman,,1,25,23,48
5394,avip,,1,44,47,91
5395,annaswims,,1,18,4,22
5396,puggydug,,1,140,95,235
5397,jamesgreddit,,1,96,122,218
5398,dinky51525,,1,1,2,3
5399,prostoalex,,1,1,2,3
5400,mahill55,,1,27,32,59
5401,paltal,,1,1,1,2
5402,dualboy24,,1,12,6,18
5403,devpopol,,1,1,2,3
5404,letoatreides,,1,36,41,77
5405,Decumanus,,1,26,92,118
5406,jsilvrs,,1,19,6,25
5407,Andareed,,1,99,109,208
5408,todalimitbaby,,1,31,13,44
5409,teambob,,1,46,102,148
5410,badwithnames,,1,5,5,10
5411,kimbokasteniv,,1,10,9,19
5412,tolley,,1,21,4,25
5413,nhuong,,1,3,8,11
5414,twb010,,1,3,8,11
5415,izend,,1,110,78,188
5416,bglodde,,1,207,87,294
5417,__init__,,1,1,1,2
5418,brain3000,,1,1,1,2
5419,RebuildHim,,1,97,40,137
5420,NoSex,,1,226,136,362
5421,jekpopulous,,1,93,2,95
5422,fulmar,,1,58,98,156
5423,madmaxpt,,1,4,17,21
5424,aelron,,1,13,4,17
5425,cyclo,,1,105,15,120
5426,reddit_hates_women,,1,3,11,14
5427,localhorst,,1,277,137,414
5428,ElJabbo,,1,1,1,2
5429,amorangi,,1,20,30,50
5430,bobbincygna,,1,168,199,367
5431,shadowvox,,1,30,24,54
5432,eidetic3d,,1,5,13,18
5433,skyhaseyes,,1,33,1,34
5434,Cousin_Dupree,,1,6,8,14
5435,jc_mizzle,,1,7,9,16
5436,tjic,,1,25,10,35
5437,dystopian,,1,46,49,95
5438,munroe,,1,24,5,29
5439,pathogenix,,1,8,9,17
5440,moxierain,,1,5,13,18
5441,SpencerH99,,1,1,1,2
5442,ctrl_alt_del,,1,1,5,6
5443,kungfoomaster,,1,17,12,29
5444,sunra,,1,3,8,11
5445,sanitz,,1,1,2,3
5446,tiffany43,,1,3,12,15
5447,TigerDelta,,1,3,2,5
5448,nas5755,,1,19,52,71
5449,tenmuses,,1,9,14,23
5450,femol,,1,2,5,7
5451,4rashi,,1,55,59,114
5452,wyoming_1,,1,7,5,12
5453,Apfelkuchen,,1,4,6,10
5454,pyrrhus,,1,9,14,23
5455,hypnopixel,,1,8,35,43
5456,somimi,,1,1,3,4
5457,What_In_Hell,,1,3,2,5
5458,pinkLady80,,1,2,7,9
5459,hethug,,1,2,4,6
5460,PumpkinSeed,,1,4,4,8
5461,m64,,1,2,3,5
5462,Axle,,1,11,10,21
5463,kerbz,,1,2,2,4
5464,BuddyHOL,,1,80,52,132
5465,amttaylor,,1,5,7,12
5466,arabelladragon,,1,4,6,10
5467,scottandrewstevens,,1,3,3,6
5468,myhazeispurple,,1,2,1,3
5469,moogah,,1,71,111,182
5470,jesperht,,1,15,5,20
5471,hopelessromanticwuss,,1,1,1,2
5472,thatrez,,1,21,57,78
5473,rgrasell,,1,3,3,6
5474,username-explainer,,1,1,1,2
5475,bluehatrider,,1,7,9,16
5476,ChicagoMemoria,,1,238,234,472
5477,towlies,,1,10,4,14
5478,tressapos,,1,39,22,61
5479,Langhorne,,1,1,1,2
5480,Sammzor,,1,36,75,111
5481,HelveticaScenario,,1,41,68,109
5482,diziaka,,1,2,1,3
5483,frozenmelon,,1,1,1,2
5484,willbently,,1,5,4,9
5485,sjmooreviking,,1,2,8,10
5486,kiznik,,1,173,234,407
5487,china_rider,,1,1,2,3
5488,avizoa,,1,1,1,2
5489,Ma-aKheru,,1,191,464,655
5490,KennyFulgencio,,1,168,286,454
5491,jezuzgirl,,1,5,1,6
5492,unheeding,,1,157,128,285
5493,Nobodyatall,,1,11,19,30
5494,CIAguy,,1,1,2,3
5495,teebes,,1,2,2,4
5496,tekronis,,1,76,161,237
5497,Wykyd,,1,1,1,2
5498,rrwhite,,1,3,1,4
5499,zcmack,,1,12,20,32
5500,mfp,,1,138,134,272
5501,ercd,,1,7,6,13
5502,spiderbite7,,1,10,12,22
5503,rzn,,1,2,1,3
5504,forceinstall,,1,1,1,2
5505,pinkbean,,1,1,4,5
5506,dezmd,,1,152,224,376
5507,lmfrey,,1,1,3,4
5508,jjjjjjjjjjjjk,,1,1,2,3
5509,BobCFC,,1,6,11,17
5510,freedomgeek,,1,1,2,3
5511,superm0nkey,,1,28,1,29
5512,SecretCommentator,,1,1,1,2
5513,rainbird997,,1,2,1,3
5514,somefool,,1,2,5,7
5515,walruteer,,1,78,71,149
5516,tuckerjohn,,1,3,2,5
5517,vailripper,,1,16,24,40
5518,jophillips,,1,63,2,65
5519,lang_war,,1,6,5,11
5520,nontoxyc,,1,5,5,10
5521,OtisDElevator,,1,2,9,11
5522,shemper,,1,1,1,2
5523,lipservisceral,,1,1,1,2
5524,Luc,,1,57,70,127
5525,dollars-and-skulls,,1,2,3,5
5526,Chlorophil,,1,9,26,35
5527,stoptrackingme,,1,1,2,3
5528,rc79wa,,1,4,9,13
5529,robstercraw,,1,2,4,6
5530,TehMCP,,1,16,32,48
5531,mjs,,1,3,6,9
5532,jack47,,1,103,69,172
5533,poozoodle,,1,12,25,37
5534,wolever,,1,6,6,12
5535,forps,,1,1,1,2
5536,cptnjack,,1,26,18,44
5537,slutbanger,,1,45,5,50
5538,motley2,,1,1,1,2
5539,BHazell,,1,874,29,903
5540,Avrumales,,1,12,7,19
5541,jaxcs,,1,90,152,242
5542,cattleprod,,1,1,2,3
5543,FancyClancy,,1,3,3,6
5544,robert2cane,,1,278,1,279
5545,sigint_bn,,1,28,65,93
5546,anothernut,,1,5,6,11
5547,zboyet,,1,1,3,4
5548,chanster,,1,82,16,98
5549,mitchwright,,1,10,47,57
5550,cc138,,1,2,7,9
5551,swrlyhrly,,1,48,90,138
5552,ChennehCis,,1,1,2,3
5553,nosound,,1,29,13,42
5554,blpatt,,1,1,2,3
5555,likeafox,,1,55,72,127
5556,rugs,,1,18,34,52
5557,nitropumpkin,,1,8,11,19
5558,jpezzznuts,,1,23,16,39
5559,cracki,,1,194,327,521
5560,JoeSick,,1,21,42,63
5561,xwigginx,,1,33,42,75
5562,JeffBuzz,,1,28,7,35
5563,sanampetri,,1,329,8,337
5564,assfloss,,1,1,3,4
5565,TR4CKS,,1,22,6,28
5566,moetwa,,1,507,26,533
5567,ladoladi,,1,1,2,3
5568,gershom45,,1,2,3,5
5569,ParadoxRoom,,1,2,3,5
5570,johnnydough,,1,29,31,60
5571,nccwarp9,,1,10,21,31
5572,Davec_15,,3,1,1,2
5573,MoreKindUS,,1,103,79,182
5574,sjbach,,1,43,14,57
5575,street-knowledge,,1,63,120,183
5576,PlutoISaPlanet,,1,94,130,224
5577,bob_gnarley,,1,2,1,3
5578,TuttiFrutti,,1,92,173,265
5579,pjbarnoy,,1,14,19,33
5580,severedbrain,,1,2,2,4
5581,Jillish,,1,12,13,25
5582,daft_monk,,1,76,129,205
5583,rogersm,,1,10,14,24
5584,shanker,,1,1,2,3
5585,undecidedname,,1,2,1,3
5586,texasbuddha,,1,4,2,6
5587,redpill911,,1,2,1,3
5588,professorOak,,1,21,8,29
5589,vints1,,1,65,74,139
5590,leddit666,,1,3,15,18
5591,crepia400,,1,1,1,2
5592,letoti,,1,194,66,260
5593,Cid_X,,1,2,1,3
5594,pref,,1,141,71,212
5595,wakeupsheeeple,,1,2,1,3
5596,areyoukiddingme,,1,1,1,2
5597,pufuwozu,,1,1,1,2
5598,pahina1,,1,13,22,35
5599,betrayedamericanvet,,1,21,63,84
5600,haywire9000,,1,176,182,358
5601,Kijamon,,1,172,182,354
5602,thelimabeanking,,1,90,90,180
5603,VerticalWindows,,1,5,7,12
5604,crazedover1111,,1,56,50,106
5605,edstace,,1,6,1,7
5606,matthiasl,,1,3,2,5
5607,stekkit,,1,1,3,4
5608,svat,,1,1,1,2
5609,hellobot,,1,11,14,25
5610,paulrbrown,,1,12,22,34
5611,scaz7,,1,2,15,17
5612,AlfHimself,,1,13,19,32
5613,MrTulip,,1,108,150,258
5614,Brachinus,,1,63,20,83
5615,SoWhatYoureSayingIs,,1,32,46,78
5616,erudition,,1,19,44,63
5617,elustran,,1,130,211,341
5618,ntrifunovic,,1,8,13,21
5619,tripcomputer,,1,6,5,11
5620,gassit,,1,86,56,142
5621,council,,1,1,4,5
5622,dfreir1,,1,22,7,29
5623,obytorno,,1,1,2,3
5624,PSUBreno,,1,38,49,87
5625,janeair,,1,26,5,31
5626,supremesonic,,1,81,20,101
5627,kalphegor,,1,17,27,44
5628,sentienceISi,,1,28,21,49
5629,jello_b,,1,128,104,232
5630,philosophize,,1,53,1,54
5631,Tigrael,,1,57,94,151
5632,jpfed,,1,88,120,208
5633,phutro,,1,5,16,21
5634,kerwinste,,1,197,20,217
5635,Scarker,,1,1498,1073,2571
5636,samtregar,,1,10,13,23
5637,inthewater,,1,124,110,234
5638,DeviousOne,,1,45,44,89
5639,volcano420,,1,6,7,13
5640,Brincuckoo,,1,1,1,2
5641,CheeseBurgerInACan,,1,5,7,12
5642,sjain,,1,11,23,34
5643,bigday,,1,1,1,2
5644,danecookfan,,1,11,11,22
5645,glokoe,,1,2,2,4
5646,praestovito,,1,191,345,536
5647,jippiejee,,1,1,11,12
5648,annevk,,1,4,3,7
5649,bwanab,,1,19,34,53
5650,maing,,1,246,9,255
5651,tinhat,,1,311,691,1002
5652,reddit_clone,,1,34,50,84
5653,feedmec00kies,,1,86,111,197
5654,spanishjonny,,1,10,14,24
5655,wwcory,,1,14,37,51
5656,abelsson,,1,23,11,34
5657,killermathilda,,1,2,6,8
5658,vanislander,,1,33,80,113
5659,greyamal,,1,1,2,3
5660,Foozie,,1,1,1,2
5661,Ummagumma,,1,45,64,109
5662,skullheadbonyhands,,1,1,1,2
5663,pamlyn,,1,1,1,2
5664,dlgtho,,1,4,6,10
5665,indylarry,,1,1,2,3
5666,Buzz_Light,,1,4,9,13
5667,mchoward,,1,23,9,32
5668,ultrafusion,,1,6,16,22
5669,beatles910,,1,6,5,11
5670,philmoskowitz,,1,227,418,645
5671,shervster,,1,2,5,7
5672,mackpayson,,1,23,94,117
5673,bboarder12_,,1,23,34,57
5674,CaspianX2,,1,378,472,850
5675,brucehoult,,1,39,57,96
5676,coda,,1,6,1,7
5677,judofyr,,1,77,70,147
5678,RSNV,,1,6,1,7
5679,snth,,1,1,1,2
5680,rattenmaus,,1,94,162,256
5681,houstonray,,1,1,1,2
5682,babblingpoet,,1,752,158,910
5683,familyguy,,1,4,1,5
5684,trengbu,,1,20,28,48
5685,aoper,,1,56,103,159
5686,ANSICL,,1,218,201,419
5687,crazy_chris,,1,6,8,14
5688,Soesoe,,1,40,27,67
5689,I-earned-that-money,,1,1,1,2
5690,maky29,,1,14,3,17
5691,lionheart,,1,41,9,50
5692,melanarchy,,1,5,3,8
5693,jason007,,1,1,1,2
5694,yoyank34,,1,1,2,3
5695,ohemgee,,1,8,5,13
5696,pronto185,,1,33,21,54
5697,Gary_Burke,,1,1,1,2
5698,Swan_Writes,,1,150,313,463
5699,owlmanatt,,1,214,253,467
5700,hectorguerra,,1,11,13,24
5701,mawdsquad,,1,2,2,4
5702,0maha,,1,9,10,19
5703,bdogm,,1,7,19,26
5704,JQT,,1,66,52,118
5705,playdead,,1,1,2,3
5706,evilpego,,1,2,4,6
5707,phlosys,,1,1,1,2
5708,blindscouse,,1,1,2,3
5709,ClintPhelps,,1,7,18,25
5710,BustaCsuk,,1,2,2,4
5711,tiffanychloe,,1,1,6,7
5712,rodditor,,1,1,2,3
5713,dudenell,,1,38,71,109
5714,Matr1xAgent,,1,2,3,5
5715,PinkEye,,1,1,3,4
5716,jennicamorel,,1,554,511,1065
5717,machim,,1,5,3,8
5718,JollyGreens,,1,3,11,14
5719,matthias_georgi,,1,24,33,57
5720,jicima71,,1,1,2,3
5721,joefritz,,1,3,10,13
5722,shazzmak,,1,6,15,21
5723,justicewalks,,1,2,2,4
5724,IlyaM,,1,2,1,3
5725,ndiin,,1,93,200,293
5726,markayler,,1,8,5,13
5727,pandadude,,1,4,1,5
5728,cursor,,1,33,1,34
5729,hazri,,1,12,6,18
5730,rhutchison,,2,5,3,8
5731,ChristianAAJ,,1,2,3,5
5732,johnptg,,1,9,14,23
5733,DaiTengu,,1,2,2,4
5734,avacadojessica,,1,1,2,3
5735,Joshsmac,,1,1,1,2
5736,jumbox,,1,54,79,133
5737,ccx,,1,1,1,2
5738,HotHead,,1,7,3,10
5739,LeviTheSmith,,1,2,1,3
5740,sakipooh,,1,7,22,29
5741,praptak,,1,27,40,67
5742,teadrinker,,1,287,392,679
5743,apogeerstarr,,1,1,4,5
5744,millerlogic,,1,4,8,12
5745,gravaton,,1,14,6,20
5746,mikelgan,,1,18,2,20
5747,freakie,,1,6,7,13
5748,deblock306,,1,1,2,3
5749,zecg,,1,251,276,527
5750,dhl,,1,1,2,3
5751,kegie,,1,5,7,12
5752,ABA477,,1,1,2,3
5753,didnthaveachoice,,1,5,4,9
5754,dchestnykh,,1,69,51,120
5755,needsmorecoffee,,1,114,22,136
5756,hyperbolic,,1,401,535,936
5757,Nakken,,1,19,78,97
5758,stevovee,,1,3,1,4
5759,NickVenture,,1,41,53,94
5760,LordHumongous,,1,19,25,44
5761,Abovethelaw,,1,2,2,4
5762,powerfulninja,,1,13,5,18
5763,Reddit_Admin,,1,2,1,3
5764,petrichor,,1,18,8,26
5765,GUBBED_AGAIN,,1,17,13,30
5766,NorthernLights,,1,1317,1,1318
5767,Erator,,1,7,15,22
5768,OneArmJack,,1,67,26,93
5769,jjj_nnn_jjj,,1,1,1,2
5770,fifitrixiebelle,,1,1,2,3
5771,mconrace,,1,9,22,31
5772,chocosebuenos,,1,15,22,37
5773,jsample2012,,1,3,17,20
5774,papalmonkey,,1,20,16,36
5775,VisVirtusque,,1,223,179,402
5776,dothebackstab,,1,1,1,2
5777,desqjockey,,1,64,133,197
5778,wellhellothere,,1,5,5,10
5779,ajturner,,1,2,1,3
5780,rokusan,,1,69,94,163
5781,mantasradzas,,1,7,5,12
5782,pseudonymous,,1,35,23,58
5783,scrimsims,,1,5,9,14
5784,petahi,,1,69,22,91
5785,poutine,,1,24,32,56
5786,khslinky,,1,1,1,2
5787,_MrBabyMan_,,1,1,1,2
5788,hyperizer,,1,3,2,5
5789,paulite,,1,1,2,3
5790,babesh,,1,4,8,12
5791,emarus,,1,69,122,191
5792,chalengr,,1,7,5,12
5793,foxxyb069,,1,1,2,3
5794,tpearl,,1,12,7,19
5795,pySSK,,1,14,11,25
5796,NoMerican,,1,6,6,12
5797,toconnell,,1,2,2,4
5798,Araneidae,,1,2,10,12
5799,vilkacis,,1,3,2,5
5800,Browzer,,1,257,155,412
5801,Jantar,,1,310,131,441
5802,EvilPigeon,,1,376,660,1036
5803,paul57,,1,2,2,4
5804,zspecs,,1,26,6,32
5805,mikicg,,1,185,11,196
5806,rotty81,,1,5,7,12
5807,sundiverdb,,1,4,3,7
5808,jcsickz,,1,6,3,9
5809,emilyq,,1,3,5,8
5810,jrembold,,1,1,2,3
5811,reenigne,,1,45,63,108
5812,steilpass,,1,1,1,2
5813,runamok,,1,129,180,309
5814,hueyplong,,1,7,19,26
5815,ubuwaits,,1,1,3,4
5816,spinchange,,1,285,253,538
5817,somebritishdude,,1,1,2,3
5818,dwastchak,,1,1,3,4
5819,Glominator,,1,4,1,5
5820,bokumo,,1,11,3,14
5821,zemlyanin,,1,10,6,16
5822,rush378,,1,1,4,5
5823,LiberalHippies3,,1,19,37,56
5824,EtherDais,,1,40,99,139
5825,tecopa03,,1,19,44,63
5826,thisisntmyrealacount,,1,8,1,9
5827,yoodle,,1,23,52,75
5828,blindbug,,1,83,89,172
5829,joebloggs2k8,,1,3,1,4
5830,fserb,,1,4,2,6
5831,patcito,,1,211,230,441
5832,israelite,,1,4,1,5
5833,Busybyeski,,1,271,490,761
5834,neoarch,,1,1,1,2
5835,sazj,,1,1,1,2
5836,neocarty,,1,6,10,16
5837,shatteredmindofc,,1,2,1,3
5838,jbrein1,,1,6,7,13
5839,Dr_Cane_Toad,,1,41,21,62
5840,Lancer383,,1,49,55,104
5841,mik3,,1,21,28,49
5842,aparrotchick,,1,2,3,5
5843,AtomicFireball,,1,1,3,4
5844,nabiki87,,1,58,52,110
5845,bradjward,,1,1,1,2
5846,peridyn,,1,312,226,538
5847,semirami,,1,1,3,4
5848,ReverendJWright,,1,2,10,12
5849,notacake,,1,2,1,3
5850,Christopher_Robin,,1,1,1,2
5851,abbynormal1,,1,84,1,85
5852,mashei,,1,16,20,36
5853,thecasbah45,,1,119,18,137
5854,Nexnecis,,1,5,9,14
5855,whatevrmn,,1,19,20,39
5856,howlingman,,1,12,7,19
5857,jtan,,1,11,13,24
5858,redditeon,,1,42,114,156
5859,NDND,,1,14,7,21
5860,Rodrush62,,1,1,1,2
5861,Alexstrandberg,,1,3,1,4
5862,Wideroe89,,1,11,20,31
5863,YesMugatu,,1,2,2,4
5864,JRR_TOLKEIN,,1,1,2,3
5865,mongrelized,,1,8,8,16
5866,chicofaraby,,1,597,629,1226
5867,Jerph,,1,9,23,32
5868,jimmywanger,,1,4,8,12
5869,ichiban,,1,2,3,5
5870,kryptonik,,1,2,2,4
5871,MyBigRed,,1,52,69,121
5872,Paperclip1,,1,130,177,307
5873,greebus,,1,1,1,2
5874,tlf,,1,3,4,7
5875,metasonix,,1,3,3,6
5876,mengland,,1,7,6,13
5877,grrranpdaaa,,1,61,78,139
5878,jerms4649,,1,2,2,4
5879,nitrousconsumed,,1,29,27,56
5880,reddit_sucks,,1,17,12,29
5881,sysmgr,,1,1,1,2
5882,iqtrm,,1,13,22,35
5883,kevbruner,,1,2,2,4
5884,FlyingUndeadSheep,,1,147,168,315
5885,kwirky,,1,250,181,431
5886,mub,,1,4,9,13
5887,Octal040,,1,7,17,24
5888,sapphire,,1,4,5,9
5889,repairman99,,1,30,1,31
5890,MonkeyAsMan,,1,63,27,90
5891,realstevejobs,,1,7,8,15
5892,yurigoul,,1,1,5,6
5893,tmalsburg2,,1,15,2,17
5894,dirtymatt,,1,10,16,26
5895,Illmitch,,1,21,20,41
5896,Geebe392,,1,250,402,652
5897,cracksmoker,,1,10,7,17
5898,ryanissuper,,1,405,577,982
5899,snowmakerme,,1,1,2,3
5900,star_boy,,1,188,276,464
5901,wwasabi,,1,33,63,96
5902,zenosrevenge,,1,78,152,230
5903,tychobrailleur,,1,2,1,3
5904,wash77,,1,3,5,8
5905,fourty_two,,1,1,2,3
5906,ggduarte,,1,5,8,13
5907,karmathestrange,,1,11,27,38
5908,Aiurtime,,1,74,97,171
5909,ouzin,,1,62,60,122
5910,codepoet42,,1,93,125,218
5911,katoninetales,,1,741,1300,2041
5912,philh,,1,76,101,177
5913,totallynate,,1,39,49,88
5914,dwadwad,,1,8,7,15
5915,gONZObLISS,,1,1,2,3
5916,szano,,1,2,3,5
5917,pastagod,,1,8,4,12
5918,Whambulance,,1,2,1,3
5919,jl98,,1,3,4,7
5920,doliner,,1,12,4,16
5921,oracleofmist,,1,5,9,14
5922,johncapello,,1,56,15,71
5923,E3K,,1,299,371,670
5924,THIS_BE_PAUL_REVERE,,1,14,6,20
5925,damnhippy,,1,4,6,10
5926,karmais4retards08012,,1,3,15,18
5927,AlanCrowe,,1,184,292,476
5928,mokshjuneja,,1,1,1,2
5929,fightingirish,,1,12,14,26
5930,bdrydyk,,1,15,4,19
5931,KBestOliver,,1,26,1,27
5932,Sarm,,1,513,550,1063
5933,blax,,1,84,67,151
5934,ultimatt42,,1,436,621,1057
5935,HarnessItAll,,1,3,3,6
5936,2ndrateidiot,,1,5,9,14
5937,wigglywonk,,1,4,6,10
5938,rubentuben,,1,57,73,130
5939,yellowfellow,,1,1,1,2
5940,eyeofthestorm,,1,144,2,146
5941,nephesh,,1,18,19,37
5942,globe,,1,4,1,5
5943,808140,,1,258,296,554
5944,jeeebus,,1,75,82,157
5945,theplanetsaturn,,1,35,63,98
5946,jakewertz,,1,4,1,5
5947,ZachsMind,,1,5,19,24
5948,PaulLev,,1,42,5,47
5949,KittyAntonik,,1,2,1,3
5950,ZainA,,1,43,8,51
5951,GoodDogLefty,,1,3,2,5
5952,thetodd007,,1,4,5,9
5953,ghost_grl,,1,18,13,31
5954,thomaspajamas,,1,1,4,5
5955,felton,,1,4,1,5
5956,directtulip,,1,53,5,58
5957,sadie8686,,1,8,13,21
5958,arcycola,,1,5,6,11
5959,xitshsif,,1,62,86,148
5960,Denihilist,,1,18,39,57
5961,joeyconrad,,1,8,8,16
5962,nosocialism,,1,1,1,2
5963,esparza74,,1,1409,651,2060
5964,lhjmq,,1,27,22,49
5965,Robdontplay,,1,1,1,2
5966,thereticent,,1,55,7,62
5967,kokberg,,1,38,84,122
5968,saltedwyfe,,1,35,1,36
5969,Supposably,,1,47,65,112
5970,blastano,,1,1,1,2
5971,Ford-Prefect,,1,2,1,3
5972,fatllama,,1,1,1,2
5973,schroefoe,,1,90,50,140
5974,Captain_Cynical,,1,1,2,3
5975,roddy1369,,1,1,1,2
5976,JuniorKane,,1,2,3,5
5977,airbeck,,1,6,8,14
5978,cubeeggs,,1,40,38,78
5979,Miss_Cleo,,1,15,17,32
5980,Dav-id,,1,4,2,6
5981,iloled,,1,30,82,112
5982,frankness,,1,6,7,13
5983,babytomato,,1,4,1,5
5984,paul4pres,,1,3,8,11
5985,thomie,,1,1,2,3
5986,BaudiIROCZ,,1,51,10,61
5987,typography_nazi,,1,1,1,2
5988,spdyvkng,,1,2,1,3
5989,Jewjr,,1,69,56,125
5990,mysterx,,1,77,14,91
5991,smarthustlersdotcom,,1,1,3,4
5992,Callero,,1,1,3,4
5993,randarchy,,1,24,61,85
5994,SoCo_cpp,,1,6,2,8
5995,klemoyne,,1,23,14,37
5996,2il,,1,1,1,2
5997,imwithmaroon,,1,1,1,2
5998,yogisfunhouse,,1,1,1,2
5999,kuruvilj,,1,1,1,2
6000,snorp,,1,7,4,11
6001,bitspace,,1,118,144,262
6002,ithika,,1,238,362,600
6003,roerd,,1,83,107,190
6004,problemwiththemoon,,1,24,29,53
6005,falmeshon,,1,9,18,27
6006,shallit,,1,37,5,42
6007,SerialCrusher,,1,3,2,5
6008,Bizdorph,,1,9,13,22
6009,JWill628,,1,25,1,26
6010,rporter,,1,3,6,9
6011,SwampYankee,,1,2,1,3
6012,WinstonsMyth,,1,2,2,4
6013,sfnick,,1,2,2,4
6014,LukeZet,,1,1,1,2
6015,theone777,,1,1,1,2
6016,nerevar,,1,32,31,63
6017,technodawg,,1,58,51,109
6018,sk33t,,1,19,15,34
6019,missbossy,,1,1,2,3
6020,nimblerabit,,1,1,4,5
6021,paperbag01,,1,21,1,22
6022,lemination,,1,5,2,7
6023,antidense,,1,235,412,647
6024,SwiftyLeZar,,1,9,7,16
6025,sajb,,1,3,15,18
6026,SavageJeph,,1,11,28,39
6027,PurifyYourMind,,1,5,3,8
6028,lorg,,1,13,5,18
6029,shortarmed,,1,72,113,185
6030,sircrowbar,,1,19,35,54
6031,Magee_MC,,1,3,2,5
6032,Flickabus,,1,10,7,17
6033,giodude,,1,338,98,436
6034,kavabean,,1,7,3,10
6035,shiftyness,,1,80,73,153
6036,THN,,1,6,5,11
6037,lloydreddit,,1,3,5,8
6038,patrickjpatten,,1,26,12,38
6039,scotty2012,,1,4,3,7
6040,somnambulant,,1,6,2,8
6041,Popeyecon,,1,1,1,2
6042,WB41590,,1,1,2,3
6043,anonibird,,1,4,1,5
6044,bdelgado,,1,142,265,407
6045,felixkunze,,1,2,1,3
6046,soupslop,,1,10,15,25
6047,zzatz,,1,31,51,82
6048,Florb,,1,1,1,2
6049,shuaz,,1,366,607,973
6050,ardent,,1,12,5,17
6051,ugmold,,1,2,3,5
6052,natezomby,,1,3,10,13
6053,ryegye24,,1,2,4,6
6054,popqva,,1,1,1,2
6055,anon1999,,1,3,2,5
6056,NaviBlueShoes,,1,6,7,13
6057,thecompletegeek,,1,235,269,504
6058,BlueRose03,,1,11,17,28
6059,Irwick,,1,2,1,3
6060,ReKast,,1,2,13,15
6061,vegard,,1,1,3,4
6062,ShadowCaster,,1,1,1,2
6063,marvinisgay,,1,19,44,63
6064,mattw,,1,2,4,6
6065,bdude,,1,91,51,142
6066,tsm11,,1,2,2,4
6067,spocksbrain,,1,15,11,26
6068,BaconPump,,1,2,3,5
6069,Damn_Straight,,1,1,4,5
6070,Stellato21,,1,91,302,393
6071,aestus,,1,11,19,30
6072,quietsushishh,,1,1,4,5
6073,Transmetropolitan,,1,44,98,142
6074,Kenji_waterloo,,1,2,5,7
6075,delirium1086,,1,22,41,63
6076,ibking,,1,46,43,89
6077,frankrizzo83,,1,4,2,6
6078,legatoz,,1,14,1,15
6079,liquidhot,,1,4,5,9
6080,thakadu,,1,6,3,9
6081,flaubert,,1,64,68,132
6082,astrodust,,1,2,2,4
6083,Fazookus,,1,427,1125,1552
6084,TaserLite,,1,16,12,28
6085,billers311,,1,17,6,23
6086,drewhenson,,1,93,143,236
6087,chrispoole,,1,42,41,83
6088,ignare,,1,3,7,10
6089,300zedex,,1,349,242,591
6090,mallotrope,,1,17,15,32
6091,shazmak,,1,3,7,10
6092,fakelogin,,1,10,24,34
6093,uncia,,1,121,160,281
6094,Double-Z,,1,10,19,29
6095,rabeidoh,,1,72,26,98
6096,nouns,,1,83,203,286
6097,bruiser,,1,7,6,13
6098,HeIsMcSAME,,1,139,92,231
6099,rofld,,1,27,36,63
6100,uberdude197,,1,3,8,11
6101,remccain,,1,166,288,454
6102,Rudolpho_Guliano,,1,1,1,2
6103,spike,,1,155,86,241
6104,slbsoftware,,1,13,7,20
6105,redditloggy,,1,1,2,3
6106,vikhound,,1,85,49,134
6107,slaney,,1,1,3,4
6108,umrgregg,,1,273,415,688
6109,Tinman67,,1,5,3,8
6110,gwenpen62,,1,1,3,4
6111,tehsuq,,1,42,88,130
6112,emindaer,,1,11,17,28
6113,fuoobar,,1,1,1,2
6114,ganders,,1,8,12,20
6115,blue-boy,,1,5,7,12
6116,toft,,1,4,3,7
6117,DrFrost501,,1,24,8,32
6118,belm0,,1,42,7,49
6119,kalishinko,,1,141,37,178
6120,kmichaelwriter,,1,1,2,3
6121,thrthr,,1,40,6,46
6122,ADAP2K,,1,533,133,666
6123,khrushchev,,1,7,9,16
6124,thinkcomp,,1,3,1,4
6125,misternovember,,1,18,24,42
6126,SenatorTedStevens,,1,9,18,27
6127,Queue29,,1,52,48,100
6128,ghettoimp,,1,1,2,3
6129,w00tw00t,,1,1,6,7
6130,knappster99,,1,1,2,3
6131,MikeAwkenbauls,,1,1,1,2
6132,FcukingCracker,,1,8,26,34
6133,SergeantPepper,,1,1,2,3
6134,mkull,,1,13,14,27
6135,ancientweird,,1,3,23,26
6136,Griselda_Blanco,,1,20,37,57
6137,nomp,,1,28,4,32
6138,Jered,,1,1,1,2
6139,jmar777,,1,4,6,10
6140,flano1,,1,1,2,3
6141,Psalm,,1,33,44,77
6142,TheMightyDane,,1,6,13,19
6143,stop08,,1,1,1,2
6144,origamete,,1,3,3,6
6145,carlosmiller,,1,94,7,101
6146,Ihategeeks,,1,213,431,644
6147,SophieFatale,,1,4,4,8
6148,Toadus,,1,7,1,8
6149,Jonathan_Swift,,1,1,2,3
6150,OdinYggdrasil,,1,3,7,10
6151,srussian,,1,29,3,32
6152,bgoody,,1,11,4,15
6153,wheat,,1,6,11,17
6154,lahayshababyblue,,3,3,1,4
6155,gcampeau,,1,1,5,6
6156,mariosavio,,1,1,1,2
6157,tooneartoofar,,1,25,19,44
6158,dgreensp,,1,85,95,180
6159,justreddit00,,1,2,2,4
6160,jklabo,,1,386,86,472
6161,Rodelero2,,1,9,32,41
6162,africaninformer,,1,38,1,39
6163,cozmonut,,1,13,47,60
6164,nclester,,1,3,4,7
6165,SirBob1701,,1,3,8,11
6166,vishenml,,1,90,1,91
6167,SkipHead,,1,2,3,5
6168,Bery_Logo,,1,7,1,8
6169,oscar202000,,1,1,4,5
6170,strokerlinx,,1,1,3,4
6171,keepinithamsta,,1,9,17,26
6172,proshorts,,1,11,6,17
6173,ChemoThatIsCuring,,1,6,5,11
6174,lurkerr,,1,17,20,37
6175,Javbw,,1,234,407,641
6176,a_9th_circuit_judge,,1,3,6,9
6177,SimplyRy,,1,4,4,8
6178,w0lfh0und,,1,87,14,101
6179,deltree,,1,4,3,7
6180,MindOps,,1,3,1,4
6181,hanjeer,,1,4,5,9
6182,syrq,,1,19,13,32
6183,matblack,,1,1,1,2
6184,mr-oblivious,,1,129,69,198
6185,xgkx,,1,9,36,45
6186,Blindweb,,1,10,9,19
6187,OniTan,,1,5,3,8
6188,veritas23,,1,24,31,55
6189,ranthony24,,1,97,34,131
6190,TheCheezCake,,1,47,71,118
6191,joseph,,1,12,19,31
6192,grumpygorilla,,1,2,3,5
6193,Kamiwill,,1,2,2,4
6194,NFGman,,1,1,3,4
6195,jaffarabdul,,1,1,5,6
6196,FreeTibet,,1,9,15,24
6197,fuzzykitten,,1,14,14,28
6198,DrStrabismus,,1,95,69,164
6199,Rippin_Kitten,,1,49,1,50
6200,Jakomako,,1,21,21,42
6201,SoggySock,,1,14,22,36
6202,ianb,,1,1,4,5
6203,Sporknight,,1,1,2,3
6204,jozxyqk,,1,4,5,9
6205,ChineseFucktard,,1,1,1,2
6206,ForcedToAnonymity,,1,3,1,4
6207,watsoninc,,1,29,6,35
6208,orduz,,1,1,3,4
6209,jone,,1,3,4,7
6210,stackcats,,1,1,1,2
6211,OGstackadolla,,1,163,240,403
6212,Savant7,,1,2,1,3
6213,keymaker1954,,1,4,9,13
6214,jmchez,,1,1080,12,1092
6215,JdoubleE5000,,1,1,4,5
6216,mattgrommes,,1,4,1,5
6217,ChefQuix,,1,17,7,24
6218,cjnkns,,1,58,104,162
6219,kalashnikov,,1,6,9,15
6220,gravis27,,1,4,2,6
6221,Poltras,,1,4,7,11
6222,tingham,,1,2,2,4
6223,edunewz,,1,1,3,4
6224,secretchimp,,1,118,256,374
6225,JohnBender,,1,8,2,10
6226,kinglouis,,1,1,1,2
6227,randomrandomwoo,,1,2,9,11
6228,scotishstriker,,1,2,7,9
6229,zenweight,,1,1,2,3
6230,overacid,,1,1,3,4
6231,wh0r4cl3,,1,33,53,86
6232,isellchickens,,1,11,3,14
6233,Vernacularry,,1,139,66,205
6234,PikaKyri,,1,30,59,89
6235,911wasa_airplane_job,,1,2,4,6
6236,cthru,,1,2,7,9
6237,DirtySouth,,1,26,47,73
6238,spaknasaurus,,1,2,1,3
6239,hpartymarty,,1,3,2,5
6240,kogk,,1,1,1,2
6241,GorillaSushi,,1,4,2,6
6242,runnig,,1,3,1,4
6243,fugu_v,,1,4,1,5
6244,Gouranga,,1,79,129,208
6245,brandonmeek,,1,1,4,5
6246,a-zwei,,1,1,2,3
6247,FasTandFuriouS37,,1,6,4,10
6248,kaemaril,,1,18,25,43
6249,brainnovate,,1,15,14,29
6250,ifnotme,,1,540,76,616
6251,socalsamba,,1,647,15,662
6252,burnnnt,,1,5,1,6
6253,mildavw,,1,4,3,7
6254,RickAstIey,,1,5,2,7
6255,Sottilde,,1,26,30,56
6256,scoot87,,1,8,8,16
6257,recoletta01,,1,11,12,23
6258,Kutchi,,1,78,9,87
6259,stikeymo,,1,34,42,76
6260,lectrik,,1,9,18,27
6261,jfedor,,1,253,207,460
6262,jayoinoz,,1,1,2,3
6263,mu22le,,1,2,1,3
6264,IanBrandt,,1,3,1,4
6265,kareem,,1,1,3,4
6266,Markademus,,1,7,6,13
6267,NewsCat,,1,69,3,72
6268,rr1899,,1,3,3,6
6269,gtapro91,,1,16,56,72
6270,lazybychoice,,1,14,3,17
6271,genpeckem,,1,1,1,2
6272,lenolium,,1,6,10,16
6273,tlrobinson,,1,118,190,308
6274,Indeme,,1,43,20,63
6275,hotdogburrito,,1,2,7,9
6276,zen_tm,,1,12,9,21
6277,GAPit,,1,1,1,2
6278,gazzigger,,1,1,1,2
6279,Tobu,,1,6,22,28
6280,Rurouni,,1,3,6,9
6281,Grammar,,1,6,3,9
6282,WhatTheGentlyCaress,,1,205,129,334
6283,McCainIzNutz,,1,3,3,6
6284,shabayek,,1,8,13,21
6285,leakfinder,,1,1,5,6
6286,VenomFangX,,1,5,4,9
6287,thebeefytaco,,1,216,283,499
6288,krat,,1,10,4,14
6289,spellcheck,,1,11,11,22
6290,username223,,1,437,758,1195
6291,opineapple,,1,110,158,268
6292,EmmEff,,1,43,74,117
6293,patach,,1,5,1,6
6294,nihilisticmonk,,1,113,87,200
6295,sirberus,,1,95,38,133
6296,jailbate,,1,2,1,3
6297,konspence,,1,49,54,103
6298,characterzer0,,1,2,1,3
6299,Tortragon,,1,69,72,141
6300,aquilisdicio,,1,1,1,2
6301,ediamond,,1,2,2,4
6302,on3,,1,1,2,3
6303,Gizzmo0411,,1,4,3,7
6304,CCMSTF,,1,48,73,121
6305,FuzzyOne,,1,1,2,3
6306,danielsevelt007,,1,3,11,14
6307,foxhunter,,1,107,125,232
6308,mikeweezer,,1,1,2,3
6309,rec800,,1,2,1,3
6310,zickx009,,1,91,20,111
6311,larsorion,,1,5,1,6
6312,grimster,,1,71,115,186
6313,Shink,,1,3,1,4
6314,hammerofhope,,1,2,1,3
6315,robertunix,,1,1,4,5
6316,murrchen,,1,11,13,24
6317,evandec,,1,16,3,19
6318,collistaeed,,1,11,1,12
6319,fro0ty,,1,87,99,186
6320,muzaki,,1,21,20,41
6321,Hypnot,,1,4,1,5
6322,rrl,,1,2,11,13
6323,keithjr,,1,462,617,1079
6324,v_ger,,1,1,1,2
6325,buttermouth,,1,2,3,5
6326,mpuv6y,,1,1,3,4
6327,haiku_summary,,1,1,1,2
6328,suppressingfire,,1,46,70,116
6329,villageatheist,,1,14,23,37
6330,Tundrasama,,1,29,47,76
6331,bostontparty,,1,1,1,2
6332,alphex,,1,11,3,14
6333,ronin5,,1,32,19,51
6334,FuckingXtianPretards,,1,12,11,23
6335,Chacarron,,1,21,34,55
6336,kimwim42,,1,421,510,931
6337,Ceebs415,,1,47,77,124
6338,darkmoonsinger,,1,5,2,7
6339,timthebrit,,1,2,2,4
6340,mok000,,1,38,79,117
6341,_Mark_,,1,2,8,10
6342,drakshadow,,1,114,253,367
6343,vich,,1,4,8,12
6344,Omnica,,1,2,5,7
6345,Todash19,,1,2,2,4
6346,puffball,,1,35,29,64
6347,thehalfwit,,1,7,1,8
6348,radiowaves,,1,2,1,3
6349,pskomoroch,,1,27,17,44
6350,benburkert,,1,1,1,2
6351,jerschneid,,1,167,65,232
6352,towsonu2003,,1,114,158,272
6353,NeighborhoodWatchCom,,1,1,2,3
6354,we3bus,,1,11,18,29
6355,moocow89,,1,1,1,2
6356,sladner,,1,1,3,4
6357,baphomet256,,1,11,2,13
6358,ferm,,1,1,1,2
6359,newschool,,1,1,4,5
6360,snark,,1,168,246,414
6361,TestFlyJets,,1,5,1,6
6362,Aleksland,,1,82,4,86
6363,banipole,,1,3,6,9
6364,noroom,,1,226,213,439
6365,TwinEagle,,1,4,5,9
6366,shelearns,,1,3,2,5
6367,blknight18,,1,7,2,9
6368,ca_geologist,,1,12,4,16
6369,robins,,1,5,3,8
6370,gotta-take-a-rove,,1,11,7,18
6371,soyonsici,,1,2,1,3
6372,sp1keNARF,,1,30,41,71
6373,SimplyZee,,1,13,27,40
6374,joekarma,,1,27,42,69
6375,graysanborn,,1,1,3,4
6376,kentonerator,,1,39,54,93
6377,CJDehnel,,1,107,130,237
6378,AbortRetryFail,,1,7,5,12
6379,icamebuckets,,1,6,5,11
6380,siong1987,,1,1,1,2
6381,funbag26,,1,49,58,107
6382,ex0cet,,1,1,1,2
6383,atralyx,,1,3,4,7
6384,sikligar,,1,1,1,2
6385,episcope,,1,369,963,1332
6386,bradsh,,1,8,22,30
6387,scotttebeau,,1,1,1,2
6388,kaetzchen,,1,2,1,3
6389,ductions,,1,28,31,59
6390,merkabish,,1,2,3,5
6391,gamma_ray_burst,,1,29,52,81
6392,meesterlars,,1,43,2,45
6393,insickness,,1,14,10,24
6394,RonObvious,,1,879,888,1767
6395,NeilEBryant,,1,1,3,4
6396,vinieux,,1,5,15,20
6397,Unknownz,,1,32,34,66
6398,glitterlok,,1,290,516,806
6399,shuntjr,,1,5,9,14
6400,runiteking1,,1,10,6,16
6401,artificeren,,1,2,4,6
6402,duz,,1,1,1,2
6403,luaptifer,,1,1,1,2
6404,Fuzzyface,,1,1,3,4
6405,isdereks,,1,2,3,5
6406,b33j0r,,1,3,7,10
6407,tsiro,,1,10,5,15
6408,piusvelte,,1,2,5,7
6409,freepenguins,,1,1,7,8
6410,redstatepride,,1,5,5,10
6411,gopalan,,1,1,1,2
6412,reddit_voter,,1,4,3,7
6413,jlraz,,1,247,14,261
6414,tacooo,,1,1,2,3
6415,wplaurence,,1,20,34,54
6416,kxxb,,1,10,24,34
6417,buythatfromus,,1,10,12,22
6418,garoboldy,,1,3,7,10
6419,eleven_thirty,,1,12,33,45
6420,burzuj,,1,1,1,2
6421,lothair,,1,41,34,75
6422,kevcos,,1,1,3,4
6423,kronich,,1,18,6,24
6424,stevo301103,,1,9,5,14
6425,xtrmntr,,1,21,33,54
6426,weakly,,1,119,234,353
6427,xxxxsHERBxxxx,,1,1,3,4
6428,dfgsdfghiourg,,1,1,1,2
6429,fldash,,1,24,19,43
6430,a_c_munson,,1,55,30,85
6431,zero2460,,1,6,15,21
6432,catfive,,1,57,44,101
6433,swanzola,,1,19,18,37
6434,dfreezy,,1,11,25,36
6435,Unl1m1t3d,,1,1,1,2
6436,oinkbeast,,1,7,4,11
6437,sdawsey,,1,17,29,46
6438,TunaMan,,1,124,108,232
6439,bpg,,1,1,2,3
6440,WilliamWallace,,1,40,50,90
6441,pwolfe,,1,4,2,6
6442,pugs909,,1,3,3,6
6443,retguy64,,1,7,5,12
6444,dirtysnachez,,1,199,272,471
6445,0xdeadbabe,,1,4,4,8
6446,Cornwell,,1,12,10,22
6447,crysys,,1,10,14,24
6448,thinman,,1,1,1,2
6449,youngviking,,1,2,5,7
6450,t_w,,1,138,125,263
6451,BFG1x,,1,18,9,27
6452,nmcc847,,1,34,1,35
6453,IamtheFBI,,1,1,1,2
6454,sonictooth,,1,3,2,5
6455,csace,,1,13,21,34
6456,diffuse,,1,4,4,8
6457,zielgruppe,,1,3,3,6
6458,70ph3r,,1,1,4,5
6459,SculptusPoe,,1,42,68,110
6460,CalipsoII,,1,31,20,51
6461,bassx,,1,1,1,2
6462,macov2,,1,76,33,109
6463,anotherusername3,,1,17,29,46
6464,angrycoffee,,1,2,2,4
6465,busterbrown,,1,3,2,5
6466,safarijoe,,1,9,20,29
6467,lejeune,,1,9,32,41
6468,insanelygreat,,1,1,2,3
6469,rytmis,,1,7,13,20
6470,FemurL,,1,2,2,4
6471,flanband,,1,32,39,71
6472,Rihatsu,,1,1,1,2
6473,garim,,1,1,1,2
6474,Vighi,,1,3,2,5
6475,holden1792,,1,11,3,14
6476,happybob007,,1,31,65,96
6477,star_scream,,1,2,3,5
6478,LoriLight,,1,16,14,30
6479,originzz,,1,1,4,5
6480,LocoMoco420,,1,2,3,5
6481,chellebelly,,1,13,4,17
6482,danpaquin,,1,5,2,7
6483,jtizzle,,1,12,2,14
6484,danchan22,,1,4,2,6
6485,washoe22,,1,1,1,2
6486,soupy,,1,6,3,9
6487,aspersieman,,1,3,6,9
6488,wootincharmander,,1,1,2,3
6489,henryaj,,1,1,1,2
6490,bigwophh,,1,3,2,5
6491,hahahah,,1,1,2,3
6492,harrokitty,,1,6,9,15
6493,glamosphere,,1,26,1,27
6494,cnu,,1,42,18,60
6495,acurrie,,1,58,23,81
6496,joss82,,1,1,2,3
6497,jonveck,,1,20,35,55
6498,burdened,,1,1,3,4
6499,zair,,1,11,16,27
6500,nobody2008,,1,1,1,2
6501,operablogger,,1,1,7,8
6502,d20,,1,2,2,4
6503,laurenbosse,,1,7,17,24
6504,4realz,,1,4,2,6
6505,jrm,,1,1,4,5
6506,alsace,,1,2,2,4
6507,drifitz,,1,88,29,117
6508,atmccr,,1,48,67,115
6509,linuxhansl,,1,29,31,60
6510,mofino,,1,2,12,14
6511,nyfresh,,1,2,1,3
6512,Hochler,,1,20,13,33
6513,shifter,,1,83,14,97
6514,Randolpho,,1,5,5,10
6515,sillypeople,,1,1,1,2
6516,Fulltangviper,,1,50,51,101
6517,dustinjones,,1,11,24,35
6518,somehugenerd,,1,159,233,392
6519,froggie007,,1,3,5,8
6520,vox_neocon,,1,1,1,2
6521,gulfie,,1,21,62,83
6522,Klemens,,1,1,1,2
6523,Skoobe,,1,7,3,10
6524,aradil,,1,1084,1742,2826
6525,ectogon,,1,40,82,122
6526,cdm9002,,1,10,14,24
6527,varunb007,,1,11,31,42
6528,redditobandito,,1,4,1,5
6529,remove,,1,12,1,13
6530,polymorph505,,1,25,34,59
6531,zerodark,,1,55,81,136
6532,biiaru,,1,7,8,15
6533,begbudii,,1,338,71,409
6534,bhorwitz,,1,42,37,79
6535,ponder22875,,1,82,186,268
6536,SaratogaCx,,1,35,20,55
6537,observer,,1,26,22,48
6538,originaluid,,1,11,8,19
6539,numbelvsi,,1,44,143,187
6540,L3xicaL,,1,10,20,30
6541,logansnick,,1,16,5,21
6542,kolya3,,1,50,14,64
6543,jnm27,,1,34,1,35
6544,tehuasuh,,1,1,2,3
6545,QaSpel,,1,11,8,19
6546,jumpyg1258,,1,330,384,714
6547,Rowaan,,1,5,18,23
6548,funpolice,,1,7,3,10
6549,partypartyparty,,1,21,29,50
6550,zeeter,,1,1,5,6
6551,Wriston,,1,3,12,15
6552,tjcronan,,1,1,2,3
6553,vodkee,,1,16,36,52
6554,furiouslol,,1,1,1,2
6555,radox,,1,3,2,5
6556,ScienceMouk,,1,59,7,66
6557,phoenixankit,,1,80,162,242
6558,TimmyC,,1,30,14,44
6559,Diktator,,1,2,3,5
6560,KyrieEleison,,1,4,4,8
6561,android08,,1,155,63,218
6562,jck97,,1,1,1,2
6563,newgoldtooth,,1,2,2,4
6564,boneillhawk,,1,5,4,9
6565,doodly123,,1,9,3,12
6566,RichardSharp,,1,9,2,11
6567,freedryk,,1,4,3,7
6568,dthomasdigital,,1,4,1,5
6569,beltingorion,,1,10,7,17
6570,smorrell,,1,9,9,18
6571,michaelmacmanus,,1,167,257,424
6572,chomper,,1,2,7,9
6573,freethinker,,1,3,2,5
6574,Boppy,,1,1,2,3
6575,Cromanomaly,,1,1,2,3
6576,beerorkid,,1,4,2,6
6577,sirenace,,1,2,1,3
6578,Tulenian,,1,9,8,17
6579,stillsad,,1,9,2,11
6580,StreetLamp,,1,30,55,85
6581,jaybirdkdx,,1,1,1,2
6582,shauniv,,1,1,1,2
6583,notquitehere188,,1,4,2,6
6584,esdi,,1,8,9,17
6585,figdish,,1,18,12,30
6586,flyhighplato,,1,2,5,7
6587,NEWARKitecture,,1,2,2,4
6588,Dante2005,,1,255,235,490
6589,shellerik,,1,25,36,61
6590,freebeetree,,1,18,29,47
6591,PIF7Pb2n,,1,3,2,5
6592,nathansu,,1,22,51,73
6593,jason4188,,1,235,181,416
6594,ghaj56,,1,9,8,17
6595,Lord_Hadda,,1,2,7,9
6596,EggshellWhyte,,1,3,4,7
6597,triumphantbike,,1,4,4,8
6598,ringlen837,,1,1,2,3
6599,craiden,,1,1,1,2
6600,tarasic,,1,1,1,2
6601,slaman,,1,3,7,10
6602,WhiteAdmiral,,1,147,18,165
6603,manatwo,,1,3,2,5
6604,liquidcloud9,,1,4,2,6
6605,nickstreet36,,1,237,47,284
6606,fleanine,,1,31,17,48
6607,vdm,,1,27,52,79
6608,arvid,,1,17,15,32
6609,azebasse,,1,3,16,19
6610,jetspeed,,1,4,1,5
6611,altmod,,1,3,1,4
6612,beatard,,1,2,4,6
6613,sgnmarcus,,1,23,45,68
6614,pharoah724,,1,1,1,2
6615,stalf,,1,2,1,3
6616,jahusain,,1,4,2,6
6617,eddie964,,1,987,822,1809
6618,frutiger,,1,513,611,1124
6619,NoxiousStimuli,,1,108,175,283
6620,abccop,,1,3,2,5
6621,nichcarlson,,1,2,1,3
6622,akim,,1,3,1,4
6623,Devz0r,,1,165,93,258
6624,rhm,,1,4,4,8
6625,Daimoneze,,1,15,31,46
6626,RickBL99,,1,1,1,2
6627,thebcb,,1,5,9,14
6628,jermanis,,1,2,6,8
6629,Unununium272,,1,149,199,348
6630,billib,,1,10,8,18
6631,aidenvdh,,1,31,31,62
6632,GT4NE1,,1,1,1,2
6633,Rafe,,1,241,323,564
6634,utterlyboring,,1,1,1,2
6635,threading,,1,30,2,32
6636,h3h,,1,3,4,7
6637,jrdoran,,1,29,1,30
6638,jacobb11,,1,1,1,2
6639,komoloko,,1,32,60,92
6640,uncleozzy,,1,1,1,2
6641,elemenop,,1,21,47,68
6642,ignorance0,,1,9,9,18
6643,SmashingTool,,1,7,22,29
6644,RawbKahn,,1,1,3,4
6645,mfrace1,,1,2,4,6
6646,giftculture,,1,1,1,2
6647,yellowwit,,1,9,4,13
6648,pwnd3r,,1,9,12,21
6649,arbitrarium,,1,13,11,24
6650,Liberty_Vendetta,,1,1,1,2
6651,SgtPepperMD,,1,1,1,2
6652,dustmop,,1,24,54,78
6653,eris404,,1,6,2,8
6654,androgy,,1,10,2,12
6655,smackanicka,,1,2,4,6
6656,V4L0R,,1,89,158,247
6657,wafflez,,1,36,53,89
6658,wwestbrook,,1,1,1,2
6659,traveler_,,1,27,48,75
6660,stelmate,,1,16,19,35
6661,pavel9,,1,28,52,80
6662,JesusLovesasamorris,,1,1,1,2
6663,ffgabq,,1,1,2,3
6664,df07,,1,1,1,2
6665,jkasten,,1,15,29,44
6666,kiarias,,1,1,2,3
6667,thelsdj,,1,48,22,70
6668,sfreak,,1,2,2,4
6669,thisisthedave,,1,1,1,2
6670,bulletboy,,1,1,1,2
6671,d00bois,,1,3,13,16
6672,smog,,1,2,1,3
6673,ragica,,1,10,21,31
6674,sum1,,1,1,2,3
6675,vetler,,1,108,63,171
6676,MountainX,,1,138,75,213
6677,ssladam,,1,18,24,42
6678,The_NSA,,1,5,8,13
6679,dobbs_end_horror,,1,5,2,7
6680,aloysiusthird,,1,36,15,51
6681,seldon452,,1,194,147,341
6682,acct_rdt,,1,15,11,26
6683,phillyharper,,1,771,160,931
6684,ballons,,1,1,4,5
6685,donq321,,1,2,3,5
6686,dmwhipp,,1,69,14,83
6687,Teamster,,1,14,20,34
6688,rkaryn6,,1,4,12,16
6689,Bosley,,1,3,5,8
6690,bamdastard,,1,52,103,155
6691,lifvgblisdufv,,1,110,48,158
6692,mrbroom,,1,801,955,1756
6693,MarlonBrawndo,,1,2,2,4
6694,EnricoFermi,,1,9,2,11
6695,samography,,1,5,8,13
6696,grandwazzoo,,1,20,17,37
6697,shacamin,,1,348,458,806
6698,jlick,,1,1,2,3
6699,socalbeachgal,,1,22,27,49
6700,Pro777,,1,1,1,2
6701,maukdaddy,,1,168,207,375
6702,wwqlcw,,1,74,83,157
6703,GreenITGuru,,1,3,1,4
6704,shmegegi,,1,2,1,3
6705,benry,,1,1,3,4
6706,AmericaFuckNo,,1,1,1,2
6707,Moldavite,,1,1198,172,1370
6708,dutchboyelm,,1,31,1,32
6709,salgat,,1,538,909,1447
6710,rickrosstheboss,,1,65,83,148
6711,enki_enlil,,1,21,24,45
6712,jseigh,,1,19,39,58
6713,periclesmage,,1,70,13,83
6714,svazan,,1,16,11,27
6715,enjahova,,1,36,44,80
6716,wonknose,,1,11,10,21
6717,rafajafar,,1,111,91,202
6718,B-Con,,1,78,100,178
6719,sala,,1,142,19,161
6720,biochembabe,,1,5,2,7
6721,dolle,,1,27,32,59
6722,freekzindel,,1,3,3,6
6723,BenE,,1,1,1,2
6724,neonpowerbomb,,1,34,46,80
6725,ovi256,,1,174,203,377
6726,this_barb,,1,111,225,336
6727,f-ranke,,1,1,2,3
6728,hhuntington2,,1,15,15,30
6729,FerricOxide,,1,36,65,101
6730,mer91,,1,6,3,9
6731,wozer,,1,294,105,399
6732,thebaroque,,1,14,3,17
6733,mesquita,,1,15,23,38
6734,armistad,,1,2,2,4
6735,forrman,,1,2,1,3
6736,davvblack,,1,213,364,577
6737,HotBBQ,,1,105,86,191
6738,merpes,,1,1,1,2
6739,SnacksOnAPlane,,1,85,102,187
6740,isaa,,1,1,2,3
6741,ukdkbr,,1,176,320,496
6742,Qiran,,1,9,17,26
6743,Scurvy_D,,1,6,9,15
6744,khoker,,1,2,3,5
6745,HappyRacist,,1,7,9,16
6746,chaos_butterfly,,1,1,1,2
6747,alllie,,1,6388,2589,8977
6748,williamwhite,,1,7,4,11
6749,inthenameofmine,,1,152,3,155
6750,stopmakingsense,,1,6,2,8
6751,namja,,1,1,1,2
6752,potentialPast,,1,16,12,28
6753,wduff2,,1,8,11,19
6754,SubGothius,,1,221,397,618
6755,CLer_in_VA,,1,7,15,22
6756,zszafran,,1,1,1,2
6757,whatsupdocs,,1,3,1,4
6758,taejo,,1,244,392,636
6759,lwfleetham,,1,11,5,16
6760,bfpp,,1,1,1,2
6761,vvn102,,1,3,2,5
6762,qwzybug,,1,3,2,5
6763,arkabc,,1,30,10,40
6764,JohnDeere,,1,8,15,23
6765,baddog992,,1,8,11,19
6766,guruthegreat,,1,19,39,58
6767,aonic,,1,1,3,4
6768,paulkeitel,,1,33,1,34
6769,ChaoPope,,1,2,2,4
6770,olsner,,1,6,16,22
6771,iamthearm,,1,126,225,351
6772,tyrannoctonus,,1,5,14,19
6773,mjd,,1,155,154,309
6774,cunninglinguist,,1,15,25,40
6775,capnpyro,,1,1,1,2
6776,Evilhenchman,,1,2,12,14
6777,Mesmorize,,1,9,6,15
6778,michaelpinto,,1,114,26,140
6779,spillreviews,,1,47,7,54
6780,nonomore,,1,1,2,3
6781,cannibalbob,,1,3,5,8
6782,sencer,,1,4,7,11
6783,halligan00,,1,144,207,351
6784,menomena,,1,16,25,41
6785,SHv2,,1,3,2,5
6786,healeydawg,,1,4,3,7
6787,syph,,1,10,3,13
6788,agag,,1,5,9,14
6789,redokapi,,1,9,11,20
6790,petervandijck,,1,4,4,8
6791,bonnyray08,,1,5,1,6
6792,GregorMendel,,1,11,14,25
6793,frikk,,1,158,255,413
6794,Nablec00,,1,19,20,39
6795,the_antichrist,,1,1,1,2
6796,twolf1,,1,4101,134,4235
6797,ryepup,,1,67,17,84
6798,darcet,,1,1,1,2
6799,korkybuchek,,1,2,1,3
6800,syboor,,1,1,3,4
6801,daedpid1,,1,46,76,122
6802,amikael,,1,2,9,11
6803,elche,,1,2,1,3
6804,Colonel_Angus,,1,6,5,11
6805,what_the_rain_knows,,1,9,8,17
6806,Vandelay797,,1,2,1,3
6807,scottharden,,1,37,55,92
6808,Awesom-O,,1,1,2,3
6809,Vancelot,,1,7,11,18
6810,smokinsteve,,1,42,4,46
6811,rgarrison,,1,2,5,7
6812,6kdaysleft,,1,2,1,3
6813,beagle,,1,20,1,21
6814,Testsubject28,,1,180,333,513
6815,thegreenfury,,1,6,5,11
6816,FTR,,1,443,431,874
6817,rybl,,1,84,18,102
6818,geekgawd,,1,2,3,5
6819,help_me,,1,2,1,3
6820,GuyWhoScreamsAlways,,1,3,2,5
6821,mixscarlet,,1,2,3,5
6822,brimstone,,1,46,5,51
6823,FORTRAN,,1,1,1,2
6824,riseUP,,1,1,2,3
6825,4609287645,,1,91,188,279
6826,boobytrapped,,1,4,4,8
6827,Charice,,1,2,4,6
6828,buddaslovehandles,,1,343,364,707
6829,groggy,,1,1,1,2
6830,zebula234,,1,23,29,52
6831,capital,,1,1,2,3
6832,ntoshev,,1,4,3,7
6833,doutta,,1,1,1,2
6834,reddit1138,,1,4,4,8
6835,popeix,,1,249,113,362
6836,superdeluxesam,,1,3,1,4
6837,mystery_guest,,1,411,557,968
6838,fugat,,1,138,50,188
6839,iamblonde,,1,1,1,2
6840,scoopz,,1,1,1,2
6841,thisismyfakeaccount,,1,2,3,5
6842,bulletballMarc,,1,3,2,5
6843,jollins,,1,1,1,2
6844,nick8325,,1,25,37,62
6845,rudster,,1,5,9,14
6846,puskunk,,1,14,23,37
6847,tedwick,,1,4,2,6
6848,tj9991,,1,96,79,175
6849,nerox3,,1,156,162,318
6850,iliketowatch,,1,74,135,209
6851,goglserw,,1,1,1,2
6852,Prosopagnosia,,1,2,4,6
6853,TheGreenMiles,,1,48,3,51
6854,ChiliGuy,,1,1,1,2
6855,lmno,,1,1,1,2
6856,CrashCodes,,1,50,33,83
6857,spartan2100,,1,69,104,173
6858,ccoveney,,1,2,1,3
6859,dmk2008,,1,120,124,244
6860,GoldenFalcon,,1,3,3,6
6861,bct,,1,12,12,24
6862,ArminVanBuuren,,1,1,2,3
6863,powrslave,,1,1,3,4
6864,jayokay,,1,128,68,196
6865,cromulentadvice,,1,1,2,3
6866,raisedinhell,,1,130,194,324
6867,Trotskyist,,1,2,3,5
6868,PeteZaHutt,,1,94,16,110
6869,neutralforce,,1,162,64,226
6870,liberalcommiefag,,1,69,72,141
6871,juniorjj,,1,2,2,4
6872,StretchinAZ,,1,4,6,10
6873,triad1996,,1,80,4,84
6874,metamutator,,1,13,23,36
6875,bkforyou,,1,2,1,3
6876,atomicthumbs,,1,870,1100,1970
6877,gamewithabrain,,1,59,3,62
6878,lazyfisherman,,1,7,24,31
6879,emilis,,1,8,3,11
6880,frumious,,1,71,202,273
6881,AbolishtheFed,,1,2,2,4
6882,Robotmanforever,,1,8,3,11
6883,livejamie,,1,15,39,54
6884,trisgeminus,,1,3,2,5
6885,kokpilau,,1,7,5,12
6886,nkurz,,1,23,23,46
6887,byteCoder,,1,1,1,2
6888,democratizor,,1,2,2,4
6889,Jibberwalk,,1,292,292,584
6890,javert,,1,17,5,22
6891,buymorechuck,,1,33,4,37
6892,wjdennen,,1,4,3,7
6893,salavari,,1,2,7,9
6894,sleepsex,,1,1,1,2
6895,khubiliaJahn,,1,11,25,36
6896,loudambiance,,1,4,4,8
6897,ikovachi,,1,2,1,3
6898,Blaidd_Dwrg,,1,89,69,158
6899,richardnday,,1,12,5,17
6900,proham,,1,3,1,4
6901,haacked,,1,5,2,7
6902,mcl768,,1,6,5,11
6903,eric966077,,1,13,10,23
6904,Codys_Down,,1,14,24,38
6905,seethru,,1,1,4,5
6906,bodq,,1,28,6,34
6907,chrisandsmith,,1,108,42,150
6908,FloobLord,,1,24,36,60
6909,exeter,,1,451,460,911
6910,rene_s,,1,53,33,86
6911,automatedATTK,,1,71,154,225
6912,rabidcow,,1,302,532,834
6913,TTFAIL,,1,33,39,72
6914,progrockusa,,1,25,36,61
6915,buravirgil,,1,1,2,3
6916,thatspants,,1,31,9,40
6917,licoriceandshreddies,,1,11,28,39
6918,h00k,,1,8,13,21
6919,datatable,,1,11,6,17
6920,mithunc,,1,93,148,241
6921,dchu,,1,6,11,17
6922,nfnaaron,,1,6,6,12
6923,VAMPIRE__BITER,,1,2,1,3
6924,MM73,,1,6,7,13
6925,LoRez,,1,2,4,6
6926,mtnbarbours,,1,3,4,7
6927,lynch03,,1,39,38,77
6928,destructo_spin,,1,3,9,12
6929,markrages,,1,30,17,47
6930,arijit57,,1,141,6,147
6931,finglonger,,1,16,12,28
6932,ExplodingHead,,1,8,17,25
6933,timmy,,1,14,17,31
6934,evilbeaver333,,1,1,2,3
6935,padsip1,,1,36,1,37
6936,huffdaddy,,1,7,4,11
6937,vikky999,,1,2,1,3
6938,riq,,1,1,1,2
6939,xumiiz,,1,5,2,7
6940,zeddblue,,1,9,43,52
6941,mocisme,,1,8,9,17
6942,ryksych,,1,2,11,13
6943,WhiteJesus,,1,3,5,8
6944,jamesyboy,,1,40,66,106
6945,werkshop1313,,1,60,128,188
6946,jensv,,1,21,7,28
6947,DeviousMrBlonde,,1,1,1,2
6948,noamsml,,1,684,953,1637
6949,danvasquez29,,1,163,205,368
6950,kazuya,,1,9,14,23
6951,veritascitor,,1,18,12,30
6952,yliaba,,1,1,2,3
6953,mrpinto,,1,1,1,2
6954,vagijn,,1,100,191,291
6955,spaten,,1,1,3,4
6956,savoya,,1,2,1,3
6957,180andback,,1,1,2,3
6958,CorkyinSiam,,1,2,8,10
6959,ogretrix,,1,1,1,2
6960,rando_man,,1,51,43,94
6961,misterwilliam,,1,1,2,3
6962,jeromejohnson,,1,8,4,12
6963,madssj,,1,53,22,75
6964,acrophobia,,1,28,32,60
6965,Kimos,,1,345,374,719
6966,dockside,,1,1,1,2
6967,aevolve,,1,1,2,3
6968,Mofme,,1,48,111,159
6969,SuperSumoYakuza,,1,83,156,239
6970,pangeakiller,,1,1,1,2
6971,gongong,,1,7,1,8
6972,bleys,,1,4,1,5
6973,nobodylikeme,,1,1,2,3
6974,nanr93,,1,19,23,42
6975,Sui64,,1,1,1,2
6976,Kesseki,,1,1,1,2
6977,Superaverageman,,1,3,6,9
6978,bschmok1,,1,23,17,40
6979,Xocyll,,1,1,1,2
6980,beachbluewave,,1,1,1,2
6981,weel,,1,4,10,14
6982,GundamX,,1,48,60,108
6983,ray_scogitans,,1,485,298,783
6984,sk1p,,1,1,1,2
6985,Noche,,1,1671,510,2181
6986,matthewlarn,,1,10,4,14
6987,quasiperiodic,,1,1156,826,1982
6988,ChefOfSin,,1,3,4,7
6989,ionosphereB,,1,3,1,4
6990,Toallpointswest,,1,132,261,393
6991,slyvulpecula,,1,87,232,319
6992,bfbartolocolon,,1,1,2,3
6993,effortman,,1,1,1,2
6994,friendsshare,,1,196,532,728
6995,escapekey,,1,9,20,29
6996,koen_,,1,1,2,3
6997,markh1967,,1,220,30,250
6998,baldersplash,,1,15,12,27
6999,ceesaxp,,1,78,117,195
7000,ts334,,1,19,15,34
7001,glguy,,1,14,9,23
7002,grjemo,,1,128,32,160
7003,RonaldFuckingPaul,,1,259,645,904
7004,copenja,,1,1,1,2
7005,uglysister,,1,7,3,10
7006,Rido777,,1,12,2,14
7007,rantillo,,1,31,40,71
7008,crappyjoe,,1,3,1,4
7009,ne999,,1,19,4,23
7010,fakeproject,,1,4,8,12
7011,Annix,,1,8,7,15
7012,edme,,1,2,1,3
7013,LivingComfortEagle,,1,4,11,15
7014,ak_avenger,,1,135,270,405
7015,autarch,,1,21,25,46
7016,SolInvictus,,1,542,238,780
7017,conjuror1972,,1,8,6,14
7018,FearlessFreep,,1,12,25,37
7019,jagerbomb,,1,24,43,67
7020,rossbren,,1,1,1,2
7021,WRXSTi,,1,1,3,4
7022,contraco,,1,356,13,369
7023,dcumbo,,1,3,12,15
7024,diarrheaUHUH,,1,1,1,2
7025,LaGnoo,,1,3,2,5
7026,SAugsburger,,1,553,919,1472
7027,Evil_Morg,,1,34,52,86
7028,guns-11,,1,3,2,5
7029,rocktherobot,,1,37,18,55
7030,conspiracyken,,1,1,1,2
7031,katedoll02,,1,1,2,3
7032,electromagnetic,,1,34,46,80
7033,Grumblestiltskin,,1,4,9,13
7034,chesterriley,,1,3,2,5
7035,KanonDrita,,1,2,1,3
7036,scott1369,,1,47,51,98
7037,IKbot,,1,69,27,96
7038,Farginan,,1,1,2,3
7039,pascal21,,1,148,182,330
7040,indiamails,,1,2,1,3
7041,FerrisYJ,,1,12,4,16
7042,philzilla,,1,14,12,26
7043,cybermage,,1,16,13,29
7044,bhal123,,1,910,792,1702
7045,Pyrogenesis,,1,18,16,34
7046,Mondoterrifico,,1,5,2,7
7047,Doji,,1,6,5,11
7048,EJFudd,,1,1,2,3
7049,ZMeson,,1,38,40,78
7050,justcreatedthis,,1,1,1,2
7051,cq1,,1,1,4,5
7052,gedsnh,,1,2,3,5
7053,keybsnbits,,1,5,1,6
7054,modernTelemachus,,1,47,72,119
7055,creator11,,1,129,170,299
7056,nino2007,,1,3,2,5
7057,ispshadow,,1,108,145,253
7058,seeeb,,1,18,24,42
7059,reddits_conscience,,1,4,1,5
7060,kitten_kicker,,1,1,1,2
7061,scoobypants,,1,2,6,8
7062,drpants,,1,295,223,518
7063,findit,,1,112,25,137
7064,chrisnyc,,1,2,9,11
7065,realityhigh,,1,3,5,8
7066,kortox,,1,1,1,2
7067,jurnei,,1,1,7,8
7068,eagleeye1,,1,45,50,95
7069,waskliewbt,,1,25,13,38
7070,tkmckenzie,,1,7,10,17
7071,Tejas_Tornado,,1,24,76,100
7072,jack_championship,,1,61,93,154
7073,counterpoint,,1,4,8,12
7074,kyohapooka,,1,14,16,30
7075,bananaa,,1,7,41,48
7076,Imalittleteapalt,,1,17,3,20
7077,douchehead,,1,4,1,5
7078,davidhbolton,,1,1,1,2
7079,acerogue26,,1,29,61,90
7080,stevana,,1,6,2,8
7081,e404,,1,9,10,19
7082,CattBoy,,1,10,17,27
7083,Criggle,,1,19,49,68
7084,notSUREwhereTOyell,,1,4,6,10
7085,zombywuf,,1,3,5,8
7086,traverse,,1,88,84,172
7087,lucraft,,1,13,16,29
7088,EverythingsHilarious,,1,5,5,10
7089,weblaunches,,1,489,106,595
7090,UrbanLegend,,1,1,2,3
7091,spitfire111,,1,21,21,42
7092,tylerfulltilt,,1,1,1,2
7093,yowtrip,,1,1,1,2
7094,jayfehr,,1,1,1,2
7095,hasaang,,1,1,2,3
7096,killtina,,1,120,118,238
7097,jeblis,,1,2,4,6
7098,RoseEncollims,,1,13,5,18
7099,bullsbarry,,1,41,57,98
7100,analbumcover,,1,54,110,164
7101,unmutual,,1,3,6,9
7102,breakwater,,1,1,2,3
7103,wldkrd1,,1,2,2,4
7104,jellicle,,1,255,228,483
7105,christoir,,1,929,34,963
7106,mikedmoon,,1,8,10,18
7107,ShannonY75,,1,47,5,52
7108,ssanders82,,1,57,47,104
7109,tzeeth,,1,45,2,47
7110,shystar06,,1,71,114,185
7111,JoshuaSmyth,,1,1,4,5
7112,guyiniraq,,1,7,7,14
7113,DrunkenWizard,,1,13,19,32
7114,ENFour,,1,1,6,7
7115,egolatra,,1,7,9,16
7116,DaveNiks,,1,65,33,98
7117,eljeffe_teh_joo,,1,1,4,5
7118,peppaz,,1,1,6,7
7119,lilfuckshit,,1,29,1,30
7120,CaseyLW,,1,2,2,4
7121,dranek,,1,3,3,6
7122,Setekh,,1,1,2,3
7123,HanFuzzy,,1,2,6,8
7124,johnan,,1,4,1,5
7125,yena,,1,2,3,5
7126,angrykeyboarder,,1,13,18,31
7127,frickindeal,,1,584,890,1474
7128,dark_im4g3,,1,2,3,5
7129,igorsk,,1,3,1,4
7130,rolanatmi,,1,138,254,392
7131,negro_machine,,1,92,178,270
7132,Soxsider,,1,5,4,9
7133,curtiscu,,1,32,33,65
7134,razmanz,,1,8,16,24
7135,brennanmusic,,1,13,9,22
7136,harfga,,1,1,2,3
7137,nowa,,1,87,66,153
7138,krisokot,,1,20,1,21
7139,CreekDK,,1,3,6,9
7140,obamaniac,,1,1,1,2
7141,VitalyO,,1,10,10,20
7142,prof_hobart,,1,175,255,430
7143,ct4ul4u,,1,57,101,158
7144,fiddleroo,,1,1,3,4
7145,JadeFrogs,,1,7,8,15
7146,olivier101,,1,74,7,81
7147,sailfishhero,,1,11,11,22
7148,duncancarroll,,1,44,81,125
7149,yetanotherotherguy,,1,2,2,4
7150,Hermel,,1,78,63,141
7151,thegunn,,1,36,69,105
7152,c2_0,,1,1,5,6
7153,flashter,,1,6,4,10
7154,xenmate,,1,858,402,1260
7155,OhHappyDaze,,1,6,11,17
7156,DJ2,,1,1,1,2
7157,journobitch,,1,2,1,3
7158,shaydog,,1,3,2,5
7159,148937948,,1,1,1,2
7160,jairadballerina,,1,31,42,73
7161,clesch,,1,6,9,15
7162,skyhancock,,1,1,1,2
7163,wgsl,,1,65,1,66
7164,mattf,,1,17,13,30
7165,Daemonax,,1,31,44,75
7166,Luminator,,1,2,2,4
7167,stoyan,,1,14,34,48
7168,cr3,,1,74,75,149
7169,GerardMcGarry,,1,28,48,76
7170,pdonadeo,,1,5,1,6
7171,elelias,,1,22,42,64
7172,dumbboys,,1,4,4,8
7173,900fool,,1,11,6,17
7174,AllenHo,,1,17,23,40
7175,Dekken_,,1,76,153,229
7176,meatpuppet,,1,1,1,2
7177,Supratik,,1,28,72,100
7178,joybusey,,1,28,2,30
7179,ilubporn,,1,10,3,13
7180,aethidd,,1,1,2,3
7181,bluemonkey,,1,2,4,6
7182,e1516,,1,1,1,2
7183,apullin,,1,2,6,8
7184,Evdawg,,1,63,11,74
7185,yuhngnegeh,,1,8,3,11
7186,inferno714,,1,15,9,24
7187,w00dstock,,1,1,1,2
7188,macadocious,,1,1,1,2
7189,FUCK_the_FCC,,1,7,2,9
7190,WillHutch5,,1,8,11,19
7191,floydiannyc,,1,1122,381,1503
7192,cmndradama,,1,6,18,24
7193,staticit,,1,1,1,2
7194,scilfish,,1,1,1,2
7195,fatsk8r,,1,1,3,4
7196,mtalbot,,1,10,1,11
7197,jsydik,,1,1,5,6
7198,phrankle,,1,95,66,161
7199,Grrrinch,,1,1,4,5
7200,Eduren,,1,2,8,10
7201,vegiimite,,1,3,1,4
7202,yks,,1,1,1,2
7203,chieffy,,1,1,2,3
7204,BenKirsch,,1,1,1,2
7205,RaDeus,,1,7,8,15
7206,gedehs,,1,4,4,8
7207,underdog138,,1,177,318,495
7208,theaceofclubz,,1,20,14,34
7209,mazenharake,,1,11,8,19
7210,neken,,1,2,3,5
7211,youenjoymyself,,1,48,64,112
7212,shammalammadingdong,,1,50,41,91
7213,weidel,,1,4,2,6
7214,smoothdzion,,1,4,6,10
7215,BobCollins,,1,13,23,36
7216,agl,,1,24,17,41
7217,kbedell,,1,183,82,265
7218,hack4good,,1,155,119,274
7219,i_am_outraged,,1,1,4,5
7220,potatop,,1,2,2,4
7221,manierisme,,1,5,6,11
7222,samuelhalle,,1,17,4,21
7223,bluh123,,1,31,3,34
7224,DataGeneral,,1,55,86,141
7225,shootdashit,,1,114,276,390
7226,Bosworth,,1,1,1,2
7227,CoolDragon,,1,83,86,169
7228,Hogulus,,1,1,1,2
7229,mrhawkinson,,1,6,8,14
7230,daubuch,,1,3,1,4
7231,handsome_b_wonderful,,1,13,19,32
7232,louis_xiv42,,1,652,374,1026
7233,Benny_Lava,,1,386,863,1249
7234,fbristow,,1,4,6,10
7235,hidden_enterprise,,1,1,1,2
7236,Hadz,,1,19,2,21
7237,Farik,,1,1,3,4
7238,blazin_chalice,,1,99,105,204
7239,gpurrenhage,,1,6,8,14
7240,rainman_104,,1,1751,1808,3559
7241,TyTN,,1,247,54,301
7242,drfrog666,,1,10,5,15
7243,studyoflife,,1,1,1,2
7244,OKKO,,1,56,21,77
7245,blooXgiuliaXcyan,,3,5,3,8
7246,photozel,,1,2,7,9
7247,Anth741,,1,21,17,38
7248,notarealaccount,,1,1,1,2
7249,Buckleydog,,1,5,3,8
7250,ScatCamel,,1,3,3,6
7251,Shad0wSP,,1,91,101,192
7252,teej,,1,153,178,331
7253,Quickswitch79,,1,6,7,13
7254,epvcu,,1,1,3,4
7255,frootloops,,1,6,4,10
7256,JackRawlinson,,1,161,463,624
7257,Mantle,,1,1,1,2
7258,goink,,1,56,64,120
7259,BunkmonKey,,1,16,4,20
7260,menstrualpoetry,,1,41,2,43
7261,okvol,,1,83,153,236
7262,sabai_sabai,,1,4,1,5
7263,noseyb,,1,24,65,89
7264,steffyboots,,1,1,1,2
7265,Ortus,,1,11,12,23
7266,svideo,,1,91,115,206
7267,bwb,,1,23,18,41
7268,corvettecraz92,,1,15,5,20
7269,NeonNinja,,1,12,5,17
7270,arexx,,1,4,5,9
7271,switchmotiv,,1,19,16,35
7272,arrozconevan,,1,30,3,33
7273,Zeerph,,1,127,220,347
7274,gry_own,,1,6,5,11
7275,curtis119,,1,119,189,308
7276,Resident_asshole,,1,27,38,65
7277,rogerniner,,1,2,2,4
7278,badenglish,,1,9,3,12
7279,glimberg,,1,7,6,13
7280,jweather,,1,3,6,9
7281,tester_person,,1,1,1,2
7282,blueletter,,1,1,6,7
7283,sirnot,,1,1,3,4
7284,BigFeets,,1,653,526,1179
7285,CrazyJoeDavola,,1,5,6,11
7286,GillyRoze,,1,20,18,38
7287,PeterDB,,1,18,6,24
7288,smedleybutler,,1,7,7,14
7289,lilleswing,,1,2,1,3
7290,Unk0,,1,3,11,14
7291,uuiU,,1,1,1,2
7292,fordnut,,1,94,4,98
7293,freewheeling,,1,7,6,13
7294,midnightmonster,,1,9,4,13
7295,sgguitar88,,1,3,4,7
7296,zamnfan,,1,1,3,4
7297,ShkaBank,,1,8,19,27
7298,Hattusa,,1,12,28,40
7299,BigRetard,,1,1,2,3
7300,machia,,1,3,5,8
7301,wotanzeit,,1,3,7,10
7302,SirDyluck,,1,108,120,228
7303,primary0,,1,57,109,166
7304,MaximumD,,1,1,1,2
7305,rhwhtrash,,1,1,3,4
7306,bangfoo,,1,2,5,7
7307,_reddit,,1,1,1,2
7308,tupiniquim,,1,23,37,60
7309,r00tus3r,,1,33,39,72
7310,utAlice,,1,1,1,2
7311,otcpdx,,1,7,7,14
7312,melissappa,,1,25,32,57
7313,oh_whoopsss,,1,36,29,65
7314,coriolis,,1,1,1,2
7315,mhongser,,1,3,3,6
7316,x864life,,1,2,2,4
7317,elmiko,,1,5,5,10
7318,DenverRocks,,1,8,12,20
7319,DragonDawg,,1,4,5,9
7320,lhxx,,1,1,1,2
7321,cyphr555,,1,23,6,29
7322,juliob,,1,13,16,29
7323,DrStabbingworth,,1,17,26,43
7324,CognitiveLens,,1,10,13,23
7325,RonpaulFTW,,1,9,4,13
7326,atlantics,,1,8,19,27
7327,qabsteak,,1,6,4,10
7328,BlackestNight21,,1,128,313,441
7329,Magsec,,1,37,66,103
7330,allergic,,1,28,54,82
7331,espn,,1,3,5,8
7332,designtofly,,1,49,3,52
7333,chunksloth,,1,1,1,2
7334,jgollad,,1,3,1,4
7335,aim2future,,1,15,25,40
7336,zzzSleepyCoder,,1,27,3,30
7337,only_one_question,,1,1,1,2
7338,musofire,,1,85,55,140
7339,adammck,,1,45,30,75
7340,sharmaamitabh,,1,3,6,9
7341,valiant19,,1,2,3,5
7342,justjeff1,,1,1,1,2
7343,DDyce,,1,1,10,11
7344,endhits,,1,17,31,48
7345,Bixie,,1,183,198,381
7346,STFXGX,,1,18,10,28
7347,el_jeffe,,1,7,22,29
7348,DoneCorpNumbers,,1,1,1,2
7349,Circuit23,,1,2,2,4
7350,efuest,,1,1,2,3
7351,Danks4theLove,,1,3,4,7
7352,crackbaby,,1,1,1,2
7353,mh94,,1,1,1,2
7354,000078754,,1,177,30,207
7355,xhb,,1,3,3,6
7356,eoyola,,1,7,10,17
7357,satx,,1,1126,1648,2774
7358,aranasyn,,1,14,22,36
7359,pimpanzo,,1,36,26,62
7360,Tralobyte,,1,177,125,302
7361,JadedTLC,,1,5,1,6
7362,mattfarr,,1,1,4,5
7363,makavely,,1,4,2,6
7364,AEIYM,,1,1,2,3
7365,JimJohnson19,,1,79,54,133
7366,Candyshanks,,1,1,2,3
7367,newguy4,,1,5,2,7
7368,cjharrod,,1,69,119,188
7369,glowleaf,,1,1,1,2
7370,specialbus,,1,8,1,9
7371,gobbles,,1,6,12,18
7372,bblfish,,1,5,7,12
7373,seaphd,,1,1,1,2
7374,schala09,,1,98,41,139
7375,bruderjakob,,1,11,2,13
7376,tcd004,,1,187,9,196
7377,Fx71,,1,4,4,8
7378,sonus,,1,2,6,8
7379,Vock,,1,3,1,4
7380,Flaaron,,1,1,2,3
7381,HaxSir,,1,32,33,65
7382,Inri137,,1,699,139,838
7383,kevinlacker,,1,1,1,2
7384,MisterTureaud,,1,4,1,5
7385,bvoid,,1,7,1,8
7386,JRRZ,,1,3,8,11
7387,sneakyfrenchspy,,1,140,57,197
7388,sungsam2,,1,11,10,21
7389,StoveBottomStuffin,,1,3,9,12
7390,lcafiero,,1,2,1,3
7391,livinginexile,,1,1,1,2
7392,spaceyraygun,,1,6,2,8
7393,devolve,,1,141,135,276
7394,junkeee999,,1,390,566,956
7395,jeremy1701,,1,3,4,7
7396,Dailylife,,1,11,28,39
7397,hoffmabc,,1,7,2,9
7398,norfty,,1,4,11,15
7399,soumokil,,1,76,167,243
7400,shade75,,1,1,1,2
7401,HunkOfLove,,1,29,18,47
7402,raresilk,,1,1,1,2
7403,goodthingnet,,1,60,1,61
7404,Mirielle,,1,15,17,32
7405,ThrasherC,,1,111,159,270
7406,zroach,,1,3,2,5
7407,Tchocky,,1,192,230,422
7408,ucratbo,,1,5,3,8
7409,bobgem,,1,35,29,64
7410,pupeno,,1,245,207,452
7411,redstarburst,,1,6,6,12
7412,quirm,,1,137,134,271
7413,oelsen,,1,1,7,8
7414,solyanik,,1,37,70,107
7415,Mordisquitos,,1,25,29,54
7416,dougie173,,1,7,6,13
7417,jackieduvall,,1,28,8,36
7418,div,,1,93,83,176
7419,delrond,,1,167,21,188
7420,isseki_nicho,,1,3,3,6
7421,ireadyou,,1,1,1,2
7422,raphtze,,1,2,1,3
7423,ahusni,,1,19,25,44
7424,taxman32,,1,6,5,11
7425,cresquin,,1,110,100,210
7426,eggsofamerica86,,1,27,55,82
7427,syscrash,,1,4,2,6
7428,betternickname,,1,50,94,144
7429,nbsp,,1,35,1,36
7430,evergay,,1,6,10,16
7431,shadowcast,,1,24,26,50
7432,ImWithStupid,,1,147,106,253
7433,blakestah,,1,37,33,70
7434,MrWhite,,1,233,368,601
7435,maxdavid,,1,26,5,31
7436,DrPoodle,,1,117,18,135
7437,Wakefield,,1,16,40,56
7438,lenden_guy,,1,1,3,4
7439,ironknee,,1,8,3,11
7440,reedlaw,,1,2,1,3
7441,chiller2002,,1,24,33,57
7442,zackman,,1,1,1,2
7443,mnevis,,1,2,2,4
7444,All23,,1,319,261,580
7445,creeront,,1,5,4,9
7446,RevoS117,,1,82,145,227
7447,jrblast,,1,5,9,14
7448,drappier,,1,1,1,2
7449,arstechnica,,1,1,3,4
7450,Korbindallas,,1,5,6,11
7451,jputnam,,1,29,36,65
7452,florinandrei,,1,66,110,176
7453,l12,,1,403,71,474
7454,deathtokarmawhores,,1,4,4,8
7455,jwang,,1,1,2,3
7456,jacobian,,1,17,22,39
7457,theShatteredOne,,1,28,71,99
7458,joemawlma,,1,12,8,20
7459,leolapinos,,1,1,1,2
7460,scott2368,,1,16,6,22
7461,sonofpookie,,1,72,88,160
7462,vmalarcon,,1,3,2,5
7463,balinx,,1,151,124,275
7464,kanak,,1,761,417,1178
7465,robert_plants_bulge,,1,5,3,8
7466,shrimp,,1,60,3,63
7467,chipmunc56,,1,1,1,2
7468,shyvyr,,1,7,7,14
7469,consultant_barbie,,1,64,168,232
7470,radarsat1,,1,57,82,139
7471,airguitarhero,,1,1,10,11
7472,fani,,1,108,158,266
7473,shaver,,1,3,6,9
7474,jwesleyclark,,1,9,3,12
7475,Gerald_Broflovski,,1,3,1,4
7476,skizmo,,1,57,110,167
7477,WrongSubreddit,,1,27,18,45
7478,asheu,,1,23,22,45
7479,I_Also_Like_Pie,,1,3,2,5
7480,UagenZlepe,,1,6,15,21
7481,sweetjayjay,,1,3,9,12
7482,Erik_Naggum,,1,2,1,3
7483,frogger1995,,1,7,17,24
7484,CoagulatedMilk,,1,12,18,30
7485,crazy4,,1,2,8,10
7486,thanatos001,,1,1,1,2
7487,kevin143,,1,226,52,278
7488,concernedcitizen2,,1,2,2,4
7489,haljordan,,1,4,5,9
7490,touche,,1,7,7,14
7491,fugue88,,1,4,10,14
7492,zambuka42,,1,3,7,10
7493,LIEberal,,1,19,33,52
7494,DrSin,,1,4,6,10
7495,LADalt,,1,1,2,3
7496,bosk,,1,1,3,4
7497,phobosdiemosx,,1,3,8,11
7498,kyrandian,,1,112,151,263
7499,EEPS,,1,5,1,6
7500,domchi,,1,12,4,16
7501,ericrolph,,1,19,25,44
7502,speakafreaka,,1,4,8,12
7503,Gremlin87,,1,6,3,9
7504,Emrecall,,1,25,17,42
7505,cpuetz,,1,74,132,206
7506,stransky,,1,38,39,77
7507,wow_reddit,,1,1,3,4
7508,andyduncan,,1,1,1,2
7509,phughes,,1,127,207,334
7510,theswingingdoor,,1,1,1,2
7511,80085,,1,1,3,4
7512,djepik,,1,208,231,439
7513,madfrogurt,,1,20,15,35
7514,ja30278,,1,19,24,43
7515,panphobia,,1,77,19,96
7516,Bridge_Dweller,,1,5,6,11
7517,tmatte,,1,22,23,45
7518,agnas,,1,2,2,4
7519,dimsdalehedgehog,,1,1,1,2
7520,ibrb,,1,1,2,3
7521,brsmits,,1,10,16,26
7522,raoulduke,,1,146,134,280
7523,fractal74,,1,1,5,6
7524,joemo,,1,1,1,2
7525,CorpusCallosum,,1,3,1,4
7526,Zenthor,,1,33,31,64
7527,scratchpunk7,,1,41,43,84
7528,nater99,,1,5,9,14
7529,jamsiepaine,,1,2,2,4
7530,Blackberry826,,1,1,3,4
7531,thodgson,,1,1,1,2
7532,andreasmk2,,1,6,12,18
7533,alurie,,1,1,3,4
7534,paisleyrob,,1,5,9,14
7535,PissinChicken,,1,4,11,15
7536,stronimo,,1,104,141,245
7537,simoncpu,,1,1,1,2
7538,Captain_Sarcastic,,1,1,3,4
7539,slabgorb,,1,155,203,358
7540,legolust,,1,7,6,13
7541,PissedNumlock,,1,3,4,7
7542,scared1,,1,210,255,465
7543,dar7yl,,1,2,1,3
7544,10acious,,1,14,50,64
7545,jpeel,,1,3,2,5
7546,RedHerringHack,,1,9,14,23
7547,walrod,,1,22,48,70
7548,typicaljoe,,1,53,7,60
7549,dnorton,,1,1,4,5
7550,krymise,,1,4,3,7
7551,Brianchef,,1,1,1,2
7552,allnewupdate,,1,4,2,6
7553,ZeroEffort,,1,37,64,101
7554,curlz,,1,11,5,16
7555,todddominey,,1,7,5,12
7556,roggor,,1,9,13,22
7557,larrypastore,,1,134,178,312
7558,emja,,1,14,24,38
7559,Abandon,,1,14,12,26
7560,xorxor,,1,98,147,245
7561,sjh3585,,1,59,118,177
7562,Sekenre,,1,6,3,9
7563,cyyip,,1,5,3,8
7564,pyroman8813,,1,2,1,3
7565,FireWorm,,1,120,29,149
7566,SEE_YOU_IN_HELL,,1,1,1,2
7567,contour,,1,43,17,60
7568,asnydercdw,,1,3,1,4
7569,erichansa,,1,8,3,11
7570,wolot,,1,1,1,2
7571,l0rddiabl0,,1,13,6,19
7572,kipmartin,,1,25,41,66
7573,JFrizzle,,1,6,6,12
7574,unclean1,,1,4,5,9
7575,lukehyper,,1,4,6,10
7576,mrcoder,,1,163,337,500
7577,syrinx,,1,1,6,7
7578,wetjack,,1,53,143,196
7579,asphodelian,,1,11,43,54
7580,hollywoodphony,,1,29,6,35
7581,jrxq,,1,36,66,102
7582,ushitomo,,1,13,25,38
7583,doctor_yukio_hattori,,1,98,170,268
7584,FritzMuffknuckle,,1,5,9,14
7585,woknroll,,0,6,4,10
7586,jfenserty,,1,1,1,2
7587,Operation_dooms,,1,6,7,13
7588,JohnFive,,1,40,15,55
7589,mecharedneck,,1,63,125,188
7590,hecubus,,1,65,91,156
7591,yellownumberfive,,1,331,337,668
7592,bluntbord,,1,2,4,6
7593,snz3,,1,1,5,6
7594,longboarder543,,1,34,22,56
7595,easymovieref,,1,6,3,9
7596,CCCCCCOMBOBREAKER,,1,6,11,17
7597,hexmode,,1,63,14,77
7598,socialmedia,,1,1,1,2
7599,mig21,,1,49,7,56
7600,MikaelMN,,1,457,19,476
7601,evoLverR,,1,7,12,19
7602,Joff1979,,1,18,15,33
7603,Locke87,,1,61,71,132
7604,redwall_hp,,1,163,301,464
7605,danleykubrick,,1,26,20,46
7606,dedac,,1,23,45,68
7607,joetehplumr,,1,1,1,2
7608,kilimanjaro,,1,9,12,21
7609,Jonathan_the_Nerd,,1,292,359,651
7610,ivey,,1,56,31,87
7611,chimere,,1,5,10,15
7612,MrKlaatu,,1,908,2515,3423
7613,paxit,,1,81,24,105
7614,MrHector,,1,102,28,130
7615,personanongrata,,1,29,9,38
7616,Frostyausty,,1,23,22,45
7617,pdoken,,1,3,9,12
7618,strikethephone,,1,1,1,2
7619,ittybiggy,,1,3,3,6
7620,tjdziuba-h8r,,1,1,1,2
7621,kalsyrinth,,1,17,26,43
7622,iuserailsdurrrrr,,1,4,2,6
7623,julaun,,1,20,40,60
7624,djl,,1,3,4,7
7625,NeuroSys,,1,4,6,10
7626,charbo187,,1,951,1062,2013
7627,nolij420,,1,6,12,18
7628,arcterex,,1,1,1,2
7629,66666,,1,6,13,19
7630,curomo,,1,17,31,48
7631,aktornado,,1,130,91,221
7632,jasonok,,1,18,4,22
7633,kallell,,1,180,16,196
7634,itzar,,1,2,2,4
7635,nraustinii,,1,4,5,9
7636,jlmayo,,1,1,2,3
7637,sanders8,,1,13,33,46
7638,vengeance64,,1,3,2,5
7639,nick_l,,1,1,1,2
7640,Sobek,,1,11,10,21
7641,peacedove,,1,5,6,11
7642,rapsey,,1,24,14,38
7643,shishou,,1,15,36,51
7644,freedomist,,1,2,4,6
7645,pixelbeat_,,1,74,63,137
7646,allhere,,1,9,26,35
7647,TheNightCat,,1,10,16,26
7648,w0wzers,,1,4,13,17
7649,doliorules,,1,36,62,98
7650,GamingTrend,,1,8,6,14
7651,RevantRed,,1,9,18,27
7652,elazutkin,,1,4,10,14
7653,grantmidwinter,,1,227,255,482
7654,redification,,1,107,296,403
7655,metrofeed,,1,133,42,175
7656,Inzamam,,1,14,13,27
7657,TheDancingSalad,,1,10,1,11
7658,Ephemeral_Node,,1,8,5,13
7659,myaj2000,,1,2,3,5
7660,maritzay,,1,1,3,4
7661,robitor,,1,7,24,31
7662,rodjam,,1,2,1,3
7663,rikardlinde,,1,5,2,7
7664,interpreter,,1,1,1,2
7665,Ic0n0clast,,1,94,53,147
7666,SanMikeva,,1,3,2,5
7667,auxxin,,1,6,9,15
7668,Woeful,,1,153,236,389
7669,Tychotesla,,1,3,9,12
7670,intypicalredditfashi,,1,4,4,8
7671,crapulent666,,1,1,2,3
7672,jinko1,,1,5,3,8
7673,danielrm26,,1,577,100,677
7674,Excremento,,1,94,16,110
7675,cynicist,,1,7,12,19
7676,permafrost91,,1,8,4,12
7677,helmut1,,1,1,1,2
7678,heythisisgandhi,,1,131,258,389
7679,burobudar,,1,2,1,3
7680,ringthorp,,1,1,3,4
7681,mitchbones,,1,205,91,296
7682,mapeni,,1,7,15,22
7683,thegalli,,1,203,129,332
7684,xingo,,1,46,122,168
7685,Shadow120,,1,10,10,20
7686,olt,,1,6,3,9
7687,Construct,,1,3,3,6
7688,mulligan,,1,36,34,70
7689,Praesil,,1,64,61,125
7690,rumpusroom,,1,110,139,249
7691,WooParadog,,1,2,1,3
7692,squirt_aka,,1,1,1,2
7693,mikkachops,,1,7,22,29
7694,ADNyce,,1,2,3,5
7695,primbet,,1,27,4,31
7696,d3r1v3d,,1,3,1,4
7697,kdraper,,1,163,304,467
7698,mrtomservo,,1,93,87,180
7699,tigeratty,,1,1,1,2
7700,Nikakoda,,1,1,1,2
7701,chadm,,1,12,23,35
7702,cardinalcajetan,,1,2,1,3
7703,thebacon,,1,8,3,11
7704,christopheles,,1,949,390,1339
7705,kc1man,,1,36,44,80
7706,sanchokeep33,,1,7,4,11
7707,sixstrings,,1,16,4,20
7708,indyjones16,,1,14,9,23
7709,counterspammer,,1,1,2,3
7710,wildster,,1,7,6,13
7711,kinkydarkbird,,1,208,306,514
7712,thebean,,1,1,2,3
7713,Ickypoopy,,1,82,131,213
7714,karapuz1,,1,42,47,89
7715,testleft,,1,7,9,16
7716,DURIDS_has_CAT_FROM,,1,9,24,33
7717,dresden1,,1,1,1,2
7718,mando5ths,,1,2,1,3
7719,savagestranger,,1,18,48,66
7720,df-sean,,1,1,1,2
7721,robmyers,,1,8,10,18
7722,groihbfg,,1,6,3,9
7723,irit1885,,1,3,5,8
7724,doingtimeonearth,,1,11,8,19
7725,lexabear,,1,60,81,141
7726,KneeGrowMAD,,1,1,2,3
7727,Pounce_ca,,1,49,16,65
7728,compu73rg33k,,1,1,8,9
7729,simplify,,1,125,102,227
7730,hatefulhater,,1,1,1,2
7731,qartis,,1,15,28,43
7732,ennead,,1,7,6,13
7733,purplebottle,,1,1,3,4
7734,eMaster101,,1,106,10,116
7735,cokekiller,,1,1,1,2
7736,onelasttime,,1,67,66,133
7737,RPftWO8,,1,4,6,10
7738,jtauber,,1,6,8,14
7739,Filmore,,1,650,890,1540
7740,dratman,,1,2,4,6
7741,eterps,,1,52,23,75
7742,someonesdaughter,,1,2,11,13
7743,w0waddict,,1,3,1,4
7744,CodenameEvan,,1,62,107,169
7745,MoeDrippins,,1,88,66,154
7746,fasdfasdfardas,,1,2,1,3
7747,qazsxx,,1,9,3,12
7748,c0sm1c8,,1,2,3,5
7749,Steffers,,1,2,1,3
7750,kylelap,,1,6,1,7
7751,danuvian,,1,4,4,8
7752,guswatkins,,1,1,2,3
7753,pdq,,1,54,42,96
7754,sugar_man,,1,7,11,18
7755,Tbola,,1,2,1,3
7756,mizike,,1,20,26,46
7757,roaplyn,,1,1,2,3
7758,playbass,,1,6,12,18
7759,jkatlanta,,1,8,2,10
7760,thecity,,1,9,13,22
7761,elberto,,1,5,4,9
7762,FesteringZodiacFairy,,1,1,4,5
7763,jjonphl,,1,1,5,6
7764,flynnfx,,1,42,45,87
7765,jslav201,,1,4,1,5
7766,NickZee,,1,10,9,19
7767,chipt4,,1,27,38,65
7768,petevalle,,1,155,188,343
7769,aerojad,,1,204,55,259
7770,redhenteam,,1,3,3,6
7771,imwalrus,,1,3,4,7
7772,zestor,,1,5,10,15
7773,blackicepro,,1,86,3,89
7774,r00kie,,1,278,494,772
7775,bingoczar,,1,111,61,172
7776,ForeverTangent,,1,9,1,10
7777,poi0987,,1,6,3,9
7778,General_Hilarity,,1,62,61,123
7779,TyroneSloth,,1,1,10,11
7780,sdfgkluj,,1,58,59,117
7781,2x4,,1,1,2,3
7782,the_vanguardian,,1,34,4,38
7783,liberte49,,1,12,22,34
7784,Taikoto,,1,1,4,5
7785,kemibe,,1,12,9,21
7786,someshta,,1,9,2,11
7787,aestheticreddit,,1,14,13,27
7788,tazmanic,,1,4,6,10
7789,JohnFromChicago,,1,7,1,8
7790,epiclogin,,1,102,48,150
7791,masterdirk,,1,66,78,144
7792,gozmeranian,,1,594,174,768
7793,topherclay,,1,315,610,925
7794,ioiioiloi,,1,1,6,7
7795,daoine_sidhe,,1,2,2,4
7796,aacase,,1,48,26,74
7797,HalcyonSskyler,,1,24,30,54
7798,swiftbuttsfortruth,,1,6,8,14
7799,axul,,1,1,2,3
7800,magz0r,,1,6,7,13
7801,Birdy58033,,1,9,8,17
7802,SnackConcepts,,1,20,24,44
7803,Squarsh,,1,126,76,202
7804,Sierra81,,1,25,2,27
7805,Virjyl,,1,2,1,3
7806,andrewjstone,,1,3,8,11
7807,mozahid,,1,6,6,12
7808,gigaset,,1,3,5,8
7809,gregturn,,1,2,6,8
7810,molls22,,1,3,1,4
7811,earthtograndma,,1,1,1,2
7812,tftb,,1,1,3,4
7813,5seconds,,1,5,1,6
7814,smylie,,1,5,3,8
7815,rule,,1,61,67,128
7816,skazhy,,1,35,13,48
7817,traxstarz,,1,6,14,20
7818,masont,,1,13,16,29
7819,Jumile,,1,20,41,61
7820,fcukbear,,1,213,86,299
7821,teeks,,1,10,7,17
7822,bagley,,1,3,2,5
7823,lotkrotan,,1,2,16,18
7824,lmanc,,1,1,1,2
7825,Flying_Teapot,,1,9,22,31
7826,bagofcats,,1,1,3,4
7827,sgtdiarrhea,,1,2,4,6
7828,north,,1,21,30,51
7829,LinesOpen,,1,45,37,82
7830,aajenkin,,1,1,1,2
7831,mblakele,,1,1,3,4
7832,newbie27,,1,5,10,15
7833,rockhoward,,1,2,18,20
7834,brockelyn,,1,15,30,45
7835,red_cloud,,1,6,21,27
7836,justaname,,1,6,16,22
7837,ngrudin,,1,1,1,2
7838,randomusername2,,1,2,1,3
7839,anon_smoker,,1,2,3,5
7840,dotist,,1,5,3,8
7841,codergirl,,1,1,1,2
7842,etiole,,1,3,1,4
7843,jdvolz,,1,8,6,14
7844,zephos,,1,7,4,11
7845,alina_popescu,,1,18,8,26
7846,foobster,,1,1,4,5
7847,narcalexi,,1,2,2,4
7848,mattrepl,,1,22,16,38
7849,Frankbert,,1,3,4,7
7850,happyhappy,,1,51,79,130
7851,balgarath,,1,3,5,8
7852,magicducksauce,,1,39,50,89
7853,tblarson,,1,407,31,438
7854,Mentor,,1,5,9,14
7855,AlucardZero,,1,20,22,42
7856,CabSyrah,,1,1,1,2
7857,InfoWarrior905,,1,36,51,87
7858,case-o-nuts,,1,171,236,407
7859,pjesi,,1,1,10,11
7860,binro,,1,4,3,7
7861,User202,,1,4,10,14
7862,meatpopsikle,,1,11,14,25
7863,-omg-optimized,,1,43,75,118
7864,iTroll,,1,95,40,135
7865,redawn,,1,97,172,269
7866,sherkaner,,1,96,142,238
7867,tookus,,1,1,3,4
7868,pRedditor11,,1,19,22,41
7869,blindcyde,,1,6,6,12
7870,Zoocchini,,1,4,16,20
7871,sockmarionette,,1,27,1,28
7872,manateesareneat,,1,93,106,199
7873,rodgling,,1,4,4,8
7874,funkyfurry,,1,1,1,2
7875,datamichaelxxx,,1,7,6,13
7876,Berry_Logo,,1,38,24,62
7877,spraynard,,1,4,13,17
7878,Monopolies,,1,8,19,27
7879,justjim73,,1,801,180,981
7880,xgerrit,,1,1,1,2
7881,insaneflame24,,1,18,12,30
7882,beosnitch,,1,6,18,24
7883,Coffee_Apocalypse,,1,13,4,17
7884,idoubleplusedyourmom,,1,1,1,2
7885,gnat23,,1,62,1,63
7886,Wallstreet,,1,2,2,4
7887,jokesterss,,1,1,2,3
7888,zerok,,1,4,1,5
7889,mirra,,1,10,13,23
7890,epic,,1,17,30,47
7891,noyfbfoad,,1,1,2,3
7892,Cardin,,1,1,1,2
7893,gwright,,1,15,18,33
7894,pr0methium,,1,8,3,11
7895,seattlebartender,,1,2,4,6
7896,kylcrow,,1,1,1,2
7897,100EducWay,,1,1,1,2
7898,Emolee,,1,9,7,16
7899,dirkmcdirt,,1,33,13,46
7900,hsdkfhusfhuio,,1,1,2,3
7901,jones77,,1,948,1172,2120
7902,Clevedog,,1,38,44,82
7903,the_engineer_says,,1,2,1,3
7904,chibioz,,1,16,28,44
7905,chaitujm,,1,30,13,43
7906,HilldogBigTitsYayuh,,1,1,2,3
7907,cesarwal,,1,6,22,28
7908,bridgietherease,,1,24,31,55
7909,stewdick,,1,17,12,29
7910,yardwaste,,1,11,10,21
7911,branston,,1,112,146,258
7912,notes,,1,6,16,22
7913,PastorX,,1,3,4,7
7914,El_Fajitas,,1,6,11,17
7915,prometeus,,1,2,2,4
7916,hoooked,,1,8,25,33
7917,pjf,,1,2,1,3
7918,ki11a11hippies,,1,498,234,732
7919,MrSarcasm,,1,2,4,6
7920,astraycat,,1,1,4,5
7921,prophet001,,1,70,129,199
7922,mumumum,,1,2,2,4
7923,fasterx,,1,1,6,7
7924,othermatt,,1,3,4,7
7925,maddpaky,,1,3,1,4
7926,Enginerd,,1,224,412,636
7927,hemmicw9,,1,103,45,148
7928,chuz0,,1,2,7,9
7929,Tabooyah,,1,9,7,16
7930,saysthegiraffe,,1,3,1,4
7931,davidlvann,,1,17,13,30
7932,milesaday,,1,2,2,4
7933,2skinny,,1,8,17,25
7934,MagicOtter,,1,1,1,2
7935,onar,,1,1,1,2
7936,mattbarclay,,1,6,10,16
7937,Anzi,,1,16,33,49
7938,remmosi,,1,1,2,3
7939,Deadpixel1221,,1,309,89,398
7940,surreal1,,1,5,9,14
7941,greenman7,,1,4,16,20
7942,Intrepid1,,1,1,1,2
7943,philipjfry,,1,10,8,18
7944,ulric,,1,1,3,4
7945,debeli,,1,2,2,4
7946,QueBarbara,,1,18,10,28
7947,kgsokl,,1,36,44,80
7948,jefehurst,,1,1,1,2
7949,Internal_Affairs_Dpt,,1,1,1,2
7950,llanor,,1,644,775,1419
7951,justastatistic,,1,20,16,36
7952,slb,,1,75,47,122
7953,travois,,1,1,2,3
7954,Lee_Nukes,,1,18,35,53
7955,ak01,,1,1,1,2
7956,fakeaccount1,,1,7,1,8
7957,btanaka,,1,3,1,4
7958,catnamedmax,,1,99,70,169
7959,cwd67,,1,4,10,14
7960,titusbrown,,1,2,4,6
7961,pragma,,1,98,12,110
7962,Meltacular,,1,1,1,2
7963,chneukirchen,,1,126,139,265
7964,panamaspace,,1,225,379,604
7965,benlund,,1,16,17,33
7966,dkeinge,,1,1,2,3
7967,paf0,,1,289,156,445
7968,Bwardrop,,1,9,2,11
7969,TheRealSwoop,,1,18,5,23
7970,bokchoy20,,1,5,2,7
7971,Audity,,1,1,1,2
7972,msaint,,1,12,12,24
7973,kevingessner,,1,4,1,5
7974,splorky,,1,1,1,2
7975,oddly,,1,1,1,2
7976,destijl13,,1,8,11,19
7977,br0wn0ut,,1,5,3,8
7978,demoniusrex,,1,9,4,13
7979,wrongwindow,,1,6,14,20
7980,Lunitide,,1,13,23,36
7981,baxyjr,,1,47,70,117
7982,hesika,,1,1,1,2
7983,ballpressure,,1,202,211,413
7984,pongo,,1,61,73,134
7985,lude,,1,13,7,20
7986,jkldfkjldfakjladsf,,1,1,1,2
7987,flavor8,,1,63,82,145
7988,saft,,1,4,8,12
7989,Shannonigans,,1,34,77,111
7990,dimitrij,,1,2,1,3
7991,lordvirus,,1,1,1,2
7992,nekosej,,1,2,1,3
7993,kickthatbass,,1,3,2,5
7994,personsaddress,,1,2,6,8
7995,homestyle,,1,2,2,4
7996,olivia_2,,1,2,1,3
7997,amandalea,,1,1,4,5
7998,usernameII,,1,1,1,2
7999,dobaman,,1,131,185,316
8000,dienaid,,1,2,2,4
8001,ltjpunk387,,1,29,29,58
8002,matelotgeek,,1,25,96,121
8003,triplewide,,1,1,2,3
8004,twotimepostaccount,,1,3,1,4
8005,captain_gordino,,1,156,274,430
8006,Anderson82,,1,5,8,13
8007,mds,,1,2,6,8
8008,Quicksilver_Johny,,1,1,2,3
8009,goobegudde,,1,1,2,3
8010,FlashRage,,1,2,2,4
8011,papelboner,,1,16,3,19
8012,drebeck,,1,56,11,67
8013,NaziGrammar,,1,18,39,57
8014,postur3,,1,3,1,4
8015,dozo,,1,1,1,2
8016,pat_o,,1,65,16,81
8017,reasonattlm,,1,30,3,33
8018,chunkyslink,,1,14,9,23
8019,brunetteonabudget,,1,3,2,5
8020,yanni,,1,30,23,53
8021,rogerssucks,,1,1257,1575,2832
8022,iocchelli,,1,52,78,130
8023,JerkfaceMcGee,,1,5,2,7
8024,loopla,,1,4,2,6
8025,jonah-,,1,2,5,7
8026,hunli,,1,5,6,11
8027,TallStu,,1,1,1,2
8028,andrewd,,1,923,1111,2034
8029,singingfish42,,1,35,33,68
8030,EsotericFox,,1,15,14,29
8031,asshole123,,1,1,1,2
8032,wendelgee2,,1,67,112,179
8033,lisp-hacker,,1,19,30,49
8034,hansolo,,1,17,26,43
8035,AutomatedTrollBot,,1,9,9,18
8036,marijn,,1,65,76,141
8037,techtoy,,1,16,17,33
8038,deaddjembe,,1,3,1,4
8039,Luinitari,,1,2,1,3
8040,mhatt,,1,49,51,100
8041,tenken,,1,402,80,482
8042,garrgh,,1,28,27,55
8043,ender6,,1,35,42,77
8044,shakestheclown,,1,14,31,45
8045,jinkop38,,1,1,2,3
8046,antmandan,,1,6,4,10
8047,gotjuice,,1,819,2,821
8048,arne,,1,3,7,10
8049,photogtony,,1,2,1,3
8050,vishnuvardhanraop,,1,7,1,8
8051,eserorg,,1,1,1,2
8052,enri,,1,7,17,24
8053,birdlives,,1,2,3,5
8054,fuelvolts,,1,12,9,21
8055,Sovereign,,1,1,1,2
8056,Sylense,,1,11,12,23
8057,Sukoshi,,1,17,33,50
8058,alucididea,,1,1,1,2
8059,fastfinge,,1,1,2,3
8060,tdrizzle,,1,149,152,301
8061,njm,,1,5,5,10
8062,dahburbb,,1,1,2,3
8063,gpowell88,,1,4,1,5
8064,bbrian1,,1,3,6,9
8065,Turno,,1,17,11,28
8066,oniall,,1,1,6,7
8067,DartStudent,,1,1,1,2
8068,Logoll,,1,54,62,116
8069,kawauchi,,1,15,1,16
8070,fino963,,1,1,2,3
8071,niggles,,1,18,17,35
8072,pushpin,,1,99,271,370
8073,picrad,,1,1,3,4
8074,bumrushtheshow,,1,2,5,7
8075,kevinalright,,1,2,4,6
8076,ThirstyFerret,,1,2,1,3
8077,skiaec04,,1,24,22,46
8078,leonstagg428,,1,1,1,2
8079,thoroughly,,1,5,6,11
8080,dharh,,1,28,56,84
8081,jeramey,,1,2,9,11
8082,e_to_the_m,,1,37,4,41
8083,lar,,1,83,9,92
8084,hurfery,,1,17,24,41
8085,kubrickrules,,1,3,7,10
8086,denimdragon,,1,1,2,3
8087,mimic,,1,57,152,209
8088,bowie36,,1,2,1,3
8089,nycjohndoe,,1,21,25,46
8090,Non_Sequitur_,,1,21,26,47
8091,andnow,,1,11,16,27
8092,unshifted,,1,127,140,267
8093,Weirdsmobile,,1,2,2,4
8094,mkk,,1,3,5,8
8095,seven10design,,1,1,1,2
8096,borud,,1,25,39,64
8097,reddit-QA,,1,4,5,9
8098,gracin,,1,7,5,12
8099,Manny82,,1,27,20,47
8100,flecknoe,,1,6,4,10
8101,blunster,,1,1,2,3
8102,Blue_Eskimo,,1,67,47,114
8103,alcanada,,1,89,50,139
8104,cendant,,1,71,39,110
8105,Pappenheimer,,1,327,511,838
8106,ssander,,1,83,33,116
8107,cemerick,,1,10,6,16
8108,timothyfitz,,1,3,6,9
8109,jnzfin,,1,6,8,14
8110,paspektibu,,1,18,19,37
8111,kdizzle13,,1,24,24,48
8112,BoardColorado,,1,32,36,68
8113,criswell,,1,79,142,221
8114,beermann,,1,3,2,5
8115,J0hnDvorak,,1,11,10,21
8116,michelle1959,,1,1,1,2
8117,gnomemage7,,1,7,10,17
8118,smaster87,,1,15,20,35
8119,NeverReadsTheArticle,,1,12,39,51
8120,qoumran,,1,1,2,3
8121,daemmon,,1,33,43,76
8122,GWaleed,,1,89,164,253
8123,Frobenius,,1,145,116,261
8124,bensone1,,1,10,17,27
8125,eluusive,,1,3,2,5
8126,spolsky,,1,10,4,14
8127,stevesan,,1,61,105,166
8128,duncanbojangles,,1,32,44,76
8129,bob4apples,,1,43,108,151
8130,alkfjasldf,,1,1,1,2
8131,meglet,,1,323,379,702
8132,Xiol,,1,411,530,941
8133,shivoham,,1,5,3,8
8134,coutourier,,1,1,4,5
8135,sabrina17331979,,1,10,18,28
8136,sesh,,1,50,16,66
8137,ast3r3x,,1,1,2,3
8138,royalawesome,,1,3,7,10
8139,TeejPDX,,1,1,1,2
8140,MonsieurX,,1,1,1,2
8141,jackolantern75,,1,15,1,16
8142,pkunk,,1,26,27,53
8143,IceCreamYou,,1,15,1,16
8144,ralphthewonderlama,,1,1,1,2
8145,raouldagain,,1,24,27,51
8146,malenky,,1,14,7,21
8147,ogeidnas,,1,7,12,19
8148,ithkuil,,1,145,154,299
8149,z0id,,1,28,14,42
8150,edelweisspirate,,1,14,21,35
8151,doubleD,,1,6,6,12
8152,louismg,,1,32,5,37
8153,SlightlyEmbarassed12,,1,1,1,2
8154,Chancy,,1,120,41,161
8155,Kayeak7,,1,1,2,3
8156,mossman,,1,41,56,97
8157,spelunker,,1,184,211,395
8158,TheHolyBible,,1,1,2,3
8159,jay71,,1,2,2,4
8160,BHGDigital,,1,2,1,3
8161,pussnboots,,1,2,2,4
8162,37prime,,1,1,4,5
8163,jdickinson,,1,5,6,11
8164,purplecow,,1,14,16,30
8165,cqxray,,1,3,4,7
8166,ObamaCampaign,,1,15,19,34
8167,tanka,,1,8,12,20
8168,poco,,1,313,497,810
8169,Dorphat,,1,7,9,16
8170,mgeisler,,1,1,2,3
8171,toastbot,,1,3,11,14
8172,formated4tv,,1,31,39,70
8173,Abegale,,1,1,1,2
8174,beamrider9,,1,118,4,122
8175,cf80,,1,14,12,26
8176,shadoi,,1,1,1,2
8177,opennorse,,1,7,1,8
8178,alicetiara,,1,1,1,2
8179,MarginOfError,,1,36,59,95
8180,Snowflake23,,1,1,1,2
8181,pedokip,,1,4,7,11
8182,jaysonbank,,1,517,581,1098
8183,Insignificant,,1,262,493,755
8184,jeepxj206,,1,16,7,23
8185,golgi42,,1,2,1,3
8186,ar8699,,1,13,14,27
8187,powersoffour,,1,2,1,3
8188,Arkonnan,,1,53,86,139
8189,bojancho,,1,227,111,338
8190,wackoquackosacko,,1,1,1,2
8191,fanboyssuck,,1,1,1,2
8192,ahminus,,1,44,74,118
8193,techshaman,,1,11,1,12
8194,morfin,,1,4,4,8
8195,ShannonO,,1,16,21,37
8196,cuzzy,,1,48,13,61
8197,PickledJesus,,1,9,9,18
8198,rtfmplease,,1,1,1,2
8199,cdellin,,1,1,1,2
8200,skippy17,,1,548,610,1158
8201,roorksw,,1,9,16,25
8202,erinsikora,,1,1,1,2
8203,brymax,,1,73,51,124
8204,J-Bone,,1,114,46,160
8205,o0dano0o,,1,52,80,132
8206,milkymanchester,,1,3,4,7
8207,hetmankp,,1,10,9,19
8208,potifer,,1,40,61,101
8209,splynch,,1,1,1,2
8210,BREAKING_OMG,,1,246,251,497
8211,codingjester,,1,3,8,11
8212,cstod83,,1,15,36,51
8213,syn-abounds,,1,464,252,716
8214,macnomad84,,1,33,41,74
8215,takebackcongress,,1,1,1,2
8216,hayzeus,,1,39,91,130
8217,SeanC,,1,2,1,3
8218,pkhuong,,1,53,81,134
8219,devolute,,1,229,362,591
8220,jojopotato,,1,6,15,21
8221,Rythin,,1,11,4,15
8222,nibinathion,,1,7,3,10
8223,tontovila,,1,23,20,43
8224,nolife,,1,1,4,5
8225,widestancedude,,1,13,12,25
8226,masg11,,1,1,1,2
8227,fyl899,,1,2,1,3
8228,uberto,,1,45,86,131
8229,arantius,,1,43,63,106
8230,taclbo,,1,2,2,4
8231,truthersaredumb,,1,1,1,2
8232,Cronof,,1,10,6,16
8233,Alexd007,,1,11,11,22
8234,sanchopanza,,1,2,7,9
8235,profblix,,1,21,29,50
8236,cofun,,1,1,1,2
8237,LostOne,,1,4,5,9
8238,Cbird54,,1,21,33,54
8239,machocheese,,1,1,2,3
8240,starkwhite,,1,188,164,352
8241,Skip_Town,,1,31,47,78
8242,IngsocFTW,,1,17,27,44
8243,carvdouttawood,,1,9,4,13
8244,roguebagel,,1,35,29,64
8245,Consumer-Warning,,1,3,7,10
8246,irjav,,1,2,3,5
8247,yesimalex,,1,2,1,3
8248,Lukadium,,1,705,10,715
8249,celebrity208,,1,1,1,2
8250,raman00,,1,10,7,17
8251,brettbum,,1,1,1,2
8252,saromanenko,,1,1,1,2
8253,carlospc,,1,6,19,25
8254,trbo20,,1,74,65,139
8255,syngen,,1,11,11,22
8256,mtanski,,1,5,4,9
8257,wnbe,,1,22,20,42
8258,RonPaulUsesLisp,,1,4,4,8
8259,cemason9009,,1,3,1,4
8260,lameuser,,1,3,2,5
8261,moussif,,1,13,14,27
8262,SamsLembas,,1,194,217,411
8263,karapuz,,1,12,12,24
8264,MoreCowbellPlease,,1,33,67,100
8265,trezor2,,1,402,513,915
8266,politicon,,1,3,3,6
8267,nomecks,,1,8,2,10
8268,Mrs_Sinner,,1,2,1,3
8269,ruffyamaharyder,,1,1,1,2
8270,Escher0,,1,3,5,8
8271,apsampson,,1,6,17,23
8272,Quizbiz,,1,36,83,119
8273,brainspan,,1,1,3,4
8274,Texel,,1,20,37,57
8275,lordgilman,,1,7,10,17
8276,malekov,,1,136,147,283
8277,diggeasytiger,,1,1,1,2
8278,assman13,,1,2,2,4
8279,zeindaman,,1,3,2,5
8280,tagx,,1,3,3,6
8281,Thats_What_She_Said,,1,2,1,3
8282,ACArticulate,,1,1,1,2
8283,UNTmeangreen,,1,5,8,13
8284,funksta,,1,36,37,73
8285,gamerates,,1,11,1,12
8286,MonumentMan,,1,31,31,62
8287,russianbandit,,1,423,82,505
8288,k79,,1,1,6,7
8289,jacksofscience,,1,5,3,8
8290,stratonike,,1,2,1,3
8291,mlawless1138,,1,322,105,427
8292,barney52,,1,8,6,14
8293,powerfuless,,1,35,47,82
8294,hannityisgod,,1,4,1,5
8295,dwils27,,1,51,82,133
8296,rnichols,,1,29,35,64
8297,mstubz,,1,1,1,2
8298,2phatgeeks,,1,24,1,25
8299,os851,,1,2,13,15
8300,hippely,,1,2,2,4
8301,spinemangler,,1,47,57,104
8302,montreal01,,1,532,92,624
8303,rugby8man,,1,94,37,131
8304,SpiritBreakr,,1,130,10,140
8305,lelthompson,,1,3,1,4
8306,monopoleroy,,1,175,49,224
8307,kyew,,1,1,3,4
8308,aquanutz,,1,26,51,77
8309,farang,,1,12,27,39
8310,mrboj,,1,9,2,11
8311,RasberryTurtle,,1,1,1,2
8312,thewriteguy,,1,150,148,298
8313,jnag,,1,156,201,357
8314,lorena,,1,125,24,149
8315,earlsofsandwich,,1,58,37,95
8316,skinnyuser,,1,1,1,2
8317,posiduck,,1,15,11,26
8318,CodeRedEd,,1,1,4,5
8319,oOllOo,,1,2,2,4
8320,brokencow,,1,1,3,4
8321,parismay34,,1,3,1,4
8322,mechastyle,,1,2,4,6
8323,buzzbeepbeep,,1,39,5,44
8324,arpunk,,1,1,1,2
8325,wankerbot,,1,292,461,753
8326,jkatz,,1,10,5,15
8327,jimmybob34,,1,5,11,16
8328,hunter9000,,1,75,149,224
8329,tunacow,,1,3,2,5
8330,jwb1504,,1,1,1,2
8331,robbyking,,1,23,50,73
8332,vidmark156,,1,2,2,4
8333,SnakeWaisted,,1,1,1,2
8334,lowerlogic,,1,3,6,9
8335,pwim,,1,13,5,18
8336,texmex,,1,36,83,119
8337,HansHotter,,1,13,13,26
8338,global360,,1,56,12,68
8339,NoYouAreTheFucktard,,1,1,1,2
8340,notpeter,,1,5,11,16
8341,nakor28,,1,2,2,4
8342,smashcrab,,1,2,1,3
8343,freshmas,,1,1,4,5
8344,sblinn,,1,1173,1551,2724
8345,bluefish101,,1,2,1,3
8346,gordohimself,,1,2,1,3
8347,judgsjobs,,1,2,1,3
8348,BentonMiller,,1,4,3,7
8349,spiretop,,1,2,1,3
8350,DocTomoe,,1,105,143,248
8351,dmi123,,1,3,4,7
8352,SyncMaster,,1,29,66,95
8353,Jjess311,,1,1,3,4
8354,kstauss,,1,1,1,2
8355,MUGATU66,,1,1,1,2
8356,dHoser,,1,314,510,824
8357,qda,,1,51,133,184
8358,br1776,,1,109,44,153
8359,brotherfirefly,,1,32,40,72
8360,maxxpower5000,,1,1,1,2
8361,semmi,,1,58,77,135
8362,DoorM,,1,11,14,25
8363,bpgb,,1,3,4,7
8364,dgilby,,1,2,2,4
8365,bekkle,,1,66,79,145
8366,mcohenATbulbsDOTcom,,1,18,3,21
8367,colindean,,1,2,2,4
8368,RaceAgainstAtrophy,,1,2,1,3
8369,KramitTheFrog44,,1,5,10,15
8370,mgainor,,1,1,1,2
8371,dwinnk,,1,1,1,2
8372,Haddaway,,1,21,25,46
8373,thesantini,,1,2,4,6
8374,justincase1021,,1,42,109,151
8375,grav,,1,2,9,11
8376,Sealab2021,,1,15,7,22
8377,Brenden105,,1,33,27,60
8378,Comic_Sans_MS,,1,4,5,9
8379,GodDamnedX,,1,1,6,7
8380,tywolff,,1,13,16,29
8381,sauce2,,1,7,9,16
8382,variableenigma,,1,2,3,5
8383,mooseclamps,,1,11,21,32
8384,carac,,1,213,293,506
8385,wustudybreak,,1,22,22,44
8386,conmulligan,,1,17,11,28
8387,MrData,,1,7,7,14
8388,Captain_Midnight,,1,282,332,614
8389,austin_k,,1,127,181,308
8390,sassmo,,1,7,3,10
8391,TheHobo,,1,6,5,11
8392,Boxorz,,1,1,1,2
8393,jwimberly,,1,1,2,3
8394,0124816,,1,8,21,29
8395,NoodlyAppendage,,1,111,214,325
8396,pudica,,1,10,9,19
8397,EFall26,,1,8,11,19
8398,zaphod_42,,1,132,116,248
8399,maxwellimus,,1,13,6,19
8400,kerbuffel,,1,359,349,708
8401,deephouse24,,1,24,25,49
8402,crox,,1,25,7,32
8403,TaterRecon,,1,12,27,39
8404,incomingfire,,1,17,26,43
8405,spikey1000,,1,37,48,85
8406,kalimistuk,,1,1,1,2
8407,Internet_Meme,,1,100,90,190
8408,el_bandito,,1,4,1,5
8409,supersauce,,1,515,1074,1589
8410,grimmuss,,1,8,24,32
8411,star-d,,1,335,115,450
8412,Technica,,1,2,1,3
8413,eugene_victor_tooms,,1,79,19,98
8414,LeNoir,,1,90,113,203
8415,madelinecn,,1,209,162,371
8416,clivefx,,1,8,20,28
8417,transeunte,,1,32,51,83
8418,sartak,,1,31,54,85
8419,vootiebox,,1,334,272,606
8420,Timequake,,1,4,5,9
8421,heresybob,,1,205,349,554
8422,miborovsky,,1,113,191,304
8423,mrjuandrful,,1,94,13,107
8424,mmmscallops,,1,2,2,4
8425,tulsakev,,1,2,3,5
8426,oxygen2,,1,20,2,22
8427,jstrebel,,1,2,1,3
8428,mikusjay,,1,4,10,14
8429,gene9,,1,5,2,7
8430,96mileshome,,1,13,17,30
8431,heyjon,,1,22,23,45
8432,ralphwiggum,,1,218,332,550
8433,littlefinger,,1,61,15,76
8434,badseedjr,,1,17,16,33
8435,zyzzx0,,1,8,10,18
8436,shisno,,1,2,3,5
8437,asr,,1,168,204,372
8438,rail16,,1,3,10,13
8439,RedGarland,,1,1,1,2
8440,Klama,,1,1,1,2
8441,vladk,,1,3,2,5
8442,inabsolutes,,1,1,1,2
8443,gottareadit,,1,185,366,551
8444,TheGunner,,1,3,8,11
8445,TheMachine,,1,62,21,83
8446,forrestparkay,,1,50,76,126
8447,epsilona01,,1,533,951,1484
8448,root,,1,10,10,20
8449,z0m_a,,1,38,49,87
8450,blinz,,1,2,2,4
8451,porkcharsui,,1,16,9,25
8452,davidreiss666,,1,1784,1247,3031
8453,mizunoz,,1,3,3,6
8454,pingwin,,1,3,3,6
8455,heh_yeh,,1,221,205,426
8456,danielg7,,1,46,74,120
8457,enkafan,,1,228,200,428
8458,fr0z3nph03n1x,,1,9,11,20
8459,neura,,1,52,46,98
8460,Artmageddon,,1,110,178,288
8461,ronpaulist,,1,3,2,5
8462,mateo3,,1,1,1,2
8463,CozyGundam,,1,6,5,11
8464,don_draper,,1,1,2,3
8465,Rockmaninoff,,1,13,6,19
8466,brave_new_world,,1,1,2,3
8467,tji,,1,1,2,3
8468,benackerman,,1,2,2,4
8469,NightcrawlerX,,1,104,13,117
8470,hishuu,,1,15,29,44
8471,Dubfire,,1,15,4,19
8472,fredhersher,,1,28,1,29
8473,tpahornet,,1,1,11,12
8474,actionscripted,,1,38,73,111
8475,generic-identity,,1,1,2,3
8476,ei2g,,1,8,1,9
8477,tlynnsimon,,1,2,1,3
8478,winnipegtommy,,1,134,169,303
8479,losferwords,,1,57,50,107
8480,GoTeamAmerica,,1,1,1,2
8481,karmachu,,1,3,2,5
8482,mijamala1,,1,17,14,31
8483,deese64,,1,1,2,3
8484,goobersmooch,,1,4,2,6
8485,brianwisti,,1,1,5,6
8486,alterEgon,,1,1,1,2
8487,jonnythin,,1,1,3,4
8488,adamfbs,,1,6,8,14
8489,ciontaba,,1,25,31,56
8490,redditspirit,,1,13,4,17
8491,somedeveloper,,1,8,2,10
8492,Keeri3,,1,10,32,42
8493,Individualista,,1,6,4,10
8494,pny,,1,2,1,3
8495,ronideutch,,1,7,7,14
8496,ajayrockrock,,1,7,13,20
8497,99percentchimp,,1,4,2,6
8498,firefruze,,1,120,296,416
8499,BandraK,,1,2,3,5
8500,kanchan_1304,,1,1,1,2
8501,keithnoir,,1,4,3,7
8502,herrmann,,1,26,11,37
8503,nexus2112,,1,15,19,34
8504,cyrusmancub,,1,2,1,3
8505,caswyn,,1,5,4,9
8506,michaeljones7,,1,2,2,4
8507,BlackJelly,,1,31,22,53
8508,happymcclinch,,1,7,5,12
8509,SJurgenson,,1,10,6,16
8510,tranquil,,1,1,1,2
8511,dcg,,1,2,2,4
8512,martincmartin,,1,135,77,212
8513,chanandler_bong,,1,4,1,5
8514,cavorite,,1,11,7,18
8515,marktron,,1,54,63,117
8516,goober8008,,1,69,135,204
8517,stroop,,1,1,2,3
8518,fvincentis,,1,21,29,50
8519,samehereyo,,1,11,12,23
8520,Prod,,1,13,15,28
8521,zwood,,1,3,8,11
8522,helloworldbea,,1,266,87,353
8523,jshirley,,1,2,3,5
8524,orsa,,1,16,18,34
8525,--------------------,,1,4,4,8
8526,Barack_Obama,,1,2,1,3
8527,Raisins,,1,233,10,243
8528,thrillho,,1,1,1,2
8529,super_duper,,1,46,67,113
8530,dassouki,,1,48,51,99
8531,raopm,,1,9,1,10
8532,willlin87,,1,25,55,80
8533,jp007,,1,46,97,143
8534,strained_brain,,1,6,4,10
8535,normal,,1,4,8,12
8536,mikeylikesit,,1,1,1,2
8537,oakleez,,1,115,7,122
8538,moldworld2008,,1,5,1,6
8539,skandel,,1,7,3,10
8540,SysAdmin412,,1,15,1,16
8541,dr_spork,,1,61,91,152
8542,JOEINDIAK,,1,10,20,30
8543,baalduriel,,1,1,3,4
8544,sgfsdfgsdfg,,1,160,165,325
8545,NEWSUNSEO,,1,2,1,3
8546,corporate_america,,1,4,8,12
8547,bryanveloso,,1,1,1,2
8548,hseldon_99,,1,2,7,9
8549,asfsadf,,1,4,2,6
8550,gtbth,,1,1,9,10
8551,eve6andahalf,,1,13,9,22
8552,mogmog,,1,349,423,772
8553,techsticle,,1,25,29,54
8554,Dadelus,,1,103,95,198
8555,kaptainlange,,1,213,330,543
8556,bustamove259,,1,1,1,2
8557,jspeights,,1,32,47,79
8558,vivaladisney,,1,10,14,24
8559,fandyboy,,1,6,10,16
8560,slim_nick,,1,1,3,4
8561,cycle2,,1,49,49,98
8562,modality,,1,8,12,20
8563,SrGrieves,,1,8,8,16
8564,sonicreducer333,,1,316,193,509
8565,arockthebebop,,1,1,2,3
8566,crzytech1,,1,16,16,32
8567,shaymoss,,1,1,2,3
8568,jodonoghue,,1,1,5,6
8569,danteferno,,1,1,1,2
8570,totalnet,,1,1,1,2
8571,notgibb,,1,179,154,333
8572,Curvature,,1,1,3,4
8573,mayuge_born,,1,9,12,21
8574,z144man,,1,4,16,20
8575,Errol,,1,5,1,6
8576,canonymousoward,,1,1,1,2
8577,spezdispenser,,1,7,5,12
8578,jals,,1,78,30,108
8579,greenmoon,,1,13,23,36
8580,freewine,,1,32,2,34
8581,jetcopter,,1,3,4,7
8582,skullphuct,,1,2,1,3
8583,arwb,,1,4,6,10
8584,Unsmith,,1,7,11,18
8585,Gregste,,1,2,1,3
8586,SSChicken,,1,7,2,9
8587,karatechops,,1,262,249,511
8588,pmazer,,1,1,1,2
8589,oneblue,,1,2,2,4
8590,andrewli4,,1,3,2,5
8591,gracenotes,,1,25,36,61
8592,88dan88,,1,218,372,590
8593,balibones,,1,25,18,43
8594,zenif,,1,45,83,128
8595,laluser,,1,32,24,56
8596,qwertys,,1,94,177,271
8597,thesupermario,,1,3,2,5
8598,mattmattmatt,,1,8,4,12
8599,robewald,,1,6,13,19
8600,hilldog,,1,82,153,235
8601,egbert,,1,214,54,268
8602,Futurepower,,1,1,2,3
8603,maytard,,1,1,1,2
8604,EternalVigilance,,1,1365,656,2021
8605,Readmore,,1,8,3,11
8606,thephilip,,1,46,19,65
8607,outofline,,1,1,1,2
8608,Pillowtalk,,1,104,166,270
8609,Hypn0s,,1,5,3,8
8610,capecode,,1,36,18,54
8611,markon,,1,6,4,10
8612,digginahole,,1,169,167,336
8613,sfluke20,,1,4,3,7
8614,johndisko,,1,1,4,5
8615,Ripzerskins,,1,12,25,37
8616,speeddaemon,,1,19,12,31
8617,jawdirk,,1,10,15,25
8618,urnyfy,,1,1,1,2
8619,mikelanzaro,,1,1,11,12
8620,Old_Timer,,1,18,17,35
8621,SteveD88,,1,181,197,378
8622,Rollouts,,1,5,4,9
8623,select,,1,12,8,20
8624,simonw,,1,80,87,167
8625,mbuf,,1,44,6,50
8626,pdrummond,,1,35,11,46
8627,disbelief,,1,6,5,11
8628,djblade1501,,1,2,1,3
8629,arkestra,,1,1,1,2
8630,giiik,,1,10,11,21
8631,christinextine,,1,2,1,3
8632,AKStuart,,1,3,5,8
8633,DL_Adidas,,1,1,1,2
8634,theredgiant,,1,353,31,384
8635,infinityvortex,,1,376,595,971
8636,herchen,,1,2,7,9
8637,anal_avenger,,1,3,5,8
8638,yome,,1,34,8,42
8639,jamwil,,1,5,8,13
8640,goj1ra,,1,48,85,133
8641,dailydishabille,,1,69,123,192
8642,TylerDurdenJunior,,1,184,77,261
8643,sizeight,,1,1,1,2
8644,ugnaught,,1,18,1,19
8645,beepsy,,1,8,6,14
8646,epicrdr,,1,102,175,277
8647,cholouno,,1,6,2,8
8648,dankimberly,,1,63,6,69
8649,tarwreck,,1,23,11,34
8650,method3,,1,25,27,52
8651,logicalnoise,,1,159,236,395
8652,orang,,1,89,67,156
8653,buhao,,1,4,1,5
8654,TheWildRover,,1,80,121,201
8655,rallyscag,,1,46,74,120
8656,Jeuk,,1,14,15,29
8657,genericerik,,1,22,11,33
8658,wumpushunter,,1,27,34,61
8659,engled68,,1,3,6,9
8660,Retinality,,1,6,2,8
8661,felinonymous,,1,1,1,2
8662,jagoff,,1,1,1,2
8663,twildz,,1,2,3,5
8664,factive,,1,2,5,7
8665,MissCellania,,1,7,9,16
8666,Formosus,,1,120,33,153
8667,nurseyourself,,1,6,3,9
8668,epsys,,1,127,99,226
8669,chucklarge,,1,1,1,2
8670,alpheccar,,1,33,11,44
8671,amichail,,1,118,49,167
8672,Elephantnews,,1,35,6,41
8673,lpettinati,,1,1,3,4
8674,avidyan,,1,1,2,3
8675,thegroom97,,1,4,3,7
8676,msblows,,1,1,1,2
8677,sugargirl,,1,18,18,36
8678,Daugaard,,1,81,136,217
8679,squeazy,,1,2,15,17
8680,stiflin,,1,11,12,23
8681,Jedai,,1,39,75,114
8682,pierski,,1,2,1,3
8683,ScratchMyJunk,,1,1,1,2
8684,booze,,1,2,1,3
8685,cliche-buster,,1,7,7,14
8686,dsdsds1,,1,19,44,63
8687,gunnerclark,,1,35,69,104
8688,mitchelwb,,1,1,4,5
8689,cthulhufhtagn,,1,556,424,980
8690,medspapa,,1,68,17,85
8691,harold_the_rebel,,1,23,25,48
8692,natterca,,1,4,4,8
8693,doopwoop,,1,1,1,2
8694,hillary2008,,1,5,2,7
8695,unkyduck,,1,115,325,440
8696,dingo_paschal,,1,18,58,76
8697,dirtnyureye,,1,1,2,3
8698,Tucci,,1,497,625,1122
8699,MooseCack,,1,20,35,55
8700,kavabula,,1,15,1,16
8701,ramen2666,,1,26,53,79
8702,sfx,,1,137,176,313
8703,jane73,,1,1,2,3
8704,KaptTorbjorn,,1,3,1,4
8705,paulc,,1,18,10,28
8706,notfancy,,1,296,436,732
8707,xrahull,,1,4,2,6
8708,eredicatorx,,1,6,16,22
8709,eyephotoguy,,1,1,1,2
8710,PPSF,,1,15,22,37
8711,writejdp,,1,58,27,85
8712,PicsOrItDidntHappen,,1,2,5,7
8713,upatrail,,1,2,1,3
8714,MorlokMan,,1,1,8,9
8715,jowdyboy,,1,1,3,4
8716,laforge,,1,13,17,30
8717,harlanji,,1,3,2,5
8718,r3dd173r,,1,718,140,858
8719,packmath,,1,6,2,8
8720,Huge_Penis,,1,5,7,12
8721,jook,,1,12,17,29
8722,silviusperry,,1,1,2,3
8723,sho19132,,1,41,19,60
8724,jleedev,,1,40,58,98
8725,Mendokusai,,1,2000,97,2097
8726,yqhardiel,,1,445,234,679
8727,mrlanemeyer,,1,1,1,2
8728,phogster,,1,3,1,4
8729,dantesfurnose,,1,1,1,2
8730,BeerSteak,,1,20,20,40
8731,CrackIsGoodForYou,,1,674,800,1474
8732,emorgant,,1,3,8,11
8733,omgmypony,,1,2,6,8
8734,mistergosh,,1,15,20,35
8735,marlowmarlowmarlow,,1,2,2,4
8736,equivoque,,1,10,2,12
8737,terryb088,,1,17,23,40
8738,gotmike,,1,4,1,5
8739,crayon78,,1,6,1,7
8740,JohnnyT9,,1,1,1,2
8741,bartczernicki,,1,1,1,2
8742,inventedscrap,,1,2,2,4
8743,roybatty,,1,5,7,12
8744,shazzzang,,1,1,1,2
8745,jmt1234,,1,4,8,12
8746,philasurfer,,1,986,139,1125
8747,piptastic,,1,19,26,45
8748,stevehnsn,,1,19,6,25
8749,tacoblah,,1,1,2,3
8750,nhelm83,,1,172,59,231
8751,MediaMoguls,,1,568,265,833
8752,all2hell,,1,13,24,37
8753,UlisesBrambila,,1,22,34,56
8754,tastytacos,,1,3,4,7
8755,aynrandfan,,1,252,97,349
8756,warget,,1,6,5,11
8757,akila9182,,1,1,1,2
8758,Parallax_Corp,,1,3,1,4
8759,ursnafu,,1,3,2,5
8760,foolman89,,1,12,20,32
8761,individual1,,1,1,1,2
8762,NickM,,1,27,21,48
8763,Timmy83,,1,89,143,232
8764,xaplexus,,1,129,234,363
8765,soupcan,,1,2,4,6
8766,yoniroit,,1,16,13,29
8767,minutillo,,1,12,13,25
8768,boojit,,1,12,13,25
8769,dawnfinder,,1,12,11,23
8770,flybirdiefly,,1,2,8,10
8771,Sherwooder,,1,51,8,59
8772,I_LIKE_PI,,1,1,1,2
8773,dirtmcgurk,,1,40,55,95
8774,justinhj,,1,190,230,420
8775,sylvikhan,,1,2,2,4
8776,Sam8131,,1,2,5,7
8777,hasNextInt,,1,53,1,54
8778,Chasmosaur,,1,21,1,22
8779,elettroreddit,,1,332,8,340
8780,kewlboontjies,,1,49,16,65
8781,begdorf,,1,3,8,11
8782,jerryred,,3,1,1,2
8783,igrigorik,,1,1,1,2
8784,satoshen,,1,3,2,5
8785,bondolo,,1,180,166,346
8786,colourAgga,,1,138,25,163
8787,MrJoeSmith,,1,1,2,3
8788,epalla,,1,36,34,70
8789,MrBean99999,,1,1,1,2
8790,wiifm69,,1,25,21,46
8791,gwynvir,,1,8,17,25
8792,merik_jb,,1,11,10,21
8793,microstuck,,1,5,2,7
8794,ashleyw,,1,8,16,24
8795,pbears,,1,1,2,3
8796,foilhead,,1,1,1,2
8797,yougoslaviayougo,,1,2,1,3
8798,johnfudrow,,1,1,1,2
8799,scottmaxim,,1,8,2,10
8800,troymcdavis,,1,328,480,808
8801,ramises,,1,250,41,291
8802,nostrich,,1,51,1,52
8803,qqqqqqqqq,,1,13,28,41
8804,ugubabba,,1,1,3,4
8805,torabisu,,1,9,10,19
8806,bigattack,,1,1,2,3
8807,tacklebox12,,1,1,2,3
8808,bostonusa2020,,1,2,8,10
8809,pcronin,,1,7,6,13
8810,GTanaka,,1,10,15,25
8811,Glendon,,1,4,2,6
8812,ryal,,1,5,8,13
8813,saradoc,,1,1,1,2
8814,wselman,,1,1,1,2
8815,Wiggles69,,1,46,84,130
8816,avzett,,1,54,44,98
8817,genuinepolitician,,1,236,445,681
8818,quazy,,1,1,2,3
8819,vonralls,,1,19,55,74
8820,listerinemouth,,1,2,2,4
8821,Franks2000inchTV,,1,130,62,192
8822,c3nder,,1,1,1,2
8823,hednej,,1,10,9,19
8824,pistonhonda1987,,1,1,3,4
8825,Tim56,,1,2,1,3
8826,clathrate,,1,18,32,50
8827,RX3715,,1,22,30,52
8828,lvwhtboyz,,1,2,1,3
8829,SovietRussia,,1,2,1,3
8830,DesCo83,,1,82,51,133
8831,BladeBV,,1,93,7,100
8832,yelaina,,1,1,4,5
8833,SteveAM1,,1,500,265,765
8834,npinguy,,1,106,113,219
8835,catfiesta,,1,1,6,7
8836,astitious,,1,80,80,160
8837,catsrgr8,,1,26,35,61
8838,bexamous,,1,8,12,20
8839,gazonvagon,,1,1,1,2
8840,norbertyappa,,1,1,2,3
8841,turfmuffin,,1,2,2,4
8842,zillode,,1,1,1,2
8843,DAVYWAVY,,1,3,7,10
8844,yourefiredpal,,1,79,119,198
8845,TheHapacalypse,,1,75,116,191
8846,Zac8241,,1,1,2,3
8847,manaleid,,1,3,3,6
8848,ChernobylBaby,,1,20,29,49
8849,aleph1,,1,7,15,22
8850,samlee,,1,399,426,825
8851,demoneyes,,1,34,21,55
8852,blackpage,,1,13,20,33
8853,neolefty,,1,98,131,229
8854,littleking,,1,4,7,11
8855,lanthus,,1,79,63,142
8856,anjamerret,,1,20,18,38
8857,stevejust,,1,1,2,3
8858,Kaoz,,1,2,1,3
8859,bearp,,1,5,4,9
8860,sling,,1,3,1,4
8861,SwordOfShannara,,1,7,2,9
8862,dreyruugr,,1,1,6,7
8863,radix89,,1,13,32,45
8864,txsteele,,1,4,9,13
8865,stugy,,1,46,50,96
8866,facebook1234,,1,4,5,9
8867,insert_name_here,,1,29,8,37
8868,meg1938,,1,13,2,15
8869,snoozzell,,1,3,3,6
8870,bongy,,1,13,14,27
8871,kirun,,1,589,1013,1602
8872,gavri,,1,12,11,23
8873,patrickomatic,,1,3,2,5
8874,icantthinkofone,,1,24,60,84
8875,eyereddit,,1,17,26,43
8876,bitflip,,1,14,16,30
8877,gravitypushes,,1,166,5,171
8878,lonelliott,,1,400,559,959
8879,creiss74,,1,86,122,208
8880,65165434518435,,1,1,1,2
8881,lazukars,,1,80,69,149
8882,rio517,,1,232,110,342
8883,TheActionCombo,,1,3,3,6
8884,jordiculous,,1,76,28,104
8885,FunnyMan3595,,1,267,375,642
8886,ymrhawk,,1,2,2,4
8887,Vaste,,1,100,161,261
8888,caesar79,,1,3,4,7
8889,gossipgirlz,,1,111,2,113
8890,matholio,,1,91,159,250
8891,apz,,1,2,3,5
8892,sandrejev,,1,1,2,3
8893,derefr,,1,494,648,1142
8894,reseph,,1,292,167,459
8895,SpiderJerusalem,,1,125,292,417
8896,tcdoey,,1,310,145,455
8897,monkeyback,,1,2,1,3
8898,Zaden,,1,2,2,4
8899,Sports_Maniac,,1,1,2,3
8900,pablogott,,1,47,62,109
8901,anamerican,,1,33,2,35
8902,ElricOfLisaBonet,,1,138,224,362
8903,Gotebe,,1,369,646,1015
8904,Mr_Sadist,,1,1652,319,1971
8905,eunos,,1,26,31,57
8906,ginger_balls,,1,72,103,175
8907,transienthobo,,1,14,28,42
8908,PoliticsSubredditCop,,1,125,324,449
8909,santabear25,,1,7,3,10
8910,__unsigned,,1,1,3,4
8911,toastyfries2,,1,250,443,693
8912,sabrewulf,,1,61,61,122
8913,GiannyL,,1,71,2,73
8914,j2d2,,1,161,232,393
8915,sariwat1,,1,2,6,8
8916,destinyland,,1,153,4,157
8917,raedix,,1,913,1271,2184
8918,Yifkong,,1,4,8,12
8919,LabThug,,1,39,68,107
8920,KosmoTheSynner,,1,101,189,290
8921,beemer330,,1,2,2,4
8922,dpzdpz,,1,329,385,714
8923,jonplim,,1,2,1,3
8924,faxxy,,1,8,17,25
8925,evandena,,1,61,68,129
8926,randommouse,,1,2,5,7
8927,drworm,,1,9,12,21
8928,drexil,,1,8,8,16
8929,itzkoolaid,,1,16,27,43
8930,cookingrobot,,1,12,15,27
8931,edbutler3,,1,29,58,87
8932,kijiki,,1,9,12,21
8933,obamaramama,,1,3,1,4
8934,EdwardCoffin,,1,3,4,7
8935,masklinn,,1,1343,2027,3370
8936,GreekStyle,,1,18,22,40
8937,grotnag,,1,7,6,13
8938,anthropology_nerd,,1,453,127,580
8939,drakarian,,1,14,25,39
8940,Lionhart,,1,3,4,7
8941,DopeyRopi,,1,2,2,4
8942,jjbbff,,1,1,2,3
8943,aaronwinningham,,1,42,6,48
8944,SapoLoco,,1,34,10,44
8945,artistry,,1,1,2,3
8946,nmcfarl,,1,2,6,8
8947,typwo,,1,6,9,15
8948,wildmXranat,,1,95,206,301
8949,antibios,,1,58,100,158
8950,Celauran,,1,2,4,6
8951,Bhaald,,1,6,4,10
8952,cyberfreak77,,1,1437,83,1520
8953,myristika,,1,88,185,273
8954,quazarjim,,1,25,52,77
8955,blazingti,,1,24,83,107
8956,lordymann,,1,1,1,2
8957,toadstool,,1,1,3,4
8958,farfinio,,1,1,1,2
8959,xinxy,,1,11,16,27
8960,rustdnails,,1,2,4,6
8961,Soulsbane,,1,7,2,9
8962,Velvette,,1,5,18,23
8963,peturoh,,1,25,13,38
8964,vitalyb,,1,39,35,74
8965,guest,,1,306,254,560
8966,Renniks,,1,48,54,102
8967,Borster,,1,2,3,5
8968,brainsik,,1,4,1,5
8969,specialdogg,,1,2,4,6
8970,villaged,,1,21,27,48
8971,nmessenger,,1,2,3,5
8972,net_junkie,,1,5,5,10
8973,sandout,,1,2,2,4
8974,ericsilver,,1,2,3,5
8975,phooey,,1,1,1,2
8976,DracheMitch,,1,5,8,13
8977,apodemos,,1,1,2,3
8978,x414353,,1,1,1,2
8979,AltTab,,1,16,40,56
8980,cuptocanada,,1,55,63,118
8981,Scutters,,1,1,5,6
8982,fishbones,,1,25,14,39
8983,lurkergirl,,1,5,4,9
8984,kiwipete,,1,58,64,122
8985,jeffbarnett513,,1,1,2,3
8986,Slickselixir,,1,47,67,114
8987,jungalero,,1,2,1,3
8988,lukejames,,1,2,2,4
8989,the_big_wedding,,1,647,713,1360
8990,Luminoth,,1,129,142,271
8991,ekimneems,,1,9,3,12
8992,sashapave,,1,1,3,4
8993,papercrane,,1,12,9,21
8994,gpn,,1,1,1,2
8995,mtaclof,,1,75,94,169
8996,that_guy,,1,2,4,6
8997,EventHorizon,,1,19,16,35
8998,harveyat,,1,7,5,12
8999,abc2014,,1,27,16,43
9000,dikaiosyne_the_wolf,,1,8,2,10
9001,rbu,,1,18,5,23
9002,pepgma,,1,5,4,9
9003,JustinHN1,,1,1,2,3
9004,chinoflav,,1,38,71,109
9005,drdballard,,1,6,8,14
9006,fizzy742,,1,3,5,8
9007,NeleH,,1,2,1,3
9008,nickydean,,1,26,40,66
9009,teabaggingmedia,,1,1,2,3
9010,timoleon,,1,239,468,707
9011,batok,,1,2,3,5
9012,freesid,,1,10,15,25
9013,Georgiacc,,1,4,7,11
9014,Simon280586,,1,7,7,14
9015,DaGoodBoy,,1,22,19,41
9016,jamesduvall,,1,3,6,9
9017,sleppnir,,1,165,378,543
9018,sensiblegirl,,1,18,43,61
9019,MoMan82,,1,2,13,15
9020,OceanSpray,,1,95,163,258
9021,Haitian_Mud_Eater,,1,8,10,18
9022,pochacco20,,1,2,4,6
9023,madmosche,,1,1,1,2
9024,Murdoc,,1,2,1,3
9025,compnski,,1,10,8,18
9026,wcalvert,,1,52,78,130
9027,Emardhi,,1,12,23,35
9028,antoniofabio,,1,5,13,18
9029,snuggleslut,,1,70,58,128
9030,broccolitroll,,1,2,1,3
9031,splatter_pattern,,1,5,8,13
9032,anonymous_howard,,1,1,1,2
9033,drgalaxy,,1,4,11,15
9034,spectre78,,1,1,1,2
9035,notheory,,1,10,7,17
9036,reverendpoon,,1,1,2,3
9037,GuavaFoo,,1,3,2,5
9038,johns-appendix,,1,31,62,93
9039,Ojai,,1,155,166,321
9040,fumar,,1,58,87,145
9041,ballm,,1,31,1,32
9042,xkero,,1,20,39,59
9043,ericpratum,,1,38,13,51
9044,mantra,,1,191,367,558
9045,citizen_snips,,1,16,23,39
9046,mattn,,1,1,1,2
9047,wearie,,1,1,1,2
9048,unled,,1,6,17,23
9049,orb,,1,94,167,261
9050,zencynic,,1,12,28,40
9051,nightshifter,,1,37,84,121
9052,gordonguthrie,,1,4,11,15
9053,rcj023000,,1,1,1,2
9054,sinnyin,,1,1,1,2
9055,fivewand,,1,2,1,3
9056,mapoftasmania,,1,245,264,509
9057,agrover,,1,4,8,12
9058,n_felon,,1,15,1,16
9059,getson,,1,17,4,21
9060,natlite,,1,3,6,9
9061,redditalienhasabig,,1,1,2,3
9062,bugmenot47,,1,31,46,77
9063,marstall,,1,15,12,27
9064,killhouse82,,1,1,6,7
9065,joe2100,,1,4,6,10
9066,RichardRoe,,1,10,13,23
9067,ladybonezzz,,1,1,1,2
9068,elie195,,1,1,2,3
9069,tibbe,,1,13,14,27
9070,smilli02,,1,28,34,62
9071,sniping4dummies,,1,30,33,63
9072,lisakay123,,1,1,3,4
9073,rudhdogg,,1,3,4,7
9074,dunsany,,1,1,1,2
9075,psychicsailboat,,1,2,2,4
9076,takker,,1,1,1,2
9077,ripbingers,,1,13,23,36
9078,Silhouette,,1,325,440,765
9079,RationalEgoist,,1,3,2,5
9080,Romantix,,1,4,5,9
9081,max3000,,1,2,2,4
9082,politics,,1,201,122,323
9083,redditnews,,1,91,6,97
9084,Archica,,1,2,2,4
9085,cmdrNacho,,1,10,19,29
9086,Bubblechaser,,1,1,3,4
9087,notjawn,,1,37,118,155
9088,TheKidd,,1,147,75,222
9089,pillage,,1,674,1089,1763
9090,whiprat,,1,10,5,15
9091,brandyn_w,,1,1,2,3
9092,andrewljohnson,,1,13,20,33
9093,huxtiblejones,,1,481,533,1014
9094,Detuned,,1,3,8,11
9095,Bevatron,,1,21,26,47
9096,pkaine,,1,29,13,42
9097,ragesoss,,1,91,119,210
9098,otheraccount,,1,1,2,3
9099,k2tse,,1,1,6,7
9100,jimmyr2021,,1,14,19,33
9101,bryan0514,,1,3,2,5
9102,lyso,,1,2,1,3
9103,Darkmeerkat,,1,383,404,787
9104,Jesus____Christ,,1,1,2,3
9105,moonchic,,1,3,4,7
9106,connerfitzgerald,,1,4,4,8
9107,jmagar,,1,1,2,3
9108,stop_it,,1,1,1,2
9109,memccoy,,1,1,1,2
9110,munney,,1,2,8,10
9111,nolman,,1,4,16,20
9112,FaithyPop,,1,78,5,83
9113,bmg50barrett,,1,4,12,16
9114,Blacky4McCain,,1,1,1,2
9115,druzix,,1,4,9,13
9116,gimpishi,,1,13,17,30
9117,vasken,,1,9,6,15
9118,Mnbvc,,1,4,4,8
9119,theonusta,,1,65,41,106
9120,thecitydesk,,1,6,4,10
9121,humdrum,,1,14,4,18
9122,mrtubby,,1,1,1,2
9123,kamillus,,1,1,1,2
9124,obamarama,,1,45,46,91
9125,johnresig,,1,6,14,20
9126,wildfire,,1,1,1,2
9127,pucko,,1,1,1,2
9128,sduff,,1,1,1,2
9129,IrrigatedPancake,,1,448,830,1278
9130,Dilettante,,1,3,3,6
9131,jamesnvc1,,1,2,3,5
9132,samongoose,,1,5,6,11
9133,Raptor7,,1,5,3,8
9134,facepalm,,1,4,5,9
9135,nagdude,,1,63,92,155
9136,chjb,,1,2,2,4
9137,rickhunter333,,1,2,2,4
9138,jparram,,1,130,81,211
9139,atlantic,,1,109,186,295
9140,silon,,1,28,61,89
9141,sandesh247,,1,6,1,7
9142,jansobieski,,1,5,5,10
9143,dmz,,1,127,16,143
9144,valloq,,1,11,9,20
9145,BradJ,,1,2,3,5
9146,SconnyRotten,,1,3,2,5
9147,Targeted,,1,3,1,4
9148,liron00,,1,46,75,121
9149,coax75ohm,,1,2,3,5
9150,CCRRJJ,,1,4,24,28
9151,HypoLuza,,1,1,2,3
9152,jstrong,,1,16,16,32
9153,xanderzeshredmeister,,1,25,40,65
9154,vintermann,,1,495,929,1424
9155,Domitri,,1,1,4,5
9156,elektro,,1,4,6,10
9157,enobrev,,1,22,10,32
9158,dude78_3,,1,68,76,144
9159,retrac,,1,32,4,36
9160,aselbst,,1,39,49,88
9161,daviday,,1,76,1,77
9162,AlasdairA,,1,1,1,2
9163,amackera,,1,12,25,37
9164,hadlongopposed,,1,2,2,4
9165,Ashex,,1,561,589,1150
9166,killerbiscuit,,1,30,8,38
9167,LowerHorn,,1,2,3,5
9168,witigonen,,1,14,2,16
9169,p1zawL,,1,2,2,4
9170,TheChris,,1,2,2,4
9171,gertjan,,1,2,1,3
9172,jewdass,,1,20,40,60
9173,Leila0373,,1,9,9,18
9174,cr125er,,1,4,8,12
9175,thefullcrimp,,1,3,3,6
9176,akakgo,,1,13,25,38
9177,yuseit,,1,1,1,2
9178,Microwave,,1,10,20,30
9179,hibryd,,1,281,259,540
9180,bulanga,,1,10,10,20
9181,brutus66,,1,110,197,307
9182,syphonn,,1,3,4,7
9183,billionareHuman,,1,1,2,3
9184,sschepis,,1,66,7,73
9185,one_word,,1,4,4,8
9186,Zabier,,1,17,51,68
9187,superegofox,,1,12,11,23
9188,cr0m,,1,3,7,10
9189,brexians,,1,3,1,4
9190,groupthinkjunkie,,1,105,150,255
9191,jonnnny,,1,4,3,7
9192,deki,,1,23,2,25
9193,deadA1ias,,1,63,73,136
9194,enfa,,1,1,3,4
9195,Solaris_,,1,17,24,41
9196,spik301,,1,2,2,4
9197,Culyt,,1,7,6,13
9198,gthsii,,1,14,31,45
9199,vthechef01,,1,1,4,5
9200,whenwe,,1,1,1,2
9201,raid517,,1,54,65,119
9202,rwbaskette,,1,17,22,39
9203,obscurity,,1,141,3,144
9204,lipjuicer,,1,333,307,640
9205,jpdoctor,,1,3,2,5
9206,cs80,,1,19,31,50
9207,alpinehigh,,1,8,8,16
9208,Articon,,1,2,3,5
9209,scienceisfun,,1,55,72,127
9210,NoFixedAbode,,1,43,46,89
9211,vlewis85,,1,3,6,9
9212,GuineaPig84,,1,129,316,445
9213,wizlb,,1,8,11,19
9214,yomammamia,,1,2,1,3
9215,bungle,,1,5,3,8
9216,his_jimboness,,1,1,3,4
9217,str8sin,,1,16,25,41
9218,MeetMyBackhand,,1,1,1,2
9219,jsaxton86,,1,2,1,3
9220,Octoman,,1,16,25,41
9221,phil-anderer,,1,10,1,11
9222,dvomedo,,1,1,5,6
9223,failfunnies,,1,1,1,2
9224,koolaidguy,,1,2,2,4
9225,ogrisel,,1,15,18,33
9226,zenox,,1,26,27,53
9227,ftrain,,1,8,1,9
9228,too_2th,,1,1,5,6
9229,quhaha,,1,335,344,679
9230,edovino,,1,2,5,7
9231,zekon,,1,4,1,5
9232,berean,,1,9,22,31
9233,blurrie,,1,28,84,112
9234,swivel,,1,28,21,49
9235,lobsters,,1,1804,251,2055
9236,pmdboi,,1,18,17,35
9237,Stooby,,1,122,144,266
9238,bonton,,1,12,4,16
9239,geiljd,,1,160,13,173
9240,oslash,,1,15,32,47
9241,lepht,,1,4,4,8
9242,granolajoe,,1,101,39,140
9243,drbonemonkey,,1,44,11,55
9244,stfudonny,,1,23,20,43
9245,TheMoo,,1,12,18,30
9246,rubink,,1,10,16,26
9247,oldmanstan,,1,2,3,5
9248,mqt,,1,52,6,58
9249,plbland,,1,4,4,8
9250,mvatlarge,,1,1,1,2
9251,shish,,1,2,2,4
9252,Pratyush,,1,1,2,3
9253,norimachebeer,,1,110,13,123
9254,heyruby,,1,22,36,58
9255,sabotank,,1,31,130,161
9256,uzmifue,,1,1,2,3
9257,landpirate,,1,2,4,6
9258,cinnix,,1,2,3,5
9259,Criminoboy,,1,344,249,593
9260,frosty1,,1,38,44,82
9261,HillaryRClinton,,1,1,2,3
9262,starfeeder,,1,276,122,398
9263,jtpesq,,1,2,3,5
9264,jdemery,,1,24,39,63
9265,mouse_user,,1,22,11,33
9266,bighemp,,1,7,6,13
9267,kemche,,1,1,4,5
9268,faerielfire,,1,313,284,597
9269,kirillt,,1,1,1,2
9270,cmucl-user,,1,1,1,2
9271,tubersalad,,1,1,2,3
9272,batrastard,,1,4,3,7
9273,eadmund,,1,1457,979,2436
9274,uberstuber,,1,118,161,279
9275,xcelsior,,1,19,13,32
9276,Shayateen,,1,56,22,78
9277,discopope,,1,3,6,9
9278,BearBearBaer,,1,1,3,4
9279,rav33n,,1,1,1,2
9280,angry_young_man,,1,2,2,4
9281,eruonna,,1,54,58,112
9282,ukygwdsa,,1,272,140,412
9283,leedalee23,,1,13,25,38
9284,kathmandu,,1,1,1,2
9285,Kioti,,1,3,1,4
9286,crusoe,,1,870,1518,2388
9287,catomaior,,1,1,1,2
9288,snarg,,1,5,14,19
9289,eurleif,,1,595,432,1027
9290,JJTizzle,,1,3,9,12
9291,relic2279,,1,1254,1427,2681
9292,bwchambers,,1,27,35,62
9293,jgarfink,,1,100,126,226
9294,nikosapi,,1,1,1,2
9295,alphadogg,,1,2,3,5
9296,thewhatifgirl,,1,2,1,3
9297,pridkett,,1,12,5,17
9298,jonpv,,1,9,19,28
9299,serhei,,1,58,65,123
9300,osp70,,1,59,90,149
9301,CunningRunt,,1,29,27,56
9302,lifofifo,,1,1,4,5
9303,sakodak,,1,47,41,88
9304,Slogby,,1,3,3,6
9305,blandry,,1,1,1,2
9306,Le_Prince,,1,4,9,13
9307,sebfisch,,1,6,3,9
9308,jehovaishere,,1,1,1,2
9309,EstebanVelour,,1,19,19,38
9310,midan22,,1,2,2,4
9311,danibx,,1,6,8,14
9312,mtkd,,1,163,54,217
9313,flyryan,,1,496,340,836
9314,buzzdiggity1,,1,327,32,359
9315,CJGibson,,1,2,8,10
9316,SFLawdog,,1,11,2,13
9317,2girls1me,,1,3,4,7
9318,krum,,1,132,164,296
9319,spatterlight,,1,24,23,47
9320,Sagan,,1,1,9,10
9321,draegtun,,1,4,2,6
9322,kennyman,,1,1,1,2
9323,mobyhead1,,1,85,128,213
9324,ProSauce,,1,1,1,2
9325,farkonian,,1,6,9,15
9326,losthalo,,1,1,2,3
9327,disco_kryptonite,,1,48,88,136
9328,nassrat,,1,2,10,12
9329,mizai,,1,59,92,151
9330,smallgovisbest,,1,22,53,75
9331,JimJones,,1,108,22,130
9332,sanitybit,,1,1,1,2
9333,oldguyfox,,1,25,4,29
9334,kewldude606,,1,25,30,55
9335,shakajumbo,,1,1,4,5
9336,eggsyntax,,1,2,3,5
9337,lekahe,,1,270,36,306
9338,candycorn,,1,3,8,11
9339,miraimatt,,1,7,2,9
9340,NeverGonna,,1,3,5,8
9341,rbcain,,1,2,2,4
9342,cecinepasunepipe,,1,32,63,95
9343,domstersch,,1,31,43,74
9344,RipRapRob,,1,32,44,76
9345,JeebusWept,,1,251,166,417
9346,ryanvm,,1,128,101,229
9347,Zoned,,1,27,56,83
9348,eitelj99,,1,8,2,10
9349,justin_henzie,,1,4,9,13
9350,cecilkorik,,1,518,827,1345
9351,urlnotfound,,1,1,1,2
9352,Flemlord,,1,2318,422,2740
9353,uhuh,,1,13,14,27
9354,bgog,,1,1,2,3
9355,45g,,1,14,11,25
9356,rhiltd,,1,1,5,6
9357,ijdk,,1,3,3,6
9358,loverollercoaster,,1,82,68,150
9359,Sirkkus,,1,9,7,16
9360,pycoder,,1,55,3,58
9361,JenniferG,,1,25,1,26
9362,eightfivezero,,1,4,4,8
9363,arthurdentlives,,1,1,2,3
9364,Merkilo,,1,2,4,6
9365,isaacand,,1,114,13,127
9366,salent241,,1,2,4,6
9367,i80and,,1,21,22,43
9368,bpowah,,1,6,9,15
9369,rtm1,,1,1,1,2
9370,Onemean98GT,,1,12,24,36
9371,leed25d,,1,59,122,181
9372,wthank,,1,2,5,7
9373,Saracudda,,1,5,4,9
9374,SolCheetah,,1,26,16,42
9375,geojaz,,1,66,85,151
9376,RepublicanMale,,1,2,1,3
9377,a47danger,,1,2,2,4
9378,dkraft,,1,42,42,84
9379,tubaTripper07,,1,1,3,4
9380,MercurialMadnessMan,,1,800,1558,2358
9381,Nils100,,1,3,1,4
9382,To0n1,,1,15,28,43
9383,opiates,,1,19,1,20
9384,LMRuane,,1,1,2,3
9385,craigg77,,1,5,9,14
9386,CaptainObIivious,,1,1,2,3
9387,karkaremtg,,1,6,2,8
9388,tonyb983,,1,4,4,8
9389,extrapolation,,1,1,1,2
9390,GoAwayStupidAI,,1,14,17,31
9391,mackh,,1,1,2,3
9392,rs8472,,1,4,5,9
9393,kurin,,1,116,152,268
9394,Big_McLargeHuge,,1,3,5,8
9395,taviso,,1,1,2,3
9396,lordbobo,,1,2,1,3
9397,jmhawk,,1,25,26,51
9398,BillyBraggFan333,,1,4,4,8
9399,iron_ball,,1,8,14,22
9400,kalayne8,,1,22,24,46
9401,jschaud,,1,1,2,3
9402,stardawg,,1,75,174,249
9403,beercheer,,1,2,2,4
9404,Xeiliex,,1,170,278,448
9405,fifth_element,,1,22,27,49
9406,SquirrelBoy,,1,24,1,25
9407,tollgate6,,1,1,1,2
9408,1point21_Jiggowatts,,1,8,8,16
9409,magnethy,,1,1,1,2
9410,dsummeriln,,1,3,4,7
9411,etank,,1,2,1,3
9412,nephros,,1,2,5,7
9413,dezro,,1,58,99,157
9414,bhb,,1,9,2,11
9415,netuserx,,1,115,24,139
9416,checolo,,1,3,12,15
9417,mangotree,,1,23,28,51
9418,unoladron,,1,87,23,110
9419,Leighther,,1,61,82,143
9420,proliberty,,1,52,3,55
9421,SiPCP,,1,11,15,26
9422,sporg,,1,1,1,2
9423,Zetavu,,1,7,4,11
9424,clem_acc,,1,1,2,3
9425,brennen,,1,386,490,876
9426,the_hmm,,1,4,4,8
9427,bumbledbee,,1,8,29,37
9428,Prorogue,,1,19,20,39
9429,plagiats,,1,2,2,4
9430,CaptainSmirko,,1,1,2,3
9431,pappy,,1,338,502,840
9432,zanelightning,,1,2,5,7
9433,tuoder,,1,1323,1447,2770
9434,chucklechops,,1,1,1,2
9435,kucinich-08,,1,2,1,3
9436,luemob,,1,1,3,4
9437,BobbyDelray,,1,2,1,3
9438,hilo,,1,4,5,9
9439,holdenk,,1,10,1,11
9440,People,,1,26,3,29
9441,biowar,,1,13,6,19
9442,hupp,,1,98,103,201
9443,steeled3,,1,97,57,154
9444,amitlu,,1,246,48,294
9445,AeroAggie,,1,38,22,60
9446,solarleaf07,,1,6,5,11
9447,vgtaluskie,,1,3,4,7
9448,notwhereyouthink,,1,2,1,3
9449,pedantic_man,,1,12,11,23
9450,trypsin200,,1,23,20,43
9451,lorderunion,,1,36,132,168
9452,nonades,,1,21,46,67
9453,czawadzki,,1,87,101,188
9454,RegretfulMorning,,1,7,16,23
9455,noahhealy,,1,1,1,2
9456,assholelikethat,,1,197,168,365
9457,livegreatnow,,1,1,1,2
9458,mrcsparker,,1,171,221,392
9459,mkoga,,1,15,13,28
9460,a2zme01,,1,2,4,6
9461,BennyG02,,1,157,258,415
9462,rudy__giuliani,,1,1,1,2
9463,notnowimbating,,1,16,21,37
9464,BogginEx,,1,1,1,2
9465,sgf,,1,1,1,2
9466,mckaym,,1,1,4,5
9467,jroos123,,1,3,1,4
9468,pandronic,,1,3,2,5
9469,clinintern,,1,47,78,125
9470,theocarina,,1,86,51,137
9471,tannedvampire,,1,15,1,16
9472,smalls760,,1,8,2,10
9473,bruce_lowery,,1,1,1,2
9474,dkeav,,1,2,7,9
9475,legatek,,1,84,110,194
9476,Greir,,1,51,66,117
9477,BostonCharlie,,1,7,7,14
9478,Frood,,1,114,159,273
9479,Pandemonium1x,,1,118,12,130
9480,weerobin,,1,1,1,2
9481,Mephiska,,1,50,69,119
9482,dpgaspard,,1,18,29,47
9483,solo1qwerty,,1,1,2,3
9484,serialmc,,1,1,6,7
9485,Schrodingers_cat,,1,5,10,15
9486,jonny324,,1,1,1,2
9487,jerivix,,1,7,7,14
9488,chirodiesel,,1,1,5,6
9489,Tigerbot,,1,20,7,27
9490,sergeyfeldman,,1,4,3,7
9491,morelearning,,1,26,64,90
9492,entwithanaxe,,1,1,2,3
9493,Propolis,,1,42,70,112
9494,kaboom_to_us_en,,1,2,1,3
9495,heliosxx,,1,22,35,57
9496,lwrun,,1,36,59,95
9497,bhoconnor,,1,5,1,6
9498,rekonquista,,1,39,32,71
9499,fbg111,,1,63,126,189
9500,jermisoot,,1,2,4,6
9501,ignorantn00b,,1,2,1,3
9502,kennethhass,,1,4,12,16
9503,sanhedrin,,1,15,27,42
9504,theinternetftw,,1,3,7,10
9505,yelkeew,,1,1,3,4
9506,hgoldsmith,,1,5,1,6
9507,sukael,,1,44,48,92
9508,cbright,,1,8,4,12
9509,thecal,,1,4,2,6
9510,the_real_captain,,1,15,33,48
9511,mikey865,,1,5,4,9
9512,downey_ryan,,1,29,6,35
9513,facemonkey,,1,3,5,8
9514,javaseeds,,1,3,5,8
9515,SarahPalinsXXXCostar,,1,2,1,3
9516,dave8927,,1,2,3,5
9517,joeber325,,1,6,1,7
9518,Nausved,,1,115,217,332
9519,nwootten,,1,17,20,37
9520,dlweinreb,,1,1,4,5
9521,Raticide,,1,62,67,129
9522,GrayOne,,1,526,554,1080
9523,counteraxe,,1,25,46,71
9524,Rorshach,,1,1,3,4
9525,DickBCheney,,1,2,1,3
9526,hacedor,,1,1,1,2
9527,twigs488,,1,3,1,4
9528,decieved545,,1,6,4,10
9529,darrenlobo,,1,22,1,23
9530,msjo,,1,1,1,2
9531,woogley,,1,1,3,4
9532,hortensius5,,1,1,1,2
9533,gerryscat,,1,49,35,84
9534,velosteve,,1,1,1,2
9535,ojnesdottir,,1,3,6,9
9536,nohit,,1,1,3,4
9537,arcsine,,1,10,2,12
9538,mg0314a,,1,188,483,671
9539,bhaller,,1,102,187,289
9540,ssdgoalie,,1,174,201,375
9541,lpiob,,1,6,7,13
9542,tugteen,,1,793,551,1344
9543,_bruno_,,1,26,15,41
9544,13ismitch,,1,3,2,5
9545,aawyee,,1,1,1,2
9546,jimmijim,,1,1,1,2
9547,Observer231007,,1,86,59,145
9548,paintmeblue719,,1,1,1,2
9549,lastshot,,1,67,220,287
9550,TedsGame,,1,63,35,98
9551,apollot4l,,1,33,55,88
9552,akatsukix,,1,156,211,367
9553,therealtombaker,,1,1,1,2
9554,invidious9000,,1,74,123,197
9555,bradleyhudson,,1,28,38,66
9556,shiryu13,,1,50,15,65
9557,bluefoot,,1,5,20,25
9558,Goodfella18,,1,10,10,20
9559,Epyo,,1,3,2,5
9560,biggest_douchbag,,1,2,2,4
9561,MinervaDreaming,,1,14,10,24
9562,bobthecow,,1,2,1,3
9563,apropos,,1,1,1,2
9564,yaye,,1,68,108,176
9565,ikimashokie,,1,67,124,191
9566,nesquik,,1,11,7,18
9567,curlicue,,1,36,37,73
9568,yellowtape,,1,4,1,5
9569,celebritywigs,,1,1,2,3
9570,Johny5,,1,77,130,207
9571,Curtisbeef,,1,50,118,168
9572,FTHamilton,,1,32,44,76
9573,rotll,,1,279,304,583
9574,dus7y,,1,116,216,332
9575,mextremist,,1,3,3,6
9576,simtek,,1,11,9,20
9577,someguyontheinternet,,1,1,1,2
9578,oodley_noodle,,1,7,18,25
9579,chrisirmo,,1,17,2,19
9580,felonious_punk,,1,1,3,4
9581,kerith,,1,4,1,5
9582,IvanBo,,1,17,2,19
9583,acer888,,1,8,1,9
9584,Samus_,,1,155,315,470
9585,ninethousand,,1,13,18,31
9586,cawel,,1,45,5,50
9587,Ihatedigg,,1,82,10,92
9588,eeltech,,1,10,9,19
9589,dlm85,,1,5,4,9
9590,firstking,,1,55,115,170
9591,ignathius,,1,24,29,53
9592,HumbleDialog,,1,49,49,98
9593,Duggers,,1,43,101,144
9594,jessicalbarry,,1,7,7,14
9595,boredomtakesover,,1,1,1,2
9596,imfinking,,1,18,10,28
9597,ivhassel,,1,3,5,8
9598,mintcoffee,,1,3,3,6
9599,jkenasiojenwff,,1,1,2,3
9600,DrJosh,,1,34,11,45
9601,solarmass,,1,5,25,30
9602,ZamboniPalin,,1,8,11,19
9603,bercikr,,1,27,1,28
9604,kpdvx,,1,1,2,3
9605,bloodmonkey,,1,2,1,3
9606,malarie,,1,20,42,62
9607,trae,,1,25,38,63
9608,ooorgh,,1,5,6,11
9609,onlythebritishfly,,1,4,6,10
9610,bigtom42,,1,16,18,34
9611,zazerr,,1,143,54,197
9612,Stereowire,,1,4,15,19
9613,dhusk,,1,856,323,1179
9614,Fromageball,,1,2,1,3
9615,jstump91,,1,2,4,6
9616,mickrussom,,1,1,2,3
9617,KAC,,1,9,3,12
9618,wubwub,,1,39,56,95
9619,8-Mighty-Arms,,1,133,162,295
9620,EX-TER-MI-NATE,,1,7,10,17
9621,tattva,,1,1,2,3
9622,zyghsdfa,,1,45,62,107
9623,dmercer,,1,34,35,69
9624,brokenteeth,,1,1,6,7
9625,bmach,,1,121,74,195
9626,DiscoRage,,1,12,28,40
9627,oce222,,1,4,4,8
9628,prohaska,,1,7,9,16
9629,T-888,,1,21,38,59
9630,bwhisenant,,1,4,6,10
9631,mdubrowski,,1,2,4,6
9632,thmanwithnoname,,1,2,3,5
9633,CyberShadow,,1,4,3,7
9634,fml,,1,2,20,22
9635,maokai,,1,11,3,14
9636,jsglick123,,1,1,1,2
9637,csalem,,1,2,2,4
9638,Vailhem,,1,6,4,10
9639,sunexplodes,,1,41,53,94
9640,foldor,,1,9,7,16
9641,jared592,,1,1,8,9
9642,osulumberjack,,1,24,4,28
9643,icjonu,,1,11,9,20
9644,Zentripetal,,1,444,458,902
9645,UnderTheMud,,1,54,109,163
9646,ExtraGravy,,1,34,28,62
9647,Phocas,,1,8,15,23
9648,adamaliqius,,1,14,57,71
9649,kirbence,,1,47,26,73
9650,pitrpatr,,1,15,12,27
9651,RomanMoroni,,1,4,3,7
9652,sriramgopalan,,1,642,494,1136
9653,blusKi,,1,1,1,2
9654,chachee,,1,2,5,7
9655,jjames456,,1,7,1,8
9656,haasted,,1,25,15,40
9657,drndown2008,,1,2,1,3
9658,CookieAcct,,1,9,10,19
9659,cfabbro,,1,573,676,1249
9660,jisakujiens,,1,2,1,3
9661,cnbc,,1,6,11,17
9662,skymajic,,1,3,1,4
9663,AmericanGoyBlog,,1,327,658,985
9664,KJW,,1,38,63,101
9665,marianass,,1,2,1,3
9666,dublinclontarf,,1,83,107,190
9667,Headache,,1,1,2,3
9668,Spiracle,,1,304,109,413
9669,brokoli,,1,45,62,107
9670,Graybeard,,1,3,2,5
9671,Jescro,,1,25,21,46
9672,themoose,,1,25,37,62
9673,trueform,,1,2,21,23
9674,ahfoo,,1,189,153,342
9675,mongrethod,,1,2,1,3
9676,TastyNewEngland,,1,1,1,2
9677,audpicc,,1,157,204,361
9678,blodulv,,1,4,8,12
9679,LincolnHat,,1,95,95,190
9680,yeswomenlikereddit2,,1,10,4,14
9681,mjar81,,1,12,18,30
9682,dzozef,,1,14,13,27
9683,Eriq,,1,15,32,47
9684,Overmind12812,,1,23,8,31
9685,SaltyBoatr,,1,404,234,638
9686,l3ri,,1,6,30,36
9687,muleherd,,1,11,12,23
9688,sonatine,,1,2,8,10
9689,gwillewyn,,1,19,32,51
9690,bobbbyy,,1,20,26,46
9691,whowhatwherenow,,1,146,117,263
9692,tornadoteddy,,1,11,16,27
9693,omg2k,,1,31,42,73
9694,conrad_hex,,1,260,341,601
9695,consoleguru,,1,1,1,2
9696,ShutUpYou,,1,2,2,4
9697,distipel,,1,3,2,5
9698,timmy242,,1,42,85,127
9699,crunchychips,,1,68,35,103
9700,mdreid,,1,81,90,171
9701,frambles,,1,36,39,75
9702,nelsoje3,,1,3,3,6
9703,KapitanObvious,,1,1,5,6
9704,s0rce7,,1,57,198,255
9705,shiroisuki,,1,8,7,15
9706,sedition,,1,56,83,139
9707,moneymatador,,1,38,2,40
9708,DSinclair,,1,307,247,554
9709,j1337,,1,394,236,630
9710,rockjohnson98,,1,51,8,59
9711,brentp,,1,3,3,6
9712,FangornWarden,,1,84,26,110
9713,grottobill,,1,109,100,209
9714,contraption,,1,30,23,53
9715,spiralz,,1,2,3,5
9716,rogerconnery,,1,1,1,2
9717,JerkFace_Asshole,,1,9,25,34
9718,hcarlgolden,,1,5,21,26
9719,jdhemsath,,1,38,8,46
9720,hank777,,1,1,2,3
9721,iwan_w,,1,25,40,65
9722,chno95,,1,2,4,6
9723,koriellis,,1,1,1,2
9724,carto,,1,1,1,2
9725,9defek-,,1,4,8,12
9726,davidreavis,,1,16,13,29
9727,geekuskhan,,1,26,43,69
9728,squarepants,,1,1,1,2
9729,ghettron,,1,49,22,71
9730,thatcrazylady,,1,3,4,7
9731,hungryfoolish,,1,35,22,57
9732,FwD,,1,13,20,33
9733,quadrupled,,1,1,1,2
9734,RiverStyx,,1,1,1,2
9735,3lilangels,,1,27,1,28
9736,Lycur,,1,64,108,172
9737,greatoz1972,,1,1,1,2
9738,Gliridae,,1,2,2,4
9739,dketterick,,1,4,2,6
9740,philo23,,1,1,1,2
9741,DevastatinDave,,1,1,1,2
9742,gdilla,,1,5,6,11
9743,OpenedEyes,,1,1,1,2
9744,s-heurist,,1,18,32,50
9745,br16,,1,47,47,94
9746,Chutch,,1,1,1,2
9747,propriable,,1,1,1,2
9748,lalaland4711,,1,165,276,441
9749,Tangerous,,1,2,4,6
9750,simmias,,1,47,31,78
9751,dkfn,,1,26,11,37
9752,mastersoda,,1,1,2,3
9753,kugai,,1,168,46,214
9754,lilzaphod,,1,25,59,84
9755,5hoe,,1,2,2,4
9756,TheMemo,,1,212,277,489
9757,valeriepieris,,1,618,258,876
9758,mattdurrant,,1,19,13,32
9759,xcalibre,,1,318,417,735
9760,ex_msft_employee,,1,2,2,4
9761,EliAndrewC,,1,19,36,55
9762,Mogreen,,1,54,1,55
9763,krucifyx,,1,2,2,4
9764,Skarrg,,1,11,5,16
9765,redthis,,1,7,8,15
9766,iminurinternet,,1,35,1,36
9767,Enkaybee,,1,188,258,446
9768,dyoo,,1,1,2,3
9769,arbitrarystring,,1,29,44,73
9770,sbma44,,1,1,1,2
9771,travis-,,1,71,75,146
9772,big_cheese,,1,228,528,756
9773,lauterhaus,,1,5,1,6
9774,turfyman,,1,7,19,26
9775,alienomega,,1,3,19,22
9776,nr0mx,,1,1,1,2
9777,tsunziven,,1,2,1,3
9778,stulove,,1,22,26,48
9779,paganel,,1,193,195,388
9780,myst112,,1,1,1,2
9781,Eilarais,,1,19,45,64
9782,cibbuano,,1,2,3,5
9783,texasflip,,1,6,6,12
9784,yanwg,,1,5,6,11
9785,desrt,,1,3,1,4
9786,lunkdjedi,,1,82,2,84
9787,beek,,1,3,3,6
9788,anon-22,,1,12,25,37
9789,gnyffel,,1,13,28,41
9790,freebasen,,1,5,14,19
9791,siliconoff,,1,7,1,8
9792,josemela1,,1,52,1,53
9793,indefinicy,,1,4,10,14
9794,wkessinger,,1,3,9,12
9795,evilgeologist,,1,69,103,172
9796,NolanT,,1,115,20,135
9797,smoooooov,,1,296,284,580
9798,enforcer51,,1,2,1,3
9799,angryjester,,1,29,28,57
9800,seul,,1,5,8,13
9801,aibzw,,1,2,12,14
9802,KatrineSegane,,1,205,19,224
9803,neilmcintyre,,1,1,1,2
9804,unonimus5,,1,68,57,125
9805,potency,,1,90,74,164
9806,kwan,,1,43,17,60
9807,appleman,,1,13,27,40
9808,monkadorganev,,1,4,1,5
9809,crazlunatic,,1,2,3,5
9810,sparkysko,,1,61,98,159
9811,DinoRider,,1,5,19,24
9812,goldenfire,,1,2,2,4
9813,alps,,1,9,16,25
9814,frank3000,,1,9,6,15
9815,look,,1,26,44,70
9816,jc8898,,1,1,2,3
9817,mrt,,1,9,7,16
9818,rironin,,1,30,43,73
9819,zsaleeba,,1,5,10,15
9820,whichdan,,1,53,87,140
9821,insertnounhere,,1,9,9,18
9822,fitqueenb,,1,100,93,193
9823,stealtheair99,,1,1,1,2
9824,au_courant,,1,7,10,17
9825,milwaukeegreenie,,1,4,6,10
9826,burnsey,,1,15,9,24
9827,levand,,1,39,12,51
9828,herosw,,1,1,1,2
9829,zgott300,,1,3,7,10
9830,algorythym,,1,26,20,46
9831,ShadowScythe13,,1,34,2,36
9832,goldenberg,,1,71,1,72
9833,colin_ebert,,1,27,2,29
9834,airwick,,1,32,8,40
9835,JohnnyS,,1,1,1,2
9836,DancesWithPenguins,,1,6,2,8
9837,OlDer,,1,1,3,4
9838,pooryorick77,,1,41,47,88
9839,sleazepleeze,,1,1,7,8
9840,ljkh,,1,24,21,45
9841,unsharp,,1,7,2,9
9842,antidentite,,1,1,1,2
9843,Oxxider,,1,6,8,14
9844,ifreew,,1,7,9,16
9845,blacklabelrum,,1,2,10,12
9846,omelman,,1,2,1,3
9847,Professr,,1,55,68,123
9848,HornyMelon,,1,54,11,65
9849,CovOps,,1,1,1,2
9850,PragmaticChris,,1,36,67,103
9851,YaBetchya,,1,12,10,22
9852,werwefsf,,1,16,10,26
9853,akurnids,,1,4,1,5
9854,imGonnaTellUhowGayUr,,1,2,2,4
9855,xyphus,,1,687,603,1290
9856,panjsher,,1,1,1,2
9857,gordol,,1,18,24,42
9858,my2ndaccount,,1,4,16,20
9859,Wakasaki_Rocky,,1,17,16,33
9860,joelanman,,1,143,76,219
9861,LainOfTheWired,,1,1,3,4
9862,petere,,1,41,1,42
9863,raddevon,,1,113,14,127
9864,zero_cool1990,,1,179,73,252
9865,roflcop,,1,1,1,2
9866,symbha,,1,1,2,3
9867,mozilla4,,1,1,1,2
9868,odinx,,1,33,1,34
9869,joevogel,,1,1,3,4
9870,pockelford,,1,141,101,242
9871,kakeeman,,1,3,5,8
9872,dick_in_a_box,,1,13,13,26
9873,lindini,,1,2,18,20
9874,JohnGalt2010,,1,15,14,29
9875,pricklypete,,1,10,16,26
9876,the_neubie,,1,353,516,869
9877,dmhouse,,1,13,18,31
9878,stcredzero,,1,295,513,808
9879,crazyvibes,,1,2,3,5
9880,WeeMary,,1,4,9,13
9881,DaPM,,1,9,7,16
9882,rb_busboom,,1,1,4,5
9883,diggthis,,1,3,5,8
9884,superiority,,1,180,195,375
9885,letsrun,,1,8,7,15
9886,JimmiP,,1,4,6,10
9887,jessb,,1,25,2,27
9888,cis4cookie,,1,1,1,2
9889,bobkingof12vs,,1,18,30,48
9890,smartkuz,,1,2,1,3
9891,bethhaught,,1,4,5,9
9892,kgsulliv,,1,2,7,9
9893,LAWSKEE,,1,55,100,155
9894,McMoop,,1,5,4,9
9895,JoeCollege,,1,26,23,49
9896,newztek,,1,1,1,2
9897,EmeraldCityElephant,,1,4,1,5
9898,focks,,1,67,66,133
9899,sonofthor,,1,1,1,2
9900,qayn,,1,3,1,4
9901,baihu,,1,6,11,17
9902,chourobin,,1,52,68,120
9903,iansocool,,1,20,31,51
9904,degustisnowshoes,,1,7,11,18
9905,mister_amazing,,1,6,21,27
9906,dr_poopeh,,1,2,2,4
9907,ichverstehe,,1,9,12,21
9908,koan,,1,80,62,142
9909,ewheat,,1,152,287,439
9910,Jan_book_lover,,1,28,30,58
9911,TomorrowCar,,1,1,1,2
9912,Ron__Paul,,1,3,7,10
9913,Lagstorm,,1,33,48,81
9914,noimallergic,,1,1,1,2
9915,powerrangers,,1,11,5,16
9916,mvo76,,1,5,11,16
9917,mctmct,,1,1,2,3
9918,itrends,,1,130,209,339
9919,mattgup,,1,257,67,324
9920,killuminati22,,1,3,4,7
9921,sternap,,1,25,20,45
9922,cstoner,,1,261,287,548
9923,_y_,,1,2,3,5
9924,formeorangeme,,1,1,3,4
9925,storko,,1,1,1,2
9926,du_playground,,1,1,3,4
9927,redditRoss,,1,191,12,203
9928,eyko,,1,18,28,46
9929,ChiXiStigma,,1,4,5,9
9930,erbowman,,1,4,7,11
9931,nhmike,,1,28,16,44
9932,notnice,,1,6,12,18
9933,doob,,1,15,24,39
9934,robcane,,1,5,4,9
9935,tanguyr,,1,70,99,169
9936,bozomind,,1,19,16,35
9937,Iggyiggy,,1,12,53,65
9938,leaknoil,,1,24,29,53
9939,lindabot,,1,2,6,8
9940,maxtheman45,,1,161,123,284
9941,kjk,,1,1,1,2
9942,awkward,,1,21,33,54
9943,Rubenb,,1,7,6,13
9944,Walhalla,,1,12,16,28
9945,lunarcanary,,1,17,18,35
9946,jmikola,,1,48,18,66
9947,Jabraltr,,1,3,2,5
9948,cinch123,,1,2,4,6
9949,mbland07,,1,8,1,9
9950,GrumpySimon,,1,892,777,1669
9951,mightyarmenian,,1,116,52,168
9952,mjk1093,,1,1639,177,1816
9953,daylily,,1,133,103,236
9954,redshoes,,1,29,46,75
9955,suleyman3,,1,16,33,49
9956,MiamiMan,,1,5,6,11
9957,fritts84,,1,1,1,2
9958,basscadet,,1,5,26,31
9959,Asbradley21,,1,21,26,47
9960,Rambis,,1,142,118,260
9961,booshmagazine,,1,13,17,30
9962,kvigor,,1,22,14,36
9963,omorashi,,1,1,1,2
9964,robliecruise,,1,1,1,2
9965,hotbaconsauce,,1,100,126,226
9966,asampson,,1,4,6,10
9967,superjuan,,1,83,106,189
9968,annekat,,1,119,182,301
9969,coel,,1,1,1,2
9970,yuxt,,1,13,31,44
9971,BossOfTheGame,,1,1,1,2
9972,bwrandall,,1,9,3,12
9973,Scientista,,1,19,28,47
9974,sonofbodil,,1,4,2,6
9975,reddit08,,1,91,107,198
9976,weeds,,1,1,1,2
9977,rub3s,,1,258,375,633
9978,niobium,,1,1,5,6
9979,TonzB,,1,13,14,27
9980,bertolotti,,1,147,60,207
9981,papatrpt89,,1,4,4,8
9982,payback1,,1,2,5,7
9983,blackstarinc,,1,1,1,2
9984,rdbb,,1,7,3,10
9985,Happinessisbetter,,1,11,5,16
9986,multani,,1,6,8,14
9987,j_b0mb,,1,3,1,4
9988,gogofromzozo,,1,27,10,37
9989,Timmah1978,,1,130,199,329
9990,whereverjustice,,1,274,341,615
9991,cantstanditanymore,,1,4,1,5
9992,greenmimmy,,1,9,1,10
9993,twrn,,1,52,64,116
9994,StarlessKnight,,1,115,220,335
9995,cerealghost,,1,5,3,8
9996,Micle,,1,10,2,12
9997,qhc23,,1,1,7,8
9998,asdfman,,1,31,14,45
9999,robe,,1,10,5,15
10000,gnudarve,,1,45,111,156
10001,nicwolff,,1,2,6,8
10002,mesmoria,,1,8,17,25
10003,calder100,,1,1,6,7
10004,creasybear,,1,1,2,3
10005,MoonPoint,,1,2,2,4
10006,joltek,,1,44,68,112
10007,miles_1963,,1,1,7,8
10008,scrunchcrunch,,1,25,25,50
10009,bigweeklynews,,1,3,4,7
10010,sheesh,,1,4,5,9
10011,sccuca,,1,1,2,3
10012,luvimarie,,1,1,1,2
10013,easterner7,,1,23,28,51
10014,wanakawoman2,,1,1,18,19
10015,djm210,,1,144,88,232
10016,solforge,,1,2,2,4
10017,NotAFanBoy,,1,2,2,4
10018,Marlowx2,,1,5,13,18
10019,lneves,,1,10,4,14
10020,comohammer,,1,3,1,4
10021,mpecsek,,1,69,84,153
10022,hudders,,1,199,321,520
10023,altie,,1,44,116,160
10024,bozarts5,,1,1,3,4
10025,Dark_Karma,,1,34,51,85
10026,flavigny,,1,1,1,2
10027,wowphreak,,1,2,2,4
10028,mlisiotti,,1,8,4,12
10029,peterington,,1,4,1,5
10030,mojomajojo,,1,4,1,5
10031,repnop,,1,13,11,24
10032,Tetragrammaton,,1,72,29,101
10033,silverionmox,,1,274,503,777
10034,CaptainIrony,,1,1,2,3
10035,fakkedap,,1,2,2,4
10036,truffle_shuffle,,1,48,54,102
10037,eatmycow,,1,21,16,37
10038,someguy456,,1,2,4,6
10039,NovusTiro,,1,103,145,248
10040,mrtactical,,1,1,1,2
10041,hepj,,1,29,25,54
10042,tridentgum,,1,592,813,1405
10043,adleym,,1,612,274,886
10044,pariahjane,,1,62,39,101
10045,fl00d,,1,15,31,46
10046,CasualReader,,1,105,149,254
10047,verblitas,,1,1,1,2
10048,zielaj,,1,1,5,6
10049,iPiranha,,1,1,1,2
10050,chubbybubba,,1,7,16,23
10051,tracknod,,1,23,22,45
10052,dictatortot,,1,1,2,3
10053,dafunk60,,1,16,25,41
10054,freshone,,1,187,300,487
10055,OreoPie,,1,8,8,16
10056,18_84_58_A6_D1_50_34,,1,1,2,3
10057,ihavenoidea,,1,1,2,3
10058,defconoi,,1,12,11,23
10059,Canadiac,,1,30,38,68
10060,pcdescha,,1,23,8,31
10061,The_Pot,,1,1,1,2
10062,musicmaverick,,1,1,3,4
10063,b17w153,,1,1,3,4
10064,teeteringwreck,,1,77,14,91
10065,roblob,,1,1,1,2
10066,andycullison,,1,6,3,9
10067,peblos,,1,16,29,45
10068,breakables,,1,10,6,16
10069,Flun,,1,2,10,12
10070,cholefischer,,1,111,28,139
10071,ChazR,,1,7,12,19
10072,tspike,,1,16,24,40
10073,robknight,,1,4,2,6
10074,tropoli,,1,126,11,137
10075,gabrielroth,,1,56,11,67
10076,JonisJon,,1,4,2,6
10077,rotbart,,1,1,1,2
10078,charliedontsurf,,1,10,10,20
10079,tripod3,,1,3,2,5
10080,druidmerlyn,,1,3,2,5
10081,scottperezfox,,1,24,27,51
10082,phoephus2,,1,53,56,109
10083,pokute,,1,10,19,29
10084,nas,,1,22,24,46
10085,cbr,,1,74,94,168
10086,randomasspseudonym,,1,1,1,2
10087,ohmdogz,,1,46,49,95
10088,drbatbawls,,1,4,5,9
10089,Chayoss,,1,15,15,30
10090,nynelyves,,1,1,1,2
10091,quitesonew,,1,89,122,211
10092,chipmunkninja,,1,4,2,6
10093,twl,,1,16,23,39
10094,he-nameth-the-twat,,1,1,16,17
10095,ermd2000,,1,162,158,320
10096,irony,,1,572,142,714
10097,sodj1,,1,45,94,139
10098,popesicle,,1,16,20,36
10099,mattbeach,,1,1,1,2
10100,icenine,,1,2,1,3
10101,HenryR,,1,121,11,132
10102,jugaru,,1,1,1,2
10103,YongWang,,1,1,1,2
10104,orkies,,1,1,7,8
10105,LaLa01,,1,4,3,7
10106,getabrain,,1,4,10,14
10107,kooby64,,1,362,65,427
10108,Musashi007,,1,1,7,8
10109,Professor_Dubya,,1,2,4,6
10110,Pesshau,,1,17,20,37
10111,nsputnik,,1,16,2,18
10112,rjglasse,,1,3,7,10
10113,Ioewe,,1,252,377,629
10114,extremeanger,,1,7,7,14
10115,diggernaught,,1,94,165,259
10116,pokrmessiah,,1,68,115,183
10117,stevepohlit,,1,3,1,4
10118,mattnyc99,,1,3,7,10
10119,Rekzai,,1,68,62,130
10120,treetree888,,1,17,19,36
10121,JRoxas,,1,11,2,13
10122,mark7,,1,20,31,51
10123,twelvestringed,,1,1,1,2
10124,ubikwitous,,1,362,223,585
10125,vbKing,,1,1,2,3
10126,justsai,,1,16,52,68
10127,ectornator,,1,15,6,21
10128,ColinDoody,,1,1,1,2
10129,yeahdude,,1,1,1,2
10130,DarthMalcontent,,1,86,161,247
10131,duncan345,,1,4,13,17
10132,mauszozo,,1,38,49,87
10133,libertyordeath1,,1,29,42,71
10134,tuirn,,1,53,128,181
10135,mcnab,,1,103,75,178
10136,joereger,,1,6,3,9
10137,brutal_one,,1,17,29,46
10138,minionx133,,1,6,13,19
10139,fishhead,,1,8,17,25
10140,uchecerulean,,3,2,2,4
10141,ionrock,,1,2,7,9
10142,ven,,1,2,3,5
10143,runway,,1,14,15,29
10144,TomonReddit,,1,22,4,26
10145,chuck74,,1,12,30,42
10146,agent_smith,,1,1,2,3
10147,safetyworm,,1,2,1,3
10148,tehpointbeing,,1,8,25,33
10149,konradj,,1,6,13,19
10150,Joeunionreview,,1,8,18,26
10151,wingofbentsteel,,1,4,4,8
10152,jjlava,,1,29,77,106
10153,benjphoto,,1,1,2,3
10154,lerdex,,1,3,11,14
10155,hahshaez,,1,7,7,14
10156,bobwrit,,1,1,3,4
10157,ramblin101010,,1,10,9,19
10158,deimos,,1,6,4,10
10159,econnerd,,1,20,36,56
10160,psbp,,1,1,2,3
10161,svadhisthana,,1,22,31,53
10162,slinger,,1,1,1,2
10163,mixsense,,1,12,3,15
10164,baldr83,,1,50,54,104
10165,dogpb,,1,4,2,6
10166,ramblnrose,,1,1,1,2
10167,Foodstamp,,1,1,2,3
10168,InternNick,,1,1,2,3
10169,matthewn,,1,1,3,4
10170,dudedominicano,,1,3,2,5
10171,illuminusluna,,1,84,97,181
10172,hoopjones,,1,2,2,4
10173,ixos,,1,3,2,5
10174,suprfsat,,1,19,37,56
10175,bhikshu,,1,1,1,2
10176,yokel,,1,1,3,4
10177,darkhelmet16,,1,22,6,28
10178,worq,,1,1,1,2
10179,venjax,,1,1,2,3
10180,clutterskull,,1,24,49,73
10181,JJCDAD,,1,25,38,63
10182,PixelMagic,,1,531,372,903
10183,insertmedia,,1,1,3,4
10184,jdfreeze,,1,1,3,4
10185,aerosquid,,1,69,120,189
10186,JoshSN,,1,5,2,7
10187,sepierce,,1,2,2,4
10188,mibchronicles,,1,4,1,5
10189,stewhar,,1,10,15,25
10190,bafta,,1,17,40,57
10191,Hendrik,,1,20,22,42
10192,H-Bar,,1,77,53,130
10193,Haiavaha,,1,472,642,1114
10194,toppur,,1,2,3,5
10195,amybean,,1,6,13,19
10196,d_goddard,,1,1,3,4
10197,wolfman116,,1,39,60,99
10198,androk,,1,11,19,30
10199,Splitter4,,1,7,9,16
10200,Booperelli,,1,9,10,19
10201,jeffg79,,1,1,1,2
10202,deepikaur,,1,7,2,9
10203,rixed,,1,5,1,6
10204,aultshark,,1,1,1,2
10205,-Swig-,,1,1,1,2
10206,addicted,,1,2,2,4
10207,saterdaies,,1,4,4,8
10208,sixbillionthsheep,,1,71,55,126
10209,Jeffnfun631,,1,1,4,5
10210,Deestan,,1,180,251,431
10211,zeddit,,1,10,12,22
10212,rknickme,,1,3,1,4
10213,valeyard,,1,17,1,18
10214,AlbyWee,,1,7,10,17
10215,Sub7,,1,25,24,49
10216,LightShadow,,1,64,73,137
10217,darmon,,1,41,33,74
10218,Pokaris,,1,5,10,15
10219,dhotson,,1,37,17,54
10220,gazmic,,1,106,159,265
10221,Happyburn,,1,77,6,83
10222,firstoutofline,,1,1,1,2
10223,aier,,1,27,44,71
10224,Hyperion1144,,1,324,329,653
10225,najnarp,,1,34,11,45
10226,mattl,,1,196,244,440
10227,shankrabbit,,1,3,4,7
10228,jsully,,1,320,425,745
10229,TechnoCrit,,1,136,154,290
10230,tuttut97,,1,2,2,4
10231,mattdoyle13,,1,10,18,28
10232,johnlert22,,1,11,6,17
10233,obamania,,1,8,2,10
10234,jimm,,1,44,31,75
10235,jellison,,1,58,43,101
10236,lazyplayboy,,1,275,460,735
10237,agyrtes,,1,1,1,2
10238,Burbulous,,1,13,23,36
10239,revdev,,1,3,3,6
10240,wonderboy2005,,1,32,44,76
10241,hyena,,1,2,1,3
10242,mcanon,,1,55,50,105
10243,carolinaswamp,,1,6,19,25
10244,nrfx,,1,6,9,15
10245,dagger_5005,,1,61,138,199
10246,texanianman,,1,2,3,5
10247,SuperThread,,1,13,16,29
10248,romwell,,1,124,167,291
10249,Finger-Nail,,1,65,56,121
10250,ayuda42,,1,2,6,8
10251,Ionse,,1,13,7,20
10252,requiem4boredom,,1,243,279,522
10253,behrangsa,,1,146,82,228
10254,Thomas_Jefferson,,1,1,4,5
10255,gregkitson,,1,9,21,30
10256,round2,,1,1,4,5
10257,neuromonkey,,1,866,2055,2921
10258,Magick93,,1,35,68,103
10259,austinwiltshire,,1,63,92,155
10260,JavaVoodoo,,1,23,3,26
10261,mockablekaty,,1,24,29,53
10262,TheSwashbuckler,,1,3,1,4
10263,ArmadilloBrillo,,1,1,1,2
10264,breakbread,,1,2,4,6
10265,anguisinherba,,1,1,2,3
10266,lamintak,,1,111,42,153
10267,madmanz123,,1,78,157,235
10268,kidnthebrook,,1,28,34,62
10269,acidargyle,,1,3,3,6
10270,hbbengal,,1,15,2,17
10271,rraaarr,,1,349,454,803
10272,TruthPicker,,1,5,16,21
10273,bowdog,,1,17,74,91
10274,AnhaengerVonMarx,,1,24,60,84
10275,mynameishere,,1,861,838,1699
10276,stopmotionsunrise,,1,291,669,960
10277,nooz,,1,1,4,5
10278,krypnos,,1,17,12,29
10279,darkshine,,1,27,6,33
10280,negcap,,1,3,1,4
10281,mfkap,,1,49,64,113
10282,attekojo,,1,51,61,112
10283,skraps,,1,73,94,167
10284,me_so_porny,,1,104,82,186
10285,flaxer,,1,1,1,2
10286,enkoopa,,1,7,7,14
10287,nexxai,,1,37,1,38
10288,Carmack,,1,8,5,13
10289,zxvf,,1,165,172,337
10290,moultano,,1,749,363,1112
10291,eigyan,,1,1,1,2
10292,death,,1,43,53,96
10293,DoeDoe,,1,53,53,106
10294,arbiterElegantiae,,1,1,2,3
10295,jorgeka,,1,47,145,192
10296,markitymark,,1,781,1336,2117
10297,biggus_dictus,,1,1,1,2
10298,prasanna_reddit,,1,11,12,23
10299,Cananopie,,1,53,14,67
10300,DMTurneR,,1,1,2,3
10301,croxmeister,,1,1,2,3
10302,captian2,,1,51,47,98
10303,webmaster8888,,1,8,3,11
10304,lpe,,1,27,32,59
10305,twodaylife,,1,36,49,85
10306,AluminiuM,,1,36,4,40
10307,sunlovey,,1,1,1,2
10308,jacobd,,1,1,2,3
10309,brad-walker,,1,673,919,1592
10310,Deezul,,1,22,27,49
10311,Spanish_Inquisition,,1,2,6,8
10312,aldarris,,1,6,5,11
10313,thinkbox,,1,3,1,4
10314,winnarps,,1,53,27,80
10315,rbrumble,,1,16,22,38
10316,cap11235,,1,59,80,139
10317,new_anus,,1,3,5,8
10318,brenelz,,1,16,1,17
10319,samsing,,1,25,43,68
10320,evilive,,1,8,2,10
10321,finix,,1,634,753,1387
10322,nublet,,1,8,4,12
10323,preferswhitesocks,,1,2,3,5
10324,rcavanaugh,,1,4,1,5
10325,greyjay,,1,105,130,235
10326,apocalypse_k,,1,18,48,66
10327,dangerpronedaphne,,1,12,24,36
10328,runn1rebels198,,1,1,1,2
10329,adn,,1,26,16,42
10330,rvirding,,1,9,14,23
10331,XBMC,,1,50,80,130
10332,drakesn,,1,3,3,6
10333,imm0rtal_aeris,,1,5,5,10
10334,Purp,,1,246,426,672
10335,rdd,,1,2,2,4
10336,DocmanCC,,1,18,20,38
10337,rywinter,,1,4,6,10
10338,Dexia,,1,2,6,8
10339,phylo,,1,3,5,8
10340,unregistered,,1,12,11,23
10341,returntofreedom,,1,155,160,315
10342,Uncle_Chachi,,1,62,92,154
10343,dwayne12,,1,1,2,3
10344,larryjohnson404,,1,3,1,4
10345,thorman,,1,4,12,16
10346,UncleTom23,,1,1,1,2
10347,afclark,,1,39,12,51
10348,wanker123,,1,1,1,2
10349,callmedanimal,,1,1,1,2
10350,alienman,,1,143,244,387
10351,dalmaer,,1,5,3,8
10352,kippy,,1,92,4,96
10353,cincimedes,,1,3,5,8
10354,detaer,,1,121,210,331
10355,secretGeek,,1,15,13,28
10356,jzief128,,1,1,1,2
10357,daramel,,1,4,9,13
10358,macbony,,1,7,6,13
10359,buckethead,,1,3,1,4
10360,mjern,,1,35,30,65
10361,nerotic,,1,1,1,2
10362,Soupstorm,,1,112,182,294
10363,specialk16,,1,3,3,6
10364,b12345en,,1,28,2,30
10365,retarded,,1,1,2,3
10366,sien,,1,22,23,45
10367,follys,,1,3,3,6
10368,j4b,,1,8,18,26
10369,jus10k,,1,22,81,103
10370,newreader,,1,10,14,24
10371,ewilliam,,1,17,15,32
10372,Mihan,,1,68,106,174
10373,russross,,1,2,5,7
10374,directq,,1,9,2,11
10375,yosterizer,,1,4,4,8
10376,astonm,,1,3,4,7
10377,lavoshe,,1,28,1,29
10378,mego,,1,33,56,89
10379,Khael,,1,13,19,32
10380,troglodytehomunculus,,1,14,30,44
10381,ron12345,,1,4,3,7
10382,rekishi,,1,7,14,21
10383,cwp,,1,3,4,7
10384,docmgmt,,1,5,10,15
10385,myopian,,1,4,4,8
10386,kaspar42,,1,111,132,243
10387,superfreak77,,1,294,496,790
10388,JonathonDD,,1,1,1,2
10389,bkharris45,,1,1,2,3
10390,mh1111q,,1,4,3,7
10391,robertpaulson0106,,1,1,2,3
10392,carbonfishbone,,1,2,1,3
10393,yorkshire99,,1,17,2,19
10394,MayanFire,,1,1,4,5
10395,laika84,,1,2,1,3
10396,nedTheInbredMule,,1,43,24,67
10397,scubastard,,1,14,20,34
10398,whatamac,,1,1,2,3
10399,lfnoise,,1,12,17,29
10400,phaneros,,1,5,11,16
10401,spidermite,,1,220,278,498
10402,a_caspis,,1,21,17,38
10403,nrieke,,1,3,6,9
10404,Batfastard,,1,9,13,22
10405,twopigs,,1,23,20,43
10406,euphoriacoffee,,1,16,1,17
10407,aurochs,,1,53,80,133
10408,nickripley,,1,29,27,56
10409,photoflyer,,1,30,23,53
10410,SteefHarsley666,,1,1,2,3
10411,mindshadow,,1,1,2,3
10412,pittmb,,1,7,7,14
10413,ltbs,,1,8,9,17
10414,Perfu,,1,1,1,2
10415,fxtrader,,1,1,5,6
10416,fsjenkins2000,,1,3,3,6
10417,johnbell,,1,1,1,2
10418,docmars,,1,5,1,6
10419,eoin2000,,1,77,158,235
10420,TRH,,1,2,2,4
10421,gregmackay,,1,1,1,2
10422,lastchance,,1,272,62,334
10423,deadfones,,1,16,26,42
10424,IIECONII,,1,15,20,35
10425,benihana,,1,560,623,1183
10426,bradbeveridge,,1,12,17,29
10427,SMN1,,1,6,5,11
10428,samrose,,1,1,3,4
10429,FUCKING_THING_SUCKS,,1,1,1,2
10430,facebones,,1,3,3,6
10431,SportsCarAdvis,,1,34,43,77
10432,noahsachs,,1,1,4,5
10433,DonCasablanca,,1,15,6,21
10434,stevenlss1,,1,1,1,2
10435,penterz,,1,22,27,49
10436,monkkbfr,,1,64,107,171
10437,msthursday,,1,2,6,8
10438,marcocanb,,1,3,1,4
10439,darrylhickson,,1,2,1,3
10440,Hittman,,1,23,22,45
10441,sidsavara,,1,25,1,26
10442,narmak,,1,10,7,17
10443,turbo-tom,,1,1,4,5
10444,werries,,1,37,52,89
10445,do-un-to,,1,275,501,776
10446,rawls,,1,19,31,50
10447,overtoncanada,,1,1,4,5
10448,newsens,,1,6,20,26
10449,MrTrolleePants,,1,21,32,53
10450,mcpagal,,1,5,1,6
10451,bcbarrett,,1,3,3,6
10452,AMysticalApproach,,1,2,1,3
10453,cheics_w,,1,1,3,4
10454,wrekxx,,1,8,16,24
10455,durkin65,,1,4,10,14
10456,MrTaco,,1,7,9,16
10457,DrScott,,1,48,89,137
10458,anonymousone,,1,2,2,4
10459,dghould,,1,56,40,96
10460,acs58,,1,2,1,3
10461,Jayschwa,,1,5,1,6
10462,nannuPAWLU,,1,3,5,8
10463,nonethelesses,,1,2,4,6
10464,STL_reddit,,1,1,1,2
10465,ecomaniac,,1,3,8,11
10466,apostoli,,1,1,1,2
10467,am533,,1,54,38,92
10468,typemast,,1,27,20,47
10469,LeMadChef,,1,35,51,86
10470,spaulo,,1,12,5,17
10471,disconcision,,1,3,3,6
10472,Bizzell,,1,1,2,3
10473,joedunn721,,1,3,5,8
10474,Draracle,,1,177,328,505
10475,cwolfe,,1,266,304,570
10476,Majination,,1,7,4,11
10477,earthacis,,1,1,2,3
10478,petenu,,1,83,95,178
10479,MikeonTV,,1,361,24,385
10480,xolusmojo,,1,7,25,32
10481,abassguitaryouare,,1,1,1,2
10482,seb101189,,1,11,18,29
10483,Harum,,1,1,2,3
10484,IkastI,,1,14,21,35
10485,neoform3,,1,1261,1428,2689
10486,chiu6411,,1,1,2,3
10487,blah23,,1,5,4,9
10488,Vraiment,,1,6,7,13
10489,nullibicity,,1,623,758,1381
10490,FormerDittoHead,,1,2,2,4
10491,endia314,,1,235,83,318
10492,Lunchy,,1,3,1,4
10493,dprevite,,1,5,13,18
10494,jayhawk691,,1,17,24,41
10495,Average-Joe,,1,46,9,55
10496,35dga,,1,1,1,2
10497,sainox,,1,33,3,36
10498,mhmdshkr,,1,4,8,12
10499,leoedin,,1,43,28,71
10500,pjism,,1,3,6,9
10501,MoltenBoron,,1,4,1,5
10502,michaelhoney,,1,5,12,17
10503,fashion_freak202,,1,2,1,3
10504,moveez,,1,2,1,3
10505,aeflash,,1,2,3,5
10506,baseball_god,,1,19,26,45
10507,whiteyonthemoon,,1,2,14,16
10508,mbana,,1,6,9,15
10509,angry_man,,1,79,63,142
10510,pwa01,,1,6,5,11
10511,riraito,,1,21,56,77
10512,Fireblend,,1,14,7,21
10513,mattc,,1,2,3,5
10514,crazyeight,,1,72,93,165
10515,newgenome,,1,15,3,18
10516,koolaidsipper,,1,1,2,3
10517,windvexer,,1,4,3,7
10518,jeffpostcn,,1,3,3,6
10519,pramodbiligiri,,1,2,5,7
10520,henrygeorge,,1,5,2,7
10521,swimmerchick,,1,3,2,5
10522,starphish,,1,94,162,256
10523,JustAnotherVagueAnon,,1,38,37,75
10524,dashteacup,,1,7,8,15
10525,nomorewar,,1,371,352,723
10526,phawnky,,1,2,8,10
10527,rezrovs,,1,3,4,7
10528,sidnelson13,,1,1,2,3
10529,xsxsxs,,1,34,14,48
10530,josef,,1,81,42,123
10531,feanor512,,1,316,458,774
10532,EndUserX,,1,3,2,5
10533,blaineT,,1,1,4,5
10534,tusharm,,1,75,1,76
10535,cde32wsxzaq1,,1,4,5,9
10536,shoesmell,,1,36,34,70
10537,Makin_You_Pay,,1,2,2,4
10538,kybernetikos,,1,31,36,67
10539,hji87,,1,1,1,2
10540,Varian,,1,6,7,13
10541,kovacs70,,1,26,29,55
10542,rampart,,1,1,5,6
10543,MrsChime,,1,2,1,3
10544,malconsidine,,1,83,32,115
10545,zamyaid,,1,1,1,2
10546,hi_lo,,1,2,1,3
10547,johngalt,,1,3,29,32
10548,amenszer,,1,3,5,8
10549,dangled,,1,2,5,7
10550,Pipstydoo,,1,6,7,13
10551,omphalaskepsis,,1,5,10,15
10552,DethKlokBlok,,1,4,1,5
10553,LukeDuke,,1,4,6,10
10554,FlamingHomoSexual,,1,5,3,8
10555,beenthereredthat,,1,3,9,12
10556,snoonoo,,1,2,2,4
10557,chrisamiller,,1,3,2,5
10558,willis77,,1,738,570,1308
10559,njfemdem,,1,16,30,46
10560,dudeabides909,,1,11,2,13
10561,portladelphia,,1,59,99,158
10562,keithwalsh1972,,1,5,4,9
10563,boomd02,,1,1,1,2
10564,william01,,1,30,52,82
10565,harvard_law_school,,1,10,8,18
10566,jon_k,,1,717,867,1584
10567,ioillusion,,1,2,3,5
10568,anglfe,,1,27,43,70
10569,fuckitwelldoitlive,,1,1,3,4
10570,Skippy_McDougal,,1,1,1,2
10571,shinaku,,1,1,7,8
10572,AHarrison,,1,18,14,32
10573,architimmy,,1,1,3,4
10574,mackatt,,1,14,1,15
10575,fubar9000,,1,5,4,9
10576,phyzhoe,,1,14,1,15
10577,gcapell,,1,7,10,17
10578,ddvlad,,1,17,18,35
10579,redditisnews,,1,14,19,33
10580,gcranston,,1,8,7,15
10581,SnakeDiver,,1,13,16,29
10582,mwilliherb,,1,82,19,101
10583,torrefaction,,1,1,2,3
10584,tooli,,1,4,7,11
10585,hulahulagirl,,1,91,168,259
10586,jpb,,1,1,1,2
10587,khl2k,,1,1,1,2
10588,fujbuj,,1,21,15,36
10589,911_truther,,1,1,1,2
10590,brad2008,,1,83,123,206
10591,meatbot,,1,2,3,5
10592,ladafum,,1,5,4,9
10593,apinecone,,1,13,13,26
10594,tyomax,,1,33,39,72
10595,bhartzer,,1,22,6,28
10596,whyshave,,1,5,8,13
10597,unknownmat,,1,25,34,59
10598,cheek_meister,,1,3,2,5
10599,wickey29,,1,3,1,4
10600,sackitup,,1,5,15,20
10601,redditwontlogmein,,1,2,1,3
10602,Derj,,1,4,2,6
10603,ilya_ost,,1,4,3,7
10604,Sueblimely,,1,1,1,2
10605,vargas,,1,19,12,31
10606,ymomo,,1,68,77,145
10607,schex86,,1,26,24,50
10608,djadamjay,,1,2,9,11
10609,keitarofujiwara,,1,81,181,262
10610,paulgraham,,1,53,26,79
10611,scazrelet,,1,7,12,19
10612,miraflox,,1,13,17,30
10613,pembo13,,1,9,11,20
10614,dbabbitt,,1,8,12,20
10615,Bane,,1,6,14,20
10616,LordSkippy,,1,56,74,130
10617,bobbyvoicu,,1,6,1,7
10618,athiejane,,1,2,9,11
10619,objectnull,,1,2,3,5
10620,pepperink,,1,4,9,13
10621,brightsunshining,,1,13,27,40
10622,olliragic,,1,1,1,2
10623,claude_1903,,1,1,2,3
10624,jledbet,,1,5,1,6
10625,clam,,1,9,3,12
10626,nodger,,1,3,3,6
10627,studio64nyc,,1,7,1,8
10628,dwarfcadaver,,1,1,1,2
10629,petteri,,1,199,29,228
10630,Corgan1351,,1,27,34,61
10631,jowjow,,1,3,1,4
10632,DavidTehGnome,,1,92,150,242
10633,infocorruption,,1,2,3,5
10634,abstractthought,,1,6,3,9
10635,CharlesIII,,1,2,4,6
10636,nice_dkjames,,1,58,83,141
10637,AviationWorld,,1,11,7,18
10638,Worldviewsblog,,1,4,3,7
10639,daragh,,1,8,7,15
10640,keruha,,1,22,33,55
10641,monkeyballs,,1,4,10,14
10642,gt384u,,1,26,33,59
10643,simen,,1,175,238,413
10644,AniMouse,,1,2,1,3
10645,jpurc,,1,2,2,4
10646,aComa,,1,14,14,28
10647,asdasdo,,1,5,5,10
10648,mkwiat,,1,27,36,63
10649,ricoza,,1,9,8,17
10650,alalex,,1,10,1,11
10651,Daarom,,1,1,1,2
10652,twism,,1,2,1,3
10653,Cameljock,,1,5,10,15
10654,mylescloutier,,1,55,76,131
10655,uberjosh,,1,1,2,3
10656,PAK-9,,1,3,2,5
10657,Proximity,,1,7,5,12
10658,AceTracer,,1,20,28,48
10659,Starcrusher,,1,303,178,481
10660,krautpastry,,1,18,28,46
10661,lever2000,,1,1,1,2
10662,adeev,,1,7,7,14
10663,how_gauche,,1,13,15,28
10664,Guiness,,1,1,1,2
10665,fxj,,1,20,42,62
10666,hulacat,,1,28,5,33
10667,vees,,1,1,4,5
10668,hifibug,,1,1,1,2
10669,trezorr,,1,154,219,373
10670,youhadmeatzugzug,,1,2,1,3
10671,Goronmon,,1,2,2,4
10672,One808,,1,3,6,9
10673,assfacejackson,,1,20,48,68
10674,yergi,,1,3,7,10
10675,WE_ARE_ALL_GONNA_DIE,,1,1,2,3
10676,gordonjay2,,1,314,333,647
10677,lucid270,,1,7,12,19
10678,Gupie,,1,35,9,44
10679,adamwulf,,1,1,2,3
10680,xesttub,,1,2,3,5
10681,Tyrone_Gomez,,1,29,17,46
10682,xott,,1,21,34,55
10683,bariswheel,,1,25,29,54
10684,ndestries,,1,9,2,11
10685,Noladishu,,1,16,15,31
10686,dneuman911,,1,431,32,463
10687,retsotrembla,,1,41,25,66
10688,masterfoo,,1,2,10,12
10689,brokendown,,1,182,206,388
10690,4fthawaiian,,1,3,5,8
10691,CrazyDave303,,1,1,2,3
10692,clexmond,,1,1,1,2
10693,zeoslap,,1,106,94,200
10694,tads73,,1,72,189,261
10695,12AngryMen,,1,3,2,5
10696,bonefry,,1,51,59,110
10697,ttaylor38655,,1,2,1,3
10698,FullOfSheeple,,1,48,82,130
10699,dumbasshit,,1,21,18,39
10700,greenlizzard,,1,24,1,25
10701,Iraq_Hussein_Osama,,1,5,11,16
10702,rlm1966,,1,1,1,2
10703,lostangel202,,1,6,2,8
10704,edf825,,1,8,13,21
10705,SVOboy,,1,643,48,691
10706,Canucklesandwitch,,1,3,2,5
10707,SierraAlpha,,1,1,1,2
10708,Bubblyboo,,1,10,3,13
10709,bort901,,1,82,19,101
10710,jeffkolez,,1,34,29,63
10711,goleez,,1,1,2,3
10712,DoesItHurt,,1,9,1,10
10713,eegan1220,,1,4,8,12
10714,TheSquirrel,,1,8,10,18
10715,foamweapons,,1,55,66,121
10716,umeshunni,,1,6,1,7
10717,kennon42,,1,49,46,95
10718,markander,,1,94,136,230
10719,bobbothegrayson,,1,239,74,313
10720,scavenger,,1,108,2,110
10721,meganmcpain,,1,15,29,44
10722,mutatron,,1,2176,3301,5477
10723,falseprophet,,1,400,224,624
10724,growne,,1,2,3,5
10725,blackocellaris,,1,3,3,6
10726,FuggyFresh,,1,1,6,7
10727,etiennep,,1,1,1,2
10728,Maitreya,,1,1,1,2
10729,baxil,,1,128,129,257
10730,lunaemt,,1,3,2,5
10731,Arrgh,,1,200,276,476
10732,Yndis,,1,1,1,2
10733,Isth-mus,,1,18,30,48
10734,MichDdot,,1,71,30,101
10735,drjekelmrhyde,,1,6,13,19
10736,pdwerryhouse,,1,16,4,20
10737,ashoka,,1,3,2,5
10738,ScientificBlogger,,1,7,11,18
10739,stapuff6,,1,2,4,6
10740,Dick_And_Bush,,1,11,5,16
10741,elus,,1,347,577,924
10742,safronloongie,,1,29,85,114
10743,WLiam2012,,1,2,1,3
10744,publicunimail,,1,1,1,2
10745,slogg,,1,3,3,6
10746,spinney,,1,10,17,27
10747,zap,,1,160,79,239
10748,felipe806,,1,65,98,163
10749,beyondration,,1,4,6,10
10750,bath0ry,,1,1,1,2
10751,petermaxwel73,,1,52,5,57
10752,krowziviche,,1,1,1,2
10753,thatguydr,,1,1133,1573,2706
10754,nayturboy,,1,1,3,4
10755,stupidinternet,,1,21,41,62
10756,xinaaj,,1,2,2,4
10757,mmiller,,1,43,83,126
10758,zosomos,,1,77,107,184
10759,reddit_is_stupid,,1,3,7,10
10760,nextedge,,1,129,173,302
10761,AlBundy,,1,1,1,2
10762,Colee,,1,21,45,66
10763,Logician,,1,5,3,8
10764,retho2,,1,69,18,87
10765,WileyG27,,1,1,2,3
10766,aroundtown,,1,18,49,67
10767,rbraeu,,1,5,25,30
10768,durkheim_306,,1,5,8,13
10769,recidivx,,1,6,8,14
10770,davidddavidson,,1,1,1,2
10771,Hitler_was_Liberal,,1,15,29,44
10772,johnrobe,,1,7,13,20
10773,trashlikeyou,,1,1,2,3
10774,Nico_,,1,16,16,32
10775,tygez,,1,4,12,16
10776,sfacets,,1,611,954,1565
10777,johnhummel,,1,131,88,219
10778,hypatia21,,1,3,2,5
10779,bjs3171,,1,3,1,4
10780,vassago,,1,1,4,5
10781,hardcorerednext,,1,7,21,28
10782,matgilbert,,1,5,18,23
10783,kevorama822,,1,1,2,3
10784,sickofgoldbrickers,,1,7,3,10
10785,bigt748,,1,45,10,55
10786,mmm69,,1,9,9,18
10787,Cleric85,,1,96,156,252
10788,kday,,1,15,26,41
10789,IThinkYouMean,,1,2,10,12
10790,MrScotchBoy,,1,4,3,7
10791,mlappy,,1,211,316,527
10792,chonnes,,1,178,160,338
10793,scatter,,1,4,2,6
10794,rbvmusic,,1,140,126,266
10795,squirrel,,1,2,2,4
10796,Kapnobatai,,1,2,4,6
10797,ratatosk,,1,7,12,19
10798,Gimble,,1,36,88,124
10799,the_devils_advocate,,1,1,1,2
10800,LoganPhyve,,1,4,23,27
10801,dufus_pufus,,1,1,1,2
10802,Soss,,1,2,4,6
10803,thesnowfox,,1,13,18,31
10804,saibatsu,,1,3,5,8
10805,bewarethetreebadger,,1,247,365,612
10806,owee,,1,16,28,44
10807,KillYourTV,,1,364,529,893
10808,jameyc,,1,1,2,3
10809,_wool,,1,3,1,4
10810,hoopshype,,1,19,1,20
10811,blue7,,1,1,1,2
10812,pablogrb,,1,6,2,8
10813,dmd,,1,326,299,625
10814,darkwulf,,1,36,69,105
10815,fit4u,,1,1,2,3
10816,itv,,1,17,27,44
10817,rubensinclair,,1,14,26,40
10818,pics1301,,1,1,1,2
10819,john87,,1,24,39,63
10820,mrhota,,1,54,102,156
10821,juanchopancho,,1,62,139,201
10822,Mr_Clownn,,1,49,31,80
10823,ShaneLives,,1,1,2,3
10824,orjan,,1,6,6,12
10825,chikkidee,,1,1,1,2
10826,easyfrag,,1,63,35,98
10827,hash150,,1,1,1,2
10828,tyler2k,,1,1,4,5
10829,jasonal,,1,14,11,25
10830,hashi_lebwohl,,1,2,8,10
10831,popat2000,,1,31,73,104
10832,2Eterneon,,1,1,1,2
10833,extraheavymarcellus,,1,2,7,9
10834,t3mp3st,,1,33,33,66
10835,Twisted,,1,140,190,330
10836,GWBWTC911,,1,3,7,10
10837,neverknow,,1,90,47,137
10838,bagpipegoatee,,1,7,15,22
10839,parisxv,,1,20,10,30
10840,ronaldst,,1,3,2,5
10841,mictlanian,,1,1,2,3
10842,Jules_motherfucker,,1,1,3,4
10843,G-Race,,1,1,4,5
10844,glosie,,1,2,5,7
10845,ticklecricket,,1,326,361,687
10846,canadiaman,,1,4,8,12
10847,jozilla,,1,1,1,2
10848,hj427,,1,2,3,5
10849,NZ420,,1,7,2,9
10850,jody_imus_rulz,,1,2,1,3
10851,rosejonescolour,,1,16,22,38
10852,Sparq,,1,10,27,37
10853,AndWat,,1,88,29,117
10854,zaru_soba,,1,19,22,41
10855,kewidogg,,1,2,1,3
10856,rafo,,1,1,4,5
10857,cshipley,,1,2,7,9
10858,Cavorticus,,1,97,209,306
10859,Bloody_Eye,,1,421,476,897
10860,stealth210,,1,41,36,77
10861,drch,,1,36,37,73
10862,Varthash,,1,3,10,13
10863,sofacough,,1,1,1,2
10864,kmack,,1,43,101,144
10865,jarpit,,1,2,4,6
10866,kevinthedude,,1,2,1,3
10867,nofunatall,,1,5,7,12
10868,circusbred,,1,32,42,74
10869,stirfry,,1,17,31,48
10870,make_cookies_permane,,1,29,35,64
10871,DeadPrez,,1,10,4,14
10872,jacobhsoboroff,,1,95,3,98
10873,Creative_Thinker,,1,1,1,2
10874,alfismoney,,1,8,7,15
10875,dirka,,1,41,29,70
10876,onehitwonder,,1,5,1,6
10877,FatAssHam,,1,2,1,3
10878,TomatoSlayer,,1,29,70,99
10879,Blkhrtd,,1,3,3,6
10880,BornAMuslimStay4Ever,,1,10,13,23
10881,godseyeview,,1,5,5,10
10882,Zootex,,1,128,177,305
10883,JohnathanD,,1,6,6,12
10884,dyneo,,1,1,1,2
10885,infernalmachine,,1,1,2,3
10886,afahmed,,1,1,2,3
10887,mandroid,,1,1,2,3
10888,UberNL,,1,2,1,3
10889,thynnus,,1,4,16,20
10890,bluishred,,1,29,31,60
10891,bwelford,,1,1,1,2
10892,hangoneveryword,,1,323,324,647
10893,rogerly,,1,5,3,8
10894,nixons,,1,6,22,28
10895,camwaite,,1,1,1,2
10896,taggesq,,1,2,4,6
10897,GTracer,,1,1,1,2
10898,rarebluemonkey,,1,236,303,539
10899,olifante,,1,7,12,19
10900,mikeyc252,,1,75,61,136
10901,Wurlitzer,,1,1,1,2
10902,DrStrngeluv,,1,1,3,4
10903,cfrey,,1,27,56,83
10904,pointy,,1,9,11,20
10905,WiseMasterRat,,1,7,7,14
10906,Trevkor,,1,5,1,6
10907,SamB,,1,1,3,4
10908,jdrogers923,,1,49,75,124
10909,soopisgoodfood,,1,145,26,171
10910,mattfasken,,1,110,177,287
10911,NoData,,1,15,22,37
10912,DrunkenTrom,,1,12,18,30
10913,snark42,,1,133,186,319
10914,nerd123,,1,3,2,5
10915,beaumct,,1,2,1,3
10916,ebee,,1,54,90,144
10917,CrazyLemurBoy,,1,23,12,35
10918,seskie,,1,2,4,6
10919,Fromez,,1,31,23,54
10920,batpanther,,1,1,3,4
10921,spacenut37,,1,46,100,146
10922,thesalus,,1,10,8,18
10923,vinigrette,,1,92,118,210
10924,Tholo,,1,13,12,25
10925,Arsecroft,,1,15,26,41
10926,Knick,,1,50,4,54
10927,rkts,,1,3,6,9
10928,sping,,1,433,695,1128
10929,muramasa,,1,121,104,225
10930,Marxshmarx,,1,14,13,27
10931,bigpeters,,1,4,5,9
10932,nuanceify,,1,1,2,3
10933,AnimZero,,1,6,4,10
10934,gruuby,,1,66,102,168
10935,jczeus,,1,9,17,26
10936,thatusernameistaken,,1,2,3,5
10937,artlung,,1,4,2,6
10938,CaptWacky,,1,159,54,213
10939,nepotism,,1,44,49,93
10940,americafuckyeah,,1,7,22,29
10941,squirreltapper,,1,1,1,2
10942,xfactorial,,1,28,27,55
10943,powerhead,,1,40,53,93
10944,modivate,,1,27,11,38
10945,youwish20,,1,3,3,6
10946,miketrash,,1,197,62,259
10947,LordFoom,,1,94,187,281
10948,I_go_out_in_my_PJs,,1,10,2,12
10949,CdnGuy,,1,4,6,10
10950,ender1980,,1,2,9,11
10951,Sutto,,1,6,11,17
10952,otherguy,,1,77,117,194
10953,modelchick8806,,1,11,16,27
10954,Gmclaurin,,1,1,1,2
10955,StarBeamAlpha,,1,21,21,42
10956,KenMixtape,,1,12,18,30
10957,Stax493,,1,1,7,8
10958,zetsurin,,1,32,43,75
10959,worldlybedouin,,1,42,58,100
10960,beohbe,,1,19,34,53
10961,magnusbe,,1,10,15,25
10962,bboy1977,,1,6,6,12
10963,shoesbuttback,,1,49,87,136
10964,bobmoretti,,1,1,2,3
10965,honkerburger,,1,126,67,193
10966,ivankirigin,,1,33,31,64
10967,Slycne,,1,1,1,2
10968,doodoohead,,1,1,1,2
10969,johso,,1,4,3,7
10970,9917,,1,13,24,37
10971,machx,,1,1,1,2
10972,MadMark,,1,10,11,21
10973,ericthefish,,1,3,3,6
10974,vishnoo,,1,24,23,47
10975,onemoretune,,1,4,9,13
10976,aphexairlines,,1,160,237,397
10977,gtmills,,1,1,1,2
10978,canipole,,1,8,9,17
10979,gagle,,1,1,3,4
10980,Gnosquito,,1,1,1,2
10981,NorthwestWolf,,1,1,3,4
10982,wiggitywhack,,1,7,18,25
10983,zoltar74,,1,19,12,31
10984,ChendlerBing,,1,1,1,2
10985,Kricket,,1,8,14,22
10986,heyblincoln,,1,11,1,12
10987,massivedooker,,1,4,5,9
10988,poleary,,1,50,34,84
10989,bg785,,1,52,19,71
10990,filberts,,1,114,144,258
10991,torontoist,,1,15,1,16
10992,apenguinatemyhamster,,1,26,23,49
10993,asnklv,,1,1,3,4
10994,funk_wumpkins,,1,19,13,32
10995,sythec,,1,14,55,69
10996,vague_blur,,1,95,246,341
10997,fancy-free,,1,87,148,235
10998,bleedpurpleguy,,1,73,131,204
10999,sweetfish,,1,1,1,2
11000,OH-YEAH,,1,4,7,11
11001,kingGBush,,1,10,21,31
11002,comedyishard,,1,16,39,55
11003,motherof2,,1,1,1,2
11004,Crazy_Cyrax,,1,9,5,14
11005,thebarbarian87,,1,106,226,332
11006,alphasignal5,,1,34,49,83
11007,pb1157,,1,5,6,11
11008,edward_r_burrow,,1,206,237,443
11009,credence,,1,108,155,263
11010,capbrune,,1,5,6,11
11011,bcorfman,,1,54,49,103
11012,sacherjj,,1,210,299,509
11013,godhammre,,1,328,423,751
11014,lynxlynx,,1,4,6,10
11015,ryuujinusa,,1,3,13,16
11016,alice_,,1,1,2,3
11017,tzan,,1,24,25,49
11018,Zyg,,1,32,19,51
11019,erictheinfonaut,,1,153,3,156
11020,ktvoelker,,1,3,4,7
11021,GirlGeorge,,1,66,17,83
11022,gmee2213,,1,1,9,10
11023,Ivashkin,,1,3,6,9
11024,mapryan,,1,138,145,283
11025,gratdbat,,1,21,31,52
11026,GFHrecluse,,1,1,7,8
11027,itsallfunfunfun,,1,2,9,11
11028,ASquaredWriter,,1,1,5,6
11029,stealthfox,,1,1,1,2
11030,drslammy,,1,84,7,91
11031,sbjf,,1,22,12,34
11032,Chexjc,,1,1,2,3
11033,jedbism,,1,5,4,9
11034,regreddit,,1,66,104,170
11035,metallicafan,,1,17,25,42
11036,creativename,,1,82,70,152
11037,flowerb0x,,1,3,2,5
11038,ussr,,1,16,3,19
11039,Admiral-Evident,,1,61,86,147
11040,spliznork,,1,93,94,187
11041,Wiseman1024,,1,476,512,988
11042,graymalkin,,1,4,4,8
11043,canhaskarma,,1,209,173,382
11044,NOT_AN_ALIEN,,1,16,17,33
11045,Redwan,,1,35,36,71
11046,edgarallenpoe,,1,112,229,341
11047,RLET,,1,22,22,44
11048,orangetide,,1,7,15,22
11049,chandler760,,1,1,1,2
11050,tacitus1,,1,407,8,415
11051,AnonymousChicken,,1,38,54,92
11052,LordQuorad,,1,9,24,33
11053,suplol,,1,1,1,2
11054,SeaLegs,,1,11,1,12
11055,rcut,,1,99,91,190
11056,chuck_c,,1,18,29,47
11057,tulku,,1,5,5,10
11058,dsb101,,1,28,20,48
11059,helloinsomnia,,1,1,1,2
11060,buddhistkitten,,1,66,86,152
11061,BangGoodOne,,1,25,68,93
11062,deafmacro,,1,6,14,20
11063,michaelll,,1,7,12,19
11064,pbinder,,1,24,15,39
11065,pfhor,,1,23,43,66
11066,kingdom,,1,5,5,10
11067,jholloway7,,1,7,7,14
11068,sirshannon,,1,3,2,5
11069,thepowerwithin,,1,1,1,2
11070,lencioni,,1,20,7,27
11071,crazedover,,1,72,73,145
11072,teaguesterling,,1,51,78,129
11073,elliotakshun,,1,4,12,16
11074,Zlatty,,1,263,341,604
11075,retnuh730,,1,20,3,23
11076,ChosenTongue,,1,1,1,2
11077,singletask,,1,1,19,20
11078,apefist,,1,4,2,6
11079,eatme0,,1,1,2,3
11080,stonecannon,,1,76,38,114
11081,rocksauce,,1,116,225,341
11082,MassesOfTheOpiate,,1,326,539,865
11083,apackofwankers,,1,9,9,18
11084,GI-20,,1,6,1,7
11085,TKN,,1,97,102,199
11086,fdgdfgdf,,1,1,1,2
11087,ohhiohhi,,1,1,1,2
11088,ctrl-freak,,1,1,1,2
11089,srpr,,1,27,1,28
11090,isepic,,1,3,2,5
11091,mitja23,,1,1,1,2
11092,mexmexmex_2000,,1,1,1,2
11093,huhwhat,,1,2,1,3
11094,The_Government,,1,9,15,24
11095,jjmac,,1,77,87,164
11096,mythogen,,1,111,158,269
11097,tkengland,,1,9,15,24
11098,djv,,1,1,1,2
11099,jedrury,,1,3,3,6
11100,meritw,,1,3,2,5
11101,rowanwolf,,1,1,1,2
11102,peepingtom,,1,1,1,2
11103,cwhite,,1,23,40,63
11104,cmak,,1,34,29,63
11105,Gglii,,1,1,3,4
11106,RalphBott,,1,7,7,14
11107,seemant,,1,60,89,149
11108,scoobeee,,1,92,225,317
11109,ShoutShout,,1,1,3,4
11110,Unfair,,1,311,502,813
11111,cuyler,,1,71,70,141
11112,babaloooo,,1,1,3,4
11113,ochen7,,1,94,47,141
11114,tededit,,1,1,6,7
11115,bishoplonnie,,1,12,5,17
11116,TaraAthenry,,1,1,1,2
11117,1cesc,,1,252,69,321
11118,SemiLOOSE,,1,33,9,42
11119,Rev_Jeremiah_Wright,,1,1,1,2
11120,drewyp,,1,12,13,25
11121,bohemus,,1,481,141,622
11122,jnoller,,1,6,12,18
11123,mrmonster,,1,21,35,56
11124,JHMcCormick,,1,3,4,7
11125,Poligan,,1,80,7,87
11126,soulicro,,1,26,14,40
11127,SarahPalin-,,1,8,12,20
11128,MockDeath,,1,1,7,8
11129,pixzor,,1,16,31,47
11130,Ohio,,1,2,3,5
11131,WWJeffersonDo,,1,5,11,16
11132,psychicbologna,,1,6,18,24
11133,qubous,,1,5,7,12
11134,JW_00000,,1,141,167,308
11135,sexymustard,,1,19,7,26
11136,no1name,,1,303,399,702
11137,silverbax,,1,2,2,4
11138,missilesilo,,1,47,67,114
11139,fmoor,,1,3,5,8
11140,sarcasticmuch,,1,9,7,16
11141,poopballs,,1,41,80,121
11142,limplipliberal,,1,2,5,7
11143,jackndacrackman,,1,3,1,4
11144,Snugglzworth,,1,3,7,10
11145,luciansolaris,,1,15,13,28
11146,thindude,,1,1,1,2
11147,raand,,1,10,16,26
11148,Syl,,1,20,46,66
11149,ahall,,1,7,9,16
11150,AwkwardSilenceMan,,1,1,3,4
11151,swovii,,1,1,1,2
11152,twiggyfoot1,,1,3,2,5
11153,JacKrac,,1,139,224,363
11154,breauxaj,,1,3,1,4
11155,jayho,,1,21,26,47
11156,Sleepman,,1,20,14,34
11157,deathonabudget,,1,1,3,4
11158,coderob,,1,3,2,5
11159,elikagan,,1,13,4,17
11160,zintzun,,1,11,10,21
11161,srika,,1,891,1336,2227
11162,warchild,,1,7,8,15
11163,xeno81,,1,1,3,4
11164,sleepyhead-,,1,4,2,6
11165,_Cactus_,,1,2,1,3
11166,ThomasEdilson,,1,71,12,83
11167,danclaw,,1,41,84,125
11168,5555,,1,66,58,124
11169,subcypher,,1,4,14,18
11170,futto,,1,53,73,126
11171,w5k3fTkZ,,1,12,4,16
11172,tracii1984,,1,36,55,91
11173,uberfr4gger,,1,17,21,38
11174,strikingviking,,1,1,1,2
11175,Ask_Reddit,,1,1,1,2
11176,slowdraw,,1,1,1,2
11177,sundogdayze,,1,97,183,280
11178,nolte3,,1,5,3,8
11179,quattro,,1,154,227,381
11180,aaronreddit,,1,192,145,337
11181,sean9812,,1,4,5,9
11182,mr_aks,,1,17,1,18
11183,spiraltri3e,,1,22,36,58
11184,terrorazzi,,1,2,1,3
11185,mcsalmon,,1,302,180,482
11186,dan537,,1,1,1,2
11187,tywebb,,1,6,6,12
11188,Derferman,,1,76,77,153
11189,BigEazy,,1,76,13,89
11190,jruderer,,1,1,3,4
11191,Rabizar,,1,3,2,5
11192,DrMic,,1,49,30,79
11193,skea1811,,1,1,1,2
11194,abyssomega,,1,73,97,170
11195,scipio_major,,1,1,4,5
11196,p337,,1,346,391,737
11197,anthonygonsalves,,1,78,166,244
11198,janpjens,,1,34,43,77
11199,xualzan,,1,2,2,4
11200,obi-nine,,1,8,3,11
11201,gama69g,,1,8,15,23
11202,Corbier,,1,22,10,32
11203,kreiger,,1,3,7,10
11204,pvande,,1,3,9,12
11205,deism666,,1,41,8,49
11206,janisdoof,,1,9,19,28
11207,redbukil,,1,6,1,7
11208,abend954,,1,35,30,65
11209,GrantCity,,1,1,2,3
11210,harisn,,1,1,4,5
11211,wormmox,,1,7,7,14
11212,saculus,,1,5,3,8
11213,elmariachi304,,1,114,111,225
11214,noideawhatisgoingon,,1,5,5,10
11215,Chompy,,1,23,29,52
11216,psnajder,,1,53,18,71
11217,JPsmooth42,,1,102,66,168
11218,marion33,,1,9,10,19
11219,ggrothau,,1,14,7,21
11220,suacy,,1,9,10,19
11221,kfm,,1,30,10,40
11222,alecco,,1,31,30,61
11223,paket,,1,1,3,4
11224,beached,,1,1,1,2
11225,Jesus_is_great,,1,6,3,9
11226,harpwn,,1,175,167,342
11227,playerbeat,,1,68,42,110
11228,opie211,,1,5,1,6
11229,Pedobear-,,1,1,1,2
11230,arnone,,1,24,28,52
11231,Zareh,,1,7,8,15
11232,thurston51,,1,1,2,3
11233,StabbyGator,,1,5,6,11
11234,timberspine,,1,425,314,739
11235,Soul_Rebel,,1,4,7,11
11236,sophistirat,,1,3,5,8
11237,Fu3go,,1,6,8,14
11238,mexicanbach,,1,16,40,56
11239,charlesmcallister,,1,1,2,3
11240,ExactlyMyThoughts,,1,5,5,10
11241,kodemage,,1,33,50,83
11242,Joe6pack,,1,26,30,56
11243,bbbobsaget,,1,66,78,144
11244,DavidMcLaughlin,,1,29,13,42
11245,rds260,,1,342,494,836
11246,smokealot,,1,38,91,129
11247,Ek0nomik,,1,53,59,112
11248,ste3ve,,1,4,3,7
11249,sfddsfsddd,,1,9,14,23
11250,i31ush,,1,2,5,7
11251,FakeFact,,1,9,12,21
11252,Redfel,,1,65,150,215
11253,Traftron,,1,1,1,2
11254,arodessa,,1,4,5,9
11255,cnichols82,,1,1,12,13
11256,pyro138,,1,73,84,157
11257,Unapox,,1,111,143,254
11258,dmun,,1,7,4,11
11259,mjpanzer,,1,54,52,106
11260,kra,,1,8,8,16
11261,petelyons,,1,15,4,19
11262,moddestmouse,,1,470,497,967
11263,cmbezln,,1,6,6,12
11264,uhhhclem,,1,43,68,111
11265,whitepaper,,1,7,20,27
11266,CaptainDevious,,1,558,648,1206
11267,ppolv,,1,1,1,2
11268,confuseum,,1,2,4,6
11269,bstard,,1,27,29,56
11270,spineless,,1,1,1,2
11271,ryanroth,,1,15,3,18
11272,redrobot5050,,1,635,1027,1662
11273,docbrolic,,1,203,178,381
11274,BunjiX,,1,6,12,18
11275,KudoKid,,1,6,11,17
11276,janzo,,1,2,1,3
11277,phooka,,1,1,3,4
11278,whatevermakesuhappy,,1,41,13,54
11279,bricklab,,1,12,21,33
11280,GuardManiaC,,1,2,4,6
11281,jorgamun,,1,11,24,35
11282,slovakov,,1,17,34,51
11283,mraseelak,,1,1,1,2
11284,yosefmartin,,1,2,2,4
11285,gangsta-gangsta,,1,45,12,57
11286,ronbot,,1,15,18,33
11287,jt32470,,1,214,440,654
11288,perrin,,1,1,3,4
11289,ryan44,,1,1,5,6
11290,mvaliente2001,,1,24,18,42
11291,vjxucu,,1,1,1,2
11292,rexhardwick,,1,15,6,21
11293,dbt08,,1,9,28,37
11294,sati,,1,15,7,22
11295,keturn,,1,11,18,29
11296,noyu,,1,8,15,23
11297,aylwin,,1,7,11,18
11298,politicallore,,1,358,22,380
11299,Chun,,1,386,270,656
11300,Astrophro,,1,3,2,5
11301,pandaba,,1,45,52,97
11302,daikiki,,1,82,18,100
11303,restore,,1,14,25,39
11304,buddhagirl,,1,1,4,5
11305,rccgd,,1,1,1,2
11306,micahi21,,1,11,25,36
11307,Vicinus,,1,15,16,31
11308,comics4u,,1,6,12,18
11309,sufraga,,1,5,12,17
11310,Chasingwaves,,1,56,59,115
11311,ricky_clarkson,,1,22,31,53
11312,Quibbling_Fucker,,1,9,3,12
11313,manipur,,1,7,1,8
11314,superanth,,1,5,3,8
11315,basninja,,1,3,2,5
11316,xhanjian,,1,22,6,28
11317,JeddHampton,,1,80,109,189
11318,Zaphrod,,1,15,15,30
11319,This_guys_sockpuppet,,1,2,5,7
11320,fingernibbler,,1,3,4,7
11321,Camarade_Tux,,1,2,3,5
11322,damageboy,,1,25,7,32
11323,pmarsh,,1,59,73,132
11324,JNTB,,1,1,3,4
11325,Pxl_Buzzard,,1,23,2,25
11326,Judas,,1,54,85,139
11327,nuclear_eclipse,,1,227,299,526
11328,electrobutter,,1,47,9,56
11329,jinendu,,1,79,100,179
11330,FooFighter828,,1,3,6,9
11331,BillyBlanks,,1,62,73,135
11332,mrgreen4242,,1,484,417,901
11333,benjamincanfly,,1,372,341,713
11334,twomeanings,,1,2,5,7
11335,makapuf,,1,1,2,3
11336,hypoglycemic,,1,6,9,15
11337,mahade,,1,94,120,214
11338,heresyforme,,1,17,14,31
11339,secmil,,1,35,33,68
11340,joecool,,1,50,38,88
11341,vastib,,1,272,193,465
11342,gterrill,,1,2,2,4
11343,mlietzen,,1,3,9,12
11344,kehaar,,1,13,21,34
11345,skytland,,1,1,3,4
11346,cgeorgan,,1,108,122,230
11347,BloodWar,,1,1,3,4
11348,macsbac,,1,1,3,4
11349,boooomsquad,,1,1,1,2
11350,mccoyn,,1,494,851,1345
11351,Wickerchair,,1,148,94,242
11352,madjalapeno,,1,11,14,25
11353,scienceevofreak,,1,4,1,5
11354,gillnana,,1,1,1,2
11355,flicea,,1,17,10,27
11356,gippo333,,1,3,3,6
11357,bethyboo,,1,2,1,3
11358,VCavallo,,1,49,75,124
11359,vprasad1,,1,12,23,35
11360,enjo42,,1,6,1,7
11361,bw1870,,1,539,1064,1603
11362,RichardPryor,,1,1472,404,1876
11363,mick92627,,1,1,1,2
11364,redwoodtree,,1,2,2,4
11365,Iconic,,1,10,22,32
11366,spiker611,,1,25,52,77
11367,hannahlin,,1,60,85,145
11368,TypicalAmerican,,1,6,15,21
11369,troubleshooter,,1,2,2,4
11370,crawfordretail,,1,3,1,4
11371,megagreg,,1,105,177,282
11372,Maxxist,,1,118,218,336
11373,norsurfit,,1,81,80,161
11374,cherryhoward,,1,1,1,2
11375,Kildurin,,1,13,14,27
11376,tibbs44,,1,1,1,2
11377,xoner2,,1,44,60,104
11378,zarubi,,1,41,15,56
11379,alkoret,,1,2,4,6
11380,mrwesticles,,1,12,23,35
11381,jwgerard,,1,1,3,4
11382,reply,,1,133,208,341
11383,bobbyb500,,1,1,2,3
11384,boobasan,,1,430,129,559
11385,bengrubb,,1,3,2,5
11386,profr,,1,4,8,12
11387,brien,,1,7,6,13
11388,johnmorris,,1,9,1,10
11389,ravemanX,,1,1,1,2
11390,pressed,,1,311,333,644
11391,flamehead243,,1,20,1,21
11392,RichardSimmons,,1,7,14,21
11393,dr3d,,1,9,30,39
11394,dheld,,1,4,3,7
11395,scabootssca,,1,5,7,12
11396,cheech_sp,,1,46,50,96
11397,ggruschow,,1,15,6,21
11398,cogtrj,,1,1,2,3
11399,zapfastnet,,1,1,3,4
11400,m_res,,1,112,202,314
11401,kojef,,1,13,5,18
11402,gongus,,1,8,10,18
11403,fetty,,1,1,1,2
11404,feilb,,1,23,8,31
11405,withclothes,,1,16,2,18
11406,dango7777,,1,1,1,2
11407,art80,,1,1,2,3
11408,jaymeekae,,1,162,130,292
11409,superherojuice,,1,1,1,2
11410,indigo-alien,,1,78,192,270
11411,nullbot,,1,1,2,3
11412,OhNoMaiFreeDumbs,,1,3,4,7
11413,SFonTHill,,1,18,9,27
11414,djeron,,1,1,2,3
11415,paradigmshaft,,1,10,13,23
11416,kanima,,1,3,5,8
11417,pingu,,1,83,155,238
11418,Nivekt13,,1,3,4,7
11419,jigulous,,1,1,1,2
11420,baltar,,1,1,1,2
11421,peerLAN,,1,4,1,5
11422,SILNTBOB,,1,1,1,2
11423,nashife,,1,20,40,60
11424,slayt00,,1,1,1,2
11425,murkos,,1,1,4,5
11426,pingish,,1,792,698,1490
11427,willpall,,1,8,19,27
11428,overand,,1,5,6,11
11429,SNerison,,1,5,2,7
11430,revilo23,,1,3,12,15
11431,JohnZoidberg,,1,17,1,18
11432,kitsy,,1,13,39,52
11433,glassjoe984,,1,2,3,5
11434,dude187,,1,6,2,8
11435,kiriyama,,1,102,2,104
11436,vor,,1,6,2,8
11437,rastawala,,1,297,5,302
11438,drewfer,,1,17,19,36
11439,code2code,,1,3,2,5
11440,eldurable,,1,1,1,2
11441,Ciceros_Assassin,,1,76,81,157
11442,LiberalDemocrat_ftw,,1,1,1,2
11443,boomi,,1,4,4,8
11444,dwahler,,1,22,39,61
11445,Freedom4You,,1,1,1,2
11446,amican,,1,297,615,912
11447,woop_,,1,17,10,27
11448,j_mcc99,,1,1,5,6
11449,Sheki,,1,1,1,2
11450,vamit11,,1,1,8,9
11451,roccobuttonlucky,,1,341,39,380
11452,lastobelus,,1,34,51,85
11453,Joss,,1,50,75,125
11454,cmv1607,,1,6,6,12
11455,iknoritesrsly,,1,9,15,24
11456,thirstyrobot,,1,1,1,2
11457,balackosama,,1,2,2,4
11458,ShadedTrow,,1,9,18,27
11459,masukomi,,1,161,234,395
11460,thechicken,,1,1,1,2
11461,ekspiulo,,1,3,5,8
11462,weddingcrasher,,1,10,4,14
11463,haija,,1,68,77,145
11464,xcyclist,,1,2,3,5
11465,Clampurloiner,,1,2,2,4
11466,seangw,,1,21,4,25
11467,scubastza,,1,25,6,31
11468,cheddarben,,1,613,330,943
11469,anonymousgoat,,1,4,3,7
11470,skibybadoowap,,1,188,99,287
11471,whadthfxup,,1,1,1,2
11472,frabbergasted,,1,1,2,3
11473,caenum,,1,1,10,11
11474,neema,,1,9,3,12
11475,libertyman,,1,4,3,7
11476,Bitey,,1,87,60,147
11477,Spiralhead,,1,11,15,26
11478,helixblue,,1,1,1,2
11479,hammermybones,,1,1,4,5
11480,weekapaugr00ve,,1,4,7,11
11481,alephnul,,1,453,1263,1716
11482,dragonstyle,,1,5,2,7
11483,rischi,,1,12,19,31
11484,Misses_DePoint,,1,11,19,30
11485,rtknox00,,1,549,46,595
11486,darianjd,,1,1,2,3
11487,fuzzo,,1,1411,912,2323
11488,extole,,1,1,4,5
11489,k3ithk,,1,66,113,179
11490,vampireface,,1,173,160,333
11491,FFFFFFFFffff,,1,30,23,53
11492,cff,,1,12,10,22
11493,asdfadsfadsf,,1,11,15,26
11494,uiopq,,1,1,1,2
11495,nancybryan,,1,2,1,3
11496,n3m6,,1,56,113,169
11497,quetzalcoatl1,,1,2,1,3
11498,RibbonsUndone,,1,1,1,2
11499,maxbaroi,,1,13,23,36
11500,heff,,1,2,1,3
11501,allanf,,1,2,2,4
11502,Ridgecliff,,1,3,5,8
11503,jonez450,,1,161,6,167
11504,JimmyMcNulty,,1,1,1,2
11505,tri6ky,,1,5,5,10
11506,JulianHyde,,1,18,32,50
11507,imdk,,1,11,19,30
11508,grubonrice,,1,5,9,14
11509,knusi1212,,1,1,1,2
11510,prestigearticle,,1,23,1,24
11511,boyyy,,1,1,2,3
11512,WhooHoo,,1,6,11,17
11513,imbiat,,1,16,3,19
11514,Ron_Jeremy,,1,1,1,2
11515,losvedir,,1,257,203,460
11516,triceratops,,1,4,1,5
11517,MrngNeom,,1,14,26,40
11518,weegeekus,,1,126,58,184
11519,dadzilla,,1,9,13,22
11520,keenerd,,1,58,20,78
11521,petercooper,,1,132,144,276
11522,redeyeco,,1,260,32,292
11523,Oatmeat,,1,3,7,10
11524,jimmyviscain,,1,16,22,38
11525,ertomo,,1,10,2,12
11526,fsck3r,,1,5,5,10
11527,jandrews442,,1,4,11,15
11528,NegativeZero,,1,4,5,9
11529,imagemax,,1,1,2,3
11530,andwi,,1,2,2,4
11531,donh,,1,81,152,233
11532,desmund,,1,47,48,95
11533,deadagain,,1,2,4,6
11534,peekapuma,,1,2,1,3
11535,Soosed,,1,84,98,182
11536,nexit,,1,31,23,54
11537,OingoBoingo,,1,8,6,14
11538,Anselmo,,1,15,47,62
11539,weeeeeeeeeeeeee,,1,19,33,52
11540,mylife64,,1,11,22,33
11541,iofthestorm,,1,285,497,782
11542,COINTELPRO,,1,37,40,77
11543,ididntknowthat,,1,25,32,57
11544,witandtears,,1,2,2,4
11545,thugesquire,,1,142,209,351
11546,uncasid,,1,2,1,3
11547,likeem,,1,4,12,16
11548,themastermold,,1,3,3,6
11549,rochskier,,1,4,6,10
11550,DrSatyr,,1,69,1,70
11551,freakin_goose,,1,4,2,6
11552,operatix,,1,2,2,4
11553,kicktown,,1,2,11,13
11554,VigRoco,,1,18,9,27
11555,commontater3,,1,1,1,2
11556,NewDemocrat,,1,72,64,136
11557,alon85,,1,6,7,13
11558,PaulT,,1,5,9,14
11559,Masiosare,,1,1,3,4
11560,moozilla,,1,180,192,372
11561,m0ve,,1,8,9,17
11562,betanerd,,1,1,3,4
11563,Suniikaa,,1,1,5,6
11564,otagoyellow,,1,40,1,41
11565,captainhaddock,,1,844,1118,1962
11566,Vex550,,1,1,3,4
11567,Olgaar,,1,19,15,34
11568,MrBismarck,,1,22,63,85
11569,ptwarhol,,1,11,35,46
11570,iamdek,,1,2,3,5
11571,garrettw,,1,2,5,7
11572,koushiro,,1,29,25,54
11573,sefus,,1,2,1,3
11574,SandyTheDJ,,1,1,1,2
11575,danfard,,1,9,14,23
11576,G-Brain,,1,127,188,315
11577,pr0spero,,1,1,1,2
11578,evilnight,,1,128,227,355
11579,zttca5,,1,2,7,9
11580,roti,,1,11,13,24
11581,FreeOrDieFl,,1,6,8,14
11582,CPops,,1,20,30,50
11583,tripping,,1,82,28,110
11584,maht0x0r,,1,160,284,444
11585,darthmile,,1,4,2,6
11586,dwarfenfart,,1,2,1,3
11587,phelonius,,1,13,11,24
11588,k4ml,,1,14,1,15
11589,dandlion,,1,33,110,143
11590,praetis,,1,4,2,6
11591,Walkertalker,,1,2,2,4
11592,GizmoC,,1,4,9,13
11593,juggle,,1,146,39,185
11594,mlh1979,,1,1,3,4
11595,maxyRO,,1,1041,98,1139
11596,Your_God,,1,1,3,4
11597,mandies37894,,1,13,2,15
11598,nicasucio,,1,15,27,42
11599,rkcr,,1,189,55,244
11600,Narfinity,,1,14,12,26
11601,spencewah,,1,107,161,268
11602,williumbillium,,1,8,10,18
11603,meganiac,,1,7,11,18
11604,zmmmzzz,,1,50,10,60
11605,triggerpuff,,1,5,3,8
11606,lovespoppies,,1,1,2,3
11607,OlyLiberal,,1,5,4,9
11608,brianwitt,,1,6,6,12
11609,dban,,1,1,1,2
11610,ScorseseFan74,,1,30,13,43
11611,rawfiji,,1,1,3,4
11612,uncreative_name,,1,310,507,817
11613,othermimic,,1,7,11,18
11614,nitrusoxyde,,1,11,34,45
11615,SHEEPLE_ALARM_CLOCK,,1,29,36,65
11616,johnwilson1969,,1,43,116,159
11617,Desparanso,,1,42,4,46
11618,shep66,,1,11,6,17
11619,benji592,,1,1,1,2
11620,canofunk,,1,3,3,6
11621,bonez1255,,1,1,1,2
11622,andominus21,,1,3,3,6
11623,afterclap,,1,1,1,2
11624,anoon,,1,1,3,4
11625,slockton,,1,111,72,183
11626,localoptima,,1,5,5,10
11627,shoehornhands,,1,16,28,44
11628,Ecorama,,1,10,8,18
11629,Papper,,1,263,433,696
11630,stacy75,,1,337,192,529
11631,elissa1959,,1,573,908,1481
11632,tiefling,,1,2,2,4
11633,thealmightygott,,1,26,81,107
11634,lunarover,,1,3,5,8
11635,sammythemc,,1,10,9,19
11636,aaltonen,,1,15,37,52
11637,paulkerzner,,1,17,6,23
11638,ahktljlqxeym,,1,7,6,13
11639,userlame,,1,7,11,18
11640,PunBreaker,,1,1,1,2
11641,Jolva,,1,32,12,44
11642,kadath,,1,38,38,76
11643,tdhoufek,,1,13,26,39
11644,conkertheking,,1,10,19,29
11645,Quicksilver,,1,41,63,104
11646,morandomdanu,,1,41,45,86
11647,visarya,,1,3,7,10
11648,QueryBean,,1,3,1,4
11649,crazydiode,,1,25,20,45
11650,cybernetic_web_user,,1,50,55,105
11651,novemestranged,,1,2,1,3
11652,nandemo,,1,7,13,20
11653,dlytle,,1,2,9,11
11654,Maxxover,,1,107,123,230
11655,stuff071,,1,1,2,3
11656,VicGirl29,,1,1,1,2
11657,modreef,,1,28,36,64
11658,Tor_Onsen,,1,187,50,237
11659,leitao,,1,3,1,4
11660,jonnyg1986,,1,4,2,6
11661,Guinness,,1,53,35,88
11662,darwinisdead,,1,6,11,17
11663,frolix8,,1,9,6,15
11664,ReginaldCousins,,1,2,2,4
11665,drbold,,1,393,642,1035
11666,keramos,,1,17,47,64
11667,DImuthu,,1,1,1,2
11668,newtonapple,,1,1,1,2
11669,sorcia1,,1,5,4,9
11670,vbouret,,1,4,5,9
11671,jonknet,,1,12,7,19
11672,etm117,,1,12,16,28
11673,aresaypay,,1,13,13,26
11674,AgingPunkRocker,,1,57,94,151
11675,Borachoke,,1,16,39,55
11676,splag,,1,1,1,2
11677,aluminumovercast,,1,94,56,150
11678,zbob,,1,9,11,20
11679,stripchamber,,1,45,94,139
11680,shoelessone,,1,2,9,11
11681,bcostlow,,1,7,17,24
11682,vampiregabe,,1,175,200,375
11683,saad85,,1,98,90,188
11684,WhiteEagle,,1,4,3,7
11685,dirtymoney,,1,1787,1932,3719
11686,dellea,,1,6,2,8
11687,vel0x,,1,5,1,6
11688,moonbeaver,,1,13,7,20
11689,CreepyLittlePuppet,,1,2,1,3
11690,bretris,,1,19,2,21
11691,seely,,1,8,1,9
11692,mook_ster,,1,4,9,13
11693,orangut,,1,1,1,2
11694,njosnari,,1,5,9,14
11695,baboose,,1,3,2,5
11696,ArtVandeley,,1,86,52,138
11697,bob_doles_hard-on,,1,5,1,6
11698,zbtgf,,1,20,9,29
11699,smurfmx,,1,1,1,2
11700,Tsien,,1,1,1,2
11701,bretthoerner,,1,30,35,65
11702,kaehyu,,1,165,38,203
11703,jxhn,,1,9,13,22
11704,gizmogwai,,1,8,14,22
11705,rbl,,1,3,2,5
11706,morish,,1,27,29,56
11707,cdb8er,,1,1,1,2
11708,stevedoredolly,,1,2,3,5
11709,hanzie,,1,24,45,69
11710,alors_je_dis,,1,7,9,16
11711,midas888,,1,9,12,21
11712,Geruna3,,1,4,1,5
11713,jdeisenberg,,1,1,2,3
11714,dokodemodoor,,1,4,9,13
11715,ecoffey,,1,10,12,22
11716,kennies,,1,1,2,3
11717,pistoriusp,,1,99,24,123
11718,fearcomplication,,1,63,41,104
11719,thebroxo,,1,6,6,12
11720,Ruckusnusts,,1,115,208,323
11721,TheBison,,1,2,3,5
11722,RepublicansSUCK6,,1,1,5,6
11723,y3110w5,,1,1,1,2
11724,zutme,,1,4,7,11
11725,chipdip,,1,2,2,4
11726,secretmethod70,,1,1,7,8
11727,l3fff,,1,4,1,5
11728,steamer123,,1,47,39,86
11729,sgricci,,1,11,6,17
11730,Filipino_Monkey,,1,4,6,10
11731,taryneast,,1,4,1,5
11732,coreyshum,,1,2,2,4
11733,polygrapher,,1,8,6,14
11734,davidvincent2,,1,39,66,105
11735,tomjenkinson,,1,35,4,39
11736,nerdmonkey,,1,1,2,3
11737,Shirlock,,1,1,1,2
11738,jwigum,,1,14,15,29
11739,donmak,,1,32,3,35
11740,denhamsdoesit,,1,103,139,242
11741,sphurthy,,1,2,3,5
11742,snarkfish,,1,34,74,108
11743,Jack9,,1,75,185,260
11744,BttShaping,,1,2,1,3
11745,karmakaze,,1,44,56,100
11746,heelspider,,1,623,913,1536
11747,causeitsme,,1,71,109,180
11748,do_thax1,,1,1,1,2
11749,gor,,1,1,1,2
11750,dripsreddy,,1,1,1,2
11751,aarkerio,,1,37,52,89
11752,wongwong,,1,1,3,4
11753,iceschade,,1,37,43,80
11754,riven08,,1,20,35,55
11755,nikhilgore,,1,1,1,2
11756,Themarduk900,,1,13,38,51
11757,losmaxos,,1,8,6,14
11758,billybobbain,,1,4,6,10
11759,macr,,1,2,1,3
11760,akincisor,,1,21,49,70
11761,ion18,,1,1,1,2
11762,toby,,1,8,4,12
11763,angoulemmy,,1,27,25,52
11764,sweetwood419,,1,1,1,2
11765,Shaleblade,,1,27,24,51
11766,bigshit,,1,17,5,22
11767,johnnyzap,,1,1,1,2
11768,implementor,,1,21,27,48
11769,zydeco,,1,16,44,60
11770,DerkaRagnarr,,1,1,3,4
11771,oibalf,,1,3,2,5
11772,seraph582,,1,9,28,37
11773,inkstom,,1,4,3,7
11774,pjthomps,,1,23,37,60
11775,Rudegato,,1,10,6,16
11776,epboyd,,1,1,5,6
11777,LoveandRockets,,1,70,106,176
11778,metageek,,1,53,79,132
11779,Kream1,,1,15,26,41
11780,o0Enygma0o,,1,29,48,77
11781,phantom_slayer,,1,120,130,250
11782,troytop,,1,40,41,81
11783,prettybunnys,,1,11,25,36
11784,shikadi,,1,45,16,61
11785,rickmb,,1,32,26,58
11786,stephenfox,,1,38,5,43
11787,kidcoma,,1,21,19,40
11788,Rubuler,,1,4,20,24
11789,upvote_capote,,1,7,19,26
11790,rubber2002,,1,165,1,166
11791,brotorious,,1,3,4,7
11792,dillona,,1,4,7,11
11793,wrongway,,1,3,2,5
11794,frodwith,,1,44,71,115
11795,Fuzzy_3D,,1,1,1,2
11796,b937,,1,1,2,3
11797,koin,,1,1,3,4
11798,CooneyCoonCoon,,1,1,7,8
11799,velogiares,,1,6,12,18
11800,briancavner,,1,86,26,112
11801,ThorHammer,,1,66,22,88
11802,ulrick,,1,46,31,77
11803,drakula,,1,1,11,12
11804,captainAwesomePants,,1,282,310,592
11805,cabrilo,,1,6,2,8
11806,Lucretius,,1,189,185,374
11807,spacedude89,,1,12,5,17
11808,P522,,1,12,23,35
11809,leondz,,1,223,230,453
11810,ankuryt,,1,25,10,35
11811,KentBrockman,,1,1,2,3
11812,dragonfly310,,1,1,6,7
11813,youcanrunperl6,,1,1,2,3
11814,gmhafiz,,1,1,2,3
11815,Comment-Revealer,,1,1,1,2
11816,andybroc,,1,1,1,2
11817,jzawodn,,1,11,1,12
11818,Hexogen,,1,55,94,149
11819,typesmith,,1,14,36,50
11820,rodders101,,1,2,2,4
11821,dafthuman,,1,133,159,292
11822,aL999,,1,3,6,9
11823,AllmanBros,,1,1,1,2
11824,sushi-zen,,1,8,3,11
11825,ppppatrick,,1,4,8,12
11826,Natas_Enasni,,1,187,332,519
11827,ajaloux,,1,16,9,25
11828,timjos,,1,6,8,14
11829,laphr0aig,,1,5,6,11
11830,klodolph,,1,1,5,6
11831,dahlberg123,,1,265,375,640
11832,davidb_,,1,34,25,59
11833,holyshittles,,1,1,10,11
11834,hadley,,1,2,8,10
11835,woockash,,1,52,17,69
11836,golemiot,,1,42,63,105
11837,soldoutactivist,,1,2,3,5
11838,notoriginal,,1,35,33,68
11839,virtualkingster,,1,6,4,10
11840,supertran,,1,2,4,6
11841,computerwhiz,,1,4,1,5
11842,mearscn,,1,1,4,5
11843,DONT-TASE-ME-BRO,,1,1,2,3
11844,cstaff,,1,64,2,66
11845,bigunit3000,,1,124,105,229
11846,NedRyerson,,1,1,1,2
11847,Caligula,,1,24,18,42
11848,seedofc,,1,6,4,10
11849,imbecile,,1,38,47,85
11850,TinheadNed,,1,15,30,45
11851,Tchakra,,1,14,19,33
11852,glutamate,,1,12,9,21
11853,ncorax,,1,6,5,11
11854,ursine,,1,4,3,7
11855,concentricpuddle,,1,24,8,32
11856,ffffffffffffffffffff,,1,19,10,29
11857,opeti,,1,2,1,3
11858,mrrsx2006,,1,8,1,9
11859,reddatic,,1,37,23,60
11860,psycloned,,1,6,3,9
11861,Aegeus,,1,54,93,147
11862,pureonyx,,1,8,27,35
11863,flippinkittin,,1,8,14,22
11864,dimitrisokolov,,1,428,450,878
11865,RipperM,,1,141,183,324
11866,alextheshortseller,,1,3,2,5
11867,Droffats,,1,33,72,105
11868,ponderstibbons,,1,2,3,5
11869,Spike973,,1,16,18,34
11870,MisterEThoughts,,1,17,68,85
11871,chiltonlib,,1,5,8,13
11872,gustogus,,1,8,7,15
11873,GKChess,,1,1,3,4
11874,DoctorHouse,,1,1,1,2
11875,Luthien77,,1,62,91,153
11876,truthrises,,1,87,104,191
11877,lameweather,,1,2,2,4
11878,altern,,1,1,2,3
11879,jvoorhis,,1,2,1,3
11880,k3v1nhu4n9,,1,1,2,3
11881,mega05,,1,10,25,35
11882,maceywj,,1,2,3,5
11883,duncanmc,,1,5,12,17
11884,Khaless,,1,2,3,5
11885,butterface,,1,36,69,105
11886,feadog,,1,3,1,4
11887,joshthejumperman,,1,1,2,3
11888,mr_babar,,1,9,10,19
11889,gtlogic,,1,3,14,17
11890,orkgpro,,1,1,1,2
11891,methodartist,,1,1,3,4
11892,squink,,1,10,10,20
11893,sqrt,,1,9,1,10
11894,micah8,,1,1,1,2
11895,turbana,,1,7,10,17
11896,hillary2012,,1,3,4,7
11897,seeker135,,1,833,1779,2612
11898,NewKidOnTheBloc,,1,13,4,17
11899,pipcwru08,,1,2,1,3
11900,bobb730,,1,1,1,2
11901,bigslick,,1,1,3,4
11902,pootytang,,1,5,10,15
11903,GregEh,,1,13,21,34
11904,globeskipper,,1,1,2,3
11905,wartexmaul,,1,350,578,928
11906,camdon,,1,2,1,3
11907,AmputateYourHead,,1,57,80,137
11908,old-dude,,1,2,1,3
11909,sameteam,,1,8,7,15
11910,STHayden,,1,1,1,2
11911,ziggyfolly,,1,5,14,19
11912,nucleophile,,1,167,4,171
11913,SpindleyQ,,1,1,4,5
11914,vsync,,1,83,49,132
11915,TwarkMain,,1,104,161,265
11916,animaniac,,1,17,9,26
11917,arrowheadaddict,,1,12,9,21
11918,EthicalReasoning,,1,512,203,715
11919,bendlund,,1,20,32,52
11920,dysmas,,1,87,141,228
11921,AtlasSlept,,1,12,22,34
11922,liklik,,1,6,2,8
11923,CrackIsWack,,1,2,8,10
11924,nebraskalaska,,1,1,2,3
11925,TigerUppercut,,1,23,38,61
11926,deterrence,,1,12,21,33
11927,kihadat,,1,120,216,336
11928,ZeeJollyRoger,,1,2,14,16
11929,zjep,,1,50,58,108
11930,Lucent,,1,22,8,30
11931,sluggysan,,1,15,5,20
11932,df1,,1,202,442,644
11933,Fireproofsoul25,,1,1,3,4
11934,mkbunday,,1,67,53,120
11935,jlistf,,1,8,5,13
11936,takethescrew,,1,16,21,37
11937,russelly,,1,23,64,87
11938,jal0pee1,,1,8,3,11
11939,mosaic2,,1,7,3,10
11940,shashinmishra,,1,6,4,10
11941,pssm,,1,15,25,40
11942,basketball,,1,1,6,7
11943,starbuck1,,1,2,1,3
11944,pinky17,,1,2,6,8
11945,michaelburns,,1,6,4,10
11946,franco81,,1,6,6,12
11947,miserylover,,1,3,2,5
11948,tacostacos,,1,277,44,321
11949,thegrott,,1,1,5,6
11950,goodhairs5,,1,1,1,2
11951,saalon,,1,9,23,32
11952,pault107,,1,5,8,13
11953,topredder,,1,14,1,15
11954,arcoare,,1,7,2,9
11955,TrikeKid,,1,8,3,11
11956,sciencegeniusgirl,,1,2,2,4
11957,joelthelion,,1,997,758,1755
11958,mysterywhiteboy8,,1,27,3,30
11959,johntb86,,1,81,128,209
11960,merstudio,,1,39,37,76
11961,miserlou,,1,175,27,202
11962,linkfoo,,1,29,52,81
11963,AsFarAsIKnow,,1,2,1,3
11964,patricka,,1,4,8,12
11965,Surkow,,1,2,2,4
11966,spetracco,,1,1,2,3
11967,dietbrisk,,1,4,3,7
11968,noKarmaNeeded,,1,3,1,4
11969,nullspace,,1,1,1,2
11970,arse,,1,7,18,25
11971,florence0rose,,1,61,115,176
11972,jmhnilbog,,1,3,2,5
11973,Dr_Simon_Shane_CM,,1,1,1,2
11974,sigint,,1,1,4,5
11975,BigGoomba,,1,3,14,17
11976,NSMike,,1,655,735,1390
11977,Grubbie,,1,3,7,10
11978,bfkennedy,,1,1,1,2
11979,maximilian,,1,2,5,7
11980,PuppyPuncher,,1,2,2,4
11981,starwarrior,,1,22,24,46
11982,storm72,,1,2,2,4
11983,pilif,,1,58,39,97
11984,knellotron,,1,29,58,87
11985,redlightdistrict,,1,3,2,5
11986,bguildner42,,1,121,209,330
11987,Double-Entendre-Man,,1,10,17,27
11988,MockinBird,,1,18,50,68
11989,coredump,,1,7,4,11
11990,Yaff,,1,12,2,14
11991,fecal_fury,,1,1,5,6
11992,TarHeelBears,,1,64,4,68
11993,8002reverse,,1,2,1,3
11994,mindbleach,,1,1437,2470,3907
11995,grouch43,,1,1,3,4
11996,12358,,1,64,61,125
11997,mooky1977,,1,2,3,5
11998,poorpredictablebart,,1,2,1,3
11999,flogic,,1,52,94,146
12000,deviation,,1,10,19,29
12001,alphonse55,,1,52,3,55
12002,torontoted,,1,13,30,43
12003,fai,,1,31,81,112
12004,bezzrb,,1,1,1,2
12005,kcolttam,,1,1,3,4
12006,TobiasV,,1,32,42,74
12007,formatt,,1,61,76,137
12008,baix,,1,17,20,37
12009,Jagula,,1,78,65,143
12010,ltcmdrobvious,,1,1,1,2
12011,reallythateasy,,1,20,39,59
12012,keepurpantson,,1,2,1,3
12013,kkireyev,,1,25,25,50
12014,treebright,,1,181,268,449
12015,yojspew,,1,3,17,20
12016,jasonkester,,1,151,23,174
12017,PrescribedGod,,1,55,3,58
12018,jato,,1,23,3,26
12019,kialari,,1,29,54,83
12020,drilldo,,1,76,21,97
12021,daemoncollector,,1,1,3,4
12022,topper123,,1,18,14,32
12023,all_ways_thinkin,,1,197,66,263
12024,Horpy,,1,10,12,22
12025,rasl,,1,39,31,70
12026,partisann,,1,1,1,2
12027,ky420,,1,94,10,104
12028,strangerx,,1,1,1,2
12029,surfgeko,,1,25,7,32
12030,PixelColada,,1,87,196,283
12031,KebertXela,,1,8,5,13
12032,zedzedtop,,1,7,15,22
12033,calcio1,,1,107,69,176
12034,j_a_p,,1,53,109,162
12035,jollyjack,,1,7,9,16
12036,s20millas,,1,29,22,51
12037,lesbianimpregnator,,1,10,1,11
12038,darkslurpee,,1,58,105,163
12039,NewSc2,,1,192,235,427
12040,kali3000,,1,16,17,33
12041,majormind329,,1,41,37,78
12042,raindogmx,,1,45,104,149
12043,jstacy,,1,1,1,2
12044,lolbacon,,1,838,517,1355
12045,chandaman,,1,18,26,44
12046,omegahedron,,1,4,9,13
12047,Slartibartfaster,,1,18,21,39
12048,bison__,,1,1,2,3
12049,zandoli,,1,1,2,3
12050,clever_name,,1,40,74,114
12051,astrox,,1,4,3,7
12052,cldnails,,1,101,111,212
12053,ucfstormmy,,1,2,2,4
12054,vph,,1,334,427,761
12055,CocoaButterThighs,,1,48,44,92
12056,daltonames,,1,3,3,6
12057,123412384908,,1,5,6,11
12058,Osmanthus,,1,117,87,204
12059,geomagman,,1,3,1,4
12060,mandiees,,1,24,12,36
12061,micmad,,1,4,11,15
12062,fattestangrywiccan,,1,15,30,45
12063,Jindraaa,,1,12,18,30
12064,tehrooni,,1,6,7,13
12065,trippingchilly,,1,151,268,419
12066,Ores,,1,1,1,2
12067,vw1972bug,,1,1,1,2
12068,InkyChan,,1,104,127,231
12069,steve_yo,,1,194,243,437
12070,FredV,,1,6,6,12
12071,mymarkx,,1,5,1,6
12072,clwnninja,,1,10,1,11
12073,boomboom16,,1,12,6,18
12074,imcguyver,,1,1,2,3
12075,TheGreaterGood,,1,1,1,2
12076,detro1tjok3r,,1,5,3,8
12077,keillor3,,1,21,18,39
12078,agrw,,1,6,4,10
12079,andreask,,1,2,2,4
12080,jmatthew,,1,45,47,92
12081,lw0x15,,1,2,2,4
12082,theantirobot,,1,518,515,1033
12083,oesj,,1,6,6,12
12084,armitageshanks,,1,4,4,8
12085,abhi119,,1,14,2,16
12086,shkoo,,1,26,16,42
12087,WigInABox,,1,103,51,154
12088,bobalobo,,3,3,2,5
12089,aevil,,1,2,1,3
12090,fooqwah,,1,12,3,15
12091,nadmaximus,,1,7,18,25
12092,HandsomeDevil,,1,5,6,11
12093,omarman,,1,3,3,6
12094,dlm,,1,170,95,265
12095,nogami,,1,46,61,107
12096,homayoon,,1,9,2,11
12097,SkiAliG,,1,9,7,16
12098,Slacher,,1,32,41,73
12099,fighttothefinish,,1,1,1,2
12100,mojuba,,1,11,3,14
12101,rajbot,,1,18,11,29
12102,citrus538,,1,2,1,3
12103,interociter,,1,34,58,92
12104,Huplescat22,,1,181,349,530
12105,lameorcoolguy,,1,3,4,7
12106,TheGreatNico,,1,35,48,83
12107,HolyShitAnExplosion,,1,5,1,6
12108,trueidentity,,1,1,3,4
12109,dlwh,,1,17,12,29
12110,mizhi,,1,18,38,56
12111,warmricepudding,,1,11,35,46
12112,NinjaDuck12,,1,102,44,146
12113,Zuph,,1,32,24,56
12114,choseph,,1,51,49,100
12115,Inkifymark,,1,3,9,12
12116,DavePhun,,1,6,17,23
12117,Another1BitesTheDust,,1,2,5,7
12118,lb2,,1,5,5,10
12119,Schnooz,,1,49,31,80
12120,clawtros,,1,4,5,9
12121,seagg,,1,2,2,4
12122,HomerWells,,1,76,137,213
12123,profs,,1,61,85,146
12124,tarvaina,,1,10,10,20
12125,kratediggah,,1,3,6,9
12126,icicle84,,1,1,2,3
12127,ro999ro,,1,26,3,29
12128,Jeremiah_Wright,,1,6,5,11
12129,john1984,,1,1,1,2
12130,dividedby0,,1,1,2,3
12131,parsifal,,1,67,85,152
12132,twoshedsmcginty,,1,11,1,12
12133,Gyanish,,1,1,1,2
12134,liver,,1,6,5,11
12135,neodorian,,1,14,65,79
12136,foundatio,,1,2,8,10
12137,daringescape,,1,90,188,278
12138,vanillazilla,,1,34,25,59
12139,d00bie,,1,6,13,19
12140,Capitol62,,1,182,236,418
12141,tsai,,1,3,2,5
12142,ginosesto,,1,3,3,6
12143,catlady,,1,3,5,8
12144,gmcmanus,,1,3,2,5
12145,VoiceofPower,,1,22,24,46
12146,radtker,,1,8,4,12
12147,RalphieWiggum,,1,1,1,2
12148,denharsh,,1,18,8,26
12149,amarcus78,,1,1,2,3
12150,kevb,,1,60,61,121
12151,phipsi180,,1,107,16,123
12152,thesmallprint13,,1,8,3,11
12153,kayden0000,,1,27,15,42
12154,twoism,,1,16,4,20
12155,dagbrown,,1,7,11,18
12156,databyss,,1,1,2,3
12157,nightguilt,,1,1,1,2
12158,Shadowstep,,1,1,2,3
12159,noddyxoi,,1,7,11,18
12160,teksimian,,1,17,22,39
12161,ddyson,,1,9,9,18
12162,katiekatums,,1,2,3,5
12163,brockers,,1,25,40,65
12164,tad_ghostal,,1,12,14,26
12165,brocker,,1,3,4,7
12166,lisvblidfk,,1,101,119,220
12167,buirish,,1,6,3,9
12168,Bruiser_Bradley,,1,48,48,96
12169,michaelk99,,1,54,54,108
12170,stacecom,,1,565,819,1384
12171,stignordas,,1,207,71,278
12172,MichaelMex,,1,1,2,3
12173,cheezymoogle,,1,34,58,92
12174,AzMoo,,1,29,37,66
12175,raynim,,1,30,23,53
12176,BarackObamaTheMUSLlM,,1,33,40,73
12177,ignore_this,,1,3,25,28
12178,enneff,,1,371,534,905
12179,degusticar,,1,2,3,5
12180,adenbley,,1,15,21,36
12181,andychamp,,1,1,1,2
12182,ppinette,,1,164,278,442
12183,g1rlb0t,,1,2,3,5
12184,54gy6dm,,1,60,117,177
12185,OneOfUs,,1,1,2,3
12186,chairface,,1,49,69,118
12187,bipartite,,1,1,1,2
12188,maggi2929,,1,172,1,173
12189,Broward,,1,1,1,2
12190,peckitt247,,1,3,3,6
12191,Elishaa,,1,4,2,6
12192,psychophil,,1,3,6,9
12193,smiling_jess,,1,5,5,10
12194,Crankingser,,1,3,3,6
12195,KaraSwims,,1,1,2,3
12196,raezr,,1,102,6,108
12197,MiniTru,,1,1,1,2
12198,Swedishdest,,1,2,3,5
12199,Faze,,1,6,7,13
12200,xoxox,,1,11,15,26
12201,cgilkey2,,1,32,5,37
12202,krebscout,,1,2,1,3
12203,SlaveToReason,,1,4,3,7
12204,vmlemon,,1,7,1,8
12205,Query3,,1,22,6,28
12206,dansinglobster,,1,4,6,10
12207,nonservitus,,1,308,90,398
12208,tthorley,,1,3,8,11
12209,hiopilit,,1,5,1,6
12210,read_it_and_weep,,1,1,2,3
12211,schenectandy,,1,1,22,23
12212,yoga56456,,1,15,5,20
12213,loryzz,,1,8,4,12
12214,umop_apisdn,,1,395,535,930
12215,scoobypoo,,1,3,9,12
12216,ananum,,1,18,19,37
12217,punctuate,,1,1,5,6
12218,D3ADBOLT,,1,204,402,606
12219,thebradmiskell,,1,111,22,133
12220,sitruss,,1,9,12,21
12221,limukala,,1,34,28,62
12222,General-Obvious,,1,8,12,20
12223,oneP,,1,65,69,134
12224,teaBagger,,1,330,451,781
12225,george443,,1,2,10,12
12226,bakunin,,1,3,5,8
12227,olddoc,,1,288,175,463
12228,ivy7496,,1,6,12,18
12229,toninio,,1,30,58,88
12230,doommonky,,1,3,8,11
12231,hsaleem,,1,1,2,3
12232,jockychan,,1,24,26,50
12233,peach3s,,1,2,5,7
12234,PsychePsyche,,1,9,11,20
12235,Steiner,,1,8,10,18
12236,Pipvault,,1,3,6,9
12237,Ocaml_Kaizen,,1,352,320,672
12238,LRonHubbard,,1,21,28,49
12239,IronChief,,1,1,1,2
12240,BUBBA_BOY,,1,28,68,96
12241,georgi0u,,1,45,18,63
12242,anderaaron,,1,10,24,34
12243,igiveyoumylife,,1,2,2,4
12244,qowieury,,1,3,4,7
12245,abering,,1,2,2,4
12246,exedore2,,1,26,26,52
12247,thirdeyeopen23,,1,11,9,20
12248,ds2oo8,,1,1,6,7
12249,Flyboy,,1,304,361,665
12250,mastej,,1,3,3,6
12251,roland19d,,1,490,851,1341
12252,cowhead,,1,59,95,154
12253,iamnowhere,,1,1,1,2
12254,pinkerdude,,1,27,43,70
12255,redheadsrage,,1,4,2,6
12256,leatherback,,1,36,24,60
12257,wookie2u,,1,2,3,5
12258,ViktorVaughn,,1,64,15,79
12259,troglodyte,,1,343,378,721
12260,bephys,,1,3,5,8
12261,JBridge,,1,140,211,351
12262,fforw,,1,154,258,412
12263,cnc,,1,1,1,2
12264,jarcoal,,1,3,4,7
12265,vectorlord,,1,12,12,24
12266,Lt-DavidW,,1,21,35,56
12267,DeadtoSin1,,1,5,3,8
12268,willtelloverdrive,,1,1,4,5
12269,zeek,,1,10,25,35
12270,pazza66,,1,2,1,3
12271,jensm,,1,73,26,99
12272,irspariah,,1,72,270,342
12273,warkro,,1,69,86,155
12274,smitisme,,1,257,311,568
12275,cr4a,,1,450,299,749
12276,sjl7678,,1,12,12,24
12277,relipuj,,1,1,3,4
12278,trwww,,1,9,22,31
12279,curtismayfield,,1,1,1,2
12280,svengalus,,1,543,685,1228
12281,KieronR,,1,15,37,52
12282,lawngnomes4pres,,1,24,4,28
12283,supercharged302,,1,1,2,3
12284,jojo624,,1,3,3,6
12285,mypasswordispassword,,1,5,5,10
12286,reepecheep,,1,2,4,6
12287,master_gopher,,1,333,654,987
12288,blindingspeed80,,1,47,108,155
12289,GeorgiaGuy,,1,1,1,2
12290,sandeeprgowda,,1,1,1,2
12291,tspiteri,,1,2,5,7
12292,minusthebux,,1,7,18,25
12293,Bill-O-Reilly,,1,1,1,2
12294,dewx0x,,1,1,2,3
12295,burningapathy,,1,10,3,13
12296,rinanina,,1,3,1,4
12297,red-dit,,1,152,350,502
12298,ACoolT5,,1,3,1,4
12299,echo057,,1,2,2,4
12300,flyhrtgigs,,1,1,3,4
12301,lennon860,,1,108,13,121
12302,Qazster,,1,4,7,11
12303,forgottend,,1,56,64,120
12304,nicofremaux,,1,1,2,3
12305,friendinweed,,1,4,10,14
12306,JackTLogan,,1,5,6,11
12307,tolas,,1,62,32,94
12308,a-lady,,1,20,44,64
12309,randallsquared,,1,287,362,649
12310,Adzoe,,1,1,3,4
12311,Junior19,,1,24,18,42
12312,amosharper,,1,17,39,56
12313,calantorntain,,1,712,459,1171
12314,karai,,1,1,1,2
12315,nymbot,,1,8,9,17
12316,swede,,1,278,294,572
12317,csharper,,1,10,13,23
12318,zeytin,,1,12,19,31
12319,Cuetzalcoatl,,1,25,24,49
12320,burningmonk,,1,124,195,319
12321,kongdong,,1,1,1,2
12322,mikefats,,1,2,1,3
12323,philosophocles,,1,42,110,152
12324,Ralgor,,1,6,11,17
12325,maroonnit,,1,12,16,28
12326,photonicks,,1,7,9,16
12327,terrordactyl,,1,5,11,16
12328,viciouspoultry,,1,2,2,4
12329,redzim,,1,1,1,2
12330,col381,,1,5,7,12
12331,snead,,1,67,48,115
12332,Qubed,,1,609,1081,1690
12333,disposableaccount876,,1,2,1,3
12334,gboston,,1,31,21,52
12335,TehSoM,,1,9,24,33
12336,Symphonic_Nightmare,,1,28,42,70
12337,miratemp,,1,6,22,28
12338,pozzoe,,1,15,34,49
12339,anon93752,,1,3,5,8
12340,mommygetspaid,,1,1,1,2
12341,mentallyvoid,,1,2,4,6
12342,Hencq,,1,6,5,11
12343,beepboopimarobot,,1,3,8,11
12344,LoneTrumpeteer,,1,1,2,3
12345,Brillig,,1,1,6,7
12346,NnyCW,,1,1,3,4
12347,ensign,,1,6,1,7
12348,tucsonalama,,1,26,31,57
12349,stroupnp,,1,189,269,458
12350,pixel,,1,32,67,99
12351,mchean,,1,2,7,9
12352,drog,,1,11,3,14
12353,msprout,,1,107,126,233
12354,ryancarnated,,1,112,128,240
12355,halo,,1,180,140,320
12356,sayaman,,1,1,1,2
12357,Gaabo,,1,14,11,25
12358,inghamb87,,1,445,104,549
12359,viroplex,,1,1,1,2
12360,seidaot,,1,2,1,3
12361,Uiaccsk,,1,38,31,69
12362,that_hz,,1,2,2,4
12363,TeddyRoSvelte,,1,2,6,8
12364,StupidGenerator,,1,1,1,2
12365,AcesUP,,1,3,7,10
12366,Tango6,,1,2,2,4
12367,nexes300,,1,120,151,271
12368,janniel,,1,22,47,69
12369,DeBurgo,,1,9,15,24
12370,psych0sys,,1,2,1,3
12371,WishIwasWitty,,1,1,2,3
12372,vili,,1,7,11,18
12373,dankelley,,1,20,30,50
12374,amack77,,1,56,7,63
12375,esila,,1,2,2,4
12376,PoliticsPlease,,1,9,2,11
12377,coffeepoet,,1,3,4,7
12378,rebeccakd83,,1,5,2,7
12379,fghjuhdj,,1,1,1,2
12380,aeroplane,,1,1,8,9
12381,ResidentRedneck,,1,25,39,64
12382,Curmudgeon,,1,9,44,53
12383,evilpoptart,,1,28,56,84
12384,knotme,,1,2,1,3
12385,IMaPlatypus,,1,2,1,3
12386,davidhua,,1,1,1,2
12387,retrowebdev,,1,11,5,16
12388,iamjack,,1,155,178,333
12389,jon314,,1,1,3,4
12390,grawson,,1,2,6,8
12391,sigurdur,,1,1,1,2
12392,rsc,,1,134,18,152
12393,bonzodogband,,1,59,44,103
12394,omegamale,,1,4,6,10
12395,MonkAndCanatella,,1,10,30,40
12396,middayc,,1,86,26,112
12397,gaop,,1,34,13,47
12398,TerryMarsh,,1,1,2,3
12399,dkeck14,,1,1,2,3
12400,etake2k,,1,10,11,21
12401,funknjunk,,1,31,31,62
12402,eloki,,1,2,9,11
12403,alpharaptor1,,1,53,120,173
12404,smithers99,,1,69,2,71
12405,vajrasky,,1,14,6,20
12406,abfalltonne,,1,2,2,4
12407,mikila9,,1,3,2,5
12408,norbot,,1,6,7,13
12409,Kcck,,1,104,123,227
12410,jrforreal,,1,47,68,115
12411,gosurob,,1,2,1,3
12412,Prine,,1,37,55,92
12413,mashedpotatoes,,1,2,2,4
12414,FireFusion,,1,1,4,5
12415,imforpbj,,1,9,2,11
12416,AnonLulz,,1,74,1,75
12417,johnnypei,,1,2,6,8
12418,BrockLee,,1,27,16,43
12419,FabFour4Ever,,1,5,1,6
12420,twolongdoxies,,1,1,2,3
12421,aaroneff,,1,1,1,2
12422,LakeSolon,,1,22,45,67
12423,flaheadle,,1,3,4,7
12424,mcgosd,,1,2,2,4
12425,funkyz,,1,153,69,222
12426,zach978,,1,2,2,4
12427,aloring,,1,37,9,46
12428,SpongeBobSquarePants,,1,1,5,6
12429,DaveChild,,1,392,358,750
12430,digimonlove,,1,274,213,487
12431,coyotej,,1,2,4,6
12432,milehighmg,,1,1,2,3
12433,rogerspears,,1,8,1,9
12434,grumpy2,,1,88,44,132
12435,baseballisnewyork,,1,128,38,166
12436,gimmesome,,1,33,5,38
12437,Daedulun,,1,5,5,10
12438,hirschmj,,1,3,7,10
12439,innocuousnameftw,,1,1,1,2
12440,bennymack,,1,85,68,153
12441,vineetk,,1,106,131,237
12442,Sephoragal,,1,1,1,2
12443,darvish,,1,6,5,11
12444,Ophois,,1,1,1,2
12445,Anonymous_Wanker,,1,1,1,2
12446,john1967,,1,3,1,4
12447,shan66,,1,4,7,11
12448,startfragment,,1,811,79,890
12449,dumpbase,,1,87,1,88
12450,Thistleknot,,1,350,273,623
12451,sashimi,,1,4,10,14
12452,rickievaso,,1,3,3,6
12453,crackcoveredcunt,,1,2,3,5
12454,hopeLB,,1,2,17,19
12455,xceph,,1,13,2,15
12456,vbeast,,1,14,19,33
12457,StoicRomance,,1,344,230,574
12458,bloqmon,,1,153,168,321
12459,ybbih,,1,195,315,510
12460,piffsmoke,,1,1,4,5
12461,righttoresist,,1,197,281,478
12462,urbanaut,,1,59,33,92
12463,mrmunkey,,1,5,13,18
12464,yawn,,1,5,2,7
12465,Fishbum,,1,101,16,117
12466,jenks517,,1,12,17,29
12467,Mummanto,,1,6,1,7
12468,danamill,,1,7,1,8
12469,sidewalkchalked,,1,166,70,236
12470,paulkafasis,,1,11,11,22
12471,anonymous_somewhat,,1,1,1,2
12472,Cosmic_Charlie,,1,118,101,219
12473,xccx,,1,32,32,64
12474,Reddit_Surveyor,,1,20,4,24
12475,camalittle,,1,611,1081,1692
12476,Andos,,1,14,17,31
12477,altheahouse,,1,142,177,319
12478,Ketamine,,1,162,136,298
12479,benologist,,1,150,186,336
12480,jaggs,,1,1,1,2
12481,sux,,1,697,36,733
12482,Eddie_Catflap,,1,7,1,8
12483,refriedi,,1,1,2,3
12484,ilisia,,1,3,2,5
12485,IrishSamurai,,1,13,6,19
12486,jqp364,,1,2,3,5
12487,mycl,,1,27,24,51
12488,nvidutis,,1,8,9,17
12489,02bluesuperroo,,1,2,5,7
12490,st23am,,1,2,1,3
12491,jaimelazaro,,1,17,20,37
12492,cturkosi,,1,153,115,268
12493,ddddbbbb,,1,184,70,254
12494,Live_Wire,,1,3,3,6
12495,nemes,,1,49,104,153
12496,wjw75,,1,72,102,174
12497,savethempire,,1,2,1,3
12498,mbup,,1,7,14,21
12499,toddsanderson,,1,3,4,7
12500,harrisontheskater,,1,1,3,4
12501,SpikeWolfwood,,1,251,423,674
12502,chucks86,,1,139,325,464
12503,rjcluvvt,,1,1,5,6
12504,stottville,,1,1,1,2
12505,quintison,,1,60,114,174
12506,lyntux,,1,1,1,2
12507,sajae80,,1,1,4,5
12508,marcmarc,,1,3,3,6
12509,qwertyy,,1,19,19,38
12510,hazmatzo,,1,1,1,2
12511,nursingrnbsn,,1,1,1,2
12512,tpodr,,1,353,165,518
12513,sagarp,,1,6,8,14
12514,abhim12,,1,3,5,8
12515,minime283,,1,15,4,19
12516,robomix,,1,8,3,11
12517,SmellyGeekBoy,,1,271,34,305
12518,collosalsquid,,1,6,3,9
12519,Golden-Shower,,1,5,6,11
12520,JezusGhoti,,1,2,1,3
12521,recorcholis,,1,9,12,21
12522,lacus,,1,33,30,63
12523,eelinow,,1,3,6,9
12524,Basye,,1,11,10,21
12525,Gra7on,,1,44,88,132
12526,gnaborretni,,1,1,1,2
12527,vtdweller,,1,63,47,110
12528,lemurlemur,,1,10,13,23
12529,imadigger,,1,8,5,13
12530,khaddy,,1,1,1,2
12531,dkny22,,1,2,2,4
12532,illicium,,1,5,5,10
12533,swaggums,,1,16,20,36
12534,springwalk,,1,1,2,3
12535,rperigo,,1,31,10,41
12536,dayoldglowsticks,,1,1,1,2
12537,lakemag,,1,2,5,7
12538,mrttbag,,1,4,6,10
12539,erohen,,1,4,10,14
12540,Slipgrid,,1,1071,690,1761
12541,ChrisatCrane,,1,1,2,3
12542,tricadex,,1,2,8,10
12543,roosterx,,1,19,24,43
12544,djy,,1,2,3,5
12545,meatloaf_man,,1,19,47,66
12546,saniee,,1,10,5,15
12547,tbarlow13,,1,1,7,8
12548,chimchimchim,,1,6,2,8
12549,jmmf,,1,12,15,27
12550,TheOtherLebowski,,1,2,7,9
12551,chromium24,,1,24,14,38
12552,mutairy,,1,8,23,31
12553,kmason5,,1,3,1,4
12554,Munkee_Boy,,1,79,185,264
12555,mamluk,,1,54,77,131
12556,weirdalchemy,,1,21,39,60
12557,jxxx,,1,6,11,17
12558,spinfish,,1,17,7,24
12559,juantastic,,1,14,5,19
12560,CitySustainable,,1,198,45,243
12561,barkingllama,,1,39,72,111
12562,AlejandroTheGreat,,1,55,63,118
12563,unl,,1,1,2,3
12564,jagermeistr,,1,1,1,2
12565,tzz,,1,3,7,10
12566,mdarcy543,,1,27,2,29
12567,White_Owl,,1,2,7,9
12568,TWIXMIX,,1,2,3,5
12569,AttackTribble,,1,1,1,2
12570,sandidge,,1,12,9,21
12571,sannwood,,1,1,1,2
12572,emit_flesti,,1,13,24,37
12573,ewatkins3,,1,1,2,3
12574,eskimodemus,,1,1,1,2
12575,TrevorJordan,,1,31,8,39
12576,x3n0s,,1,92,86,178
12577,JesusWasAnEfinHippie,,1,1,1,2
12578,culix,,1,5,3,8
12579,bgeorge82,,1,1,1,2
12580,jkosmo,,1,15,27,42
12581,reddit-turd,,1,3,1,4
12582,coul2t,,1,13,8,21
12583,dertimbo,,1,2,2,4
12584,kayj,,1,1,1,2
12585,chaoskitty,,1,2,5,7
12586,lifeseeddeath,,1,14,14,28
12587,Ken_Watts,,1,3,4,7
12588,shgorhgoahrio,,1,1,1,2
12589,justinpgardner,,1,1891,284,2175
12590,tiredmountain,,1,1,1,2
12591,SkipHash,,1,99,100,199
12592,iamyo,,1,7,8,15
12593,eob,,1,24,1,25
12594,Preston4tw,,1,2,3,5
12595,splatnasty,,1,9,3,12
12596,thebigbradwolf,,1,253,510,763
12597,polar,,1,710,173,883
12598,neggbird,,1,13,37,50
12599,secret1234,,1,215,244,459
12600,homerunhomer,,1,3,14,17
12601,SuminderJi,,1,45,63,108
12602,four56,,1,8,6,14
12603,pixel7000,,1,12,20,32
12604,maxineshaney,,1,2,3,5
12605,madwicked,,1,5,1,6
12606,roosterjack,,1,484,39,523
12607,downerisdead,,1,4,4,8
12608,shools23,,1,1,1,2
12609,doing_it_live,,1,36,25,61
12610,atrn,,1,3,4,7
12611,beansworth,,1,324,592,916
12612,heirloom,,1,2,1,3
12613,sam512,,1,458,688,1146
12614,Darkstar68,,1,137,158,295
12615,cyclone7676,,1,2,2,4
12616,brianfit,,1,3,2,5
12617,dreamisle,,1,11,5,16
12618,phykicks,,1,2,5,7
12619,kocha,,1,2,2,4
12620,kuliweb,,1,6,6,12
12621,doompuma,,1,9,19,28
12622,eadwacer,,1,3,9,12
12623,Artman009,,1,12,20,32
12624,gomerspile,,1,2,1,3
12625,abhagg,,1,2,1,3
12626,escorn,,1,10,18,28
12627,em3r1c,,1,1,2,3
12628,Miggity,,1,4,1,5
12629,JoeyRamone63,,1,720,94,814
12630,cot6mur3,,1,34,42,76
12631,Rathbone,,1,223,274,497
12632,nkabbara,,1,19,1,20
12633,harsman,,1,16,16,32
12634,yaginuma,,1,2,3,5
12635,Praeger,,1,6,4,10
12636,combuchan,,1,25,26,51
12637,Sdek,,1,41,11,52
12638,wrf2,,1,4,1,5
12639,ijelsner,,1,9,1,10
12640,227de616,,1,1,1,2
12641,smsc,,1,374,870,1244
12642,darkfarmer,,1,13,18,31
12643,bartleby,,1,53,94,147
12644,chocolategamer,,1,1,3,4
12645,banz23,,1,1,1,2
12646,byukate,,1,2,2,4
12647,ntufar,,1,112,175,287
12648,ssushant,,1,2,6,8
12649,Ravenjade,,1,5,12,17
12650,netcowboy,,1,7,16,23
12651,flying_read,,1,2,1,3
12652,jeffyhunter,,1,4,2,6
12653,toomasr,,1,27,18,45
12654,dazzled1,,1,20,14,34
12655,Evil_Bastard,,1,15,20,35
12656,marinopagan,,1,2,1,3
12657,legoman31245,,1,9,5,14
12658,hoodiemonster,,1,169,100,269
12659,Therrick,,1,8,2,10
12660,MattWilcox,,1,23,22,45
12661,jojopapa,,1,4,3,7
12662,MikeNardozzi,,1,109,152,261
12663,kmudrick,,1,1,1,2
12664,kgrgreer,,1,1,2,3
12665,asgarmabuk,,1,1,1,2
12666,wiseduckling,,1,83,60,143
12667,auruspex,,1,5,6,11
12668,aeitzen,,1,1,1,2
12669,beefofages,,1,3,2,5
12670,cult45,,1,3,7,10
12671,aphlipp,,1,20,13,33
12672,cuteseal,,1,12,17,29
12673,mypasswordissimple,,1,22,18,40
12674,ArcadeBumstead,,1,52,76,128
12675,rickdiculous,,1,33,46,79
12676,colton36,,1,15,11,26
12677,pail,,1,38,34,72
12678,mcella,,1,2,2,4
12679,lessthanx,,1,4,1,5
12680,jsschreck,,1,7,10,17
12681,haron91,,1,2,1,3
12682,wither88,,1,3,3,6
12683,firahs,,1,11,9,20
12684,globewire,,1,13,10,23
12685,rhamej,,1,4,5,9
12686,phatmonkey,,1,1,5,6
12687,heartrush,,1,29,49,78
12688,oldschoolredditor,,1,3,1,4
12689,dt529,,1,3,14,17
12690,hanshasuro,,1,13,15,28
12691,audiodude,,1,68,73,141
12692,lotusstp,,1,1,4,5
12693,gnarlin,,1,2,3,5
12694,redditbannedmeagain,,1,61,95,156
12695,ThatGuyNamedBob,,1,18,25,43
12696,enjo13,,1,8,3,11
12697,ammonsld,,1,32,48,80
12698,nirk,,1,9,4,13
12699,citemach,,1,1,3,4
12700,cloudsurfer,,1,38,30,68
12701,mikey987,,1,4,3,7
12702,Aquaman,,1,3,4,7
12703,rack88,,1,56,33,89
12704,kuato,,1,897,195,1092
12705,bensylvania,,1,1,1,2
12706,midsummernightstoker,,1,178,37,215
12707,Aero72,,1,14,15,29
12708,hirschhorn,,1,34,66,100
12709,Chumbodonk,,1,19,41,60
12710,mootchell,,1,29,49,78
12711,cybrbeast,,1,1,1,2
12712,SuperJack108,,1,7,22,29
12713,astrosmash,,1,413,319,732
12714,D_rock,,1,6,1,7
12715,mrhomer,,1,85,19,104
12716,originator,,1,1,2,3
12717,denn2009,,1,4,1,5
12718,Katychell,,1,9,7,16
12719,Smits77,,1,2,4,6
12720,conformnow,,1,1,1,2
12721,Dagon,,1,135,202,337
12722,twistedcain,,1,732,792,1524
12723,vaskark,,1,1,1,2
12724,H3g3m0n,,1,202,246,448
12725,thruxton,,1,2,5,7
12726,beefsundae,,1,1,1,2
12727,Briamah,,1,2,6,8
12728,soupskin,,1,11,7,18
12729,reverendlongcat,,1,1,1,2
12730,romancexkills,,1,1,2,3
12731,xenon,,1,24,29,53
12732,biscuitjack,,1,1,1,2
12733,DoeL,,1,41,54,95
12734,mishka123,,1,21,27,48
12735,somethingrandom,,1,10,16,26
12736,srsly,,1,5,6,11
12737,pu3ka,,1,2,7,9
12738,YOMOMMA,,1,8,23,31
12739,jello3d,,1,2,1,3
12740,heee,,1,10,9,19
12741,3ugene,,1,54,3,57
12742,JRBobDobbs,,1,1,2,3
12743,rarerumrunner,,1,5,6,11
12744,Nitroadict,,1,213,411,624
12745,Perl_pro,,1,7,10,17
12746,subhuman33,,1,1,1,2
12747,piglatin,,1,24,36,60
12748,rhenrikson,,1,3,1,4
12749,fattymcgee311,,1,5,4,9
12750,Drexxle,,1,3,6,9
12751,suetonius101,,1,1,1,2
12752,sterling2505,,1,18,25,43
12753,JackoKill,,1,2,3,5
12754,ArcadeVeteran_70,,1,1,3,4
12755,darad0,,1,13,9,22
12756,tangy,,1,9,7,16
12757,madmonk,,1,2,4,6
12758,hellosaysme,,1,10,16,26
12759,boiserm,,1,20,12,32
12760,watevruwant,,1,82,24,106
12761,kelar,,1,4,3,7
12762,tealeg,,1,24,16,40
12763,BornToBeWilder,,1,7,6,13
12764,Juless_pistol,,1,4,2,6
12765,Buttsexman,,1,2,4,6
12766,CharlotteL,,1,1,2,3
12767,sunshine-x,,1,754,1073,1827
12768,tlms77,,1,1,1,2
12769,pahool,,1,16,24,40
12770,thebungalow,,1,1,1,2
12771,ipissonjellyfish,,1,1,1,2
12772,lpottsy,,1,4,8,12
12773,TechnologyGuy,,1,48,3,51
12774,munchhausen,,1,13,26,39
12775,nothingcorporate,,1,1,2,3
12776,kousi,,1,464,600,1064
12777,khill,,1,8,13,21
12778,dlan1000,,1,1,1,2
12779,dhgaut,,1,5,4,9
12780,runnerr0,,1,1,3,4
12781,RottenPeaches,,1,9,16,25
12782,lordcutter,,1,1,1,2
12783,PerfectShape,,1,1,4,5
12784,bdover234,,1,1,7,8
12785,Captain_Birdseye,,1,1,1,2
12786,egportal2002,,1,5,2,7
12787,djumbrosia,,1,263,92,355
12788,basteln,,1,1,3,4
12789,boga,,1,1,1,2
12790,meltingwax,,1,8,18,26
12791,andymikey,,1,185,219,404
12792,chimeric,,1,10,15,25
12793,spot,,1,5,4,9
12794,sunbear47,,1,2,5,7
12795,lahdeedah,,1,3,7,10
12796,msaleem,,1,511,9,520
12797,chancesarent,,1,15,14,29
12798,floatzilla911,,1,1,3,4
12799,newtronbomb,,1,1,1,2
12800,liorn,,1,5,1,6
12801,Zybergod,,1,53,35,88
12802,fyc,,1,3,15,18
12803,qnaal,,1,188,295,483
12804,dbarefoot,,1,94,77,171
12805,Clockind,,1,17,28,45
12806,jinstevens,,1,13,24,37
12807,rob_j,,1,16,21,37
12808,dan7gg,,1,3,1,4
12809,yoda17,,1,558,937,1495
12810,mage2k,,1,37,78,115
12811,rish_789,,1,31,25,56
12812,MethylRed,,1,1,1,2
12813,xoswiss,,1,33,29,62
12814,wing-tip,,1,6,7,13
12815,obijohn,,1,11,3,14
12816,edd_b,,1,12,15,27
12817,arkicfbjj,,1,4,3,7
12818,javascript,,1,9,12,21
12819,notochord,,1,1,2,3
12820,gh0st3000,,1,67,101,168
12821,Jamon,,1,28,8,36
12822,z_kungfu,,1,1,1,2
12823,vanillagamer,,1,280,434,714
12824,jaseaco,,1,8,31,39
12825,BasharTeg,,1,1,1,2
12826,nessthehero,,1,75,65,140
12827,fpisfun,,1,1,8,9
12828,ahalam,,1,8,17,25
12829,philostrato,,1,264,38,302
12830,ferveo,,1,84,205,289
12831,RuffBrute,,1,15,30,45
12832,sruizmier,,1,1,1,2
12833,udptelecom,,1,1,1,2
12834,quuxman,,1,12,5,17
12835,netstream,,1,29,24,53
12836,bghlek,,1,2,2,4
12837,rolik,,1,2,1,3
12838,lightdarkness,,1,16,5,21
12839,americangoy,,1,292,313,605
12840,ep_,,1,2,5,7
12841,lgeorgiadis,,1,1,2,3
12842,LarryCraig,,1,7,15,22
12843,420greg,,1,14,30,44
12844,WayOfTheIronPaw,,1,28,64,92
12845,aquraishi,,1,4,1,5
12846,chocolategirl,,1,2,7,9
12847,thepublicrecord,,1,86,1,87
12848,nocoolnametom,,1,2,5,7
12849,echo419,,1,1,5,6
12850,myMirrorImage,,1,21,36,57
12851,PoisnBGood,,1,20,31,51
12852,sfsdfd,,1,3,4,7
12853,psayer,,1,1,4,5
12854,foobr,,1,40,57,97
12855,Thadster,,1,91,116,207
12856,exuro3k7,,1,2,4,6
12857,durin42,,1,4,5,9
12858,kutch430,,1,16,17,33
12859,fourcylthrill,,1,2,2,4
12860,Troosk,,1,50,1,51
12861,dmercier,,1,75,66,141
12862,KiddieFiddler,,1,302,409,711
12863,domodomo,,1,2,3,5
12864,tawhaki,,1,36,22,58
12865,mcarolan,,1,1,3,4
12866,chrisodd,,1,3,6,9
12867,t4z3r,,1,19,12,31
12868,qubit,,1,8,1,9
12869,nsfwftw,,1,1,3,4
12870,retzed,,1,1,1,2
12871,contantofaz,,1,49,36,85
12872,jon_gaudet,,1,11,9,20
12873,dredd,,1,251,484,735
12874,mondongo,,1,30,36,66
12875,sanka,,1,76,110,186
12876,metmerc,,1,290,396,686
12877,the-red-mistress,,1,1,1,2
12878,F_A_S_T,,1,1,1,2
12879,louise6380,,1,1,3,4
12880,laurenth,,1,76,94,170
12881,defenstrated,,1,1,1,2
12882,kbaum,,1,3,3,6
12883,angry_wombat,,1,9,9,18
12884,128d,,1,14,16,30
12885,cygnus42,,1,4,2,6
12886,Ockham,,1,14,7,21
12887,hankrearden,,1,5,9,14
12888,Dmitri_Mendeleev,,1,1,1,2
12889,2390480192384,,1,7,4,11
12890,Scottybones,,1,3,1,4
12891,ops7roger,,1,206,5,211
12892,kay3121999,,1,1,1,2
12893,risottoinc,,1,22,6,28
12894,d1ss0nant,,1,7,9,16
12895,kayowas,,1,53,1,54
12896,drivingrain87,,1,14,12,26
12897,somedev,,1,10,10,20
12898,porcelainkitty,,1,12,2,14
12899,fascismUSA,,1,2,6,8
12900,nco71,,1,1,4,5
12901,jettca1,,1,10,15,25
12902,bitterbug,,1,2,2,4
12903,herminator,,1,354,120,474
12904,MrBucket,,1,5,6,11
12905,gwniobombux,,1,5,10,15
12906,CorbinFox,,1,47,127,174
12907,kevinb11,,1,44,102,146
12908,hgathers,,1,1,1,2
12909,zorlan,,1,1,1,2
12910,pathogen,,1,110,111,221
12911,nekoniku,,1,301,380,681
12912,kohan69,,1,19,36,55
12913,JoeSniff,,1,2,2,4
12914,wogwogwogwogwog,,1,1,1,2
12915,70dot7,,1,2,4,6
12916,cwabunga,,1,19,11,30
12917,stigma,,1,29,61,90
12918,isaacbroyles,,1,1,1,2
12919,suntzusartofarse,,1,55,68,123
12920,rbr,,1,1,1,2
12921,ph1103,,1,39,7,46
12922,donoyako,,1,1,3,4
12923,biffabacon,,1,3,3,6
12924,kimbele,,1,2,1,3
12925,indtechy,,1,6,1,7
12926,uncreative,,1,1,1,2
12927,timdoug,,1,2,1,3
12928,ted3977,,1,19,27,46
12929,farghal,,1,8,11,19
12930,felicity5150,,1,16,16,32
12931,famous_potato,,1,1,1,2
12932,kman2k1,,1,7,18,25
12933,Hrearden,,1,218,88,306
12934,shoelzer,,1,264,13,277
12935,psalm405,,1,9,17,26
12936,dries,,1,1,1,2
12937,SolidBones,,1,37,37,74
12938,roblodocus,,1,1,1,2
12939,techboy500,,1,1,1,2
12940,iankino,,1,3,4,7
12941,MorningRooster,,1,86,56,142
12942,BentSlightly,,1,188,315,503
12943,bloodriver,,1,2,3,5
12944,fifteencat,,1,2,1,3
12945,shb100,,1,2,1,3
12946,DisposableLogin667,,1,2,2,4
12947,DougExeter,,1,6,10,16
12948,kirkt,,1,121,153,274
12949,adjustafresh,,1,17,27,44
12950,marxsydc,,1,111,128,239
12951,thefeint,,1,37,87,124
12952,edong,,1,60,58,118
12953,scrollop,,1,11,6,17
12954,zorglub421,,1,10,8,18
12955,w0073r,,1,56,65,121
12956,colkowalski,,1,32,55,87
12957,hups,,1,78,97,175
12958,fellow,,1,139,16,155
12959,listen_to_blogs,,1,3,5,8
12960,supersocialist,,1,324,557,881
12961,breezytrees,,1,130,154,284
12962,liquidos,,1,7,6,13
12963,swyitch,,1,3,2,5
12964,jwoodsutk,,1,84,58,142
12965,fatpads,,1,75,122,197
12966,albenali,,1,1,2,3
12967,dinosuzerarlitarism,,1,25,38,63
12968,AlboxII,,1,1,1,2
12969,comradhuff,,1,9,5,14
12970,Mr_Belding,,1,336,63,399
12971,epb205,,1,17,24,41
12972,weekendcoder,,1,1,9,10
12973,mcdvda,,1,34,58,92
12974,kidfromnyc,,1,396,93,489
12975,JarvisCocker,,1,404,722,1126
12976,Verde,,1,3,5,8
12977,dejb,,1,9,15,24
12978,klarth,,1,224,199,423
12979,lschofield,,1,55,47,102
12980,eratus,,1,46,87,133
12981,k4t0n4,,1,4,1,5
12982,errer,,1,38,39,77
12983,dracovixen,,1,4,7,11
12984,stegner,,1,56,99,155
12985,aussiejoe,,1,27,37,64
12986,y4kk,,1,4,4,8
12987,Europe,,1,3,7,10
12988,mandysteve,,1,66,70,136
12989,DudasMoreira,,1,6,12,18
12990,Tiny_Elvis,,1,193,190,383
12991,nondecisive,,1,29,47,76
12992,jbuberel,,1,3,3,6
12993,soreyes,,1,2,4,6
12994,lite2005,,1,2,2,4
12995,Petrarch1603,,1,427,486,913
12996,Billy_Mays,,1,3,4,7
12997,zopiclone,,1,22,40,62
12998,mcg1103,,1,7,9,16
12999,meiso,,1,6,19,25
13000,infraredline,,1,62,104,166
13001,stopchasingplants,,1,2,2,4
13002,hakomasong,,1,16,8,24
13003,sn0wcommie,,1,4,6,10
13004,joe0926,,1,1,1,2
13005,megablahblah,,1,976,633,1609
13006,yay_monkeys,,1,45,52,97
13007,ParadoX_,,1,284,213,497
13008,dfekt,,1,30,38,68
13009,sfgeek,,1,870,789,1659
13010,Glanton,,1,485,563,1048
13011,dimdog,,1,5,3,8
13012,campkev,,1,5,8,13
13013,jpease,,1,73,58,131
13014,itsjibba,,1,26,14,40
13015,serrakat,,1,2,2,4
13016,sweetbldnjesus,,1,26,41,67
13017,Deif,,1,4,5,9
13018,monkeyborg,,1,232,226,458
13019,radstopper5,,1,3,1,4
13020,grandmoffcory,,1,1,5,6
13021,rmmead,,1,2,3,5
13022,MooseLicker,,1,35,42,77
13023,doctordocs,,1,1,2,3
13024,delma1947,,1,1,2,3
13025,jcastle,,1,650,1046,1696
13026,FFM,,1,26,38,64
13027,F4il3d,,1,5,12,17
13028,hollylovesyourguts,,1,2,2,4
13029,crunchbag,,1,19,48,67
13030,apex32,,1,90,22,112
13031,ZebZ,,1,924,892,1816
13032,yosefk,,1,15,19,34
13033,willhasbro,,1,1,1,2
13034,we_are_good_people,,1,22,29,51
13035,djnightshade,,1,1,2,3
13036,Grymes,,1,2,3,5
13037,nalison,,1,5,2,7
13038,fibber,,1,4,10,14
13039,llkoolk,,1,1,2,3
13040,Discmasterstu,,1,29,32,61
13041,bthx11389,,1,5,1,6
13042,wtreilly,,1,1,2,3
13043,starji,,1,1,2,3
13044,dkl,,1,2,4,6
13045,airborne99,,1,1,2,3
13046,str0be117,,1,5,5,10
13047,aaallleeexxx,,1,181,94,275
13048,beefsupreme,,1,8,16,24
13049,keith_phillips,,1,72,120,192
13050,extrabellum,,1,212,309,521
13051,Dellitron,,1,1,1,2
13052,bubcis,,1,2,4,6
13053,hafetysazard,,1,126,174,300
13054,fingerband,,1,14,18,32
13055,magpi3,,1,70,59,129
13056,laurens10,,1,18,25,43
13057,greenerthanmoney,,1,33,10,43
13058,EuropeForDummies,,1,6,3,9
13059,netbuzz,,1,442,31,473
13060,stateofdenial,,1,8,9,17
13061,santa4nt,,1,215,405,620
13062,Tatsumi,,1,7,14,21
13063,r_j_c,,1,3,3,6
13064,tannerthedog,,1,9,14,23
13065,HBH,,1,2,3,5
13066,vyralinfection,,1,18,18,36
13067,barkbark,,1,11,11,22
13068,kucinichguy,,1,2,1,3
13069,dpjames,,1,34,88,122
13070,Czo,,1,244,348,592
13071,kinglear,,1,6,5,11
13072,jackyardbackoff,,1,4,7,11
13073,WarmMachine,,1,15,18,33
13074,SMACKONE,,1,1,5,6
13075,vagifiswrong,,1,2,2,4
13076,ntallen,,1,1,3,4
13077,realist777,,1,1,1,2
13078,sophiee,,1,4,20,24
13079,plumcreek2,,1,1,1,2
13080,taxinfo07,,1,7,6,13
13081,EricWard,,1,4,2,6
13082,ender1004,,1,7,7,14
13083,etherreal,,1,3,2,5
13084,morty,,1,69,62,131
13085,illusina,,1,9,28,37
13086,Poultry_In_Motion,,1,943,931,1874
13087,enver,,1,5,11,16
13088,bwReddit,,1,2,5,7
13089,nostradumass,,1,1,1,2
13090,BIllyHatesYou1,,1,8,17,25
13091,jirachiex,,1,18,48,66
13092,Zoomerdog,,1,41,73,114
13093,Jushooter,,1,1645,145,1790
13094,sdcDaOriginal,,1,6,13,19
13095,JonValjon,,1,41,34,75
13096,jimmy_john,,1,5,6,11
13097,mortalwind,,1,12,50,62
13098,lgoldman,,1,8,9,17
13099,Indestructible,,1,5,2,7
13100,assholeface,,1,198,225,423
13101,pakistani,,1,39,4,43
13102,laurak,,1,117,80,197
13103,defconner,,1,1,1,2
13104,kitanokikori,,1,3,5,8
13105,A1phab3t,,1,2,2,4
13106,rwparris2,,1,20,34,54
13107,black2back,,1,1,1,2
13108,jasmined,,1,12,6,18
13109,DeathandGravity,,1,1,1,2
13110,dloewenherz,,1,20,1,21
13111,RonnyPfannschmidt,,1,10,15,25
13112,black7mgk,,1,4,8,12
13113,pragmatick,,1,30,64,94
13114,samebrian,,1,15,11,26
13115,redboots,,1,1,1,2
13116,csmith7502,,1,17,1,18
13117,nobody554,,1,10,22,32
13118,tetleyex,,1,1,2,3
13119,zaphodfl,,1,1,3,4
13120,itguru,,1,6,5,11
13121,arias85,,1,1,1,2
13122,cookedegg,,1,3,1,4
13123,tokamoka,,1,17,30,47
13124,mikaelhg,,1,339,531,870
13125,bering,,1,28,11,39
13126,drzowie,,1,1,2,3
13127,birdmanjeremy,,1,10,9,19
13128,flipflopg,,1,1,1,2
13129,KirkWylie,,1,42,35,77
13130,kumaku,,1,14,32,46
13131,mejaredme,,1,121,24,145
13132,westlingken,,1,58,9,67
13133,sets14,,1,2,1,3
13134,pfemeter,,1,1,1,2
13135,mattgif,,1,45,50,95
13136,pagemag1,,1,2,1,3
13137,Thunar,,1,33,39,72
13138,racherdoodles,,1,5,4,9
13139,shaynesweeney,,1,1,1,2
13140,illini,,1,6,13,19
13141,sfjoe,,1,1,1,2
13142,redleg,,1,22,27,49
13143,dstone,,1,4,1,5
13144,cgdc,,1,7,6,13
13145,opusdei,,1,9,16,25
13146,eriksays,,1,2,6,8
13147,Neptuneblue,,1,34,50,84
13148,automation,,1,1,1,2
13149,brightboy,,1,5,15,20
13150,geniusninja,,1,2,5,7
13151,blabla999,,1,1,2,3
13152,snackmaster,,1,10,13,23
13153,hoekbrwr,,1,1,1,2
13154,kohlmannj,,1,5,8,13
13155,ididntdoit,,1,19,19,38
13156,cultured_banana_slug,,1,386,482,868
13157,lennysan,,1,30,3,33
13158,mydirtyshoe,,1,1,1,2
13159,draxil,,1,1,1,2
13160,e1ioan,,1,9,7,16
13161,fred1980,,1,1,1,2
13162,blah881664,,1,73,77,150
13163,sixbit,,1,41,3,44
13164,clos01,,1,61,66,127
13165,rprz,,1,16,21,37
13166,cannedthought,,1,117,180,297
13167,teye,,1,2,4,6
13168,Lactoes,,1,4,3,7
13169,pisanty,,1,1,1,2
13170,mmm_coffee,,1,112,80,192
13171,haroldlovesmaude,,1,3,2,5
13172,youidiota,,1,1,1,2
13173,MrAchievement,,1,1,7,8
13174,jimmyb207,,1,180,64,244
13175,igoro,,1,42,4,46
13176,Cputerace,,1,2,3,5
13177,GomuGomu,,1,3,2,5
13178,akdas,,1,831,1659,2490
13179,andrewcubbie,,1,2,4,6
13180,react,,1,26,34,60
13181,nmcyall,,1,1320,2124,3444
13182,peteman,,1,2,3,5
13183,atypic,,1,10,11,21
13184,XenoZohar,,1,76,149,225
13185,tleaman,,1,17,29,46
13186,BorisKafka,,1,133,167,300
13187,asundi,,1,9,6,15
13188,wrerzl,,1,2,3,5
13189,billtheprofessor,,1,10,11,21
13190,torpid,,1,1,1,2
13191,flyafly1,,1,1,1,2
13192,cafematt,,1,1,1,2
13193,jschuba,,1,6,9,15
13194,sparechange2,,1,4,8,12
13195,bluspiders,,1,2,4,6
13196,hoekstar,,1,1,2,3
13197,SteveZarc,,1,5,2,7
13198,monkiman96,,1,11,9,20
13199,cb122,,1,5,13,18
13200,Zenderquai,,1,8,8,16
13201,grsites2008,,1,1,2,3
13202,Chewyboognish,,1,26,38,64
13203,break99,,1,409,826,1235
13204,melinte,,1,215,75,290
13205,howardjena,,1,6,7,13
13206,Lomborg,,1,2,2,4
13207,pflarr,,1,5,1,6
13208,stickynips,,1,19,25,44
13209,paledo,,1,5,3,8
13210,katsi,,1,481,701,1182
13211,topsdot,,1,17,1,18
13212,nadim,,1,2,3,5
13213,miked4o7,,1,1,1,2
13214,makhno,,1,83,54,137
13215,dialectic,,1,2,5,7
13216,sh0rtwave,,1,84,139,223
13217,springtime,,1,19,23,42
13218,Greentype,,1,4,1,5
13219,NickBurd,,1,2,1,3
13220,cybe2,,1,34,53,87
13221,raytube,,1,2,4,6
13222,ikefruusto,,1,6,4,10
13223,mworthin,,1,2,2,4
13224,2views,,1,3,8,11
13225,flrff,,1,1,1,2
13226,martinpolley,,1,16,34,50
13227,superwazn,,1,1,2,3
13228,havengr,,1,79,1,80
13229,ahoyhere,,1,35,72,107
13230,whatwhy,,1,3,5,8
13231,The_DEA,,1,1,1,2
13232,timothj,,1,3,5,8
13233,cheeseysynapse,,1,3,2,5
13234,Avonalt,,1,6,13,19
13235,PrashantV,,1,20,31,51
13236,Escafane,,1,1449,449,1898
13237,hermitcrab,,1,98,5,103
13238,the_Internet,,1,37,60,97
13239,kaboom,,1,15,13,28
13240,safishb,,1,374,64,438
13241,cybersnoop,,1,21,32,53
13242,alstewart73,,1,5,5,10
13243,Clintondiditfirst,,1,1062,678,1740
13244,dreesemonkey,,1,69,120,189
13245,yellowbkpk,,1,443,411,854
13246,SilverSureShot,,1,12,2,14
13247,aequitasdei,,1,1,4,5
13248,centrocampista,,1,97,1,98
13249,dawn3000,,1,2,1,3
13250,washjones,,1,1,1,2
13251,zyorker,,1,6,3,9
13252,paxton,,1,1,2,3
13253,dkohler72,,1,25,32,57
13254,seijio,,1,1,2,3
13255,bendybendy,,1,4,4,8
13256,coolmos1,,1,53,108,161
13257,zrooster99,,1,6,4,10
13258,benoror,,1,3,6,9
13259,andrewburnett,,1,117,30,147
13260,ArcticCelt,,1,561,886,1447
13261,protomyth,,1,1,1,2
13262,collegecallgirl,,1,19,11,30
13263,dhjdhj,,1,263,326,589
13264,blin10,,1,32,1,33
13265,notgoodatcomputer,,1,44,24,68
13266,wilkes,,1,2,4,6
13267,Zounas,,1,75,78,153
13268,wbennett,,1,4,3,7
13269,sigloiv,,1,3,12,15
13270,Zude01,,1,2,1,3
13271,yurtali,,1,15,25,40
13272,IdleMind,,1,9,2,11
13273,WallaceStevens,,1,3,3,6
13274,doylecentral,,1,1,2,3
13275,tomwill2000,,1,31,23,54
13276,skurk,,1,25,30,55
13277,enzomedici,,1,417,498,915
13278,Cophet,,1,154,188,342
13279,BuckWFush,,1,1,4,5
13280,KathyWinchell,,1,1,1,2
13281,temp2345,,1,3,1,4
13282,segv,,1,17,16,33
13283,ramblemn,,1,76,119,195
13284,PreferentialAttacher,,1,2,1,3
13285,Reita,,1,4,18,22
13286,mbonar1001,,1,1,3,4
13287,Tarantio,,1,76,87,163
13288,sabjek777,,1,1,1,2
13289,sockpuppet5381,,1,6,1,7
13290,letired,,1,67,68,135
13291,ballantyne1984,,1,1,2,3
13292,oldfag,,1,1,1,2
13293,xigam,,1,33,58,91
13294,rumbygum,,1,5,6,11
13295,tonny4,,1,11,16,27
13296,mgedmin,,1,1,2,3
13297,astraykitten,,1,1,2,3
13298,Korendir,,1,1,3,4
13299,dariyam,,1,1,4,5
13300,blandlife,,1,3,3,6
13301,hengsu,,1,4,6,10
13302,evilpeter,,1,32,37,69
13303,chuncken,,1,15,10,25
13304,WhirlyGirly,,1,8,15,23
13305,amclennon,,1,1,3,4
13306,milbs066,,1,3,1,4
13307,parcydarks,,1,6,2,8
13308,pclouds,,1,51,18,69
13309,skillet-thief,,1,37,70,107
13310,alphaterminus,,1,8,8,16
13311,wkukinslayer,,1,59,72,131
13312,obama12345,,1,2,1,3
13313,uglymike,,1,6,13,19
13314,The_Terrorists,,1,1,4,5
13315,blatsnorf,,1,3,7,10
13316,mbh1985,,1,17,17,34
13317,keenintellect,,1,39,13,52
13318,zaulus,,1,42,75,117
13319,Kerrik,,1,2,1,3
13320,driver8,,1,50,83,133
13321,k82l,,1,1,3,4
13322,mikealao,,1,109,44,153
13323,zootsuit,,1,11,9,20
13324,winkler,,1,3,3,6
13325,clearingtheagenda,,1,343,82,425
13326,green21821,,1,46,73,119
13327,sparkle8,,1,1,7,8
13328,_martind,,1,62,63,125
13329,abergou,,1,5,6,11
13330,Infogleaner,,1,7,6,13
13331,edwardkmett,,1,120,90,210
13332,jnorlie,,1,4,2,6
13333,Pooch_Badger,,1,34,68,102
13334,siegfail,,1,83,180,263
13335,luweewu,,1,9,6,15
13336,lanes,,1,1,1,2
13337,scipe,,1,621,211,832
13338,q5_,,1,4,3,7
13339,cmj1981,,1,259,4,263
13340,Mitch_Hedberg,,1,2,1,3
13341,cold_in_nome,,1,1,1,2
13342,abc2012,,1,24,7,31
13343,psyne,,1,382,542,924
13344,johnfn,,1,323,470,793
13345,Jimmy-D,,1,1,1,2
13346,calebbrown,,1,18,2,20
13347,dendrite,,1,36,4,40
13348,Msyjsm,,1,71,130,201
13349,ryhall,,1,2,7,9
13350,apottedficus,,1,40,39,79
13351,DLincoln,,1,27,19,46
13352,Ralith,,1,14,21,35
13353,ubermorph,,1,5,5,10
13354,somared,,1,4,14,18
13355,penguin673,,1,7,5,12
13356,itsame_mario,,1,20,3,23
13357,Linus-2,,1,1,1,2
13358,IamNotGivingMyName,,1,15,17,32
13359,RavenOfNod,,1,132,117,249
13360,FalconNL,,1,9,16,25
13361,nibbi,,1,2,1,3
13362,thepicto,,1,89,118,207
13363,d16n,,1,36,32,68
13364,littlemindy,,1,1,1,2
13365,BlakeRHB,,1,2,2,4
13366,peskypescado,,1,21,12,33
13367,rejser,,1,1,1,2
13368,mme_zonbu,,1,2,3,5
13369,safrax,,1,5,5,10
13370,carl915,,1,10,1,11
13371,livingdangerously,,1,4,5,9
13372,davidak,,1,16,22,38
13373,lorill,,1,9,4,13
13374,r2pro,,1,61,87,148
13375,elisabethjw,,1,1,1,2
13376,dangson,,1,15,20,35
13377,Pplus,,1,3,7,10
13378,binzbok,,1,41,6,47
13379,gravelrhodes,,1,1,1,2
13380,mfenniak,,1,58,63,121
13381,supajax,,1,35,35,70
13382,baadshahfarhan,,1,72,47,119
13383,GET_OFF_MY_LAWN,,1,2,1,3
13384,alantrick,,1,164,254,418
13385,antico,,1,248,177,425
13386,mdw,,1,81,42,123
13387,toolow,,1,26,35,61
13388,batcdav,,1,70,75,145
13389,woodenteeth,,1,1,1,2
13390,mckirkus,,1,215,220,435
13391,slithy_tove,,1,2,6,8
13392,911_was_an_inside_jo,,1,4,1,5
13393,blayde,,1,1,1,2
13394,kaskoosek,,1,113,220,333
13395,everlong,,1,3,2,5
13396,elmanchosdiablos,,1,1,1,2
13397,Antipop,,1,26,45,71
13398,liftaren,,1,1,1,2
13399,Bmelt,,1,4,4,8
13400,karenkleen,,1,13,1,14
13401,lgv,,1,5,13,18
13402,MANYplaces84,,1,73,91,164
13403,cgrd,,1,2,5,7
13404,godsvagina,,1,1,1,2
13405,jeffbell,,1,30,54,84
13406,gardosattila,,1,77,6,83
13407,Spelling_Nazi,,1,2,2,4
13408,niconiconico,,1,9,18,27
13409,gamingfox,,1,1,4,5
13410,gattis,,1,3,2,5
13411,braz1l,,1,4,3,7
13412,DazedenConfewzd,,1,1,1,2
13413,FrankGmoNEY,,1,1,2,3
13414,moker,,1,37,22,59
13415,aznegglover,,1,4,3,7
13416,sacado,,1,10,17,27
13417,BenderRodriquez,,1,14,18,32
13418,tuckerkevin,,1,2,4,6
13419,cbranden,,1,1,7,8
13420,diggflap,,1,1,3,4
13421,FoePaw,,1,51,70,121
13422,slap_shot_12,,1,24,29,53
13423,sandossu,,1,1313,37,1350
13424,bebnet,,1,527,768,1295
13425,logophobia,,1,35,40,75
13426,kurotome,,1,6,6,12
13427,bulletbh,,1,14,3,17
13428,Shapichka,,1,65,74,139
13429,tomjen,,1,870,1318,2188
13430,peterhogg,,1,2,3,5
13431,mnlg,,1,81,55,136
13432,TweakTastic,,1,15,34,49
13433,tandersen,,1,1,1,2
13434,halcy,,1,211,235,446
13435,ComradeBill,,1,3,4,7
13436,skeets99,,1,7,3,10
13437,stryker5252,,1,118,199,317
13438,MrSandman321,,1,14,15,29
13439,logic11,,1,3,1,4
13440,appleface77,,1,4,7,11
13441,LongTimeLurker,,1,2,1,3
13442,espot1,,1,6,18,24
13443,Flubb,,1,23,31,54
13444,joechin,,1,2,4,6
13445,vijayc05,,1,1,2,3
13446,LRonPaultard,,1,38,77,115
13447,karmus,,1,10,10,20
13448,catbertz,,1,3,7,10
13449,IncredibleSulk,,1,4,3,7
13450,maartenm,,1,1,2,3
13451,adamshades,,1,2,5,7
13452,ogg208,,1,1,2,3
13453,Tjalve,,1,38,9,47
13454,ARC72,,1,65,37,102
13455,aelbric,,1,1,1,2
13456,anarchocap,,1,4,6,10
13457,YAOMTC,,1,57,67,124
13458,SenatorSecretMoslem,,1,29,24,53
13459,rasmuss,,1,2,1,3
13460,callmejeremy,,1,10,3,13
13461,Nutritional,,1,4,6,10
13462,happychihuahua,,1,2,1,3
13463,p3p3,,1,5,3,8
13464,flybywire2a,,1,29,3,32
13465,hipilarius,,1,4,2,6
13466,lulula,,1,1,2,3
13467,gnazzah,,1,7,10,17
13468,ctrager2,,1,60,13,73
13469,prvtswtee,,1,2,1,3
13470,jebudas,,1,48,79,127
13471,dqualls,,1,5,8,13
13472,wolverian,,1,20,34,54
13473,johnigles,,1,6,4,10
13474,michaeltron,,1,17,27,44
13475,joshdick,,1,290,477,767
13476,Pendulum,,1,34,56,90
13477,heederspead,,1,15,17,32
13478,sourlout,,1,13,15,28
13479,nm8,,1,5,2,7
13480,arundelo,,1,49,32,81
13481,jefeweiss,,1,1,5,6
13482,scuffia,,1,2,1,3
13483,ninjaspy,,1,4,1,5
13484,KBPrinceO,,1,3,17,20
13485,opally,,1,2,2,4
13486,blakero,,1,1,1,2
13487,flower_sermon,,1,1,1,2
13488,ormebk,,1,4,2,6
13489,kirkleton,,1,364,550,914
13490,jt18,,1,14,23,37
13491,guchdog,,1,1,1,2
13492,kieronbm,,1,12,4,16
13493,the_golden_eel,,1,57,58,115
13494,sdoorex,,1,17,30,47
13495,madwetsquirrel,,1,3,1,4
13496,mdanas,,1,10,4,14
13497,InvidFlower,,1,44,94,138
13498,gc3,,1,10,12,22
13499,drumr,,1,27,43,70
13500,siliconman,,1,250,13,263
13501,theville1974,,1,1,1,2
13502,moab9,,1,33,53,86
13503,monotux,,1,4,6,10
13504,skelo,,1,4,7,11
13505,airhead75,,1,142,151,293
13506,mr_pickles,,1,98,35,133
13507,joelmbenge,,1,5,12,17
13508,yakk,,1,5,3,8
13509,vingt,,1,1,3,4
13510,helloandre,,1,1,1,2
13511,kidawesome,,1,27,39,66
13512,roamzero,,1,60,63,123
13513,mcneany,,1,5,1,6
13514,luke314pi,,1,8,14,22
13515,dfx,,1,7,13,20
13516,sime,,1,12,15,27
13517,tharkban,,1,50,88,138
13518,bulinutza,,1,6,3,9
13519,amide,,1,2,2,4
13520,dwmg,,1,1,1,2
13521,Tomoki,,1,18,10,28
13522,seanc04,,1,31,6,37
13523,thatperson12,,1,4,1,5
13524,NitsujTPU,,1,319,529,848
13525,Lazified,,1,1,1,2
13526,spudge,,1,10,20,30
13527,srmatto,,1,196,457,653
13528,leastrandom,,1,65,60,125
13529,Glyndm,,1,14,13,27
13530,NotChrisMatthews,,1,22,36,58
13531,hello_dfa,,1,5,9,14
13532,gnuix2008,,1,1,1,2
13533,MikeCerm,,1,6,3,9
13534,dowlls,,1,1,6,7
13535,Neticule,,1,188,105,293
13536,torgo,,1,6,8,14
13537,Redebo,,1,97,84,181
13538,Jinno,,1,216,243,459
13539,CobaltBlue,,1,1,5,6
13540,Xyleene,,1,40,44,84
13541,guitarromantic,,1,23,15,38
13542,Bjartr,,1,109,248,357
13543,r1ch,,1,15,22,37
13544,fortes,,1,3,4,7
13545,pointmetotheinternet,,1,7,8,15
13546,mant,,1,63,48,111
13547,Omoikane,,1,3,4,7
13548,JaneTsai,,1,1,1,2
13549,rman666,,1,93,90,183
13550,Schwallex,,1,386,352,738
13551,vinyl_x,,1,37,4,41
13552,zaph0d,,1,64,13,77
13553,MichaelDotNet,,1,1,1,2
13554,on2them,,1,20,17,37
13555,haroldp,,1,155,190,345
13556,neilo_au,,1,1,2,3
13557,retired_paratrooper,,1,12,7,19
13558,dominicds,,1,3,2,5
13559,shimon,,1,3,4,7
13560,me9atron,,1,9,4,13
13561,Leviathrix,,1,2,2,4
13562,lachlanhunt,,1,5,3,8
13563,katebroome1,,1,4,7,11
13564,Zlik,,1,1,2,3
13565,eraserh,,1,145,194,339
13566,jericho6,,1,52,4,56
13567,ladybluered,,1,34,23,57
13568,ma1content,,1,1,1,2
13569,interbutt,,1,1,13,14
13570,ashanbtb,,1,2,11,13
13571,mantic,,1,1,1,2
13572,jamesob,,1,19,21,40
13573,jim258kelly,,1,139,199,338
13574,passive,,1,48,76,124
13575,alneo5527,,1,7,3,10
13576,TriumphInsComicDog,,1,3,5,8
13577,Rhode,,1,391,567,958
13578,TeriyakiDelight,,1,1,1,2
13579,tinto2,,1,1,1,2
13580,loki614,,1,4,4,8
13581,esbern,,1,71,3,74
13582,theoriginalalex,,1,9,14,23
13583,EatSleepJeep,,1,278,523,801
13584,Iredditaoften,,1,136,31,167
13585,jayrolandsb,,1,14,9,23
13586,wof8,,1,39,68,107
13587,kyr,,1,3,3,6
13588,jasonbrennan,,1,243,194,437
13589,silversnowe,,1,9,5,14
13590,jozarich,,1,1,1,2
13591,rocketbike,,1,13,3,16
13592,commodore84,,1,9,18,27
13593,truthseeker37,,1,8,2,10
13594,mst3kcrow,,1,2,1,3
13595,Bogtha,,1,48,50,98
13596,Cookie,,1,219,174,393
13597,abbydigital,,1,1,1,2
13598,joeypt,,1,15,11,26
13599,Wendel,,1,78,89,167
13600,jjdonald,,1,6,4,10
13601,atorger1,,1,9,19,28
13602,0b4m4FTW,,1,12,5,17
13603,cowardlydragon,,1,154,165,319
13604,fbp,,1,30,41,71
13605,willdabeast,,1,84,102,186
13606,sb404,,1,145,240,385
13607,Arox,,1,1,2,3
13608,KomodoAce,,1,8,6,14
13609,nasadataboy,,1,4,5,9
13610,alex135,,1,2,10,12
13611,naturek,,1,129,4,133
13612,imonsei,,1,5,11,16
13613,protix,,1,1,6,7
13614,wintintin,,1,4,1,5
13615,creativeaccountname,,1,2,1,3
13616,nohope,,1,4,3,7
13617,somebody7,,1,2,3,5
13618,halter73,,1,27,39,66
13619,foodnerd,,1,2,1,3
13620,infinityplus1,,1,2,3,5
13621,eyesee,,1,3,3,6
13622,pilaf,,1,42,74,116
13623,hurleyNY,,1,2,1,3
13624,shutupnorthamerica,,1,1,1,2
13625,peachi,,1,3,2,5
13626,Moridin,,1,29,2,31
13627,jimsterbell,,1,6,11,17
13628,johncsadler,,2,2,1,3
13629,bitchincamaro,,1,8,4,12
13630,mian2zi3,,1,6,10,16
13631,unpercent,,1,1,2,3
13632,tripmcneely30,,1,1,3,4
13633,Crib_D,,1,77,90,167
13634,jd230,,1,1,1,2
13635,blueberryspecial,,1,3,2,5
13636,jay_vee,,1,299,519,818
13637,Sadepurple,,3,3,2,5
13638,shifty3,,1,12,4,16
13639,true911,,1,1,3,4
13640,EarthEmperor,,1,3,2,5
13641,SEMW,,1,26,34,60
13642,futino,,1,4,4,8
13643,craterass,,1,1,8,9
13644,mckooiker,,1,25,9,34
13645,emostar,,1,6,8,14
13646,yourfavweapn,,1,3,10,13
13647,RobertZimmerman,,1,8,11,19
13648,regnare,,1,6,8,14
13649,truename,,1,47,73,120
13650,ballardr,,1,50,136,186
13651,HasOvaries,,1,2,10,12
13652,merulus,,1,2,2,4
13653,pensivewombat,,1,19,10,29
13654,burke,,1,487,639,1126
13655,weaselheart,,1,14,15,29
13656,sofutofu,,1,33,9,42
13657,PimmyJalmer,,1,3,9,12
13658,redcrvtte05,,1,152,485,637
13659,stressedstoner,,1,7,9,16
13660,okcomputer,,1,1,4,5
13661,Inquisitor1,,1,69,136,205
13662,effjaygee,,1,1,1,2
13663,EllieElliott,,1,1509,131,1640
13664,unbelated,,1,13,19,32
13665,ovidiu_s,,1,3,2,5
13666,darwonka,,1,5,3,8
13667,filfakmaffia,,1,3,6,9
13668,OrcAndBeans,,1,35,11,46
13669,halb,,1,62,101,163
13670,futurespin,,1,27,23,50
13671,Torlek42,,1,25,12,37
13672,mordero,,1,7,7,14
13673,saturdayplace,,1,61,76,137
13674,lekisgoesbump,,1,1,2,3
13675,Whisper,,1,806,1142,1948
13676,CNBC-CNBC-CNBC,,1,6,3,9
13677,Dragoonie,,1,10,14,24
13678,leokennis,,1,207,236,443
13679,hoover,,1,2,4,6
13680,coditza,,1,69,111,180
13681,senatorpjt,,1,209,438,647
13682,gashford,,1,10,17,27
13683,ropers,,1,1735,2159,3894
13684,fignew,,1,2,2,4
13685,Pizzaboxknight,,1,40,36,76
13686,alisunwunderland,,1,2,3,5
13687,dlamarre,,1,14,8,22
13688,yel02,,1,1,3,4
13689,BelaLinguini,,1,1,1,2
13690,Capt_Kewl,,1,2,9,11
13691,drmc_coy,,1,172,370,542
13692,novafan,,1,3,4,7
13693,mr-jones,,1,5,4,9
13694,boskie,,1,71,2,73
13695,ricdit,,1,6,12,18
13696,liquid_kore,,1,69,70,139
13697,Spaceman_Spliff,,1,229,218,447
13698,mk_gecko,,1,255,270,525
13699,dontlookatmynameok,,1,2,8,10
13700,Mauwer,,1,35,23,58
13701,KrypieKat,,1,2,1,3
13702,rbalko,,1,16,4,20
13703,pitchblack16,,1,6,9,15
13704,IAmBroom,,1,6,6,12
13705,amynew,,1,13,12,25
13706,Nuli,,1,191,338,529
13707,fireworkkid,,1,6,17,23
13708,Scooson,,1,17,3,20
13709,drewcd1,,1,2,2,4
13710,diabede,,1,92,63,155
13711,CannonGod,,1,1,8,9
13712,groceryheist,,1,1,1,2
13713,eglinski,,1,147,19,166
13714,mgibbons,,1,241,279,520
13715,wtf___over,,1,8,17,25
13716,Chris_Hansen_,,1,1,1,2
13717,Darksaw,,1,2,3,5
13718,xwerebearx,,1,9,5,14
13719,gabrielus,,1,1,1,2
13720,pertsix,,1,11,13,24
13721,heart_pineapple,,1,1,5,6
13722,kapuzineralex,,1,5,13,18
13723,mustardman,,1,2,3,5
13724,pjiggalo,,1,25,16,41
13725,akov,,1,18,27,45
13726,kuhsay,,1,152,86,238
13727,DrFri,,1,1,1,2
13728,lostwombat,,1,2,1,3
13729,ltworek,,1,8,9,17
13730,artimas2,,1,5,3,8
13731,humpy,,1,13,15,28
13732,R_Kelly,,1,5,1,6
13733,physon,,1,23,35,58
13734,Ellsworthskate,,1,1,2,3
13735,mossycheong,,1,1,1,2
13736,maelnum,,1,1,8,9
13737,ganjablue,,1,3,5,8
13738,typ3,,1,3,4,7
13739,starffy,,1,1,1,2
13740,desrosiers,,1,292,410,702
13741,TheWaiter,,1,10,17,27
13742,joetakagi,,1,5,4,9
13743,exton,,1,73,142,215
13744,netturtle,,1,50,3,53
13745,Solmu,,1,2,4,6
13746,DonkeyShowPunchBowl,,1,1,2,3
13747,mangote,,1,2,2,4
13748,Herald_MJ,,1,121,65,186
13749,zakk,,1,44,19,63
13750,g4T0r,,1,7,7,14
13751,tarski,,1,3,5,8
13752,pifantastic,,1,1,1,2
13753,mooglor,,1,175,138,313
13754,SCK,,1,1,1,2
13755,mpr312,,1,1,1,2
13756,daload,,1,40,109,149
13757,stilldidntdoit,,1,5,8,13
13758,pointsofdata,,1,32,34,66
13759,goldfire,,1,2,5,7
13760,brispone,,1,132,175,307
13761,covertlyobvious,,1,6,4,10
13762,Chairmclee,,1,9,12,21
13763,Milligan,,1,26,44,70
13764,discom,,1,33,56,89
13765,Flankk,,1,120,176,296
13766,folderol,,1,90,137,227
13767,toomatoo,,1,12,8,20
13768,AllModerate,,1,122,86,208
13769,myklee,,1,3,5,8
13770,DrZoid,,1,4,12,16
13771,Killfile,,1,72,11,83
13772,wtfgecko,,1,21,19,40
13773,tudorama,,1,8,8,16
13774,Fidelpolpotbinhitler,,1,113,73,186
13775,kimora,,1,4,10,14
13776,rabyd,,1,2,1,3
13777,whyso,,1,3,14,17
13778,zutroy,,1,2,4,6
13779,elliottcable,,1,19,55,74
13780,kisielk,,1,4,3,7
13781,Gun-Jehuty,,1,10,4,14
13782,boyb,,1,111,65,176
13783,thevoid,,1,186,249,435
13784,miriku,,1,58,76,134
13785,elq,,1,109,26,135
13786,bradbeattie,,1,6,15,21
13787,girkabob,,1,8,6,14
13788,zmary,,1,1,1,2
13789,bitchkat,,1,8,14,22
13790,Autoclave,,1,18,33,51
13791,mrection,,1,1,1,2
13792,eidolontubes,,1,299,459,758
13793,teelynn,,1,2,1,3
13794,zq00,,1,4,6,10
13795,teacoder,,1,49,57,106
13796,pinkypornstar,,1,82,52,134
13797,Albatr0ss,,1,4,2,6
13798,Borgismorgue,,1,149,217,366
13799,megamanwich,,1,1,1,2
13800,andrewnorris,,1,136,157,293
13801,bittie,,1,4,3,7
13802,leexkor,,1,1,2,3
13803,chachacha,,1,19,1,20
13804,william4chao,,1,81,154,235
13805,troyec001,,1,2,3,5
13806,sprobertam,,1,2,2,4
13807,stroem,,1,1,1,2
13808,linknight,,1,2,5,7
13809,Multra,,1,16,22,38
13810,cgonzo,,1,1,1,2
13811,yanilkr,,1,14,18,32
13812,alesis,,1,136,236,372
13813,shrek-unit,,1,8,15,23
13814,karc,,1,12,12,24
13815,stumo,,1,292,369,661
13816,Benjaminsen,,1,2,2,4
13817,maheshee11,,1,69,6,75
13818,jay4r0,,1,1,2,3
13819,d_cox,,1,10,9,19
13820,funkymedina,,1,8,1,9
13821,reb42,,1,8,14,22
13822,ruipereira,,1,3,4,7
13823,greencourt,,1,4,13,17
13824,pariah_john,,1,4,10,14
13825,BizarreNews,,1,4,1,5
13826,katatonos,,1,1,7,8
13827,peeloo,,1,5,4,9
13828,I_love_energy_drinks,,1,23,48,71
13829,louisc,,1,27,42,69
13830,woodsmit,,1,15,23,38
13831,rechlin,,1,34,36,70
13832,klugerama,,1,4,6,10
13833,dbrose67,,1,2,4,6
13834,speedkills,,1,8,3,11
13835,snitko,,1,1,1,2
13836,pradador,,1,860,869,1729
13837,Slayback,,1,8,12,20
13838,ViolentRevolution,,1,1,3,4
13839,grey_0x2a,,1,10,15,25
13840,brreod,,1,10,4,14
13841,zzazz,,1,14,28,42
13842,nightlys,,1,2,5,7
13843,Xfocus,,1,126,158,284
13844,milliondollarbill,,1,28,49,77
13845,PJMurphy,,1,14,25,39
13846,DarthFenrir,,1,10,16,26
13847,imthedevil,,1,1,2,3
13848,OpticalAlchemy,,1,5,2,7
13849,uglyfunny,,1,6,3,9
13850,burlygurlyman,,1,9,5,14
13851,sleepysentry,,1,8,2,10
13852,jcalm28,,1,2,4,6
13853,brownbat,,1,1,1,2
13854,sites,,1,1,1,2
13855,maddmike,,1,54,42,96
13856,cainunable,,1,4,14,18
13857,MisterClaw,,1,3,8,11
13858,redditaccount77,,1,1,1,2
13859,winchells,,1,13,16,29
13860,techshift,,1,4,7,11
13861,psylent,,1,74,69,143
13862,kepple,,1,7,4,11
13863,andrejevas,,1,139,281,420
13864,mecablaze,,1,14,19,33
13865,deejaymc,,1,2,5,7
13866,icallbullshit,,1,1,1,2
13867,jshell,,1,1,3,4
13868,FoolsRun,,1,71,102,173
13869,Azr43L,,1,3,7,10
13870,snarks,,1,1,1,2
13871,aGorilla,,1,477,856,1333
13872,goonusrex,,1,18,22,40
13873,fbriggs,,1,19,5,24
13874,clubber_lang,,1,43,74,117
13875,vdot90,,1,11,1,12
13876,feefifofum,,1,3,8,11
13877,sarahkm,,1,10,9,19
13878,jodrellblank,,1,12,17,29
13879,Coridan,,1,95,91,186
13880,awongca,,1,3,4,7
13881,nornagon,,1,8,12,20
13882,newborn,,1,400,306,706
13883,saegiru,,1,2,6,8
13884,SpaceWorld,,1,5,10,15
13885,pumah,,1,6,4,10
13886,MizzAnon,,1,8,7,15
13887,TPDC130,,1,63,105,168
13888,clouwn,,1,5,9,14
13889,thatfellow,,1,29,16,45
13890,jesusistheway,,1,1,1,2
13891,TheKCGuy,,1,11,5,16
13892,Partario,,1,7,1,8
13893,Rosey,,1,22,29,51
13894,stephw8,,1,1,2,3
13895,swiftheart,,1,246,284,530
13896,contents,,1,23,15,38
13897,cwittiker22,,1,5,5,10
13898,lvov,,1,2,1,3
13899,joshbates15,,1,1,2,3
13900,oakenn,,1,2,2,4
13901,melchior_,,1,2,3,5
13902,WinerDinerSixtyNiner,,1,4,14,18
13903,FelixFelis,,1,7,15,22
13904,bennybreeze,,1,129,115,244
13905,serge_mamian,,1,8,3,11
13906,smeenz,,1,54,73,127
13907,turdf3rguson79,,1,4,3,7
13908,ValleyGirls,,1,1,1,2
13909,mattbert,,1,30,30,60
13910,p3ngwin,,1,85,161,246
13911,wearedevo,,1,315,313,628
13912,trifilij,,1,74,90,164
13913,dublued,,1,31,96,127
13914,spamham,,1,7,20,27
13915,ettubrute,,1,1,1,2
13916,frofro,,1,18,5,23
13917,DrGeneRay,,1,15,9,24
13918,AnonymousLOL,,1,1,1,2
13919,monk-e-boy,,1,2,1,3
13920,carldamien,,1,296,171,467
13921,nifran,,1,5,4,9
13922,chinajones,,1,2,1,3
13923,redditpuggle,,1,10,2,12
13924,kkrizs,,1,11,25,36
13925,tsxh,,1,1,2,3
13926,dudenextdoor00,,1,1,4,5
13927,sikkdog,,1,5,5,10
13928,konzahiker,,1,2,4,6
13929,metaperl,,1,20,26,46
13930,mr_ree,,1,25,9,34
13931,Itchinosi,,1,11,18,29
13932,pipecock,,1,1,3,4
13933,ChokingVictim,,1,15,10,25
13934,bacila,,1,21,8,29
13935,hobg,,1,25,6,31
13936,The_Voice_of_Reason,,1,125,105,230
13937,nepthar,,1,5,4,9
13938,jsfhejefkjelkj,,1,3,2,5
13939,I_Lurk,,1,2,4,6
13940,nachos,,1,2,4,6
13941,krasotkin,,1,41,58,99
13942,sdOverKill,,1,4,2,6
13943,SkeuomorphEphemeron,,1,153,300,453
13944,psb,,1,10,11,21
13945,fergie9275,,1,13,25,38
13946,SheauxDown,,1,3,3,6
13947,adibou,,1,94,183,277
13948,Th3Tru7h,,1,37,10,47
13949,Phoenixdying,,1,84,103,187
13950,Internet_Pirates,,1,1,1,2
13951,kmikz,,1,22,22,44
13952,lesbonics,,1,27,6,33
13953,jeffsimmermonTWC,,1,8,6,14
13954,anonymous2,,1,2,1,3
13955,tfinniga,,1,47,60,107
13956,neoryan,,1,1,1,2
13957,devro1040,,1,19,35,54
13958,MrFuzzywuzzle,,1,2,5,7
13959,TitaniumDreads,,1,21,26,47
13960,DiNovi,,1,16,7,23
13961,angeljoan,,1,1,6,7
13962,Svenski,,1,3,1,4
13963,drinnit,,1,7,9,16
13964,tfad,,1,1,2,3
13965,salty_oz,,1,2,3,5
13966,FortunesFool,,1,8,9,17
13967,Alaska_Brosef,,1,2,4,6
13968,moofus,,1,9,2,11
13969,surajbarkale,,1,131,151,282
13970,lukebox,,1,99,113,212
13971,tealc,,1,4,1,5
13972,wellofsouls,,1,1,1,2
13973,thomasfl,,1,13,9,22
13974,phoenix1701,,1,1,3,4
13975,carav,,1,3,11,14
13976,octopede,,1,40,44,84
13977,rodan1967,,1,6,6,12
13978,melhouse,,1,16,26,42
13979,chrishyde,,1,17,9,26
13980,c4rl,,1,8,8,16
13981,jlangr,,1,2,2,4
13982,ncsu1982,,1,6,6,12
13983,marisak,,1,3,14,17
13984,c4st,,1,3,2,5
13985,neurolux,,1,168,295,463
13986,zargon5,,1,14,11,25
13987,Marlyhalperngraser,,1,1,1,2
13988,IConrad,,1,1271,2216,3487
13989,bill04,,1,106,112,218
13990,crikey,,1,5,11,16
13991,lollerkeet,,1,6,8,14
13992,_Seo_,,1,10,4,14
13993,Cladari,,1,90,121,211
13994,tekprodfx16,,1,5,4,9
13995,forkbum,,1,9,5,14
13996,aphrodendrite,,1,6,4,10
13997,synctext,,1,2,3,5
13998,jsichol,,1,19,34,53
13999,johnnybazookajoe,,1,41,5,46
14000,theoraclesam,,1,5,1,6
14001,sarahkh66,,1,3,2,5
14002,harpes,,1,1,4,5
14003,mastertabemono,,1,1,1,2
14004,llamapeasant,,1,3,3,6
14005,mangda716,,1,50,12,62
14006,stateq2,,1,4,12,16
14007,meddlepal,,1,22,36,58
14008,radmarshallb,,1,52,27,79
14009,jbell,,1,7,15,22
14010,tuxracer,,1,279,269,548
14011,DarkSamus,,1,4,15,19
14012,spoileralert,,1,84,72,156
14013,PeterJerome,,1,2,2,4
14014,tmorton,,1,9,9,18
14015,FeralTitan,,1,8,8,16
14016,aspade,,1,2,5,7
14017,drunkentune,,1,42,58,100
14018,ulisse,,1,4,3,7
14019,matt_havener,,1,8,13,21
14020,rp1790,,1,4,20,24
14021,btgeekboy,,1,101,150,251
14022,dickcheney08,,1,111,142,253
14023,byzas,,1,229,18,247
14024,trav110,,1,10,16,26
14025,downdiagonal,,1,1884,589,2473
14026,strawberry,,1,33,5,38
14027,two0them,,1,14,32,46
14028,jcase,,1,13,18,31
14029,Scratchie_Chan,,1,2,3,5
14030,cactus,,1,26,24,50
14031,wallakoala,,1,6,3,9
14032,jasonmantey,,1,20,17,37
14033,thislooksfamiliar,,1,4,2,6
14034,Pyren,,1,1,2,3
14035,AllInOne,,1,4,5,9
14036,andmixtapes,,1,4,3,7
14037,jugbo,,1,5,2,7
14038,ineptsegue,,1,1,1,2
14039,dhpye,,1,103,194,297
14040,leavesoflorien,,1,234,145,379
14041,danth78,,1,1,2,3
14042,antheia,,1,1,2,3
14043,missreddit,,1,22,4,26
14044,sphs-873041,,1,1,1,2
14045,boradis,,1,1,1,2
14046,sriscarlet,,3,3,5,8
14047,CatsRein,,1,2,2,4
14048,datababble,,1,2,1,3
14049,midnightmoonbeam,,1,131,208,339
14050,zupatol,,1,16,19,35
14051,dukestravels,,1,22,1,23
14052,lemonescomy,,1,99,33,132
14053,farnz,,1,5,5,10
14054,nomdeplume,,1,123,106,229
14055,dantheman333,,1,32,39,71
14056,alogghe,,1,1,1,2
14057,laszlo,,1,4,4,8
14058,drona,,1,3,4,7
14059,poohneat,,1,1,1,2
14060,lulz,,1,276,340,616
14061,RisenPhoenix,,1,31,2,33
14062,letsinnovate,,1,3,3,6
14063,gsw07a,,1,47,73,120
14064,weekendlush,,1,8,12,20
14065,6c602,,1,2,3,5
14066,asyncster,,1,28,8,36
14067,nih777,,1,90,136,226
14068,HUNTUMBLINGCHRIST,,1,6,5,11
14069,jotaeme,,1,2,1,3
14070,2Legit,,1,1,1,2
14071,mbrezu,,1,16,22,38
14072,cliffmoon,,1,10,12,22
14073,randompower,,1,1,1,2
14074,knowmo,,1,2,4,6
14075,sunych,,1,9,1,10
14076,voolze,,1,1,3,4
14077,gmalva,,1,6,2,8
14078,Jhinra,,1,2,1,3
14079,libertas,,1,12,23,35
14080,JMSantos,,1,24,28,52
14081,newfag,,1,2,3,5
14082,Entropy,,1,384,636,1020
14083,bpg131313,,1,3,6,9
14084,catinahat1,,1,28,68,96
14085,garhole,,1,4,18,22
14086,Buckwheat469,,1,102,125,227
14087,nlogax,,1,8,15,23
14088,roast_beef,,1,24,51,75
14089,bling-bling,,1,689,49,738
14090,nellocin,,1,2,1,3
14091,peterwschlamp,,1,121,75,196
14092,foyf,,1,5,6,11
14093,unibeat,,1,1,1,2
14094,Prox,,1,11,27,38
14095,bugeats,,1,10,10,20
14096,seeandyspin,,1,48,20,68
14097,guinunez,,1,72,64,136
14098,alok0,,1,93,106,199
14099,iu34,,1,1,3,4
14100,x540x,,1,6,19,25
14101,somn,,1,423,400,823
14102,Vidd,,1,50,80,130
14103,shadowsurge,,1,684,527,1211
14104,InRehab,,1,13,13,26
14105,colas,,1,2,5,7
14106,T-man,,1,6,8,14
14107,yearrgh,,1,10,1,11
14108,misdirectomy,,1,1,4,5
14109,martingwalker,,1,1,1,2
14110,lechtitseb,,1,3,3,6
14111,badiozam,,1,103,155,258
14112,ANRAND,,1,5,11,16
14113,JTShultzy,,1,127,153,280
14114,Digger99,,1,1,1,2
14115,Semifreek,,1,6,2,8
14116,sbazerque,,1,2,1,3
14117,hongkonger,,1,1,1,2
14118,andrewglover87,,1,31,31,62
14119,Ingineer,,1,1,1,2
14120,MikeLinPA,,1,2,3,5
14121,ayoproduct,,1,6,12,18
14122,newagey,,1,1,3,4
14123,sfrank,,1,3,4,7
14124,frankthechicken,,1,8,4,12
14125,cbasst,,1,11,14,25
14126,d_ahura,,1,24,26,50
14127,leadtogold,,1,2,1,3
14128,Shepy,,1,11,15,26
14129,ivanfp1,,1,1,2,3
14130,wundagrrl,,1,1,3,4
14131,bahdler,,1,10,12,22
14132,kstauch,,1,3,8,11
14133,bwa32,,1,3,4,7
14134,jrs235,,1,14,17,31
14135,carwynllew,,1,193,50,243
14136,BadBroker,,1,3,2,5
14137,ian13,,1,15,2,17
14138,frooo,,1,7,1,8
14139,jubripley,,1,2,3,5
14140,uSeeEsBee,,1,20,33,53
14141,StoneCypher,,1,10,10,20
14142,tesserakt,,1,3,5,8
14143,gossipgrrl,,1,2,1,3
14144,CaptainDungtrumpet,,1,3,7,10
14145,pulaski,,1,6,3,9
14146,taxonimous,,1,57,24,81
14147,plazman30,,1,13,6,19
14148,AnimalMachine,,1,5,7,12
14149,Marcocchio,,1,3,4,7
14150,shorugoru,,1,44,61,105
14151,jbiz,,1,74,67,141
14152,artificialidiot,,1,2,4,6
14153,reddit_doe,,1,29,39,68
14154,thaen,,1,9,19,28
14155,kokooo,,1,36,69,105
14156,HaywoodJablomi,,1,65,114,179
14157,EightBelles,,1,1,1,2
14158,Mattfeliks,,1,23,16,39
14159,comwiz,,1,1,1,2
14160,WhatTheFuck,,1,65,102,167
14161,bigkahunaca,,1,6,9,15
14162,ledgersghost,,1,72,30,102
14163,bradz77,,1,1,1,2
14164,gnufied,,1,42,53,95
14165,gamergirl007,,1,12,8,20
14166,saladtossser,,1,24,16,40
14167,psublue,,1,9,22,31
14168,ttpmx,,1,10,5,15
14169,rimwalker,,1,58,43,101
14170,mattsavinar,,1,11,1,12
14171,oberon,,1,28,35,63
14172,karramel,,1,1,1,2
14173,dig1,,1,9,9,18
14174,superstar123,,1,7,3,10
14175,poopinator,,1,8,10,18
14176,traal,,1,349,382,731
14177,M4rk7r0n,,1,3,5,8
14178,byron,,1,272,280,552
14179,toekneelin,,1,3,6,9
14180,xurble,,1,26,35,61
14181,fridgetarian,,1,9,7,16
14182,SnowCrashv5,,1,58,39,97
14183,Asmodeus,,1,173,300,473
14184,redditator,,1,53,5,58
14185,bokka1,,1,1,4,5
14186,afuchs,,1,6,16,22
14187,Tze-Lu,,1,161,230,391
14188,CGM,,1,8,12,20
14189,miro781,,1,1,1,2
14190,horsebees,,1,13,12,25
14191,pwoolf,,1,4,3,7
14192,thelibrarian,,1,13,21,34
14193,wekt,,1,426,193,619
14194,hahahamonkeys,,1,5,10,15
14195,funnybong,,1,2,3,5
14196,moonsocket,,1,2,2,4
14197,phig,,1,12,24,36
14198,silverwoodchuck47,,1,63,111,174
14199,guiscard,,1,28,74,102
14200,JangusKhan,,1,251,171,422
14201,neologism,,1,3,1,4
14202,ahassan5,,1,3,3,6
14203,spadbob,,1,14,6,20
14204,ferret_fan,,1,48,9,57
14205,MyBrainIsTooBig,,1,1,1,2
14206,sliceofbread,,1,33,54,87
14207,zolaar,,1,34,72,106
14208,deskamess,,1,5,2,7
14209,clarkbmiller,,1,4,3,7
14210,ilmar,,1,4,1,5
14211,bnporter,,1,110,49,159
14212,kaervek,,1,2,1,3
14213,GJtheMahler,,1,39,62,101
14214,anybodyhome,,1,5,2,7
14215,Smokey_The_Bear,,1,1,1,2
14216,UnderBear,,1,1,1,2
14217,skews13,,1,1,2,3
14218,djiivu,,1,9,9,18
14219,alerolli1,,1,5,3,8
14220,cotl,,1,25,29,54
14221,kodak543,,1,16,22,38
14222,Mythrl,,1,2,4,6
14223,registrarsoffice,,1,1,1,2
14224,binnorie,,1,74,136,210
14225,qkwozz,,1,4,4,8
14226,mjklin,,1,4,7,11
14227,magicsammy,,1,25,25,50
14228,shadowofdeath15,,1,7,6,13
14229,adelle,,1,13,12,25
14230,jackau,,1,43,8,51
14231,bigears08,,1,11,12,23
14232,DaydreamNation,,1,40,34,74
14233,gtj,,1,340,123,463
14234,eeno,,1,2,3,5
14235,thedarklabs,,1,84,48,132
14236,sgtscherer,,1,1,2,3
14237,zotquix,,1,28,54,82
14238,thussey,,1,1,1,2
14239,Pikajabroni,,1,1018,1392,2410
14240,pablumite,,1,1,3,4
14241,pantherman,,1,2,9,11
14242,Farfalla,,1,94,50,144
14243,Shades87,,1,6,12,18
14244,cheeseburger,,1,3,4,7
14245,damienkatz,,1,119,116,235
14246,ImaginaryRadical,,1,4,4,8
14247,chiggah,,1,2,3,5
14248,this,,1,36,19,55
14249,chrisb,,1,53,19,72
14250,dentr0n,,1,6,7,13
14251,subterraneus,,1,20,22,42
14252,redditlessthan3,,1,10,1,11
14253,tenaciousJk,,1,63,103,166
14254,pmpott,,1,7,13,20
14255,storyofitall,,1,116,190,306
14256,alan7388,,1,22,45,67
14257,anchalsingh,,1,98,19,117
14258,lmtku,,1,6,31,37
14259,gebop,,1,2,2,4
14260,ryanguill,,1,8,12,20
14261,NotDarx,,1,21,28,49
14262,sliverlizard,,1,3,3,6
14263,joeljkp,,1,170,71,241
14264,myalternatelife,,1,3,8,11
14265,silentbob583,,1,13,18,31
14266,machinegunn,,1,9,20,29
14267,AlexTrebek,,1,4,5,9
14268,DV2,,1,7,19,26
14269,glenndanzig1984,,1,2,7,9
14270,dardan_aeneas,,1,141,51,192
14271,communomancer,,1,11,14,25
14272,ihope127,,1,1,3,4
14273,n00biz,,1,5,7,12
14274,SillyGrampa,,1,5,2,7
14275,omegasnk,,1,5,15,20
14276,mountainman,,1,90,133,223
14277,CPOliver,,1,6,16,22
14278,mfdoom,,1,4,8,12
14279,Aaronius,,1,56,74,130
14280,uklathemot,,1,1,1,2
14281,petron,,1,1,1,2
14282,Diderot,,1,13,12,25
14283,eatadonut,,1,69,103,172
14284,Vladomis,,1,4,2,6
14285,herkimer_sith,,1,34,65,99
14286,Kagi,,1,5,2,7
14287,leopoldbloom,,1,4,1,5
14288,eindbaas,,1,161,36,197
14289,joellevin,,1,13,6,19
14290,wuaha,,1,49,103,152
14291,planza,,1,17,6,23
14292,8418a65850d1df3486e3,,1,1,2,3
14293,veracity,,1,119,12,131
14294,jmuk,,1,25,15,40
14295,bigpun8601,,1,19,23,42
14296,VacuousTart,,1,5,13,18
14297,joeplayer91,,1,22,23,45
14298,masta,,1,1799,495,2294
14299,mcreeves,,1,1,11,12
14300,hoobyjuice,,1,9,20,29
14301,CLBumbc,,1,10,15,25
14302,kensington,,1,7,8,15
14303,sweetiepup,,1,6,6,12
14304,Dr-No,,1,551,1043,1594
14305,cybertron3,,1,10,8,18
14306,tsbardella,,1,10,13,23
14307,ltratt,,1,8,10,18
14308,linsage,,1,65,43,108
14309,tmilanese,,1,9,1,10
14310,_Lysis,,1,5,10,15
14311,permial,,1,11,38,49
14312,malicart,,1,111,174,285
14313,jroot,,1,5,5,10
14314,tritelife,,1,1,1,2
14315,300zxkyle,,1,15,25,40
14316,vgwe4i7,,1,1,1,2
14317,attractivechaos,,1,7,9,16
14318,stevomo,,1,3,1,4
14319,mctofuburger,,1,3,1,4
14320,pankakekid,,1,1,1,2
14321,Stereo,,1,31,22,53
14322,visage,,1,4,1,5
14323,subie,,1,3,3,6
14324,plight43,,1,18,54,72
14325,possummomma,,1,1,1,2
14326,dmacd,,1,2,12,14
14327,paulscholes,,1,1,1,2
14328,EnsignPaul,,1,2,10,12
14329,stacknuker,,1,1,3,4
14330,tech3399,,1,1,1,2
14331,reddit_already,,1,2,3,5
14332,oppenklein,,1,4,2,6
14333,Mikey_K,,1,1,2,3
14334,djpressplay,,1,1,1,2
14335,vinneh,,1,18,32,50
14336,jklyon,,1,5,5,10
14337,d1mension7,,1,1,1,2
14338,murf43143,,1,27,47,74
14339,forthewinyo,,1,1,1,2
14340,aruki,,1,14,32,46
14341,viperucf,,1,3,7,10
14342,bugbear,,1,1,1,2
14343,ochristmastree,,1,5,1,6
14344,biscuitgirl,,1,93,2,95
14345,dillywash,,1,19,32,51
14346,santacruzluke,,1,2,2,4
14347,tzimmerm,,1,1,1,2
14348,sceanti,,1,6,1,7
14349,Breeze99,,1,2,7,9
14350,refusedlud,,1,31,46,77
14351,Cpt2Slow,,1,16,22,38
14352,leavermentality,,1,7,9,16
14353,david_ncl,,1,42,66,108
14354,druzel,,1,25,49,74
14355,dizm,,1,4,6,10
14356,joecooool,,1,12,29,41
14357,reddit1964,,1,1,1,2
14358,mg0abraxas,,1,28,28,56
14359,katiedid382,,1,5,4,9
14360,askedandanswered,,1,2,3,5
14361,biogeek1,,1,1,2,3
14362,arianit,,1,5,9,14
14363,phoenixstrike,,1,4,3,7
14364,evangelos,,1,1,1,2
14365,fishandchips,,1,273,51,324
14366,derricks,,1,101,208,309
14367,BigFootsDick,,1,1,7,8
14368,mcmUK,,1,9,10,19
14369,nafki,,1,1,2,3
14370,starfox863,,1,152,203,355
14371,bparkey,,1,2,5,7
14372,jcarrea,,1,8,15,23
14373,LilBabyCakes,,1,3,5,8
14374,saintdaniel,,1,49,23,72
14375,i386,,1,14,16,30
14376,lesapeur,,1,9,6,15
14377,zorglubb,,1,2,4,6
14378,CharlieBlix,,1,1,1,2
14379,dminor04,,1,2,11,13
14380,largarararar,,1,44,56,100
14381,callingshotgun,,1,14,13,27
14382,brandaggio,,1,1,1,2
14383,xavier687,,1,22,2,24
14384,soonbesleeping,,1,1,1,2
14385,bigbob,,1,3,2,5
14386,misterO,,1,1,2,3
14387,secularhumanismsucks,,1,4,3,7
14388,aardvarkious,,1,783,946,1729
14389,sjn,,1,1,1,2
14390,redriot,,1,1,2,3
14391,youngNactive,,1,1,1,2
14392,jungle,,1,3,3,6
14393,ziusudra,,1,107,120,227
14394,null0ne,,1,48,66,114
14395,denser,,1,1,1,2
14396,jeffkilliandotcom,,1,5,3,8
14397,sleepyslim,,1,1,3,4
14398,rayhoffman,,1,302,19,321
14399,tcz06a,,1,1,3,4
14400,meg1,,1,1545,2,1547
14401,ZEUS_SKY_FATHER,,1,2,3,5
14402,Kreatienmonster,,1,3,6,9
14403,meinpresident,,1,1,1,2
14404,watso4183,,1,4,1,5
14405,nullxposur,,1,38,63,101
14406,Locke,,1,5,10,15
14407,analogy6,,1,49,69,118
14408,wombatz,,1,45,28,73
14409,mrp,,1,245,363,608
14410,fullerenedream,,1,3,9,12
14411,noirling,,1,42,170,212
14412,_batman_,,1,1,1,2
14413,eatwithaspork,,1,84,24,108
14414,packer64,,1,52,93,145
14415,agracey,,1,3,2,5
14416,chalkdrinker,,1,1,1,2
14417,noxyu,,1,237,73,310
14418,free-book,,1,2,1,3
14419,alex77,,1,2,1,3
14420,Unhandled,,1,11,9,20
14421,wetwarehacker,,1,1,2,3
14422,Jack-Sparrow,,1,4,12,16
14423,illuder,,1,1,1,2
14424,Madcat407,,1,6,7,13
14425,one010101,,1,533,363,896
14426,ironeus,,1,2,6,8
14427,thelivingk,,1,3,8,11
14428,Jegschemesch,,1,17,25,42
14429,dtz_prokyon,,1,4,7,11
14430,NotSocrates,,1,99,146,245
14431,noiserr,,1,127,172,299
14432,redditblowz,,1,18,37,55
14433,ashinohara,,1,4,2,6
14434,noahking,,1,14,10,24
14435,sher14,,1,70,34,104
14436,highgear,,1,8,15,23
14437,williambeaufoy,,1,11,2,13
14438,darkness,,1,16,15,31
14439,moosemanca,,1,67,143,210
14440,wainstead,,1,188,171,359
14441,natepurvis,,1,8,36,44
14442,jonbwhite,,1,9,9,18
14443,impulsiveboy,,1,62,71,133
14444,zieski,,1,3,2,5
14445,youAreHere,,1,2,2,4
14446,palin_drome,,1,7,7,14
14447,sickofthisshit,,1,286,468,754
14448,sambo_the_ninja,,1,2,3,5
14449,justanotheraccount,,1,13,15,28
14450,gserafini,,1,4,5,9
14451,manna18,,1,1,2,3
14452,joshstix,,1,42,61,103
14453,geost77,,1,16,1,17
14454,audacityofchope,,1,4,2,6
14455,bisserke,,1,4,7,11
14456,netkitten22,,1,2,3,5
14457,aarondbaron,,1,16,23,39
14458,outlawdba,,1,2,1,3
14459,morefish,,1,2,10,12
14460,tryk48s,,1,141,226,367
14461,jramon,,1,158,163,321
14462,numtel,,1,6,15,21
14463,GoWithTheFlow,,1,327,1,328
14464,dcanatsey,,1,1,1,2
14465,Biohazix,,1,1,1,2
14466,qeorge,,1,1,7,8
14467,yambo,,1,3,1,4
14468,wolof,,1,12,20,32
14469,Adam_B,,1,18,8,26
14470,sunbright,,1,59,73,132
14471,SanBenito,,1,142,3,145
14472,hoppaaaa,,1,7,4,11
14473,sybilll,,1,4,3,7
14474,uptoyou,,1,468,11,479
14475,atomicpoet,,1,73,7,80
14476,krava,,1,1,1,2
14477,iam413x,,1,7,7,14
14478,deadilyduplicate,,1,27,43,70
14479,fiddlefaddle,,1,2,6,8
14480,jgsfcaus,,1,7,17,24
14481,ihendley,,1,2,3,5
14482,austinpete3,,1,2,1,3
14483,Nemo84,,1,266,277,543
14484,cheetahforce,,1,55,59,114
14485,davidzilla27,,1,2,1,3
14486,nixx,,1,2,1,3
14487,brubsy,,1,739,102,841
14488,MikeCapone,,1,1107,192,1299
14489,gonorrhea,,1,139,209,348
14490,zanshin,,1,1,2,3
14491,burnte,,1,35,31,66
14492,zhz,,1,29,1,30
14493,glazedham,,1,2,5,7
14494,myriad,,1,6,6,12
14495,Cbosselman,,1,3,1,4
14496,garagumu,,1,1,2,3
14497,smokinsamsim,,1,347,498,845
14498,gonzopancho,,1,157,310,467
14499,LKPGKS,,1,1,1,2
14500,too-much-4chan,,1,3,1,4
14501,temujin9,,1,12,9,21
14502,qwertyboy,,1,13,31,44
14503,herb_lubalin,,1,1,1,2
14504,PhilA,,1,58,94,152
14505,seoredditspammer,,1,1,2,3
14506,jvboom,,1,3,9,12
14507,elljazz,,1,1,1,2
14508,Loggie,,1,9,5,14
14509,saadghauri,,1,17,12,29
14510,benjimix,,1,16,16,32
14511,rabbitz,,1,3,1,4
14512,leastwise,,1,1,1,2
14513,DaSuHouse,,1,109,98,207
14514,mellowmuppet,,1,6,4,10
14515,xxshteviexx,,1,12,3,15
14516,crawfishsoul,,1,926,757,1683
14517,emeraldchild,,1,35,13,48
14518,degustibus,,1,639,719,1358
14519,Tomasd,,1,27,85,112
14520,sanshou,,1,1,1,2
14521,DemonWasp,,1,36,38,74
14522,taliesinsmuse,,1,2,3,5
14523,anneas,,1,4,33,37
14524,markansoul,,1,319,220,539
14525,swanrt,,1,1,1,2
14526,Tumbler,,1,28,73,101
14527,GuruM,,1,36,31,67
14528,heirenton,,1,3,6,9
14529,skuttlesSUPERHOTwife,,1,1,1,2
14530,y0ssarian_lives,,1,5,4,9
14531,francomanco,,1,1,1,2
14532,narf760,,1,8,14,22
14533,jingo04,,1,193,252,445
14534,stevob2007,,1,20,7,27
14535,xsvfan,,1,52,78,130
14536,mrpeepers,,1,146,51,197
14537,Keedo,,1,114,107,221
14538,TJ700,,1,12,17,29
14539,SCThornley,,1,14,28,42
14540,keghiaguy,,1,1,1,2
14541,fdsawrefsdf,,1,3,6,9
14542,Carleton,,1,46,56,102
14543,nejda,,1,1,1,2
14544,dfn_doe,,1,10,17,27
14545,trebok,,1,9,2,11
14546,nibulis,,1,1,1,2
14547,Terry_Wogan,,1,1,1,2
14548,KauLad,,1,56,175,231
14549,canadianstudent,,1,4,5,9
14550,juri,,1,152,54,206
14551,bigman11,,1,39,41,80
14552,quandrum,,1,3,2,5
14553,towel106,,1,2,6,8
14554,BarkingIguana,,1,60,2,62
14555,leofellmann,,1,1,1,2
14556,jarnot,,1,26,17,43
14557,4Kitch,,1,5,6,11
14558,alrecruits,,1,3,11,14
14559,n3sky,,1,3,2,5
14560,supersix8,,1,2,6,8
14561,all4one,,1,31,2,33
14562,kdevilbiss,,1,4,2,6
14563,FrazRoc,,1,2,5,7
14564,DorkAvenue,,1,1,1,2
14565,neuquino,,1,337,469,806
14566,allisonschest,,1,10,11,21
14567,roflcoptars,,1,9,5,14
14568,Franey97,,1,40,75,115
14569,mudita4,,1,2,7,9
14570,refuch,,1,254,206,460
14571,toast_and_oj,,1,90,100,190
14572,RoboHobo,,1,6,10,16
14573,lesbianmonad,,1,2,2,4
14574,Mondex,,1,4,8,12
14575,moxy,,1,98,56,154
14576,Kythas,,1,1,3,4
14577,malte,,1,4,10,14
14578,ejegg,,1,18,19,37
14579,novan_leon,,1,4,6,10
14580,hatboysam,,1,23,24,47
14581,Tspyder90,,1,9,4,13
14582,xanados,,1,27,34,61
14583,brownmajik,,1,3,4,7
14584,Seizure,,1,4,5,9
14585,vanNood,,1,15,20,35
14586,realrbman,,1,4,8,12
14587,lockhart000,,1,373,734,1107
14588,treefrog3,,1,8,7,15
14589,wacky,,1,58,82,140
14590,staticflux,,1,3,5,8
14591,sergiu,,1,34,36,70
14592,MostUsually,,1,587,185,772
14593,jdubba,,1,12,13,25
14594,drluke21,,1,2,1,3
14595,zdiggler,,1,59,108,167
14596,gardsmyg,,1,2,1,3
14597,zybler,,1,2,5,7
14598,erinswake11,,1,1,1,2
14599,pythor,,1,208,183,391
14600,fjohnson,,1,7,6,13
14601,frycook,,1,1086,150,1236
14602,onymous,,1,26,49,75
14603,Smitty1315,,1,35,51,86
14604,robotify,,1,7,4,11
14605,wmdeez,,1,1,1,2
14606,potheadpaul,,1,1,5,6
14607,GeDaMo,,1,33,36,69
14608,diggtard,,1,1,1,2
14609,andoy,,1,44,59,103
14610,andrew2825,,1,14,19,33
14611,nikron,,1,59,66,125
14612,potesf,,1,2,2,4
14613,Recycle_Grav_Water,,1,9,5,14
14614,illuminati11_13,,1,29,50,79
14615,sabliss,,1,5,11,16
14616,tolmeda,,1,2,2,4
14617,fbsdaemon,,1,2,1,3
14618,ThePantsParty,,1,606,666,1272
14619,machotaco,,1,33,13,46
14620,HeywoodFloyd,,1,17,38,55
14621,chedabob,,1,14,27,41
14622,blahblah984,,1,125,116,241
14623,clashradio,,1,1,1,2
14624,motd,,1,127,7,134
14625,vademecum,,1,17,14,31
14626,The_Slinky,,1,7,5,12
14627,myshambar,,1,11,9,20
14628,HipX,,1,74,108,182
14629,stratoscope,,1,60,112,172
14630,oliverhulland,,1,1,1,2
14631,peanutcruncher,,1,7,6,13
14632,thewaxtadpole,,1,1,1,2
14633,jsinger,,1,58,82,140
14634,Caledo,,1,5,11,16
14635,drp,,1,23,19,42
14636,jimmyw,,1,7,4,11
14637,Waven,,1,2,7,9
14638,Dick-Cheney,,1,3,2,5
14639,miramesa,,1,64,4,68
14640,anticompany,,1,1,1,2
14641,bdpf,,1,4,22,26
14642,Underbelly,,1,1,3,4
14643,macworks,,1,1,1,2
14644,hunter-man,,1,227,493,720
14645,r2002,,1,2524,400,2924
14646,richroger68,,1,2,1,3
14647,monsterchaos,,1,16,15,31
14648,thomaspaine23,,1,63,18,81
14649,mberning,,1,8,6,14
14650,wedsngr,,1,6,17,23
14651,jdiggity,,1,6,15,21
14652,wat,,1,161,341,502
14653,englishpaulm,,1,14,20,34
14654,nullpuppy,,1,1,1,2
14655,Tits,,1,1,2,3
14656,dfdemar,,1,1,3,4
14657,gunzler,,1,5,2,7
14658,Unlucky13,,1,963,1026,1989
14659,Stani,,1,4,1,5
14660,jftduncan,,1,18,54,72
14661,nagycalsmom,,1,20,22,42
14662,MinionKeeper,,1,1,1,2
14663,admiralteal,,1,324,357,681
14664,v1p3r,,1,119,11,130
14665,stnkyme,,1,1,2,3
14666,RecycleBin,,1,7,5,12
14667,mozinator,,1,5,3,8
14668,ABoringStory,,1,3,3,6
14669,sorinescu,,1,1,1,2
14670,jbourne,,1,58,84,142
14671,morgawr,,1,3,3,6
14672,xeferae,,1,2,2,4
14673,haliquim,,1,3,6,9
14674,educ8r,,1,1,1,2
14675,dmead,,1,227,439,666
14676,petert111,,1,2,2,4
14677,revence27,,1,93,27,120
14678,locke-peter,,1,1,4,5
14679,mhatmaker,,1,79,8,87
14680,an_idiot,,1,7,24,31
14681,jarwiz,,1,10,3,13
14682,fryfut,,1,5,1,6
14683,Reeking_Havoc,,1,10,31,41
14684,slacker_express,,1,1,3,4
14685,cray,,1,47,2,49
14686,walkerandtexasranger,,1,26,45,71
14687,f350,,1,2,1,3
14688,alaithea,,1,9,4,13
14689,killswithspoon,,1,85,161,246
14690,cmatta,,1,27,8,35
14691,inataysia,,1,56,78,134
14692,mokba,,1,14,28,42
14693,mrmch,,1,1,1,2
14694,savyboy,,1,3,3,6
14695,lostcause,,1,2,1,3
14696,CrawstonWaffle,,1,43,60,103
14697,qiwi,,1,206,142,348
14698,OnkelOnd,,1,1,2,3
14699,six2one,,1,27,54,81
14700,honkytonks,,1,259,355,614
14701,austinap,,1,24,45,69
14702,rodbibeau,,1,365,40,405
14703,heasmo,,1,3,4,7
14704,Sivart,,1,136,16,152
14705,amburka,,1,10,29,39
14706,deputy,,1,3,2,5
14707,lobster_johnson,,1,17,17,34
14708,twistedlogix,,1,17,24,41
14709,acm,,1,149,144,293
14710,w-smith,,1,762,345,1107
14711,find_the_orphan,,1,143,303,446
14712,spinelssinvrtebrate,,1,9,12,21
14713,iamdeirdre,,1,1,4,5
14714,trixare4kids,,1,2,2,4
14715,jamieg77,,1,264,83,347
14716,fivekitten,,1,1,1,2
14717,corser,,1,12,16,28
14718,vogella,,1,2,1,3
14719,FlySwat,,1,1340,1207,2547
14720,lmaurits,,1,46,40,86
14721,geldan01,,1,1,3,4
14722,hammerfist,,1,4,3,7
14723,salival,,1,11,6,17
14724,867_5309,,1,2,2,4
14725,arumalla,,1,5,2,7
14726,derosabomb,,1,34,71,105
14727,ireddit_didu,,1,10,9,19
14728,raaaaaj,,1,1,1,2
14729,redditer029,,1,3,1,4
14730,GhostSonata,,1,107,154,261
14731,atc,,1,246,100,346
14732,finreddit,,1,156,96,252
14733,nbomberger,,1,1,1,2
14734,boo_radley,,1,410,176,586
14735,desperatechaos,,1,1,1,2
14736,quark2universe,,1,2,4,6
14737,lazyl,,1,10,12,22
14738,takezo,,1,6,9,15
14739,rwattonville,,1,21,4,25
14740,jsmith55,,1,7,11,18
14741,CannonBall7,,1,8,9,17
14742,culalem,,1,20,21,41
14743,M-Jo,,1,27,27,54
14744,mrossi,,1,1,1,2
14745,vypermann,,1,45,116,161
14746,NucularOption,,1,19,15,34
14747,kbax,,1,1,1,2
14748,kahlveen,,1,3,6,9
14749,Bluebuilder,,1,4,20,24
14750,vasi,,1,6,1,7
14751,davidkclark,,1,55,104,159
14752,Otis_Inf,,1,45,67,112
14753,kraemahz,,1,560,784,1344
14754,SyndicatedCynic,,1,17,8,25
14755,asses4all,,1,18,16,34
14756,blindsideboarder,,1,5,2,7
14757,radix2,,1,278,435,713
14758,knutert,,1,13,25,38
14759,insaneferret,,1,2,2,4
14760,EcoLogic,,1,6,18,24
14761,thomasjkeeley,,1,2,2,4
14762,beta_pup,,1,3,5,8
14763,Corosus,,1,12,20,32
14764,zjohnson,,1,2,2,4
14765,Nulli,,1,8,20,28
14766,positiveexperience,,1,1,4,5
14767,QueryNerd,,1,14,12,26
14768,BenderBRodriguez,,1,1,1,2
14769,kunal,,1,3,3,6
14770,L505,,1,1,5,6
14771,troofs,,1,1,1,2
14772,relativityboy,,1,1,2,3
14773,BBHoss,,1,9,8,17
14774,yamahaha,,1,7,16,23
14775,karlgluck,,1,20,18,38
14776,booku,,1,2,4,6
14777,photoho,,1,41,65,106
14778,senorsam,,1,1,1,2
14779,blindmikey,,1,12,21,33
14780,vezquex,,1,93,165,258
14781,stevos,,1,2,1,3
14782,User-Name-,,1,2,1,3
14783,czone2,,1,11,12,23
14784,qvtsd,,1,109,94,203
14785,Stupid_boy,,1,13,13,26
14786,j3anjean,,1,3,11,14
14787,jasondm,,1,32,28,60
14788,xcbsmith,,1,296,464,760
14789,goodfun,,1,344,344,688
14790,aquowf,,1,1,1,2
14791,snerfu,,1,12,3,15
14792,hahabitch,,1,1,1,2
14793,skypedia,,1,171,3,174
14794,catpartyletsgo,,1,7,1,8
14795,honeyguy,,1,16,16,32
14796,slarti101,,1,4,3,7
14797,InfamousMrSatan,,1,1,1,2
14798,Raegnar,,1,2,2,4
14799,raskolnikov027,,1,7,11,18
14800,nohtyp,,1,81,98,179
14801,Jenkin,,1,5,6,11
14802,bdj789,,1,2,1,3
14803,moontalyn,,1,1,1,2
14804,myjunkmailblog,,1,139,19,158
14805,renumeratedfrog,,1,106,188,294
14806,decode,,1,34,41,75
14807,MrDectol,,1,362,205,567
14808,themightytimmah,,1,34,43,77
14809,spirithappy,,1,5,1,6
14810,oneredshoe,,1,2,2,4
14811,gudolph,,1,49,1,50
14812,cheerstothat,,1,1,4,5
14813,lookyhere,,1,55,110,165
14814,Ian1971,,1,39,62,101
14815,patrickthebeerguy,,1,1,7,8
14816,Kydosa,,1,30,28,58
14817,pattister,,1,12,20,32
14818,locke2002,,1,810,1116,1926
14819,siff,,1,8,16,24
14820,YakumoFuji,,1,14,15,29
14821,mdaniel018,,1,1,4,5
14822,mfritze,,1,2,1,3
14823,corbet,,1,115,6,121
14824,jerfalco,,1,1,1,2
14825,lolret,,1,37,40,77
14826,chaimonster,,1,14,28,42
14827,mm256,,1,1,1,2
14828,cunning_alias,,1,2,6,8
14829,FapFapFapSquirt,,1,39,54,93
14830,imp4hire,,1,53,83,136
14831,exteNz,,1,1,1,2
14832,mozo,,1,18,43,61
14833,nakul,,1,29,2,31
14834,uri2007,,1,2,2,4
14835,EgoEater,,1,1,1,2
14836,charlieb,,1,28,7,35
14837,Media_Offline,,1,16,19,35
14838,kluikens,,1,2,1,3
14839,HaloShy,,1,2,7,9
14840,mahlankeruu,,1,1,1,2
14841,papared,,1,29,44,73
14842,stevage,,1,27,64,91
14843,runo,,1,1,2,3
14844,molasses,,1,7,7,14
14845,booc0mtaco,,1,125,237,362
14846,misterguy,,1,32,39,71
14847,Volred,,1,5,2,7
14848,ariessoul,,1,5,13,18
14849,noob09,,1,2,5,7
14850,ichae,,1,243,266,509
14851,laffer82,,1,2,8,10
14852,MarginalMeaning,,1,15,23,38
14853,donutwant,,1,1,1,2
14854,lmpinto,,1,26,25,51
14855,ampwoden,,1,1,1,2
14856,pstryder,,1,18,14,32
14857,joshery420,,1,1,1,2
14858,toolhater,,1,49,71,120
14859,shelter33,,1,21,27,48
14860,squishee,,1,2,3,5
14861,easlern,,1,18,36,54
14862,pRtkL_xLr8r,,1,34,24,58
14863,BizCoach,,1,3,1,4
14864,davros,,1,2,2,4
14865,quaesitum,,1,1,1,2
14866,fenalphthalein,,1,1,1,2
14867,wirehead,,1,20,19,39
14868,RevFred,,1,31,75,106
14869,Omar_Little,,1,7,8,15
14870,maven1000,,1,12,17,29
14871,MindStalker,,1,99,136,235
14872,tyler0is0sexy,,1,12,17,29
14873,jonimius,,1,1,1,2
14874,rfriendselectric,,1,13,28,41
14875,john1968,,1,1,1,2
14876,almeerow,,1,1,1,2
14877,notoryious,,1,77,14,91
14878,BossColo,,1,70,36,106
14879,stashu,,1,42,53,95
14880,pineapplecharm,,1,189,136,325
14881,mnckelly,,1,168,11,179
14882,wildjasmyne,,1,3,1,4
14883,AlanisMorissette,,1,2,3,5
14884,Quantic,,1,13,22,35
14885,soWifeWontRead,,1,1,1,2
14886,mgdmw,,1,21,2,23
14887,jonndailey,,1,2,5,7
14888,jechasteen,,1,15,24,39
14889,zuiop,,1,2,2,4
14890,TW9zc2Fk,,1,49,47,96
14891,Cyn_Helen,,1,5,9,14
14892,Russss,,1,4,2,6
14893,NealJiutai,,1,8,4,12
14894,BrkneS,,1,44,81,125
14895,wurtis16,,1,317,508,825
14896,gorgonette,,1,3,3,6
14897,Insurrexi,,1,16,13,29
14898,tckearns,,1,27,17,44
14899,FritzGuy,,1,34,32,66
14900,Libertwriter,,1,85,3,88
14901,flashgasoline,,1,126,49,175
14902,cancer_will_kill_you,,1,1,1,2
14903,Polarisman,,1,60,78,138
14904,Ai3d,,1,11,19,30
14905,rozbluewhite,,3,2,1,3
14906,diddy223,,1,16,32,48
14907,jmr81,,1,9,9,18
14908,ric_astley,,1,4,5,9
14909,seaport,,1,24,2,26
14910,chiragshah1,,1,11,12,23
14911,Jivlain,,1,523,691,1214
14912,rhpk,,1,18,5,23
14913,grendel001,,1,66,81,147
14914,fisheyeguy,,1,1,1,2
14915,radar-luv,,1,29,26,55
14916,xtra_sharp,,1,114,202,316
14917,Bloaf,,1,36,63,99
14918,pmctosh,,1,12,5,17
14919,bakekitsune,,1,2,2,4
14920,sablewing,,1,2,1,3
14921,thepenismightier,,1,2,1,3
14922,myclone,,1,6,6,12
14923,ratley,,1,1,2,3
14924,RRightmyer,,1,8,10,18
14925,goldenbug,,1,4,3,7
14926,yugurta,,1,1,1,2
14927,leapinleopard,,1,26,18,44
14928,mronge,,1,1,1,2
14929,Gauze,,1,2,1,3
14930,rufosanch,,1,3,5,8
14931,glaeken,,1,18,19,37
14932,theneonwind,,1,2,2,4
14933,zplot,,1,2,7,9
14934,lostangelonline,,1,59,114,173
14935,orrizo,,1,17,34,51
14936,swervely,,1,3,2,5
14937,Ember357,,1,2,1,3
14938,nopenotreally,,1,1,1,2
14939,Sarkwa,,1,3,3,6
14940,atoztoa,,1,1,1,2
14941,Eminence120,,1,111,153,264
14942,7amWDG,,1,10,7,17
14943,sal4321,,1,6,3,9
14944,gdupe,,1,3,3,6
14945,grau,,1,22,45,67
14946,christopherness,,1,3,1,4
14947,superdupertigercat,,1,5,6,11
14948,wanderful,,1,36,78,114
14949,lemonheadzzz,,1,1,1,2
14950,aethauia,,1,34,60,94
14951,jmesserly,,1,1,2,3
14952,johannesfarr,,1,2,4,6
14953,RogueJediX,,1,18,31,49
14954,geneticmaterial,,1,10,27,37
14955,etrochim,,1,3,1,4
14956,furless,,1,1,4,5
14957,Calamaro,,1,1,5,6
14958,pookiey,,1,1,1,2
14959,smarterthanyoda,,1,8,16,24
14960,NLP,,1,12,18,30
14961,Spoots,,1,1,1,2
14962,Tygerdave,,1,2,3,5
14963,giantstonedbot,,1,18,13,31
14964,tanglisha,,1,88,108,196
14965,tenpastmidnight,,1,5,12,17
14966,americanadian,,1,55,41,96
14967,rurias1,,1,3,2,5
14968,zodpower,,1,11,38,49
14969,Jonno94,,1,1,1,2
14970,shawnwasson,,1,420,21,441
14971,dhays2000,,1,9,15,24
14972,Ionice,,1,215,6,221
14973,alecthomas,,1,2,8,10
14974,fuzzmop,,1,70,76,146
14975,oimeetsgrrl,,1,18,13,31
14976,thisuserisapipe_bomb,,1,6,5,11
14977,exitjudas,,1,8,4,12
14978,wmarcello,,1,114,126,240
14979,MSchmahl,,1,104,85,189
14980,eviladam,,1,1,1,2
14981,dangboi,,1,4,10,14
14982,captaink,,1,17,22,39
14983,jhrf,,1,8,6,14
14984,bdgr,,1,2,2,4
14985,wiccan333,,1,11,14,25
14986,josh42042,,1,4,9,13
14987,tjuric,,1,3,1,4
14988,PacoDG,,1,87,1,88
14989,vckt,,1,1,1,2
14990,mydyingdreams,,1,28,39,67
14991,bjornhallberg,,1,13,4,17
14992,gwn,,1,2,1,3
14993,Sippin40z,,1,2,4,6
14994,Pyroice04,,1,5,6,11
14995,otnug,,1,19,34,53
14996,sshannon,,1,5,6,11
14997,PeteMoss,,1,1,2,3
14998,elvenrunelord,,1,81,7,88
14999,HARTempire,,1,35,3,38
15000,Murkt,,1,1,7,8
15001,ehcolem,,1,204,202,406
15002,teskoner,,1,6,8,14
15003,johnwally54,,1,30,2,32
15004,locket42,,1,1,2,3
15005,kdeforche,,1,6,4,10
15006,glatisant,,1,7,14,21
15007,bad_llama,,1,639,717,1356
15008,alcan_100,,1,2,2,4
15009,lollapaulooza,,1,13,16,29
15010,N4X,,1,3,3,6
15011,mareacaspica,,1,262,28,290
15012,lucyd,,1,21,19,40
15013,omokoro,,1,3,2,5
15014,myfivelies,,1,70,121,191
15015,IhateRedditors,,1,1,1,2
15016,mongreloctopus,,1,7,13,20
15017,psionicman,,1,2,2,4
15018,clevername,,1,5,18,23
15019,ronoe0,,1,1,6,7
15020,visik7,,1,4,3,7
15021,lifeform,,1,5,6,11
15022,anamorphosis,,1,3,2,5
15023,anmol2k4,,1,134,178,312
15024,timclark,,1,75,29,104
15025,mario64,,1,32,33,65
15026,bigorangehippo,,1,3,4,7
15027,Magneon,,1,2,3,5
15028,Atheinostic,,1,748,258,1006
15029,skynxnex,,1,2,5,7
15030,sporksmith,,1,8,9,17
15031,rstanny,,1,6,6,12
15032,deathbychopsticks,,1,2,1,3
15033,mdipierro,,1,105,121,226
15034,flyernati,,1,24,13,37
15035,ephemerat,,1,6,18,24
15036,Raerth,,1,189,119,308
15037,Dreynsen,,1,1,5,6
15038,waxandwane,,1,34,81,115
15039,sgillies,,1,6,10,16
15040,priest,,1,33,28,61
15041,freeradical,,1,16,10,26
15042,great-pumpkin,,1,201,135,336
15043,kittish,,1,39,79,118
15044,Mediabalance,,1,2,1,3
15045,bhavi,,1,79,13,92
15046,hzuigq,,1,3,2,5
15047,onemadfool,,1,55,27,82
15048,sheasie,,1,13,8,21
15049,brianary,,1,90,91,181
15050,mentat,,1,81,95,176
15051,cdsmith,,1,143,158,301
15052,Fucknut,,1,49,43,92
15053,despirit,,1,150,168,318
15054,AndrewO,,1,27,50,77
15055,GeeWhiz2000,,1,6,7,13
15056,ginkster88,,1,5,3,8
15057,XTL,,1,29,34,63
15058,strazzerj,,1,69,99,168
15059,cafedude,,1,54,40,94
15060,wham,,1,2,4,6
15061,rsander,,1,40,13,53
15062,Slick42,,1,4,7,11
15063,ir8prim8,,1,49,23,72
15064,slackwalker,,1,35,36,71
15065,schleyfox,,1,17,18,35
15066,redlemon,,1,5,4,9
15067,d4r4ki4n,,1,4,7,11
15068,Bliumchik,,1,1,1,2
15069,PhagsRU,,1,1,7,8
15070,jason_w87,,1,103,183,286
15071,Barto246,,1,27,49,76
15072,fyl999,,1,22,22,44
15073,dep,,1,1,2,3
15074,xlxcigaroxlx,,1,9,1,10
15075,flaneur,,1,84,14,98
15076,Raoulmeister,,1,6,23,29
15077,mspang,,1,1,1,2
15078,asdf333,,1,34,45,79
15079,ottothebobcat,,1,1,1,2
15080,Wavicle,,1,245,330,575
15081,Sandkat,,1,2,9,11
15082,Abhorrence,,1,4,1,5
15083,FrankJov,,1,103,10,113
15084,mickrobk,,1,4,3,7
15085,AvailableName,,1,28,5,33
15086,acowno,,1,44,48,92
15087,Leinistar,,1,3,8,11
15088,tpyo,,1,4,17,21
15089,theg2,,1,130,162,292
15090,joaomc,,1,103,150,253
15091,fijal,,1,2,2,4
15092,chickenofthewoods,,1,68,205,273
15093,veri69e,,1,1,28,29
15094,truthseeker8,,1,1,1,2
15095,tkilgore,,1,4,3,7
15096,StinkyLetters,,1,6,3,9
15097,Cenobite,,1,39,63,102
15098,IHateCrocs,,1,21,24,45
15099,AntiStar,,1,1,4,5
15100,corkill,,1,451,381,832
15101,enry,,1,190,283,473
15102,bvm,,1,5,2,7
15103,intheoryiamworking,,1,63,67,130
15104,justinvh,,1,1,1,2
15105,Lx_Rogue,,1,2,9,11
15106,wopr,,1,1,3,4
15107,damnwhity,,1,17,53,70
15108,peterjoel,,1,1,1,2
15109,foonly,,1,531,1301,1832
15110,random393508375,,1,1,2,3
15111,kiwimonster,,1,195,156,351
15112,impiri,,1,83,92,175
15113,seymour85202,,1,2,2,4
15114,badgerken,,1,3,2,5
15115,youssef,,1,16,8,24
15116,Mooshiga,,1,88,123,211
15117,UofCstudent,,1,18,2,20
15118,BillyBoyJoy,,1,8,1,9
15119,bluto20,,1,6,7,13
15120,mozfan,,1,87,7,94
15121,qwidjibo,,1,2,4,6
15122,SirEdmund,,1,85,170,255
15123,option08,,1,241,102,343
15124,linuxlass,,1,517,778,1295
15125,mja333,,1,10,20,30
15126,crkota,,1,28,5,33
15127,aprelog,,1,11,1,12
15128,dfndoe,,1,190,162,352
15129,snb,,1,29,53,82
15130,Escapism,,1,1,3,4
15131,orlock,,1,2,11,13
15132,tbeanz,,1,181,304,485
15133,AndrewTerry,,1,11,5,16
15134,thegman,,1,1,2,3
15135,mycatverbs,,1,28,65,93
15136,JamesieAB,,1,2,3,5
15137,threedaymonk,,1,9,28,37
15138,frobots,,1,4,4,8
15139,judeofascism,,1,1,4,5
15140,tghw,,1,105,117,222
15141,akasan,,1,22,37,59
15142,RonnieRaygun,,1,32,53,85
15143,gwarmerdam,,1,1,1,2
15144,jmwilliams,,1,13,5,18
15145,ICantReadThis,,1,215,192,407
15146,waqsax,,1,5,1,6
15147,akitaonrails,,1,2,1,3
15148,confuseme,,1,25,10,35
15149,tarjan,,1,4,3,7
15150,ounfsfbosdfb,,1,79,125,204
15151,spatialmongrel,,1,6,3,9
15152,paulsteinway,,1,70,240,310
15153,linkbackproject,,1,35,16,51
15154,Juan0325,,1,1,2,3
15155,dtxBullet,,1,5,1,6
15156,josetavares,,1,66,52,118
15157,anexxus,,1,2,2,4
15158,harinath,,1,7,4,11
15159,trjames,,1,9,17,26
15160,jetcombo15,,1,64,104,168
15161,lldmer,,1,2,1,3
15162,acrim,,1,62,74,136
15163,GowdTeefs,,1,2,4,6
15164,zenchess,,1,15,29,44
15165,didroe,,1,254,330,584
15166,xen0cide,,1,2,1,3
15167,macholusitano,,1,20,21,41
15168,AJSmithy91,,1,7,4,11
15169,SaveOurSouls,,1,502,141,643
15170,Sickly404,,1,3,4,7
15171,pingwax,,1,25,25,50
15172,lilliwhite,,1,4,6,10
15173,Caper,,1,15,13,28
15174,meshko,,1,14,6,20
15175,uncannybuzzard,,1,12,12,24
15176,Thud,,1,25,18,43
15177,alistaircroll,,1,12,9,21
15178,nekidchickens,,1,2,2,4
15179,Thestormo,,1,83,122,205
15180,itstoobad,,1,3,6,9
15181,xiojqwnko,,1,1,1,2
15182,grandson39,,1,1,2,3
15183,Burnage,,1,77,79,156
15184,PixelatorOfTime,,1,30,52,82
15185,daphnl,,1,4,4,8
15186,WHERE_IS_THE_RAGE,,1,1,2,3
15187,byrule62,,1,6,3,9
15188,inspired1,,1,4,2,6
15189,byte1918,,1,67,103,170
15190,wandula,,1,3,3,6
15191,oakes,,1,50,44,94
15192,mgoflash,,1,1,3,4
15193,grandmclargehuge,,1,6,1,7
15194,Random_Redditor,,1,10,19,29
15195,Conservativepublican,,1,282,116,398
15196,DOGA,,1,986,2046,3032
15197,Shaper_pmp,,1,1172,1737,2909
15198,randomb0y,,1,2319,3296,5615
15199,TheGonzo,,1,81,186,267
15200,SamIWas,,1,10,4,14
15201,gomtuu123,,1,1,2,3
15202,mrplinko,,1,28,53,81
15203,rachael02,,1,24,37,61
15204,lokal,,1,1,5,6
15205,lexiticus,,1,4,7,11
15206,The_RePoster,,1,1,1,2
15207,ufh8rjhf,,1,2,5,7
15208,tdrusk,,1,26,22,48
15209,Nosher,,1,21,19,40
15210,KILL_YOURSELF,,1,1,3,4
15211,jwag57,,1,76,2,78
15212,jstraszheim,,1,4,3,7
15213,lovestofail,,1,37,46,83
15214,socketwiz,,1,7,9,16
15215,dogsbody,,1,9,2,11
15216,zan_shikai,,1,1,3,4
15217,FionaSarah,,1,351,530,881
15218,lzm,,1,52,45,97
15219,Tobblo,,1,4,1,5
15220,MosquitoXR13,,1,6,39,45
15221,MaddenedMan,,1,101,240,341
15222,astroheadzombie,,1,2,3,5
15223,MalachiConstant,,1,84,17,101
15224,cls2deg,,1,1,1,2
15225,yyme,,1,1,4,5
15226,bsterne,,1,3,13,16
15227,damageCTRL,,1,67,39,106
15228,niddleplexto,,1,1,2,3
15229,ivanpw,,1,51,1,52
15230,dex_paranoia,,1,26,27,53
15231,Establishment,,1,1,1,2
15232,ladymeg,,1,7,3,10
15233,myotheruserid,,1,16,15,31
15234,krypteia,,1,34,3,37
15235,pimpdown,,1,33,47,80
15236,gsxrman,,1,7,7,14
15237,alexcabrera,,1,1,1,2
15238,krafdkat,,1,15,31,46
15239,ahnunahki,,1,12,8,20
15240,NameSpaceCollision,,1,2,4,6
15241,Santito,,1,10,19,29
15242,tjw,,1,263,343,606
15243,Fat_Trevor,,1,1,1,2
15244,Hippo78,,1,4,3,7
15245,Locke005,,1,38,35,73
15246,chriszf13,,1,14,8,22
15247,rchase,,1,1,1,2
15248,huntercrimson,,1,4,1,5
15249,Glaeal,,1,8,19,27
15250,bmorlok,,1,43,67,110
15251,kilometer,,1,5,8,13
15252,lion22,,1,35,2,37
15253,gbdc01,,1,1,1,2
15254,BenPS,,1,8,7,15
15255,diamond9,,1,259,34,293
15256,zach_jdia,,1,184,118,302
15257,flaxeater,,1,220,335,555
15258,jerrysinful,,1,11,8,19
15259,mvsac,,1,2,4,6
15260,the_mgt,,1,16,17,33
15261,acgourley,,1,40,16,56
15262,velvus,,1,1,1,2
15263,walrusgumboot,,1,17,22,39
15264,GhostofGod,,1,7,9,16
15265,allthor,,1,8,2,10
15266,Gatecrasherc6,,1,20,27,47
15267,ModerateDbag,,1,1,11,12
15268,johnnyaardvark,,1,12,6,18
15269,esoterik,,1,185,64,249
15270,mrcow,,1,18,5,23
15271,PaperSkyline,,1,1,8,9
15272,tongue,,1,1,1,2
15273,grimitar,,1,45,10,55
15274,shinta9,,1,25,25,50
15275,LuvKrahft,,1,5,8,13
15276,Chandon,,1,168,236,404
15277,gurami,,1,2,5,7
15278,pist,,1,298,220,518
15279,frezzi,,1,2,1,3
15280,picklepete,,1,7,7,14
15281,NjoyDaSilence93,,1,1,1,2
15282,crumblenaut,,1,2,3,5
15283,dpark,,1,114,118,232
15284,radiofreeearth,,1,13,3,16
15285,chata8,,1,86,133,219
15286,Gorbama,,1,204,189,393
15287,sandyenglish,,1,70,7,77
15288,spaceghoti,,1,445,916,1361
15289,evad04,,1,1,1,2
15290,Deewiant,,1,47,58,105
15291,jhoelybabyblue,,3,1,1,2
15292,ISeriouslyDoubtIt,,1,1,5,6
15293,tertiary,,1,229,245,474
15294,csw,,1,28,9,37
15295,asereth,,1,4,7,11
15296,Phrodo_00,,1,80,135,215
15297,yuin,,1,1,1,2
15298,profpan,,1,34,32,66
15299,A-Jota,,1,3,4,7
15300,hypertor,,1,2,2,4
15301,thegeoffmeister,,1,6,9,15
15302,viggity,,1,16,13,29
15303,Resilience,,1,651,556,1207
15304,Adduc,,1,13,24,37
15305,l0rn,,1,8,13,21
15306,kopo27,,1,73,79,152
15307,blacking_out,,1,1,1,2
15308,nickisnt,,1,1,3,4
15309,guyincorporated,,1,6,13,19
15310,jplindstrom,,1,35,73,108
15311,gurudatt,,1,837,19,856
15312,urrtha,,1,5,5,10
15313,furiousc,,1,11,8,19
15314,Username314,,1,1,8,9
15315,muckraker,,1,1,1,2
15316,Jewmerica,,1,7,5,12
15317,notmyrealaccount,,1,2,2,4
15318,zeazzz,,1,20,1,21
15319,radbean,,1,3,3,6
15320,Alumman,,1,7,13,20
15321,shitfuck,,1,8,5,13
15322,apage43,,1,9,8,17
15323,kylemax,,1,28,20,48
15324,schokn,,1,16,10,26
15325,atsparagon,,1,1,2,3
15326,thaislump,,1,11,10,21
15327,TomaszD,,1,21,24,45
15328,warlock_05,,1,1,1,2
15329,ghost911,,1,9,6,15
15330,Awwdok,,1,1,1,2
15331,vaporgriffin,,1,6,7,13
15332,asmith1243,,1,45,2,47
15333,freedomfighter666,,1,4,1,5
15334,ezrastiles,,1,122,11,133
15335,karmasquirrel,,1,3,3,6
15336,theCorrectorator,,1,1,1,2
15337,carakor,,1,1,2,3
15338,NukeAMuslimForYHWH,,1,1,2,3
15339,ScantilyClad,,1,3,12,15
15340,otaku,,1,4,4,8
15341,TheSimkin,,1,13,10,23
15342,zodirento,,1,3,7,10
15343,Hybird21,,1,13,4,17
15344,Khawaga,,1,1,1,2
15345,aburton,,1,46,82,128
15346,whiskeysquared,,1,35,82,117
15347,ppcpunk,,1,17,18,35
15348,Thorts,,1,1,3,4
15349,green_gums,,1,1,1,2
15350,danielroundy,,1,2,2,4
15351,jjcwalker,,1,6,1,7
15352,ihaveapuma,,1,3,4,7
15353,mleonhard,,1,12,24,36
15354,corvidae,,1,3,4,7
15355,Cpt_Winterbottom,,1,1,1,2
15356,mbracken,,1,3,1,4
15357,loginator,,1,16,30,46
15358,frozu,,1,17,2,19
15359,tchen3,,1,30,5,35
15360,A_Smooth,,1,2,4,6
15361,pponso1,,1,22,28,50
15362,mercere99,,1,5,5,10
15363,CRUISECONTROLFORCOOL,,1,1,1,2
15364,sgtpepper,,1,255,269,524
15365,Slices,,1,3,5,8
15366,andrewkantor,,1,9,1,10
15367,johnboyer,,1,30,44,74
15368,marrip,,1,1,1,2
15369,A_Moose,,1,1,1,2
15370,the_other,,1,1,5,6
15371,Fran,,1,111,160,271
15372,firsthander,,1,3,3,6
15373,r888888888,,1,3,2,5
15374,reditttroll,,1,7,8,15
15375,gedden,,1,4,6,10
15376,toussaint,,1,6,9,15
15377,suricatta79,,1,14,33,47
15378,CoconutPete,,1,30,32,62
15379,summary,,1,2,4,6
15380,WildYams,,1,40,57,97
15381,dhull,,1,18,2,20
15382,lamontredditthethird,,1,216,281,497
15383,turdpusher,,1,1,1,2
15384,peyton,,1,2,3,5
15385,awsaws,,1,4,7,11
15386,hilzfuld,,1,2,1,3
15387,race_traitor,,1,8,8,16
15388,reddit_user13,,1,1115,1940,3055
15389,veggiedog,,1,4,2,6
15390,aldenhg,,1,473,564,1037
15391,g27radio,,1,4,4,8
15392,BMeph,,1,2,6,8
15393,maple-syrup,,1,19,24,43
15394,Kanye_West,,1,1,1,2
15395,AlpT,,1,2,3,5
15396,vay,,1,2,1,3
15397,Courtie,,1,1,1,2
15398,Amdijefri,,1,110,30,140
15399,way_instain_mother,,1,1,3,4
15400,riotgrrl421,,1,1,5,6
15401,blingmaster,,1,4,3,7
15402,ifatree,,1,241,477,718
15403,myeye,,1,1,1,2
15404,Haga,,1,4,2,6
15405,isleshocky,,1,98,88,186
15406,jarvis400,,1,166,373,539
15407,mmac,,1,1,1,2
15408,vocoder,,1,3,1,4
15409,SnakeO,,1,23,19,42
15410,ogos,,1,1,2,3
15411,fusiat,,1,7,8,15
15412,math20,,1,11,10,21
15413,CyberSkull,,1,27,2,29
15414,thenewgray,,1,2,11,13
15415,freejack,,1,9,2,11
15416,oznob,,1,3,4,7
15417,youremyjuliet,,1,294,288,582
15418,BobII,,1,2,1,3
15419,emil-63,,1,1,1,2
15420,babybearishungry,,1,1,1,2
15421,sberan,,1,18,26,44
15422,c00pa,,1,5,3,8
15423,wiredfu,,1,3,11,14
15424,zed857,,1,101,107,208
15425,xdrone,,1,3,4,7
15426,univerio,,1,92,149,241
15427,chags,,1,36,96,132
15428,dzhezus,,1,36,73,109
15429,pierluc,,1,9,21,30
15430,tomchuk,,1,2,2,4
15431,spurton,,1,20,8,28
15432,paulydavis,,1,11,23,34
15433,BjornSlippy,,1,247,420,667
15434,voidv2,,1,1,2,3
15435,Chuck-Norris,,1,7,8,15
15436,barnaclebill,,1,3,4,7
15437,Urbatect,,1,128,271,399
15438,GrammarJew,,1,7,16,23
15439,obamawins,,1,7,4,11
15440,77or88,,1,1,1,2
15441,wccarrington,,1,21,20,41
15442,revicon,,1,2,2,4
15443,tbthomps,,1,57,33,90
15444,mystikraven,,1,6,10,16
15445,RightWing,,1,13,32,45
15446,LiberalHippies10,,1,10,8,18
15447,MikeRT,,1,11,12,23
15448,sarahsynonymous,,1,2,2,4
15449,Reso,,1,26,29,55
15450,ozmotion,,1,65,66,131
15451,AnarchoCapitalist,,1,51,49,100
15452,dacoatne,,1,31,6,37
15453,imaweirdo,,1,37,66,103
15454,AllLiquid,,1,25,39,64
15455,SonOfAJudge,,1,1,1,2
15456,kobyk,,1,5,1,6
15457,kingkilr,,1,504,681,1185
15458,Derelict,,1,9,9,18
15459,otakucode,,1,2283,3027,5310
15460,thunderbay-expat,,1,2,1,3
15461,JeromeB,,1,3,12,15
15462,qquicksilver,,1,269,307,576
15463,adjc,,1,1,1,2
15464,strangerzero,,1,63,152,215
15465,idynkydnk,,1,5,11,16
15466,zora,,1,1,2,3
15467,dent424,,1,19,4,23
15468,silent719,,1,7,4,11
15469,passwordiswordpass,,1,5,5,10
15470,Drebin,,1,1,1,2
15471,Wilfried,,1,1,1,2
15472,kazzyD,,1,130,15,145
15473,roadtripgirl,,1,1,5,6
15474,zeker,,1,59,40,99
15475,TeamZissou,,1,40,64,104
15476,quink,,1,270,341,611
15477,rmassart,,1,1,1,2
15478,Hufnagel,,1,52,81,133
15479,mdarnton,,1,9,7,16
15480,lowerdown,,1,188,207,395
15481,comety,,1,21,14,35
15482,Gunson,,1,16,1,17
15483,rankible,,1,1,1,2
15484,crckr,,1,1,1,2
15485,Rhomboid,,1,3,2,5
15486,pokerface,,1,4,9,13
15487,hanten,,1,2,1,3
15488,snarfy,,1,137,158,295
15489,opiii,,1,2,2,4
15490,pquoi,,1,8,4,12
15491,taner7812,,1,30,5,35
15492,penisland,,1,12,1,13
15493,ZachPruckowski,,1,16,22,38
15494,collintmiller,,1,2,2,4
15495,smeg_head,,1,2,4,6
15496,chiggeybean,,1,10,8,18
15497,Undermined,,1,6,6,12
15498,jarrodtrainque,,1,9,4,13
15499,schwann,,1,1,1,2
15500,sc71,,1,1,1,2
15501,gcalpo,,1,172,333,505
15502,reddista3,,1,1,2,3
15503,causticmango,,1,9,15,24
15504,Schpariel,,1,24,25,49
15505,vondelpark420,,1,7,5,12
15506,jvciv3,,1,32,50,82
15507,Whatsisname,,1,1,14,15
15508,binstock,,1,1,1,2
15509,gl0bals0j0urner,,1,9,21,30
15510,raresilk9,,1,136,206,342
15511,trigo,,1,1,2,3
15512,harmreduction,,1,1,1,2
15513,l1lll,,1,2,5,7
15514,facezappa,,1,17,7,24
15515,uptwolait,,1,16,61,77
15516,Tokugawa,,1,506,515,1021
15517,mastadonstomping,,1,3,5,8
15518,abaddon1125,,1,42,66,108
15519,ffi,,1,1,1,2
15520,uglor,,1,103,7,110
15521,eyespypro,,1,2,6,8
15522,TheOne11,,1,1,1,2
15523,slorenzo,,1,1,1,2
15524,thedeadparrot,,1,1,1,2
15525,eulogious,,1,1,3,4
15526,moonshn,,1,19,20,39
15527,regnadkcin,,1,2,6,8
15528,buckwilson,,1,15,28,43
15529,____,,1,16,30,46
15530,sw32,,1,8,10,18
15531,deterak1,,1,1,3,4
15532,mookst3r,,1,5,4,9
15533,spectrus,,1,6,2,8
15534,beatyatoit,,1,1,5,6
15535,rafuzo2,,1,463,577,1040
15536,nitram9,,1,3,2,5
15537,devicenull,,1,1,1,2
15538,DaRabidDuckie,,1,6,8,14
15539,superrationalist,,1,22,17,39
15540,reprobation,,1,1,4,5
15541,tylerdmace,,1,160,290,450
15542,timlol,,1,2,2,4
15543,quixote_arg,,1,3,2,5
15544,rascalnet,,1,1,1,2
15545,mega,,1,2,3,5
15546,The_If,,1,149,347,496
15547,paganize,,1,142,183,325
15548,dj3strikes,,1,67,1,68
15549,narr,,1,2,1,3
15550,ham1,,1,5,7,12
15551,Avantcore,,1,8,10,18
15552,littlebuddha2004,,1,427,17,444
15553,marmalito,,1,1,1,2
15554,outsiderplay,,1,128,24,152
15555,sportz103,,1,2,3,5
15556,wishninja,,1,2,1,3
15557,moginspace,,1,61,91,152
15558,BooshPilot,,1,2,3,5
15559,VersusGod,,1,10,13,23
15560,Epistemologist,,1,62,108,170
15561,sieb,,1,2,7,9
15562,inventor2010,,1,23,54,77
15563,banden,,1,2,4,6
15564,ansigt,,1,1,3,4
15565,cbg,,1,50,47,97
15566,pseale,,1,8,17,25
15567,drdan78,,1,1,2,3
15568,ryan101,,1,6,2,8
15569,senfood,,1,6,7,13
15570,fishpi,,1,5,2,7
15571,delta5,,1,1,1,2
15572,So_Fresh,,1,3,8,11
15573,bobbyi,,1,276,487,763
15574,AtomicCow,,1,1,2,3
15575,skulltula,,1,18,10,28
15576,NoYou,,1,32,15,47
15577,imbaczek,,1,223,323,546
15578,niktavalos,,1,63,102,165
15579,MaFibOsheth,,1,1,1,2
15580,cr0s1s,,1,2,2,4
15581,epdx,,1,66,130,196
15582,silent3,,1,2,3,5
15583,quoderat,,1,10,10,20
15584,ghotibait,,1,1,1,2
15585,osmenl,,1,1,1,2
15586,thoaCrl4,,1,1,3,4
15587,jimmyfreddy,,1,20,10,30
15588,FcukingThingSucks,,1,10,29,39
15589,youmissedthepoint,,1,24,32,56
15590,edzillion,,1,71,100,171
15591,okpgreg,,1,6,7,13
15592,inthefade,,1,4,7,11
15593,vanjulio,,1,4,12,16
15594,davidrools,,1,10,16,26
15595,dujek,,1,4,4,8
15596,assram,,1,24,13,37
15597,katto,,1,11,9,20
15598,funkytimes,,1,55,59,114
15599,cdny,,1,3,1,4
15600,mediumblack,,1,2,2,4
15601,interalia,,1,48,34,82
15602,FrenchPrince,,1,2,1,3
15603,antonjenkins,,1,4,4,8
15604,Nodatilu,,1,87,1,88
15605,MattJayP,,1,87,63,150
15606,murki,,1,14,17,31
15607,queerunity,,1,136,10,146
15608,canuckistani,,1,93,82,175
15609,andyeff,,1,14,4,18
15610,flanged,,1,2,1,3
15611,justsomedood,,1,82,71,153
15612,verifex,,1,34,34,68
15613,rayx,,1,273,130,403
15614,space1999,,1,149,150,299
15615,mig174,,1,313,348,661
15616,mshoe,,1,1,1,2
15617,AmosYoder,,1,23,21,44
15618,eton,,1,34,15,49
15619,megamiyawn,,1,7,7,14
15620,andrea-janine,,1,3,5,8
15621,holypumpkins,,1,9,5,14
15622,len69,,1,159,229,388
15623,LuxOFlux,,1,61,193,254
15624,usicafterglow,,1,72,19,91
15625,potatoe,,1,9,26,35
15626,PowerPill,,1,3,1,4
15627,jcolman,,1,70,36,106
15628,jmzachary,,1,7,4,11
15629,jawngee,,1,15,18,33
15630,TrollsSuck,,1,14,20,34
15631,TheKorn,,1,158,225,383
15632,polarbear2,,1,3,1,4
15633,NovaProspekt,,1,32,28,60
15634,bobdole,,1,2,1,3
15635,piratepanties,,1,6,10,16
15636,ratbear,,1,47,85,132
15637,njhbftd567yu,,1,2,1,3
15638,creysoft,,1,6,8,14
15639,flapcats,,1,15,31,46
15640,wooosh,,1,8,6,14
15641,rpeters,,1,2,3,5
15642,bumpinthosebeats,,1,5,4,9
15643,eugenianus,,1,3,4,7
15644,Karmaa,,1,41,6,47
15645,Briney_Spears,,1,18,25,43
15646,mr420,,1,107,159,266
15647,shmooth,,1,1,7,8
15648,policestateterrorism,,1,5,2,7
15649,bigandyuk,,1,4,1,5
15650,EvolutionTheory,,1,9,20,29
15651,kkks,,1,21,8,29
15652,marcog,,1,85,13,98
15653,michaeljsmalley,,1,32,46,78
15654,cairnsa,,1,1,1,2
15655,dansherman,,1,2,1,3
15656,annainpajamas,,1,1,1,2
15657,debbie_debater,,1,2,1,3
15658,japowl,,1,10,9,19
15659,frankichiro,,1,31,16,47
15660,cskaryd,,1,13,20,33
15661,yellowstuff,,1,87,81,168
15662,Guairdean,,1,2,2,4
15663,knappz,,1,36,77,113
15664,gumbril,,1,2,4,6
15665,WooHooFirst,,1,2,4,6
15666,obamabatmitsfa,,1,3,15,18
15667,whywhywhy,,1,33,67,100
15668,deadzebra,,1,31,6,37
15669,stringparts,,1,28,4,32
15670,08734152,,1,1,3,4
15671,colanderman,,1,36,51,87
15672,deafsound,,1,57,70,127
15673,thewupka,,1,9,4,13
15674,kreihst,,1,18,43,61
15675,nandemoari,,1,38,1,39
15676,ubermu,,1,27,35,62
15677,adremeaux,,1,768,905,1673
15678,handschristian,,1,7,6,13
15679,2_of_8,,1,54,59,113
15680,pastafaria,,1,83,141,224
15681,dillmunch3d,,1,60,135,195
15682,MrHaHaHaaaa,,1,23,55,78
15683,BELAZER,,1,6,22,28
15684,Eigard,,1,27,2,29
15685,mrwabu,,1,5,7,12
15686,synaestring,,1,27,49,76
15687,cunningjames,,1,209,269,478
15688,killian35,,1,2,9,11
15689,jimofwales,,1,32,17,49
15690,snakehunter17,,1,1,2,3
15691,lowtechmagazine,,1,1,1,2
15692,FadieZ,,1,45,67,112
15693,duhblow7,,1,242,380,622
15694,thoughto,,1,6,7,13
15695,LeftFairDotCom,,1,3,2,5
15696,Irioth,,1,5,6,11
15697,eungyu,,1,3,1,4
15698,Cereo,,1,9,11,20
15699,jamesatracy,,1,152,25,177
15700,Homeoftheben,,1,2,2,4
15701,horseloverfat,,1,78,47,125
15702,RedditIsAnInsideJob,,1,4,2,6
15703,BetiBeti,,1,1,2,3
15704,schleppy,,1,7,9,16
15705,IamBatman,,1,1,1,2
15706,rontothelight,,1,1,1,2
15707,jeremyis,,1,5,2,7
15708,HiyooyiH,,1,13,27,40
15709,gavtar,,1,4,7,11
15710,knomknomknom,,1,1,1,2
15711,mightychicken,,1,21,22,43
15712,chall85,,1,752,444,1196
15713,politicalfan08,,1,21,2,23
15714,muttleee,,1,59,28,87
15715,l0lwut,,1,3,10,13
15716,RuarriS,,1,11,14,25
15717,vardyr,,1,14,23,37
15718,johndango,,1,84,56,140
15719,dudeznothappy,,1,5,3,8
15720,joefukinsixpack,,1,19,31,50
15721,nickesson,,1,137,131,268
15722,davidcrookes,,1,1,1,2
15723,lolkittah,,1,3,9,12
15724,ibetstewarthasabigD,,1,1,1,2
15725,lan3y,,1,1,2,3
15726,mathmojo,,1,6,6,12
15727,rabidlizzy,,1,6,9,15
15728,matthendrix,,1,43,48,91
15729,ilikesboobs,,1,10,7,17
15730,RubyisRails,,1,41,47,88
15731,Tobicles,,1,20,52,72
15732,sciolizer,,1,118,90,208
15733,hwaara,,1,1,2,3
15734,blatta,,1,2,1,3
15735,zizzerzazus,,1,3,11,14
15736,ihateyouall,,1,4,6,10
15737,dogwatchinghdtv,,1,12,18,30
15738,habitue,,1,14,17,31
15739,ManaSmoker,,1,209,201,410
15740,edgan,,1,1,2,3
15741,trenchy,,1,6,3,9
15742,ConfuciusDamnIt,,1,1,1,2
15743,dantaeos,,1,1,3,4
15744,finalcut,,1,35,53,88
15745,rkalajian,,1,3,2,5
15746,ReligiousTurd,,1,6,26,32
15747,dougfelt,,1,1,1,2
15748,terrilldent,,1,1,2,3
15749,gnz,,1,7,20,27
15750,bricksandwind0ws,,1,23,49,72
15751,ofimmsl,,1,4,4,8
15752,heretikdclxvi,,1,1,1,2
15753,amerikaisfrii,,1,1,1,2
15754,tangled,,1,524,548,1072
15755,futatorius,,1,152,289,441
15756,settrans,,1,15,16,31
15757,sjraptor,,1,2,3,5
15758,sckpppt,,1,1,1,2
15759,NewAurora,,1,3,7,10
15760,OryTheSaint,,1,2,7,9
15761,d_lay123,,1,66,95,161
15762,signalfirerock,,1,1,1,2
15763,fredgrigg,,1,3,5,8
15764,residentwork,,1,11,30,41
15765,cozzyd,,1,9,16,25
15766,mdg09,,1,22,1,23
15767,franksands,,1,3,5,8
15768,dse,,1,38,37,75
15769,thethb,,1,1,1,2
15770,azanar,,1,14,19,33
15771,Lhall2008,,1,1,1,2
15772,F_C,,1,15,14,29
15773,gnome94,,1,114,28,142
15774,ziv_TA,,1,15,20,35
15775,CAPTAlN_OBVIOUS,,1,82,117,199
15776,ChickenFriedTroll,,1,31,41,72
15777,Kelvin,,1,11,32,43
15778,iq9,,1,13,9,22
15779,abenton,,1,1,1,2
15780,canthony,,1,26,19,45
15781,Dyken,,1,1,2,3
15782,passwordispassword1,,1,1,3,4
15783,keithobambertman,,1,43,38,81
15784,strentax,,1,109,99,208
15785,johnry07,,1,38,39,77
15786,remiserg,,1,1,1,2
15787,windynights,,1,850,1159,2009
15788,MrSane,,1,3,10,13
15789,Korben82,,1,30,53,83
15790,DyceFreak,,1,6,10,16
15791,lowlyGiant,,1,3,1,4
15792,weezierocks,,1,1,2,3
15793,shepheb,,1,1,1,2
15794,cthouse13,,1,7,2,9
15795,jwstaddo2,,1,23,16,39
15796,gina_g,,1,3,1,4
15797,loadmoarcomments,,1,1,3,4
15798,9jack9,,1,469,368,837
15799,keyj63,,1,46,9,55
15800,LASERGangsta,,1,3,5,8
15801,acegibson,,1,107,190,297
15802,NineDeuce,,1,3,5,8
15803,josephmotha,,1,2,5,7
15804,dimacq,,1,12,6,18
15805,Iconical,,1,1,3,4
15806,adjei7,,1,108,79,187
15807,timshead,,1,41,18,59
15808,Dinkerdoo,,1,1,5,6
15809,Ugly_Pete,,1,7,8,15
15810,frasoftw,,1,29,59,88
15811,unperson,,1,1,2,3
15812,dicey,,1,694,620,1314
15813,savagecat,,1,130,273,403
15814,creativeembassy,,1,43,24,67
15815,uvdiv,,1,2,2,4
15816,charloBravie,,1,7,12,19
15817,RCDL,,1,12,3,15
15818,odoylerulez,,1,2,2,4
15819,cheska21,,1,3,1,4
15820,Brochtrup,,1,162,8,170
15821,doken,,1,6,7,13
15822,mcdg,,1,112,201,313
15823,buu700,,1,359,565,924
15824,tomakin1217,,1,1,2,3
15825,MarquisdeBad,,1,141,176,317
15826,gentlemen,,1,18,20,38
15827,freefood,,1,3,5,8
15828,katerose26,,1,559,124,683
15829,mgalvin,,1,59,70,129
15830,piracy,,1,14,12,26
15831,Phranqlin,,1,31,20,51
15832,adambrewster,,1,11,6,17
15833,cookier35,,1,1,1,2
15834,paja1954,,1,1,1,2
15835,d0k,,1,1,4,5
15836,p1dbull,,1,22,32,54
15837,ameancupoftea,,1,2,5,7
15838,namemanresu,,1,12,16,28
15839,themoshez,,1,33,6,39
15840,Johnny_Weeks,,1,1,1,2
15841,barsae,,1,1,6,7
15842,nothingWrong,,1,1,1,2
15843,p1r4nh4,,1,39,23,62
15844,chiaolun,,1,8,13,21
15845,ReallyStoned,,1,4,1,5
15846,JimmyLeach,,1,14,1,15
15847,albinoth,,1,1,2,3
15848,jewbacca,,1,16,6,22
15849,ymagynatyf,,1,1,3,4
15850,cct,,1,14,9,23
15851,a_calder,,1,1,1,2
15852,caspper69,,1,1,1,2
15853,dosed,,1,46,74,120
15854,albinofrenchy,,1,318,397,715
15855,mrnoir,,1,16,15,31
15856,NoIWillNot,,1,4,40,44
15857,skydaddy,,1,9,8,17
15858,madenvoy,,1,29,41,70
15859,spud438,,1,107,7,114
15860,stelriah,,1,9,16,25
15861,fidoburger,,1,2,10,12
15862,Trendy2,,1,8,10,18
15863,GlennLThompson,,1,1,3,4
15864,cheebmonger,,1,50,22,72
15865,REBELinBLUE,,1,13,14,27
15866,limpet,,1,8,23,31
15867,slowdive,,1,508,13,521
15868,vintagegatos,,1,1,1,2
15869,Deniol,,1,26,1,27
15870,PlenoJure,,1,2,2,4
15871,gandhiofdoom,,1,10,16,26
15872,jrohila,,1,147,145,292
15873,Chr1831,,1,3,5,8
15874,skyshock21,,1,66,126,192
15875,schoolhard,,1,7,7,14
15876,canadianking,,1,1,13,14
15877,Xineph,,1,1,2,3
15878,astrocry,,1,1,2,3
15879,shekmalhen,,1,69,121,190
15880,sherina,,1,22,5,27
15881,x-cubed,,1,3,4,7
15882,dustinbrewer,,1,32,6,38
15883,altano,,1,45,26,71
15884,Emarpi,,1,1,3,4
15885,tylerni7,,1,20,20,40
15886,myared,,1,6,3,9
15887,dzitam,,1,4,2,6
15888,fbru02,,1,63,61,124
15889,mschaef,,1,322,519,841
15890,Jody_Imus_Rules,,1,1,1,2
15891,dontforgetcarlos,,1,1,1,2
15892,beero,,1,170,258,428
15893,harm064,,1,6,19,25
15894,delrinian,,1,7,2,9
15895,digiphaze,,1,95,122,217
15896,BlackSquirrel,,1,215,274,489
15897,almery,,1,2,3,5
15898,_Pedobear_,,1,2,1,3
15899,daerana,,1,2,4,6
15900,lesbiatopia,,1,3,1,4
15901,flandersuea,,1,1,2,3
15902,Tal71,,1,1,2,3
15903,msheyw37,,1,36,46,82
15904,DiarrheaMonkey,,1,155,351,506
15905,abdelazer,,1,13,24,37
15906,88p,,1,19,16,35
15907,Junckaroo,,1,21,45,66
15908,predigested,,1,7,3,10
15909,GaxLover,,1,3,7,10
15910,GenericUserName,,1,39,31,70
15911,defacedcreation,,1,16,3,19
15912,Daleo,,1,19,38,57
15913,ohno,,1,270,383,653
15914,mightybyte,,1,30,5,35
15915,ozziegt,,1,37,29,66
15916,pursatrat,,1,11,13,24
15917,dchurch0,,1,4,2,6
15918,unsigned,,1,77,37,114
15919,uninformative,,1,1,1,2
15920,robinthehood,,1,291,394,685
15921,astrallab,,1,1,1,2
15922,RedHawk,,1,1,2,3
15923,snargle,,1,3,9,12
15924,OhReelee,,1,1,1,2
15925,raustin,,1,7,7,14
15926,elbagerena,,1,3,1,4
15927,voracious_id,,1,1,4,5
15928,Imbob,,1,2,7,9
15929,brelson,,1,28,19,47
15930,Aanidaani,,1,3,4,7
15931,carc,,1,28,22,50
15932,chrishan,,1,1,2,3
15933,lolcat_scratch_fever,,1,5,2,7
15934,dogster,,1,9,1,10
15935,cryptid,,1,463,8,471
15936,DocBaker69,,1,18,27,45
15937,rek,,1,527,792,1319
15938,bms42,,1,21,19,40
15939,sambeatty,,1,4,3,7
15940,girlxgenius,,1,33,77,110
15941,BryceW,,1,16,27,43
15942,freeradical97,,1,54,81,135
15943,55ten,,1,48,13,61
15944,agnokapathetic,,1,26,37,63
15945,Smock511,,1,6,2,8
15946,bhagany,,1,200,288,488
15947,friism,,1,5,1,6
15948,tophatstuff,,1,121,146,267
15949,margeriedrinkwater,,1,1,5,6
15950,Haggismaximus,,1,15,8,23
15951,absconditus,,1,26,35,61
15952,jkga,,1,16,8,24
15953,dabombnl,,1,66,124,190
15954,ichor,,1,10,13,23
15955,simplekismet,,1,4,3,7
15956,ericsink,,1,23,14,37
15957,lolmancologne,,1,3,9,12
15958,ultramega,,1,1,1,2
15959,ahdn,,1,7,14,21
15960,gordonlovesgordon,,1,18,26,44
15961,xhandler,,1,86,123,209
15962,trevordtodd,,1,2,1,3
15963,jayktar,,1,1,3,4
15964,JackPlant,,1,1,1,2
15965,arrowoftime,,1,232,163,395
15966,pacifiedcitizen,,1,7,18,25
15967,waffleninja,,1,205,345,550
15968,kawarazu,,1,40,48,88
15969,kromlic,,1,171,278,449
15970,TheMiddle,,1,3,8,11
15971,petrochrist,,1,28,5,33
15972,Lobosch,,1,4,6,10
15973,Ludovico,,1,2,5,7
15974,adam_von_indypants,,1,13,13,26
15975,somazx,,1,22,39,61
15976,brash,,1,8,8,16
15977,andykcom,,1,14,4,18
15978,LisPark,,1,7,1,8
15979,donio,,1,25,29,54
15980,Kafteinn,,1,1,1,2
15981,squashai,,1,140,97,237
15982,mindependent,,1,2,4,6
15983,dwwatk01,,1,16,15,31
15984,SlowDown,,1,4,4,8
15985,vexeffect,,1,17,24,41
15986,ZildjianLudwig,,1,24,3,27
15987,Nietecht,,1,4,4,8
15988,maydayusa,,1,4,31,35
15989,BrainTwinkey,,1,52,4,56
15990,sypavion,,1,1,1,2
15991,feckya,,1,6,3,9
15992,snowforts,,1,2,3,5
15993,PopeRalphIV,,1,7,10,17
15994,greggh,,1,1,1,2
15995,firemillen2,,1,10,5,15
15996,TheGrammarCommie,,1,1,1,2
15997,lowrentkicker,,1,1,4,5
15998,tjskydive,,1,39,31,70
15999,misterlang,,1,9,12,21
16000,anon_troll,,1,4,3,7
16001,camotito,,1,16,21,37
16002,excite_bike,,1,1,2,3
16003,sgclarke,,1,2,1,3
16004,dazmax,,1,57,55,112
16005,marley88,,1,16,4,20
16006,Shaman666,,1,25,63,88
16007,wolfos,,1,13,11,24
16008,rubicon_crossed,,1,2,3,5
16009,seafowl,,1,1,1,2
16010,dasstrooper,,1,480,722,1202
16011,lucidguru,,1,111,34,145
16012,mrdevin,,1,1,1,2
16013,davemcdave,,1,1,1,2
16014,maaz,,1,494,223,717
16015,ecombatant,,1,15,8,23
16016,robert2734,,1,4,15,19
16017,kangas,,1,1,1,2
16018,onisamsha,,1,2,1,3
16019,tttppp,,1,1,2,3
16020,get_a_brain_moran,,1,3,3,6
16021,mikerouse,,1,1,3,4
16022,lhmathys,,1,7,5,12
16023,jcypher,,1,8,10,18
16024,CamelTap,,1,116,8,124
16025,chikkensoop,,1,2,3,5
16026,pliu22,,1,29,28,57
16027,opix,,1,1,1,2
16028,retired_raganwald,,1,4,2,6
16029,herval,,1,2,1,3
16030,BigDumbMoron,,1,7,2,9
16031,RichardPeterJohnson,,1,552,796,1348
16032,JonFugeEverybody,,1,50,52,102
16033,angry_guy,,1,3,8,11
16034,MeanFoo,,1,7,19,26
16035,bigdadro,,1,2,1,3
16036,male_salmon,,1,5,3,8
16037,MrTibbs,,1,2,1,3
16038,questionmark,,1,351,400,751
16039,yeahyeahyeahyeah,,1,97,198,295
16040,waful,,1,26,58,84
16041,Trogdor66,,1,3,3,6
16042,fandiddy,,1,1,1,2
16043,JoKerHill,,1,26,9,35
16044,cedars,,1,16,25,41
16045,sosoez,,1,129,95,224
16046,CyphirX,,1,11,31,42
16047,falc0n2600,,1,20,3,23
16048,Stabback,,1,95,113,208
16049,shadowplay,,1,1,5,6
16050,wilsonics,,1,1,5,6
16051,dangerfan,,1,10,7,17
16052,LordHelmet,,1,7,5,12
16053,GiveYouBadPun,,1,6,26,32
16054,eoinmadden,,1,61,73,134
16055,billy24,,1,2,1,3
16056,jessiecafe,,1,2,1,3
16057,chochazel,,1,11,14,25
16058,asamorris,,1,21,41,62
16059,evrosl,,1,32,29,61
16060,OldBoots,,1,1,5,6
16061,draketherake,,1,28,5,33
16062,cjlesh,,1,2,2,4
16063,mwcraig,,1,4,2,6
16064,mikepaco,,1,71,106,177
16065,williamsburgnerd,,1,7,4,11
16066,emn13,,1,1,1,2
16067,ttyy,,1,15,19,34
16068,eelaws,,1,222,233,455
16069,newspower,,1,2,2,4
16070,JoeCracker,,1,22,43,65
16071,flatlander30,,1,18,14,32
16072,dcrapier,,1,1,2,3
16073,paulshannon,,1,98,63,161
16074,Gormogon,,1,9,21,30
16075,OminousG,,1,2,1,3
16076,DrDooom,,1,1,1,2
16077,jedankitty,,1,64,7,71
16078,simon1,,1,7,9,16
16079,6degreesbranding,,1,2,1,3
16080,clearly,,1,27,20,47
16081,reallifepixel,,1,278,126,404
16082,Obama_Why_No_Flagpin,,1,18,28,46
16083,Bascome,,1,188,264,452
16084,m741,,1,3,4,7
16085,brio1337,,1,11,8,19
16086,thires,,1,4,5,9
16087,allstar22,,1,403,51,454
16088,tygergolf,,1,7,7,14
16089,peacebob,,1,616,36,652
16090,intranets,,1,1,1,2
16091,ddipaolo,,1,40,39,79
16092,gh0st32,,1,257,290,547
16093,periwinkles,,1,3,4,7
16094,olshfski,,1,13,13,26
16095,optimis344,,1,9,10,19
16096,marks1,,1,1,1,2
16097,kunia,,1,1,1,2
16098,falingodingo,,1,1,5,6
16099,besonen,,1,3,3,6
16100,bigbengb,,1,13,7,20
16101,TimmyCracKorn,,1,111,2,113
16102,sleepy_emoticon,,1,1,1,2
16103,cirra,,1,3,7,10
16104,shentou,,1,2,1,3
16105,esquire_rsa,,1,96,122,218
16106,ririd,,1,5,7,12
16107,bsiviglia9,,1,868,1300,2168
16108,Selenolycus,,1,72,72,144
16109,Daemoncoder,,1,4,7,11
16110,caudicus,,1,13,4,17
16111,badbadman2,,1,246,228,474
16112,o0bluewater0o,,1,33,47,80
16113,nubesauce,,1,2,1,3
16114,davorg,,1,4,3,7
16115,dacjames,,1,1,1,2
16116,StupidObamaSupporter,,1,1,2,3
16117,Magical_Trevor,,1,22,34,56
16118,michdoch,,1,3,3,6
16119,Wewento,,1,12,14,26
16120,arturo227,,1,28,34,62
16121,randy9876,,1,291,391,682
16122,dingleberry_gary,,1,41,48,89
16123,nubi78,,1,30,26,56
16124,PateraSilk,,1,3,5,8
16125,dmunro,,1,8,2,10
16126,Vaerok,,1,25,17,42
16127,jackson8,,1,4,2,6
16128,ellingthepirate,,1,6,15,21
16129,lemonjello,,1,11,15,26
16130,QWERTYmustDie,,1,3,1,4
16131,newtonic83,,1,3,21,24
16132,The_Oblivious,,1,1,1,2
16133,rstevenson,,1,82,8,90
16134,LordyLordyGeordie,,1,23,7,30
16135,joshwoodward,,1,3,3,6
16136,xfiles,,1,1,3,4
16137,mastercockblocker,,1,4,3,7
16138,maatc,,1,1,1,2
16139,stoertebeker,,1,29,44,73
16140,gdienahrt,,1,67,2,69
16141,aaronp,,1,15,4,19
16142,cyanobyte,,1,8,5,13
16143,hilaricat,,1,1,2,3
16144,ander501,,1,2,2,4
16145,sleming,,1,3,8,11
16146,Redivivus,,1,1,6,7
16147,Kibatsu,,1,12,9,21
16148,euphoria,,1,2,3,5
16149,dfaskflhaiu234ry89er,,1,4,14,18
16150,ataraxian,,1,17,14,31
16151,Shrill,,1,1,2,3
16152,solstice680,,1,7,12,19
16153,flostre,,1,68,108,176
16154,XanKiran,,1,1,2,3
16155,bmathieu,,1,18,1,19
16156,wheeloofah,,1,119,170,289
16157,sema4,,1,1,1,2
16158,dodicula,,1,79,124,203
16159,Skavenblight,,1,249,248,497
16160,CraigTorso,,1,285,451,736
16161,PermanentDamage,,1,3,4,7
16162,mykezebb,,1,10,1,11
16163,killyourfm,,1,6,4,10
16164,SpicyTacos,,1,77,122,199
16165,jamesallen74,,1,295,174,469
16166,acinonys,,1,6,15,21
16167,oceanographer,,1,8,20,28
16168,ninex,,1,1,1,2
16169,wizbor,,1,38,43,81
16170,stegodone,,1,1,5,6
16171,davehansen,,1,4,10,14
16172,astromanbearpig,,1,1,1,2
16173,patrician,,1,3,2,5
16174,adfdsfas,,1,1,1,2
16175,redhatcat,,1,15,34,49
16176,shaft0rz,,1,10,16,26
16177,dukephoenix,,1,4,15,19
16178,9398348,,1,2,1,3
16179,fallingbrick,,1,1,4,5
16180,hotredditaction,,1,95,90,185
16181,sigh,,1,49,55,104
16182,Asekigal,,1,1,2,3
16183,junaman,,1,17,7,24
16184,urlwolf,,1,5,3,8
16185,hopeless_case,,1,170,287,457
16186,f00sion,,1,23,33,56
16187,vahan,,1,2,1,3
16188,tkdguy,,1,18,27,45
16189,bink821,,1,41,66,107
16190,mismetti,,1,93,198,291
16191,froderick,,1,860,1213,2073
16192,conan08,,1,2,1,3
16193,eheller,,1,1,1,2
16194,iPood,,1,2,2,4
16195,incalcitrant,,1,5,13,18
16196,ericN,,1,70,97,167
16197,diggit08,,1,83,5,88
16198,stedwick,,1,35,24,59
16199,jcorkern,,1,468,358,826
16200,pmill001,,1,3,1,4
16201,n8shac78,,1,11,10,21
16202,dthompsn,,1,2,3,5
16203,sikosmurf,,1,3,4,7
16204,kogus,,1,91,63,154
16205,AM088,,1,111,167,278
16206,ejt,,1,1,1,2
16207,heath_ledger,,1,13,12,25
16208,damg,,1,212,133,345
16209,unkleman,,1,17,50,67
16210,lisak,,1,4,8,12
16211,CUNexTuesday,,1,151,222,373
16212,oilmonkey,,1,6,2,8
16213,jeepdays,,1,4,12,16
16214,greenion,,1,3,5,8
16215,digindrivefast,,1,7,32,39
16216,srgntpoliteness,,4,14,20,34
16217,Bzzt,,1,21,53,74
16218,GLneo,,1,42,64,106
16219,brienf18,,1,27,31,58
16220,greatgrandpa,,1,1,1,2
16221,Mikeybarnes,,1,9,19,28
16222,vatavr,,1,6,8,14
16223,matthiasB,,1,51,84,135
16224,doteedoot,,1,1,1,2
16225,skitzy,,1,1,7,8
16226,GreenSmithC,,1,20,13,33
16227,initself,,1,88,86,174
16228,kanuk877,,1,5,11,16
16229,t0r,,1,7,2,9
16230,vheissu1974,,1,19,4,23
16231,factgirl,,1,9,1,10
16232,iWasMolested,,1,1,1,2
16233,vesci,,1,1,2,3
16234,bluetahoe99,,1,30,3,33
16235,talkingwires,,1,32,67,99
16236,tripclaw,,1,34,72,106
16237,molbio,,1,29,33,62
16238,supersurfer,,1,26,15,41
16239,kishoba,,1,6,7,13
16240,elbekko,,1,3,14,17
16241,jiaco,,1,135,269,404
16242,G_Morgan,,1,909,1373,2282
16243,charltones,,1,16,20,36
16244,EnosDrawkCabeht,,1,5,9,14
16245,BradBlog,,1,109,10,119
16246,sinkface,,1,9,13,22
16247,godsfire,,1,2,2,4
16248,WG55,,1,204,255,459
16249,TheNoxx,,1,494,478,972
16250,frankzappa,,1,6,10,16
16251,9ner,,1,101,270,371
16252,wegoin2sizzla,,1,7,8,15
16253,redveg,,1,9,16,25
16254,emptyhead75,,1,8,9,17
16255,reisyboy,,1,6,7,13
16256,Sir_Isaac_Brock,,1,113,287,400
16257,Kosko,,1,4,8,12
16258,pielud,,1,3,3,6
16259,rexraygun,,1,2,4,6
16260,nman,,1,5,17,22
16261,r_u_stupid2,,1,3,2,5
16262,mosha48,,1,76,149,225
16263,semanticart,,1,3,8,11
16264,anatinus,,1,143,277,420
16265,MarlonBain,,1,1294,1563,2857
16266,snnmnd,,1,2,5,7
16267,DaveyC,,1,45,67,112
16268,demonofthefall,,1,33,64,97
16269,fisheye1999,,1,2,4,6
16270,stevedrew,,1,22,10,32
16271,st3fan,,1,2,1,3
16272,jaymill,,1,3,3,6
16273,yoss86,,1,2,4,6
16274,Mystae,,1,3,7,10
16275,JosephSmithOverdrive,,1,1,3,4
16276,jankphil,,1,1,2,3
16277,snahor,,1,3,2,5
16278,Nitron,,1,31,53,84
16279,mhermans,,1,28,30,58
16280,aitzim,,1,9,18,27
16281,Jeff_Albertson,,1,39,73,112
16282,ellrjay,,1,3,10,13
16283,psyklohps,,1,15,19,34
16284,h00dwink,,1,24,39,63
16285,crucifer,,1,2,4,6
16286,rakantae,,1,92,111,203
16287,slana,,1,2,3,5
16288,gtoal,,1,1,1,2
16289,dust_that_moves,,1,1,1,2
16290,huronbikes,,1,2,7,9
16291,deflective,,1,88,144,232
16292,zentsunami,,1,66,148,214
16293,mr_qwerty,,1,5,4,9
16294,toogy,,1,2,3,5
16295,The_Funny,,1,96,112,208
16296,natehamilton82,,1,1,1,2
16297,avenue22,,1,1,1,2
16298,JBecerra,,1,7,7,14
16299,MrBabyMan,,1,1,2,3
16300,LRonPaultard1,,1,4,20,24
16301,RickyGervais,,1,1,1,2
16302,ninjawarrior,,1,54,6,60
16303,highd,,1,19,28,47
16304,redkamel,,1,1,1,2
16305,lowfat,,1,4,11,15
16306,wearebeingliedto,,1,3,1,4
16307,zandi,,1,2,4,6
16308,benjc,,1,19,2,21
16309,monkeyjoebla,,1,1,1,2
16310,thelilacgirl,,1,2,12,14
16311,cknipe,,1,20,22,42
16312,Blammo,,1,8,4,12
16313,akamakavely,,1,23,2,25
16314,MichaelGScott,,1,1,3,4
16315,aychberg,,1,34,6,40
16316,zachm,,1,70,66,136
16317,mac_hater,,1,1,1,2
16318,tomato00,,1,1,1,2
16319,mogrify,,1,28,13,41
16320,amscadding,,1,1,1,2
16321,ChiefWanker,,1,9,5,14
16322,rnayden,,1,11,1,12
16323,sofal,,1,59,93,152
16324,wpfeffer,,1,1,2,3
16325,frotorious,,1,3,7,10
16326,Blisslyke,,1,91,66,157
16327,Hemiptera,,1,4,14,18
16328,RKom,,1,4,4,8
16329,OhCobblers,,1,162,1,163
16330,jdunck,,1,37,49,86
16331,projectpaul,,1,2,1,3
16332,AllForChange,,1,223,135,358
16333,imkwtrz0r,,1,5,14,19
16334,kolloid,,1,17,8,25
16335,stevecooper,,1,9,6,15
16336,crazybones,,1,1316,835,2151
16337,djaltitude,,1,9,8,17
16338,tys022,,1,1,1,2
16339,Shutterbug,,1,17,15,32
16340,dwliving,,1,2,2,4
16341,marathi_mulgaa,,1,12,15,27
16342,xiorlanth,,1,36,79,115
16343,shabonkerz,,1,4,5,9
16344,lwgoodman,,1,7,11,18
16345,MSC,,1,1,1,2
16346,dr_gonzo,,1,89,30,119
16347,jj_williams08,,1,8,3,11
16348,stoptypingnow,,1,2,4,6
16349,doktaru,,1,27,21,48
16350,selfprodigy,,1,2,2,4
16351,werebear,,1,18,20,38
16352,soillife,,1,6,8,14
16353,iceplanethoth,,1,1,2,3
16354,bythewar,,1,12,14,26
16355,sirbarrums,,1,2,1,3
16356,the1pato,,1,64,35,99
16357,kefeer,,1,6,16,22
16358,rooskie,,1,31,9,40
16359,nmrk,,1,198,209,407
16360,Celsius233,,1,38,46,84
16361,katqanna,,1,1,2,3
16362,kryx,,1,3,1,4
16363,Macchu,,1,15,11,26
16364,obixx,,1,2,3,5
16365,timbro1,,1,136,183,319
16366,badassumption,,1,209,165,374
16367,rengeek,,1,29,22,51
16368,Tickthokk,,1,5,14,19
16369,the_unbroken_broken,,1,1,5,6
16370,novamortis,,1,25,44,69
16371,LordofMelancholy,,1,26,21,47
16372,trekman,,1,93,17,110
16373,solly_cardy,,1,3,1,4
16374,plorelle,,1,49,100,149
16375,sportsman1000,,1,1,2,3
16376,xuhu,,1,43,48,91
16377,Un_Suppressed,,1,78,94,172
16378,karamorf,,1,26,32,58
16379,dolbydog,,1,5,5,10
16380,bradtwo,,1,1,1,2
16381,driftdesigns,,1,4,8,12
16382,BlackGlass,,1,25,34,59
16383,zargon1978,,1,9,11,20
16384,infinitysnake,,1,83,206,289
16385,evabungle,,1,24,58,82
16386,HeDiBo,,1,3,1,4
16387,Rocky22,,1,27,68,95
16388,Hoodlum,,1,2,1,3
16389,werepika,,1,21,33,54
16390,TH3_Dude,,1,83,204,287
16391,peter_wiggins,,1,8,6,14
16392,changeocracy,,1,1,1,2
16393,hxcldy,,1,1,2,3
16394,croooner,,1,3,4,7
16395,bigdog05,,1,1,1,2
16396,neror,,1,56,2,58
16397,magic6435,,1,6,10,16
16398,gtranbot,,1,48,75,123
16399,wisp,,1,11,12,23
16400,seanzer,,1,9,28,37
16401,innerspirit,,1,185,162,347
16402,lhp,,1,5,2,7
16403,larryni,,1,9,3,12
16404,Delmarc,,1,19,31,50
16405,xpatkat,,1,1,1,2
16406,abennett,,1,26,51,77
16407,jasoncollin,,1,2,3,5
16408,petrograd,,1,3,3,6
16409,speedwagin,,1,12,2,14
16410,beedee,,1,22,46,68
16411,petuniapredator,,1,16,17,33
16412,dblyth,,1,8,2,10
16413,Kattana,,1,11,29,40
16414,deepthot42,,1,78,180,258
16415,damovisa,,1,7,3,10
16416,brownsauce,,1,8,2,10
16417,lattepiu,,1,25,13,38
16418,threetimepostaccount,,1,5,3,8
16419,Wiggles2,,1,1,2,3
16420,mcavoybn,,1,1,1,2
16421,flava_flav,,1,9,12,21
16422,salkhan,,1,5,6,11
16423,bigbigdolphin,,1,3,2,5
16424,fleaflicker51,,1,12,5,17
16425,sarhoshamiral,,1,1,1,2
16426,latkahgravis,,1,1,9,10
16427,cynicizm,,1,72,95,167
16428,chickenontop,,1,2,1,3
16429,gimpy21,,1,7,7,14
16430,camlllama,,1,1,1,2
16431,lebonzo,,1,2,5,7
16432,benyaminshoham,,1,15,3,18
16433,bobby999,,1,3,6,9
16434,paternoster,,1,340,643,983
16435,gmonkey1972,,1,1,1,2
16436,joebert72,,1,2,2,4
16437,Som12H8,,1,4,8,12
16438,irrationalpie,,1,1,4,5
16439,Zero1328,,1,1,2,3
16440,robywar,,1,366,565,931
16441,avecfrites,,1,7,10,17
16442,POLAR_BEAR,,1,6,7,13
16443,capt_awesome,,1,9,11,20
16444,gen3ric,,1,1,2,3
16445,zscheidt,,1,1,2,3
16446,SLAUTCAANS,,1,605,1066,1671
16447,stormboy,,1,12,30,42
16448,LWRellim,,1,195,245,440
16449,midge,,1,55,115,170
16450,ctp6360,,1,5,7,12
16451,grungefan,,1,1,3,4
16452,prayerforengland,,1,24,25,49
16453,texodus,,1,2,1,3
16454,CommentRevealer,,1,3,5,8
16455,devvie,,1,55,85,140
16456,itwasntmenana,,1,76,171,247
16457,arkool,,1,102,100,202
16458,vonoy,,1,17,38,55
16459,mejaredme1,,1,1,1,2
16460,equal,,1,8,1,9
16461,plaguey,,1,4,8,12
16462,bobcat,,1,2958,1797,4755
16463,bitshifter,,1,39,36,75
16464,MrDowntown,,1,20,21,41
16465,fukkndog,,1,1,1,2
16466,Flatline_hun,,1,20,52,72
16467,josh8227,,1,5,6,11
16468,gayniggerfetus,,1,1,1,2
16469,billbillbilly,,1,20,33,53
16470,rks404,,1,7,10,17
16471,misterswarvey,,1,2,3,5
16472,userreddit,,1,56,48,104
16473,Afro-Ninja,,1,3,3,6
16474,Fishy_McFish,,1,110,238,348
16475,wilberforce,,1,10,12,22
16476,zapdos,,1,12,4,16
16477,Spanners,,1,2,6,8
16478,afreddy87,,1,2,1,3
16479,musikal1,,1,1,1,2
16480,gmax,,1,1,3,4
16481,fuzzyfuzz,,1,15,13,28
16482,Unbathed,,1,9,10,19
16483,locolan,,1,23,47,70
16484,OpticsFiber,,1,12,22,34
16485,alanbrunsdon,,1,71,101,172
16486,therp,,1,1,1,2
16487,tortito,,1,2,3,5
16488,Flower2112,,1,136,272,408
16489,notzach,,1,5,3,8
16490,surlymcbastard,,1,12,16,28
16491,lpslogan,,1,14,4,18
16492,szopa,,1,8,7,15
16493,forkula,,1,7,1,8
16494,monximus,,1,5,11,16
16495,sghe,,1,1,2,3
16496,nadnate,,1,3,5,8
16497,armchaircritic,,1,2,5,7
16498,mknight44,,1,33,26,59
16499,jashsu,,1,2,2,4
16500,BetterWorld,,1,2,1,3
16501,tmiya,,1,1,1,2
16502,topsyturvy,,1,7,12,19
16503,theoppositeofleft,,1,3,2,5
16504,GrnLight,,1,1,1,2
16505,ellimayhem,,1,53,140,193
16506,matt7718,,1,1,1,2
16507,MrXfromPlanetX,,1,48,43,91
16508,billorites,,1,69,74,143
16509,supersloth666,,1,1,1,2
16510,fap2loli,,1,3,3,6
16511,leemy,,1,150,174,324
16512,Satook2,,1,5,5,10
16513,ARABS_DID_911,,1,14,24,38
16514,dkbaehr,,1,2,3,5
16515,Slattz,,1,1,2,3
16516,johnbentley,,1,48,101,149
16517,random5820350235,,1,32,18,50
16518,projectileboy,,1,17,20,37
16519,redline6561,,1,9,16,25
16520,Stingray88,,1,614,997,1611
16521,CLaBo,,1,2,2,4
16522,Wartz,,1,255,463,718
16523,pcmxa,,1,38,36,74
16524,ahotdog4life,,1,2,1,3
16525,lroselg,,1,92,175,267
16526,drizzle,,1,153,220,373
16527,thanatosys,,1,8,24,32
16528,bodenplukt,,1,78,271,349
16529,zohyil,,1,8,4,12
16530,dubu2584,,1,143,85,228
16531,bullfrog047,,1,1,1,2
16532,danjerman,,1,3,1,4
16533,dubphonics,,1,21,28,49
16534,MZepeda,,1,4,2,6
16535,idontreadthearticles,,1,1,3,4
16536,0oruneo0,,1,4,7,11
16537,CaptainComboBreaker,,1,1,1,2
16538,floweryleatherboy,,1,87,117,204
16539,mount_earnest,,1,254,383,637
16540,werewhale,,1,1,2,3
16541,diversey,,1,1,1,2
16542,letloosegal,,1,8,4,12
16543,gloushire,,1,8,12,20
16544,trippp,,1,2,3,5
16545,black_swan,,1,14,10,24
16546,Kiz11,,1,4,5,9
16547,knowsguy,,1,320,472,792
16548,Brocklesocks,,1,391,398,789
16549,1ickitung,,1,14,13,27
16550,Genetics,,1,35,37,72
16551,foxyvixen,,1,451,352,803
16552,pro_sephiroth,,1,26,43,69
16553,epicanis,,1,17,28,45
16554,znine,,1,1,1,2
16555,HaiNewUser,,1,3,3,6
16556,Epistaxis,,1,296,454,750
16557,InstantIndian,,1,111,130,241
16558,andreiru,,1,3,5,8
16559,thetimeisnow,,1,281,523,804
16560,tekrat,,1,39,52,91
16561,Speaktomenow,,1,40,84,124
16562,tamersalama,,1,19,39,58
16563,banchai,,1,29,45,74
16564,TUstudent,,1,2,1,3
16565,fuzznight,,1,4,4,8
16566,irafews,,1,72,4,76
16567,gtalmond,,1,11,14,25
16568,risend,,1,2,5,7
16569,ramhick,,1,1,1,2
16570,lcm133,,1,59,32,91
16571,ninjarobot,,1,18,49,67
16572,artofwar,,1,8,10,18
16573,cute_lil_bun_bun,,1,5,3,8
16574,severn,,1,12,10,22
16575,Fosnez,,1,61,75,136
16576,Brinna,,1,6,3,9
16577,cryo,,1,8,15,23
16578,ancient_multix,,1,1,5,6
16579,clandestin,,1,4,5,9
16580,surge1,,1,6,3,9
16581,ShrimpCrackers,,1,96,111,207
16582,EODTEC85,,1,1,1,2
16583,Space_Guy,,1,1,2,3
16584,kowzler,,1,8,28,36
16585,PGRacer,,1,11,14,25
16586,toodytang,,1,9,14,23
16587,fallentree,,1,3,4,7
16588,pootiechang,,1,3,2,5
16589,xvst,,1,21,23,44
16590,Zernhelt,,1,1,1,2
16591,Dru89,,1,17,26,43
16592,oPerrin,,1,10,15,25
16593,blacksuit,,1,52,61,113
16594,buddhahead,,1,15,29,44
16595,ihmc,,1,2,2,4
16596,wreese,,1,7,4,11
16597,myg204,,1,3,3,6
16598,Inspired,,1,9,27,36
16599,jpotell,,1,1,3,4
16600,itsjustajoy,,1,66,67,133
16601,toppredditor,,1,80,4,84
16602,sesse,,1,90,134,224
16603,xChrisk,,1,15,22,37
16604,amazingman,,1,7,17,24
16605,sjbrown,,1,2,5,7
16606,rachid116460,,1,1,2,3
16607,invalid-user-name,,1,55,23,78
16608,aintbroke,,1,5,5,10
16609,casualcollapse,,1,2,4,6
16610,claesh1,,1,15,26,41
16611,Cruise4,,1,2,4,6
16612,gsurface,,1,11,8,19
16613,kor_revelator,,1,1,2,3
16614,dickensian,,1,4,3,7
16615,pennyscan,,1,4,7,11
16616,rztwkk,,1,2,1,3
16617,hillad,,1,2,4,6
16618,darkandscary,,1,13,9,22
16619,dontstop,,1,86,4,90
16620,Niuk,,1,5,11,16
16621,aqbd,,1,6,5,11
16622,agiaccone,,1,35,17,52
16623,dkaz,,1,18,21,39
16624,Fanatixxx,,1,16,2,18
16625,timf3d,,1,22,18,40
16626,SinusTate,,1,18,28,46
16627,Volt,,1,3,5,8
16628,Radical_Centrist,,1,76,104,180
16629,mrekted,,1,84,21,105
16630,pranksomequaine,,1,31,51,82
16631,ThomK,,1,12,35,47
16632,joshuaahatfield,,1,20,23,43
16633,MrDrego,,1,29,25,54
16634,aaneton,,1,7,5,12
16635,b04877054,,1,7,8,15
16636,Palex95,,1,12,2,14
16637,AtheismFTW,,1,234,136,370
16638,fordf150,,1,5,5,10
16639,cranktheguy,,1,164,186,350
16640,Kinokokao,,1,1,2,3
16641,shaunanigans,,1,56,104,160
16642,ebrake,,1,50,11,61
16643,LordBodak,,1,22,14,36
16644,polarfire,,1,6,7,13
16645,showermanager,,1,2,1,3
16646,conanobrien,,1,9,5,14
16647,moroccobama,,1,1,2,3
16648,mrappard,,1,1,1,2
16649,jsichkaryk,,1,2,7,9
16650,mojonone,,1,1,1,2
16651,workisglory,,1,49,5,54
16652,ChrisAndersen,,1,218,494,712
16653,SorryReddit,,1,13,11,24
16654,fadeddata,,1,8,3,11
16655,xobs,,1,6,11,17
16656,WHAKATE,,1,5,3,8
16657,caster,,1,12,27,39
16658,I_AM_A_TROLL,,1,7,12,19
16659,butcandy,,1,273,440,713
16660,yerfired,,1,5,3,8
16661,wrekone,,1,1,7,8
16662,crowdadmin,,1,21,2,23
16663,vanibahl,,1,33,4,37
16664,Sarstan,,1,1,1,2
16665,trpcicm,,1,166,140,306
16666,smonsoon,,1,13,20,33
16667,b0jangles,,1,25,31,56
16668,itdev2,,1,1,1,2
16669,markrmarkr,,1,2,3,5
16670,evilcharles,,1,1,2,3
16671,Sevenduolux,,1,2,2,4
16672,termdark,,1,1,2,3
16673,mgodswell,,1,1,2,3
16674,bellgong,,1,14,17,31
16675,melb_ev,,1,14,19,33
16676,banister,,1,1,2,3
16677,raendrop,,1,60,139,199
16678,altmiket,,1,3,2,5
16679,jonnablaze,,1,86,19,105
16680,falcon8,,1,63,37,100
16681,Elbarfo,,1,5,16,21
16682,robtw,,1,1,5,6
16683,outsideofapex,,1,23,18,41
16684,uday0210,,1,31,7,38
16685,mistermoxy,,1,675,1098,1773
16686,IvyPhilly,,1,37,79,116
16687,Durric,,1,5,5,10
16688,cousinavi,,1,54,44,98
16689,hollipop,,1,2,1,3
16690,DortP,,1,38,74,112
16691,Phineaus,,1,11,11,22
16692,franzer,,1,16,13,29
16693,SohumB,,1,75,85,160
16694,xoswald,,1,1,3,4
16695,tofergregg,,1,36,11,47
16696,Talamasca,,1,39,139,178
16697,zachg,,1,26,35,61
16698,doctorlw,,1,4,3,7
16699,gregular,,1,1,2,3
16700,jvnk,,1,4,6,10
16701,TakaIta,,1,70,139,209
16702,zaphodi,,1,68,118,186
16703,WasForClinton,,1,144,111,255
16704,rastermon,,1,2,3,5
16705,vlkun,,1,6,2,8
16706,carcharodon,,1,4,6,10
16707,elspif,,1,5,2,7
16708,PracticalPanda,,1,30,38,68
16709,smokeweed,,1,57,27,84
16710,TheWiseNoob,,1,7,7,14
16711,horacevsthespiders,,1,24,26,50
16712,eallan,,1,160,216,376
16713,HaxorParadox,,1,8,9,17
16714,hipitarius,,1,4,6,10
16715,cyancynic,,1,628,1035,1663
16716,HiveMind118,,1,1,1,2
16717,san1ty,,1,328,244,572
16718,exec721,,1,5,9,14
16719,breakneckridge,,1,774,784,1558
16720,terumo,,1,39,137,176
16721,Nexum,,1,150,175,325
16722,crunkchip,,1,2,3,5
16723,andaleguero,,1,60,30,90
16724,tstorm,,1,8,35,43
16725,Kanin,,1,113,302,415
16726,theRIAA,,1,3,4,7
16727,willmorgan,,1,1,2,3
16728,alanis_morissette,,1,1,4,5
16729,David31337,,1,8,7,15
16730,mokopa,,1,8,14,22
16731,hwkns,,1,96,351,447
16732,droyal,,1,10,11,21
16733,Lightfiend,,1,3,7,10
16734,For_Iconoclasm,,1,7,18,25
16735,adamjay28,,1,1,3,4
16736,munnabhai,,1,52,30,82
16737,drjonez,,1,20,21,41
16738,Tony_Reaves,,1,2,3,5
16739,cgrand,,1,38,21,59
16740,goo321,,1,56,88,144
16741,charred,,1,1,1,2
16742,acepukas,,1,7,12,19
16743,Othello,,1,601,983,1584
16744,Anomolies,,1,19,4,23
16745,japhet,,1,8,37,45
16746,m1a2c2kali,,1,7,12,19
16747,DarkSideofOZ,,1,387,489,876
16748,3Scorpion,,1,1,3,4
16749,peanut_butter,,1,21,15,36
16750,starkinter,,1,161,168,329
16751,OrangeCoconut,,1,23,22,45
16752,commonmanuser,,1,6,7,13
16753,I_AM_A_LIBERAL,,1,32,5,37
16754,jfklein13,,1,1,5,6
16755,crabe1,,1,1,1,2
16756,C_istheroot,,1,1,2,3
16757,tejmin,,1,1,2,3
16758,aislingdarby,,1,16,24,40
16759,fortyhands,,1,6,4,10
16760,docgravel,,1,145,190,335
16761,aoru,,1,2,1,3
16762,w00ty,,1,208,139,347
16763,anthropic,,1,133,87,220
16764,crakthm,,1,1,1,2
16765,Canucklechuck,,1,3,4,7
16766,the_real_one,,1,8,3,11
16767,gosub,,1,63,24,87
16768,itsandrew,,1,1,2,3
16769,webjunkie1,,1,6,14,20
16770,ecks,,1,5,9,14
16771,friendly_titan,,1,3,6,9
16772,marmalade,,1,198,116,314
16773,zark,,1,10,1,11
16774,macneib,,1,68,99,167
16775,roryokane,,1,7,18,25
16776,NeoPaladin394,,1,45,63,108
16777,rgalan,,1,130,21,151
16778,clueless,,1,110,47,157
16779,2sjh1,,1,14,27,41
16780,tomparker,,1,5,5,10
16781,DINKDINK,,1,59,52,111
16782,bluesman03,,1,2,2,4
16783,KanadaRux,,1,16,2,18
16784,redpirate,,1,19,4,23
16785,lilzilla,,1,1,1,2
16786,stp6435,,1,343,69,412
16787,lurker00110,,1,26,46,72
16788,CXI,,1,4,3,7
16789,max_w,,1,2,4,6
16790,backcatalogue,,1,9,12,21
16791,pranayshrestha,,1,61,3,64
16792,infcow,,1,2,3,5
16793,chimmyc,,1,4,1,5
16794,dharmon555,,1,186,159,345
16795,duckduckdog,,1,1,1,2
16796,jokekiller,,1,7,15,22
16797,joelhardi,,1,122,186,308
16798,dupin,,1,5,2,7
16799,futureman19,,1,2,9,11
16800,verizonguy,,1,1,1,2
16801,mliving,,1,131,222,353
16802,run_citizen,,1,2,1,3
16803,Wonderama,,1,4,6,10
16804,troseph,,1,1,5,6
16805,hx219,,1,3,3,6
16806,messlah,,1,2,3,5
16807,RKBA,,1,406,642,1048
16808,AmidTheSnow,,1,122,212,334
16809,Hesperus,,1,93,152,245
16810,nextag82,,1,1,1,2
16811,mrstrongsad,,1,1,1,2
16812,xsp,,1,37,61,98
16813,neelk,,1,37,37,74
16814,nathan,,1,20,6,26
16815,rossta,,1,270,14,284
16816,DorothyNed,,1,3,1,4
16817,rrra,,1,71,100,171
16818,kuqumi,,1,48,92,140
16819,Taomongoose,,1,3,5,8
16820,rlancefield,,1,16,18,34
16821,ngroot,,1,352,518,870
16822,Arelius,,1,12,19,31
16823,beachking777,,1,2,3,5
16824,evolent,,1,147,23,170
16825,neophytoplasm,,1,42,67,109
16826,gooz,,1,25,41,66
16827,dubyabinlyin,,1,373,583,956
16828,jodv,,1,516,443,959
16829,Tobias42,,1,6,8,14
16830,lliiffee,,1,85,95,180
16831,bugged11,,1,20,30,50
16832,enitine,,1,18,28,46
16833,Penosaurus_Sex,,1,6,8,14
16834,harmonik,,1,135,173,308
16835,al-khanji,,1,8,5,13
16836,orph3us,,1,4,12,16
16837,ancientgreekredditor,,1,8,1,9
16838,ye_prasad,,1,78,2,80
16839,rephlektiv,,1,25,11,36
16840,thebizer,,1,18,2,20
16841,fernandoacorreia,,1,39,49,88
16842,surfinsoljah,,1,41,82,123
16843,rerentyourhot,,1,1,1,2
16844,Kingham,,1,4,2,6
16845,c0y0te,,1,18,4,22
16846,XS4Me,,1,456,568,1024
16847,bobsmo,,1,74,130,204
16848,potus445566,,1,2,1,3
16849,sheen7334,,1,1,5,6
16850,ehwot,,1,1,1,2
16851,dorkboat,,1,61,179,240
16852,djmichaelb,,1,1,1,2
16853,checksinthemail,,1,141,354,495
16854,jbrechtel,,1,2,1,3
16855,lisapisa77,,1,1,1,2
16856,vegasbomber,,1,1,1,2
16857,fancyman,,1,37,60,97
16858,Faustyna,,1,33,27,60
16859,molsoncanadian,,1,1,1,2
16860,Selina1,,1,1,1,2
16861,kazoodude,,1,3,4,7
16862,rodsgottit,,1,5,11,16
16863,startchangego,,1,226,90,316
16864,joshmcfarlane,,1,24,27,51
16865,eee777,,1,1,4,5
16866,sleeepykenny,,1,24,54,78
16867,nothingtodo,,1,3,2,5
16868,sqerl,,1,60,118,178
16869,whisperthis,,1,425,79,504
16870,ovets,,1,109,113,222
16871,SirSandGoblin,,1,139,310,449
16872,jdkeith,,1,18,20,38
16873,mvnu07,,1,7,1,8
16874,a_kind_stranger,,1,45,11,56
16875,maiacoop,,1,1,1,2
16876,allywilson,,1,30,30,60
16877,micdundee,,1,12,23,35
16878,311_was_a_rockin_job,,1,4,3,7
16879,suzwatkins,,1,12,12,24
16880,isthatarabbit,,1,1,1,2
16881,mrbillabong,,1,10,10,20
16882,truth_will_out,,1,6,7,13
16883,CDubbs,,1,1,2,3
16884,heymikedude,,1,4,20,24
16885,randomnebula,,1,3,1,4
16886,WTFppl,,1,38,72,110
16887,clownshoes_,,1,1,1,2
16888,abulfurqan,,1,1,1,2
16889,dngrmouse,,1,53,82,135
16890,yoboyhoy,,1,96,8,104
16891,Jezekiah,,1,331,227,558
16892,redditacct,,1,308,768,1076
16893,TheHulk,,1,2,1,3
16894,misouza,,1,23,1,24
16895,mddawso,,1,253,182,435
16896,inquirer,,1,371,58,429
16897,HarleyJane,,1,1540,114,1654
16898,spipe,,1,27,4,31
16899,logoswar,,1,313,167,480
16900,ehs,,1,8,10,18
16901,leski,,1,59,22,81
16902,robodale,,1,176,271,447
16903,kDubya,,1,11,12,23
16904,LeoDaCat,,1,1,1,2
16905,klugefoo,,1,6,13,19
16906,tapnclick,,1,33,53,86
16907,dhbanes,,1,213,388,601
16908,Ammit,,1,24,70,94
16909,essellewohc,,1,9,3,12
16910,spinfire,,1,284,458,742
16911,chrsprec,,1,4,1,5
16912,chungkaishek,,1,190,77,267
16913,sleepysheeple,,1,2,4,6
16914,skinnybuddha,,1,7,10,17
16915,Ravenlock,,1,62,98,160
16916,jtq1,,1,54,35,89
16917,samuraiswordsman,,1,23,60,83
16918,sapere_aude,,1,16,26,42
16919,y78u,,1,2,5,7
16920,wreckula,,1,13,9,22
16921,Deuce,,1,18,19,37
16922,symmetry,,1,1,4,5
16923,nc6220,,1,8,9,17
16924,masterudia,,1,6,7,13
16925,dacracot,,1,1,1,2
16926,popcorn2000,,1,18,23,41
16927,CACuzcatlan,,1,16,17,33
16928,MuttBuncher,,1,16,46,62
16929,foolio,,1,4,1,5
16930,omierbej,,1,2,5,7
16931,mikeporter,,1,7,2,9
16932,shamrin,,1,12,3,15
16933,greml1n,,1,27,1,28
16934,totsuka,,1,6,6,12
16935,someonelse,,1,108,256,364
16936,StvYzerman,,1,126,73,199
16937,lienny,,1,36,2,38
16938,theprime,,1,27,50,77
16939,schubart,,1,23,6,29
16940,wnecsdamion,,1,7,23,30
16941,murphy11211,,1,7,14,21
16942,kasutori_Jack,,1,252,275,527
16943,phargarten,,1,18,18,36
16944,afaircomparison,,1,11,7,18
16945,redbulluk,,1,1,1,2
16946,likeyrhst,,1,15,2,17
16947,indycysive,,1,311,628,939
16948,Snazz,,1,45,98,143
16949,kuking,,1,18,27,45
16950,eygy54yg,,1,2,1,3
16951,chaosgroove,,1,5,15,20
16952,runfaster27,,1,6,4,10
16953,citrivium,,1,14,22,36
16954,karlhungus,,1,38,65,103
16955,mspmsp,,1,11,12,23
16956,thecave,,1,22,70,92
16957,danzimakittykat,,1,3,9,12
16958,dar512,,1,3,12,15
16959,AnnArchist,,1,246,290,536
16960,mouron,,1,4,11,15
16961,tnadas,,1,1,1,2
16962,jackalope,,1,27,40,67
16963,Kingsox,,1,21,16,37
16964,icey,,1,189,277,466
16965,howardhus,,1,67,130,197
16966,mattindustries,,1,431,665,1096
16967,mistermilo,,1,2,1,3
16968,SlackerCS,,1,5,9,14
16969,martoo,,1,609,685,1294
16970,LilatheCetacean,,1,80,71,151
16971,Apostrophe,,1,11,3,14
16972,Roninspoon,,1,73,102,175
16973,b_billy_bosco,,1,131,47,178
16974,macncheese,,1,147,196,343
16975,contrastingsounds,,1,40,62,102
16976,captanonymous,,1,372,108,480
16977,3badcats,,1,1,7,8
16978,dutchbag,,1,22,26,48
16979,scrottie,,1,1,1,2
16980,xempathy,,1,5,8,13
16981,StarlitEyes,,1,1,2,3
16982,HydroCabron,,1,72,96,168
16983,robertson_davies,,1,1,6,7
16984,reDust,,1,2,3,5
16985,SunnyPessimist,,1,1,3,4
16986,newton_dave,,1,848,1316,2164
16987,Anocka,,1,29,35,64
16988,jamesaimonetti,,1,1,1,2
16989,ebonio,,1,25,41,66
16990,kkille1lsu,,1,19,7,26
16991,riddles,,1,2,3,5
16992,TDaulnay,,1,26,23,49
16993,Sheridan,,1,14,25,39
16994,docgnome,,1,47,21,68
16995,mrgatorboy,,1,25,30,55
16996,Darbro,,1,2,2,4
16997,lynnmag,,1,1,1,2
16998,zuben,,1,16,13,29
16999,LiberalHippies9,,1,210,267,477
17000,amrathelion,,1,1,1,2
17001,koverda,,1,3,4,7
17002,eikonos,,1,2,2,4
17003,feral_nick,,1,1,2,3
17004,Zapatero,,1,1,1,2
17005,Bengt77,,1,32,67,99
17006,dallashigh,,1,57,1,58
17007,fiddlerpaul,,1,10,8,18
17008,IlliterateJedi,,1,294,438,732
17009,philixthecat,,1,7,3,10
17010,jyoull,,1,1,1,2
17011,PunThreadPolice,,1,42,32,74
17012,ADoc,,1,4,2,6
17013,KMAR,,1,1,2,3
17014,bruce779,,1,15,15,30
17015,gradualunderstanding,,1,4,5,9
17016,tictock,,1,21,27,48
17017,jamiribon,,1,22,3,25
17018,soulonfirexx,,1,3,1,4
17019,ProudNativeTexan,,1,13,6,19
17020,btsr7414,,1,6,4,10
17021,hork,,1,168,71,239
17022,BobLoco64,,1,3,4,7
17023,DGolden,,1,139,241,380
17024,repete,,1,93,162,255
17025,Nhoj,,1,51,130,181
17026,icaruswings,,1,1,1,2
17027,The_Wolf,,1,9,25,34
17028,hng_rval,,1,8,5,13
17029,nebbugvrok,,1,7,15,22
17030,halcyon,,1,37,73,110
17031,LindaDanvers,,1,2,3,5
17032,dageshi,,1,2,1,3
17033,sweatervest,,1,174,159,333
17034,Spazum,,1,27,40,67
17035,boomshanka,,1,1,2,3
17036,lonely_forest,,1,2,1,3
17037,movzx,,1,1083,1787,2870
17038,LucidFate,,1,1,5,6
17039,pinghuan,,1,2,6,8
17040,eyes24,,1,4,4,8
17041,rdomanski1,,1,31,2,33
17042,liscio,,1,4,4,8
17043,smokingbabies,,1,6,9,15
17044,maudite,,1,6,14,20
17045,invisibastard,,1,1,1,2
17046,Capt_Redbeard,,1,30,6,36
17047,I_Am_Trent_Reznor,,1,1,1,2
17048,chortle23,,1,1,1,2
17049,yojustkeepitreal,,1,91,27,118
17050,stupid_reddit,,1,25,25,50
17051,derpderp,,1,11,4,15
17052,shdwflyr,,1,1,2,3
17053,adrianmonk,,1,1183,1509,2692
17054,pfunkman,,1,1,1,2
17055,redwhale,,1,18,23,41
17056,groupShout,,1,1,8,9
17057,buddhahat,,1,284,314,598
17058,XXchromosome,,1,4,4,8
17059,Ref,,1,1,1,2
17060,sleepymeme,,1,321,23,344
17061,cacylist,,1,6,9,15
17062,a-p,,1,5,26,31
17063,brauhze,,1,16,8,24
17064,miner60,,1,8,8,16
17065,Jur,,1,5,7,12
17066,exocet_uk,,1,1,2,3
17067,leehar24,,1,261,903,1164
17068,magpie707,,1,3,9,12
17069,cl3ft,,1,52,84,136
17070,wrongtoothbrush,,1,10,28,38
17071,OTN,,1,33,25,58
17072,TeddGCM,,1,30,14,44
17073,jmjinks,,1,50,40,90
17074,perkonis,,1,7,4,11
17075,nappy-doo,,1,36,30,66
17076,audio_addict,,1,5,6,11
17077,hajid,,1,1,5,6
17078,vhs,,1,8,29,37
17079,tallow,,1,1,2,3
17080,FordStang,,1,2,8,10
17081,kmactane,,1,33,58,91
17082,James_T_Kirk,,1,1,4,5
17083,digitalfever,,1,2877,261,3138
17084,rayburt,,1,8,5,13
17085,mikero,,1,9,1,10
17086,marleymarl,,1,18,11,29
17087,lennon,,1,11,9,20
17088,worldputra,,1,24,11,35
17089,syowr,,1,1,1,2
17090,TheJeff,,1,24,22,46
17091,879,,1,1,3,4
17092,DeadIrwin,,1,1,2,3
17093,streo,,1,87,25,112
17094,IanOsgood,,1,2,3,5
17095,Fitzsimmons,,1,40,61,101
17096,Cactus44,,1,7,7,14
17097,unikuser,,1,18,29,47
17098,rossdakin,,1,2,2,4
17099,evanfp,,1,8,11,19
17100,discontinuity,,1,10,22,32
17101,cynest,,1,10,44,54
17102,lengau,,1,122,271,393
17103,Taladar,,1,775,1168,1943
17104,chubby_chaser,,1,3,1,4
17105,IceX,,1,171,159,330
17106,pyroman,,1,30,32,62
17107,Microfoot,,1,44,60,104
17108,Gman8941,,1,66,41,107
17109,pngl,,1,4,3,7
17110,RaspberryTurtle,,1,2,1,3
17111,tjg05,,1,11,9,20
17112,Hetisjantje,,1,182,110,292
17113,GreenPlastik,,1,1,3,4
17114,stoned_cat,,1,13,24,37
17115,realblublu,,1,1,6,7
17116,ItsNotMyRealAccount,,1,5,1,6
17117,chaohan,,0,14,18,32
17118,mspiels,,1,1,3,4
17119,atlbeer,,1,22,6,28
17120,Rudy9iu11ani,,1,5,2,7
17121,Hexquan,,1,4,4,8
17122,Slackbeing,,1,25,30,55
17123,RockSci,,1,2,4,6
17124,itgoesthere,,1,323,568,891
17125,plzthx,,1,3,1,4
17126,KrazeeEyezKilla,,1,12,11,23
17127,anti-neonominator,,1,4,2,6
17128,beatmonger,,1,2,1,3
17129,Saucepan,,1,4,1,5
17130,inferno0000,,1,620,850,1470
17131,supegruicho2000,,1,2,4,6
17132,MrSomeone,,1,21,2,23
17133,xenusaves,,1,9,22,31
17134,newsmanwebber,,1,3,1,4
17135,BinderGang,,1,6,10,16
17136,salt44,,1,7,17,24
17137,magelisk,,1,27,45,72
17138,opportuneport,,1,5,7,12
17139,sry_not4sale,,1,2,2,4
17140,GodBreedsU,,1,2,1,3
17141,thedaveg,,1,17,10,27
17142,pancakeradio,,1,10,16,26
17143,zexus,,1,5,5,10
17144,wdr1,,1,9,23,32
17145,Jakary,,1,10,48,58
17146,simonthesnail,,1,10,2,12
17147,tagawa,,1,11,9,20
17148,Kelevra,,1,31,70,101
17149,luxazur,,1,89,222,311
17150,theseb,,1,9,14,23
17151,Mosz,,1,5,10,15
17152,mintwhip,,1,1,2,3
17153,loginx,,1,49,21,70
17154,TMaples,,1,9,13,22
17155,blotus,,1,1,2,3
17156,english_guy_78,,1,30,35,65
17157,joelax02,,1,2,4,6
17158,boobsbr,,1,18,30,48
17159,zphantom,,1,2,1,3
17160,TheMemlingIndex,,1,46,1,47
17161,360news,,1,4,7,11
17162,apoc123,,1,2,2,4
17163,sumnihil,,1,3,2,5
17164,FireAtWill,,1,1,1,2
17165,emacsenorg,,1,5,1,6
17166,mohanji,,1,1,2,3
17167,bontaq,,1,12,16,28
17168,Liquid_2,,1,49,77,126
17169,thekong,,1,2,5,7
17170,darrenk,,1,10,15,25
17171,crapfoodpants,,1,338,141,479
17172,simpwn,,1,49,67,116
17173,3HackBug77,,1,234,252,486
17174,perlgeek,,1,16,13,29
17175,freeyourself,,1,8,9,17
17176,blankblix,,1,4,2,6
17177,ishmal,,1,146,215,361
17178,valkyrie120,,1,3,1,4
17179,laydens,,1,49,8,57
17180,BakersDozen,,1,5,6,11
17181,UpVoteWhore,,1,2,2,4
17182,Nevyn_Etharr,,1,3,5,8
17183,ungulation,,1,31,27,58
17184,fishypants,,1,66,127,193
17185,cmer,,1,15,34,49
17186,g2g079,,1,20,19,39
17187,arkavianx,,1,1,3,4
17188,fanniepop,,1,1,1,2
17189,Gendron5000,,1,1,1,2
17190,niko7865,,1,8,10,18
17191,fduffner,,1,40,13,53
17192,justturned2,,1,3,4,7
17193,nostradamnit,,1,5,15,20
17194,weinerman,,1,3,3,6
17195,jasonstatham,,1,154,26,180
17196,jz_,,1,18,15,33
17197,ilf,,1,1,3,4
17198,mattbeetee,,1,107,51,158
17199,leshrac55,,1,25,6,31
17200,mtklein,,1,4,5,9
17201,a_scientologist,,1,12,7,19
17202,forgotpwx4,,1,10,9,19
17203,Borniet,,1,16,1,17
17204,riderclimber,,1,22,1,23
17205,econo,,1,16,10,26
17206,cwbrandsma,,1,15,29,44
17207,qwerty_dvorak,,1,1,5,6
17208,oookiezooo,,1,1,1,2
17209,onor,,1,3,3,6
17210,tallpizza,,1,1,1,2
17211,jingleman,,1,45,6,51
17212,3d3m0n,,1,3,6,9
17213,mkk144,,1,9,1,10
17214,ATsDIGwagon,,1,2,4,6
17215,plaintext,,1,17,18,35
17216,WineGlass,,1,38,41,79
17217,Barbaricfellow,,1,4,11,15
17218,PMolinero,,1,21,4,25
17219,shoseki,,1,78,181,259
17220,Mr45,,1,25,37,62
17221,elfan,,1,7,16,23
17222,readdit7,,1,77,77,154
17223,tendentious,,1,13,20,33
17224,illuminaris,,1,9,9,18
17225,unoriginal42,,1,33,28,61
17226,Clothos,,1,763,1408,2171
17227,kantapro,,1,1,1,2
17228,daywalker1,,1,4,3,7
17229,cashmoneylife,,1,32,11,43
17230,drdrang,,1,1,1,2
17231,martinsulistio,,1,1,3,4
17232,barclay,,1,19,35,54
17233,ghoest,,1,2,8,10
17234,eshinshin,,1,3,3,6
17235,bucknasty,,1,3,1,4
17236,carpathian,,1,1,1,2
17237,SarahWPalin,,1,4,2,6
17238,gijsbert_h,,1,2,2,4
17239,timmins,,1,111,133,244
17240,paulVeraguth,,1,35,16,51
17241,gtg681r,,1,15,15,30
17242,omegahinny,,1,2,2,4
17243,nograj,,1,1,1,2
17244,howdoyoustopit,,1,1,2,3
17245,mayfer,,1,2,1,3
17246,makkz,,1,3,5,8
17247,djloche,,1,22,93,115
17248,omegapoint,,1,63,67,130
17249,makingspace,,1,370,128,498
17250,SreeramKS,,1,2,2,4
17251,BadassVonWhitebeard,,1,1,1,2
17252,Diddit,,1,9,9,18
17253,othilien,,1,4,8,12
17254,softbatch,,1,4,5,9
17255,cornball,,1,2,2,4
17256,ianoji,,1,6,11,17
17257,maetl,,1,7,11,18
17258,flowithego,,1,182,224,406
17259,archister,,1,64,75,139
17260,dilithium,,1,2,5,7
17261,heepajunk,,1,115,179,294
17262,donkeypunch2,,1,2,1,3
17263,0-0,,1,3,3,6
17264,keatsta,,1,26,21,47
17265,lteague,,1,34,17,51
17266,charliie,,1,12,6,18
17267,LSU_Tiger,,1,84,35,119
17268,demoneyes1,,1,2,1,3
17269,voicereason,,1,1,2,3
17270,ecrunner,,1,6,7,13
17271,ultrasupergenius,,1,2,3,5
17272,PathologyOfPower,,1,1,2,3
17273,Submission_Critic,,1,2,1,3
17274,micampe,,1,78,75,153
17275,rsuavenator,,1,21,34,55
17276,ragweed,,1,112,97,209
17277,jhumphries,,1,2,2,4
17278,dasponge,,1,5,13,18
17279,RECURSIVE_META_JOKE,,1,6,4,10
17280,iudex,,1,10,20,30
17281,waldoj,,1,69,5,74
17282,bluegrey,,1,10,11,21
17283,projectshr,,1,5,5,10
17284,6hdC91ePMcwk0K1wsogZ,,1,4,2,6
17285,seeya,,1,367,174,541
17286,biggusjimmus,,1,1,3,4
17287,Chocobean,,1,9,2,11
17288,revonrat,,1,14,23,37
17289,ahsan_m87,,1,5,4,9
17290,macvijay1985,,1,5,3,8
17291,cappslocke,,1,2,3,5
17292,BicyclesforPeace,,1,381,456,837
17293,redditaddicttt,,1,8,1,9
17294,phish27134,,1,2,2,4
17295,ariesfatboy2,,1,12,12,24
17296,bibster,,1,10,7,17
17297,manixus,,1,1,1,2
17298,wardrox,,1,280,142,422
17299,mecazrz,,1,1,7,8
17300,tomhagen,,1,24,11,35
17301,GoogilyMoogily,,1,35,35,70
17302,WWWWWWWWWW,,1,1,2,3
17303,StevenMussel,,1,4,1,5
17304,leftpan,,1,58,95,153
17305,Fen_,,1,63,20,83
17306,kick11,,1,125,45,170
17307,nomadic,,1,8,8,16
17308,mrdatter,,1,1,2,3
17309,cedd82,,1,4,5,9
17310,applextrent,,1,3,1,4
17311,pescek,,1,21,2,23
17312,ennuionwe,,1,2,4,6
17313,fauge,,1,2,1,3
17314,codeninja,,1,9,1,10
17315,precip,,1,51,47,98
17316,noface,,1,170,56,226
17317,VPDickCheney,,1,1,1,2
17318,manewitz,,1,25,6,31
17319,briank,,1,7,13,20
17320,kevincobarno,,1,292,31,323
17321,stewy_w,,1,4,8,12
17322,bitshifternz,,1,2,7,9
17323,neels,,1,1,1,2
17324,BLG89,,1,1,2,3
17325,Sylveran-01,,1,385,503,888
17326,thrakhath,,1,391,577,968
17327,FeebleAntelope,,1,2,4,6
17328,ouztopia,,1,1,3,4
17329,sidenote,,1,5,4,9
17330,kranix,,1,169,282,451
17331,bellabelial,,1,96,136,232
17332,otlmath,,1,104,62,166
17333,VRFour,,1,13,13,26
17334,matteyes,,1,44,39,83
17335,slomo68,,1,264,340,604
17336,fortfive,,1,3,6,9
17337,daravinne,,1,10,17,27
17338,shsmurfy,,1,16,14,30
17339,intrepidlytrite,,1,17,13,30
17340,PhilK,,1,3,7,10
17341,titaniumjackal,,1,280,433,713
17342,scrumpydoo23,,1,216,448,664
17343,bobby200,,1,73,23,96
17344,blueaugur,,1,6,3,9
17345,tdreyno,,1,2,1,3
17346,stix1972,,1,3,1,4
17347,rationalitate,,1,8,10,18
17348,bertrand,,1,387,232,619
17349,robotron2000,,1,4,3,7
17350,wetelectric,,1,178,173,351
17351,Ventura,,1,4,5,9
17352,LilHumanist,,1,2,4,6
17353,AgentFireWire,,1,4,8,12
17354,jrbored,,1,3,8,11
17355,bluser,,1,10,1,11
17356,thedailynathan,,1,1,1,2
17357,amniarix,,1,24,23,47
17358,chorankates,,1,1,4,5
17359,chaz6,,1,10,12,22
17360,ademus05,,1,1,1,2
17361,hamsterboy,,1,12,7,19
17362,talso,,1,1,2,3
17363,salstress,,1,3,5,8
17364,ComcastRapesPuppies,,1,48,84,132
17365,yemenim,,1,1,4,5
17366,monkeymynd,,1,344,353,697
17367,danieldayblood,,1,11,14,25
17368,dbeck21,,1,5,5,10
17369,stupidis,,1,3,4,7
17370,LawDog54,,1,3,2,5
17371,apatton19,,1,66,53,119
17372,patmcnally,,1,2,2,4
17373,ThisIsMyProfile,,1,27,93,120
17374,sudarkoff,,1,1,1,2
17375,Samzo,,1,311,211,522
17376,syslinkdown,,1,15,20,35
17377,llaurent,,1,1,1,2
17378,siyang11,,1,1,1,2
17379,twosteptothatyo,,1,28,6,34
17380,Revidescent,,1,1,3,4
17381,moliket,,1,4,13,17
17382,seacollie,,1,6,2,8
17383,ucsmc_izzy,,1,2,4,6
17384,growt,,1,8,10,18
17385,jinkim,,1,2,2,4
17386,jmhodges,,1,29,20,49
17387,natlekkas,,1,3,1,4
17388,winbert,,1,24,28,52
17389,Cacophonny,,1,2,1,3
17390,stone_fox,,1,9,9,18
17391,Cygnus16,,1,2,7,9
17392,bradlingdale,,1,2,3,5
17393,bigpresh,,1,15,28,43
17394,hoppy44,,1,102,70,172
17395,ZachWasTaken,,1,1,1,2
17396,mugu22,,1,39,36,75
17397,boomerxl,,1,307,93,400
17398,OldDoper,,1,4,2,6
17399,BucketofTruth,,1,3,3,6
17400,tammberlin,,1,12,14,26
17401,nertzy,,1,93,3,96
17402,inoe,,1,3,1,4
17403,grayFalcon,,1,11,8,19
17404,woodsrunner77,,1,1,1,2
17405,matthewmoore2,,1,35,11,46
17406,tbp,,1,2,1,3
17407,chudgooo,,1,1,6,7
17408,MC-Master-Bedroom,,1,40,45,85
17409,sirormadame,,1,408,644,1052
17410,fitfreak,,1,3,1,4
17411,Skeeter19,,1,14,3,17
17412,F4ion1,,1,1,1,2
17413,thetickisblue,,1,7,13,20
17414,indigocc,,1,26,19,45
17415,dimensional_dan,,1,46,82,128
17416,BlackSails,,1,11,14,25
17417,dfbbjr,,1,4,2,6
17418,billyk,,1,1,6,7
17419,bootsinowski,,1,4,5,9
17420,Cody2,,1,11,17,28
17421,motch,,1,1,5,6
17422,hubris,,1,1,1,2
17423,jgagnon,,1,2,8,10
17424,deckman,,1,418,270,688
17425,pvidler,,1,16,31,47
17426,ac3raven,,1,31,35,66
17427,triangles,,1,1,1,2
17428,davidcthompson,,1,1,5,6
17429,gubatron,,1,12,10,22
17430,Pushkin23,,1,72,22,94
17431,gmcg_abidesII,,1,560,684,1244
17432,Bakrain,,1,50,94,144
17433,chordonblue,,1,60,72,132
17434,sarcastro,,1,4,12,16
17435,bithead,,1,650,985,1635
17436,tialys,,1,4,5,9
17437,sherlok,,1,114,119,233
17438,glnkb,,1,1,1,2
17439,KazamaSmokers,,1,1563,1490,3053
17440,sallah,,1,5,2,7
17441,MyPantsAreWet,,1,37,88,125
17442,gethought,,1,7,10,17
17443,iritanium,,1,63,3,66
17444,kuhlmanngj,,1,6,9,15
17445,ch1xx0r,,1,7,3,10
17446,kobes,,1,61,92,153
17447,Dazureus,,1,11,17,28
17448,mandolinpicker,,1,39,63,102
17449,inaciog,,1,3,3,6
17450,LordSlashstab,,1,68,213,281
17451,auspex,,1,1,3,4
17452,Teoti,,1,15,50,65
17453,rgawenda,,1,17,32,49
17454,dyncon,,1,26,30,56
17455,eldertaco,,1,14,16,30
17456,0rca,,1,21,17,38
17457,octavious,,1,2,8,10
17458,BaconUpThatSausage,,1,2,1,3
17459,DENelson83,,1,16,43,59
17460,litebright,,1,1,1,2
17461,alaric1224,,1,113,50,163
17462,eheheh,,1,3,5,8
17463,Darrin-J-Viccione,,1,1,1,2
17464,blinkenlightz,,1,13,3,16
17465,jon_titor,,1,1430,2517,3947
17466,dustwads_101,,1,10,31,41
17467,kuruptr,,1,128,20,148
17468,anoncoward101,,1,325,161,486
17469,typicalatypical,,1,15,8,23
17470,kwangqengelele,,1,43,68,111
17471,mrwormwood,,1,1,1,2
17472,reltuk,,1,5,3,8
17473,Aybraus,,1,53,77,130
17474,_tornado_,,1,18,10,28
17475,dr_root,,1,57,83,140
17476,SilverliningSB,,1,1,1,2
17477,postrad,,1,5,3,8
17478,Ramulus16,,1,1,2,3
17479,hotlemon,,1,17,33,50
17480,fraser11,,1,7,8,15
17481,ZuSpat,,1,9,24,33
17482,Shimbouzi,,1,1,3,4
17483,mmiiss,,1,1,4,5
17484,Apox66,,1,93,115,208
17485,Hypnotod,,1,5,7,12
17486,samp,,1,81,67,148
17487,silverwolfe,,1,13,17,30
17488,LazyWolfman,,1,301,190,491
17489,wvenable,,1,18,22,40
17490,Factran,,1,1,1,2
17491,antonius_block,,1,4,6,10
17492,shniken,,1,775,388,1163
17493,Megakazbek,,1,43,34,77
17494,Gaylard,,1,17,29,46
17495,Random_Username,,1,18,19,37
17496,Adqam,,1,63,75,138
17497,rickyspears,,1,2,3,5
17498,Shiggityx2,,1,79,120,199
17499,jensenw,,1,18,23,41
17500,manbefree,,1,40,29,69
17501,PenName,,1,445,104,549
17502,nehpets,,1,28,3,31
17503,perlandsen,,1,2,3,5
17504,vlabakje,,1,9,5,14
17505,neohx_7,,1,2,4,6
17506,jaw762,,1,1,2,3
17507,zeco,,1,81,62,143
17508,rkhoyh,,1,2,3,5
17509,ashishkh,,1,1,1,2
17510,Tivmic,,1,3,4,7
17511,fakeredditaccount,,1,1,3,4
17512,ewokskick,,1,46,48,94
17513,ammut,,1,43,59,102
17514,cygnosis,,1,2,1,3
17515,cwy,,1,36,17,53
17516,JesseOnReddit3,,1,410,502,912
17517,eroevo,,1,15,1,16
17518,ioi,,1,2,1,3
17519,ourmet,,1,2,1,3
17520,Wengchun,,1,94,1,95
17521,nmarchet,,1,1,1,2
17522,vima,,1,1,2,3
17523,lbyrd6,,1,1,1,2
17524,graverubber,,1,1,1,2
17525,extempore42,,1,1,1,2
17526,KaseyKasem,,1,41,53,94
17527,behanger,,1,92,45,137
17528,thothamon,,1,5,5,10
17529,ima_coder,,1,5,12,17
17530,flappymcflappypants,,1,18,12,30
17531,webdoodle,,1,202,7,209
17532,kfury,,1,76,46,122
17533,hydraxis,,1,12,25,37
17534,Khaaaaaan,,1,1,1,2
17535,ed-admin,,1,24,8,32
17536,johnwastson11218,,1,1,1,2
17537,mason55,,1,4,9,13
17538,micro506,,1,2,2,4
17539,bluequail,,1,472,1260,1732
17540,undertow,,1,3,4,7
17541,emelpy,,1,19,17,36
17542,stun,,1,1,1,2
17543,supplyandcommand,,1,3,16,19
17544,hexed,,1,20,20,40
17545,monototo,,1,3,6,9
17546,imsteve22,,1,17,40,57
17547,carlthejumper,,1,6,4,10
17548,richardma00,,1,2,4,6
17549,crapuser371,,1,28,20,48
17550,inmatarian,,1,84,147,231
17551,affliction,,1,1,9,10
17552,xmarxspot,,1,1,6,7
17553,shemule,,1,4,20,24
17554,yvelle,,1,10,19,29
17555,zorroplata,,1,1,2,3
17556,decorral,,1,1,1,2
17557,zaqwer,,1,1,1,2
17558,speedmaster,,1,53,2,55
17559,vic42482,,1,303,37,340
17560,mnsugi,,1,43,48,91
17561,djspray,,1,48,100,148
17562,redditex2,,1,16,51,67
17563,skipperdoo,,1,2,2,4
17564,shalabh,,1,3,7,10
17565,sivananda,,1,2,3,5
17566,Alvin666,,1,1,2,3
17567,PeEll,,1,3,2,5
17568,blisar,,1,1,1,2
17569,hellfish,,1,247,238,485
17570,internationale,,1,25,25,50
17571,revjrbobdodds,,1,2,7,9
17572,olaf_peterson,,1,1,1,2
17573,JustOneWord,,1,9,37,46
17574,mtulia,,1,4,5,9
17575,Rieuxx,,1,27,18,45
17576,giapet,,1,1,3,4
17577,vbh61422,,1,7,14,21
17578,fakeaccount2,,1,4,3,7
17579,sets13,,1,7,3,10
17580,Nibaritone,,1,17,13,30
17581,mike774,,1,2,10,12
17582,monkey_zen,,1,190,131,321
17583,jaguar92,,1,2,1,3
17584,huima,,1,4,11,15
17585,MasterManipulator,,1,2,2,4
17586,dog_banger,,1,2,5,7
17587,beginner,,1,17,35,52
17588,paul41982,,1,2,1,3
17589,leviself,,1,18,3,21
17590,wobblebonk,,1,5,7,12
17591,QuestionObama,,1,24,6,30
17592,gkaukola,,1,2,8,10
17593,vilaca,,1,5,18,23
17594,banditoitaliano,,1,97,107,204
17595,bstone17,,1,3,6,9
17596,PibbTibbs,,1,13,11,24
17597,rekka,,1,25,28,53
17598,kylebaked,,1,7,4,11
17599,trickyphillips,,1,15,1,16
17600,shipwrecker,,1,1,1,2
17601,RonaldHartman,,1,4,8,12
17602,AnarkeIncarnate,,1,9,13,22
17603,redtit,,1,6,5,11
17604,abcd,,1,1,1,2
17605,nuggetchap,,1,20,20,40
17606,aneeley,,1,10,20,30
17607,redrom,,1,1,1,2
17608,bizzykehl,,1,225,197,422
17609,hwerdna,,1,7,8,15
17610,omicron8,,1,33,29,62
17611,RodionsRache,,1,4,6,10
17612,qenbirqeni,,1,5,2,7
17613,adavies42,,1,3,3,6
17614,cesarosummary,,1,4,3,7
17615,huntmaster,,1,1,5,6
17616,tuskefege,,1,1,1,2
17617,chefjulia,,1,1,3,4
17618,amnezia,,1,397,431,828
17619,Xenthan,,1,20,64,84
17620,Ritchell,,1,45,36,81
17621,jk4net,,1,11,1,12
17622,misterjoker,,1,5,6,11
17623,realgame84,,1,8,1,9
17624,b3nj4m,,1,2,1,3
17625,jaegerian,,1,7,5,12
17626,crybelovedcountry,,1,1,1,2
17627,eightysix,,1,39,17,56
17628,guessishould,,1,2,1,3
17629,kevinweb55,,1,59,3,62
17630,zxxx,,1,2,2,4
17631,CircusMaximo,,1,2,1,3
17632,mrkyle72,,1,1,3,4
17633,grosvenor,,1,137,104,241
17634,jsares,,1,1,2,3
17635,chromehound47,,1,55,90,145
17636,curtisw,,1,231,374,605
17637,Nuggit,,1,17,28,45
17638,murx,,1,7,10,17
17639,silentscape,,1,1,1,2
17640,man_from_nantucket,,1,4,3,7
17641,natesavestheday,,1,4,5,9
17642,PogoPoutine,,1,28,13,41
17643,dontal,,1,30,59,89
17644,gcandela,,1,55,93,148
17645,slartibartfast75,,1,1,1,2
17646,fooshoe,,1,3,4,7
17647,DuquanWeems,,1,1,1,2
17648,chewybass,,1,29,32,61
17649,edwin,,1,9,10,19
17650,NoSalt,,1,997,1524,2521
17651,mattmahon,,1,8,7,15
17652,Lighting,,1,284,44,328
17653,Keri29,,1,5,6,11
17654,figley,,1,76,10,86
17655,loonytoad,,1,132,42,174
17656,Ilici,,1,4,3,7
17657,cainmadness,,1,5,4,9
17658,zaidr,,1,1,7,8
17659,anodari,,1,12,20,32
17660,bigshum,,1,11,17,28
17661,brave_heart,,1,8,44,52
17662,flamingmb,,1,9,7,16
17663,Togakangaroo,,1,81,18,99
17664,NattyBumppo,,1,46,26,72
17665,jlrobins_uncc,,1,1,3,4
17666,tavago1,,1,1,3,4
17667,VincentVega12,,1,167,245,412
17668,PainIsMyFreind,,1,1,2,3
17669,reader,,1,4,3,7
17670,fallacious,,1,118,162,280
17671,ch1d3th,,1,10,5,15
17672,AmericanElephant,,1,37,2,39
17673,Justintoxicated,,1,18,43,61
17674,deep_thinker,,1,21,45,66
17675,bus3nsc,,1,189,227,416
17676,Wokcus,,1,24,42,66
17677,rogpeppe,,1,2,3,5
17678,localmaximum,,1,3,5,8
17679,Rachel69,,1,16,4,20
17680,ctrocks,,1,7,5,12
17681,TheMagoozer,,1,121,106,227
17682,bs9tmw,,1,33,39,72
17683,sevans59,,1,7,10,17
17684,iamhrh,,1,5,7,12
17685,schmecky,,1,60,124,184
17686,pbogatsky,,1,2,2,4
17687,zoephoenix,,1,12,19,31
17688,thombrady,,1,3,11,14
17689,tjdziuba,,1,466,552,1018
17690,dec10,,1,44,56,100
17691,pocketpencil,,1,3,4,7
17692,qpdb,,1,1,2,3
17693,wtfjoel,,1,21,2,23
17694,NOLAsigma,,1,2,1,3
17695,RandomWords,,1,2,3,5
17696,driftware,,1,1,3,4
17697,theodoregray,,1,3,7,10
17698,jergens,,1,104,202,306
17699,karacho,,1,49,9,58
17700,bobraham,,1,2,11,13
17701,srulik001,,1,2,4,6
17702,OpT1mUs,,1,6,8,14
17703,ba3boos,,1,1,1,2
17704,CAPSLOCKED,,1,91,83,174
17705,irrelative,,1,85,40,125
17706,starbuck2,,1,73,29,102
17707,faintdeception,,1,85,126,211
17708,lukelephant,,1,6,5,11
17709,zorlack,,1,94,78,172
17710,pennyroyal,,1,4,8,12
17711,qotile,,1,15,10,25
17712,Abaaba,,1,1,2,3
17713,borland,,1,10,7,17
17714,citizen511,,1,34,60,94
17715,lostintime,,1,1,1,2
17716,rsn112,,1,64,87,151
17717,netgear1,,1,10,4,14
17718,p-smith,,1,3,5,8
17719,acvterr,,1,3,5,8
17720,nsfwdreamer,,1,145,33,178
17721,dan525,,1,168,90,258
17722,the_nil,,1,8,19,27
17723,chemprofmatt,,1,1,1,2
17724,WritertotheWorld,,1,2,1,3
17725,Valkyrie1234,,1,5,13,18
17726,arkx,,1,16,12,28
17727,dani,,1,72,20,92
17728,ceqw4o8b,,1,9,17,26
17729,westlib,,1,614,456,1070
17730,Kadin2048,,1,105,170,275
17731,toddtyrtle,,1,11,8,19
17732,enki,,1,92,16,108
17733,ewokjedi,,1,104,190,294
17734,psyno,,1,83,168,251
17735,lovebandit,,1,868,160,1028
17736,Unbound,,1,10,1,11
17737,thef1sh,,1,4,1,5
17738,iiiiiooooo,,1,1,1,2
17739,theseusastro,,1,193,335,528
17740,springfawn,,1,62,148,210
17741,stefanrusek,,1,36,17,53
17742,bastardoperator,,1,1,3,4
17743,artgreen,,1,3,3,6
17744,donger,,1,1,1,2
17745,ErikDaReddit,,1,2,4,6
17746,Synthetik,,1,55,61,116
17747,nick09,,1,2,3,5
17748,subesc,,1,56,85,141
17749,moskaudancer,,1,201,321,522
17750,magnav0x,,1,21,34,55
17751,antisocialite,,1,1,5,6
17752,jenna_malia,,1,6,1,7
17753,McCain08,,1,46,56,102
17754,PaulRay,,1,108,206,314
17755,rationalreflections2,,1,2,1,3
17756,SSJDouche,,1,4,1,5
17757,fktubby,,1,10,1,11
17758,steppenfox,,1,2,2,4
17759,oblivion95,,1,60,105,165
17760,jwalk,,1,65,71,136
17761,glottis,,1,59,69,128
17762,iancwishlist,,1,2,6,8
17763,pebrain66,,1,12,32,44
17764,InfinateJane,,1,200,178,378
17765,sempf,,1,101,146,247
17766,bangsilverhammer,,1,4,1,5
17767,Permagrin,,1,1,3,4
17768,Expez,,1,1,2,3
17769,kucinichFTW,,1,1,1,2
17770,LoKi128,,1,18,18,36
17771,Atomsk0042,,1,6,1,7
17772,jharlequin,,1,2,3,5
17773,normality_inc,,1,12,8,20
17774,ProudAmerican1,,1,2,1,3
17775,docomo,,1,283,97,380
17776,qu6767,,1,1,4,5
17777,kmunse,,1,3,7,10
17778,mattletron,,1,18,43,61
17779,ImAFriendlyGuy,,1,628,168,796
17780,keldy,,1,1,5,6
17781,Malaclypze,,1,2,2,4
17782,TopherT,,1,51,60,111
17783,kp2575,,1,591,62,653
17784,lobsterrocket,,1,4,2,6
17785,megawhiz,,1,8,9,17
17786,mobekigala,,1,301,4,305
17787,jggube,,1,17,14,31
17788,Rayge,,1,3,7,10
17789,NoMoreNicksLeft,,1,2818,4155,6973
17790,girlvinyl,,1,116,124,240
17791,red18hawk,,1,25,54,79
17792,megaman821,,1,9,1,10
17793,ShaneFalco,,1,1,5,6
17794,zhx,,1,61,56,117
17795,greenbes,,1,3,6,9
17796,desertc,,1,4,1,5
17797,92873893474,,1,13,12,25
17798,fatpat,,1,3,5,8
17799,oglu,,1,1,2,3
17800,temp_anon_account,,1,1,1,2
17801,batiste,,1,47,32,79
17802,stefbra,,1,2,5,7
17803,apowers,,1,295,342,637
17804,drinktomeonly,,1,12,8,20
17805,abrahamhlincoln,,1,3,10,13
17806,veresp,,1,47,1,48
17807,drdrewfus,,1,2,6,8
17808,buzzedition,,1,1,1,2
17809,sllouis,,1,2,5,7
17810,alphabetagamma,,1,23,61,84
17811,delphonso,,1,9,7,16
17812,uberalles2,,1,31,30,61
17813,titan88c,,1,18,4,22
17814,l0c0dantes,,1,27,32,59
17815,NUNick06,,1,1,1,2
17816,lokiexinferis,,1,20,8,28
17817,ph34rb0t,,1,8,14,22
17818,capriceclassic,,1,303,130,433
17819,tony_vipros,,1,2,2,4
17820,ohell,,1,4,3,7
17821,cyber_rigger,,1,437,773,1210
17822,smenger,,1,2,1,3
17823,celphafiael,,1,3,5,8
17824,thuper,,1,9,20,29
17825,czernyman,,1,23,23,46
17826,threecheersfornick,,1,1,3,4
17827,klibbersoo,,1,15,35,50
17828,IgnatiousReilly,,1,321,148,469
17829,jaymz168,,1,56,129,185
17830,stokedone,,1,13,14,27
17831,Wonton,,1,1,1,2
17832,whitross,,1,6,3,9
17833,operativ3,,1,1,3,4
17834,5tevef,,1,5,4,9
17835,stevegasm,,1,8,11,19
17836,WilmaM,,1,3,1,4
17837,megafreedom,,1,53,56,109
17838,Goeran,,1,480,109,589
17839,mshiltonj,,1,193,382,575
17840,moon,,1,5,6,11
17841,mmazing,,1,499,663,1162
17842,oscabat,,1,35,76,111
17843,dani0100,,1,31,11,42
17844,comocomo,,1,1,4,5
17845,oreng,,1,345,501,846
17846,wsppan,,1,10,9,19
17847,karstens_rage,,1,26,36,62
17848,chronicdisorder,,1,25,38,63
17849,lskkdfjs,,1,4,2,6
17850,meer,,1,4,11,15
17851,roppery,,1,1,2,3
17852,eatingorange,,1,1,3,4
17853,XblackX,,1,2,1,3
17854,glap1922,,1,6,7,13
17855,warner62,,1,20,33,53
17856,rob_dimarco,,1,4,2,6
17857,voldosnort,,1,10,4,14
17858,paradisefound,,1,29,47,76
17859,SpartanJ,,1,2,1,3
17860,dO_ob,,1,6,7,13
17861,cherrios_salad,,1,30,64,94
17862,JamesR,,1,3,3,6
17863,klaengur,,1,39,95,134
17864,cartoon_nate,,1,13,13,26
17865,kss123,,1,4,5,9
17866,TheAFactor22,,1,4,8,12
17867,acid77,,1,3,6,9
17868,killiansman,,1,6,13,19
17869,noahlt,,1,89,47,136
17870,sarehu,,1,5,7,12
17871,motionSymmetry,,1,2,3,5
17872,lauri,,1,42,1,43
17873,rudemaniac,,1,9,9,18
17874,ScrollMaker,,1,4,10,14
17875,bcrossman,,1,2,2,4
17876,evohollywood,,1,5,3,8
17877,Paxalot,,1,50,69,119
17878,superic,,1,1,3,4
17879,jdalkdfjad,,1,20,38,58
17880,ZaoGao,,1,2,8,10
17881,stuartpidd,,1,12,30,42
17882,VibratingClownShit,,1,1,2,3
17883,Awoody87,,1,2,8,10
17884,kpkristy,,1,32,43,75
17885,saxxtreme,,1,4,2,6
17886,marcoporno,,1,25,15,40
17887,NSNick,,1,68,164,232
17888,evan,,1,6,2,8
17889,kanzenryu,,1,32,6,38
17890,sad_panda,,1,111,144,255
17891,lisalove,,1,28,18,46
17892,pytechd,,1,22,40,62
17893,IAmARobot,,1,11,19,30
17894,mrdingdong,,1,31,10,41
17895,devinus,,1,22,15,37
17896,SacrificialGoat,,1,356,586,942
17897,matthewcieplak,,1,83,136,219
17898,akezf,,1,1,2,3
17899,tintub,,1,67,100,167
17900,endtwist,,1,7,2,9
17901,LA-Punk,,1,7,15,22
17902,jcjasmin,,1,44,51,95
17903,re182x,,1,2,9,11
17904,mastercook,,1,18,30,48
17905,reddit528,,1,1,1,2
17906,bsergean,,1,52,98,150
17907,prince373,,1,3,1,4
17908,masaruproject,,1,1,11,12
17909,tetask,,1,1,1,2
17910,fasdfadsf,,1,3,2,5
17911,zakhar,,1,3,5,8
17912,z4r4thustr4,,1,13,23,36
17913,ironfroggy_,,1,4,5,9
17914,ionlion,,1,3,1,4
17915,fibbery,,1,135,148,283
17916,avonbarksdale,,1,23,13,36
17917,johnyaya137,,1,14,14,28
17918,Gamboholic,,1,1,4,5
17919,HolyJuan,,1,467,211,678
17920,DaveUNC,,1,20,2,22
17921,JeremyStein,,1,2,6,8
17922,krh,,1,42,66,108
17923,mortis,,1,1,1,2
17924,stu091,,1,3,5,8
17925,anthonymckay,,1,23,30,53
17926,reborndead,,1,16,21,37
17927,Joseppi,,1,55,152,207
17928,pedroelbee,,1,14,11,25
17929,coldacid,,1,100,110,210
17930,bennymangina,,1,1,1,2
17931,psyonic,,1,44,90,134
17932,Apaulo,,1,106,114,220
17933,catmckinney,,1,1,3,4
17934,apostrophes,,1,5,5,10
17935,docid,,1,186,328,514
17936,clay,,1,2,1,3
17937,shmifaats,,1,1,2,3
17938,theconformyst,,1,2,3,5
17939,cogwheim,,1,6,5,11
17940,Zooph,,1,16,27,43
17941,farkinga,,1,1,1,2
17942,PrinceAuryn,,1,2,2,4
17943,Lameretardant,,1,37,72,109
17944,JohnInMableton,,1,29,58,87
17945,AdamPearlman,,1,6,29,35
17946,SyntaxPolice,,1,9,9,18
17947,seektruth,,1,73,24,97
17948,flakey,,1,2,6,8
17949,assidic,,1,2,2,4
17950,kiru1983,,1,2,3,5
17951,bennthewolfe,,1,2,1,3
17952,borsodas,,1,2,4,6
17953,dpatru,,1,7,12,19
17954,appleb0y,,1,1,4,5
17955,ajrw,,1,260,378,638
17956,vivienashley,,1,7,1,8
17957,jeffus,,1,5,2,7
17958,dying_sphynx,,1,5,1,6
17959,lukeydukey,,1,76,76,152
17960,summersjss,,1,1,1,2
17961,Neoro,,1,4,4,8
17962,Daleeburg,,1,148,157,305
17963,shivax,,1,1,4,5
17964,cypherx,,1,400,491,891
17965,srslyorg,,1,5,3,8
17966,demigod186,,1,11,6,17
17967,AuburnTigers,,1,1,1,2
17968,andrewmin,,1,45,6,51
17969,ksalley,,1,38,43,81
17970,PhiLLyinDaLLaS,,1,1,10,11
17971,bunnies501,,1,39,31,70
17972,homelessvet,,1,1,1,2
17973,richsim,,1,2,2,4
17974,LibertyOne,,1,128,75,203
17975,schneby,,1,128,123,251
17976,Tesladownunder,,1,1,1,2
17977,hattifattener,,1,13,16,29
17978,atom138,,1,6,2,8
17979,votedforwar,,1,30,40,70
17980,blueant1,,1,21,40,61
17981,trollbane,,1,1,1,2
17982,pedahzur,,1,28,28,56
17983,prodeath,,1,278,404,682
17984,itsnotlupus,,1,728,1164,1892
17985,99cent,,1,13,37,50
17986,silverbullet85,,1,18,31,49
17987,barbazul,,1,1,1,2
17988,alman1,,1,2,3,5
17989,dtommf,,1,9,8,17
17990,anonymousperv,,1,14,32,46
17991,Boones,,1,2,2,4
17992,kiwidave,,1,104,113,217
17993,dangauthier,,1,4,2,6
17994,dodgyc,,1,53,65,118
17995,garywiley,,1,27,37,64
17996,MelechRic,,1,182,182,364
17997,mbredditor,,1,69,54,123
17998,absenthanded,,1,1,1,2
17999,Quickdood,,1,3,3,6
18000,bassmrod,,1,41,40,81
18001,knight_47,,1,7,7,14
18002,thezoner,,1,19,1,20
18003,labajada,,1,33,20,53
18004,push40hex,,1,10,11,21
18005,wobzire,,1,16,57,73
18006,Man_or_Monster,,1,1,1,2
18007,barb_s13,,1,1,1,2
18008,physt,,1,3,2,5
18009,jamesshuang,,1,210,244,454
18010,zrail,,1,7,23,30
18011,wagthesam,,1,47,24,71
18012,redwards,,1,2,9,11
18013,seabasss,,1,1,1,2
18014,tvKloDqI,,1,1,2,3
18015,soulajax,,1,284,347,631
18016,Obligatory_Woosh,,1,1,3,4
18017,assfck,,1,16,20,36
18018,jsdvnc,,1,13,13,26
18019,adnam,,1,5,2,7
18020,siekosunfire,,1,9,20,29
18021,broken_heart_11,,1,5,1,6
18022,tikster,,1,1,1,2
18023,Txiasaeia,,1,65,52,117
18024,Caper8888,,1,16,12,28
18025,Illyr,,1,27,38,65
18026,smarker,,1,16,2,18
18027,AbleBaker,,1,9,31,40
18028,GAMEOVER,,1,60,57,117
18029,fRANkENChRiST,,1,1,2,3
18030,thespoon,,1,46,49,95
18031,Tl-lomas,,1,7,15,22
18032,ubergeek42,,1,1,1,2
18033,JamesVII,,1,2,2,4
18034,derekkraan,,1,7,5,12
18035,Glorificus,,1,223,208,431
18036,bywndr,,1,5,5,10
18037,dasch,,1,1,3,4
18038,riverguardian,,1,16,1,17
18039,Number86,,1,62,27,89
18040,sga65,,1,3,1,4
18041,elijahsnow,,1,1,1,2
18042,rhammonsster,,1,10,33,43
18043,hcl4,,1,28,14,42
18044,Toneloak,,1,8,13,21
18045,agvotv,,1,2,1,3
18046,tlogank,,1,1,3,4
18047,trippin113,,1,54,13,67
18048,Valkarie70,,1,7,12,19
18049,Imagineti,,1,166,6,172
18050,guey80,,1,85,25,110
18051,stepasha,,1,1,1,2
18052,2eeaarrgh,,1,8,19,27
18053,andrewcooke,,1,16,29,45
18054,discsid,,1,49,80,129
18055,sushionagrill,,1,1,1,2
18056,syntheticfaith,,1,12,10,22
18057,jxc,,1,6,14,20
18058,MeepZero,,1,1,2,3
18059,smittybacker24,,1,1,1,2
18060,nsfw77,,1,13,2,15
18061,omegian,,1,341,499,840
18062,wonboodoo,,1,15,14,29
18063,genebo,,1,2,1,3
18064,elliot42,,1,2,3,5
18065,macmulberry,,1,17,18,35
18066,bobloblawballs,,1,8,19,27
18067,n-space,,1,23,27,50
18068,catsfive,,1,9,21,30
18069,hiredgoon,,1,744,868,1612
18070,johnwyand,,1,6,8,14
18071,complicious,,1,107,15,122
18072,kishi,,1,113,192,305
18073,yomimashita,,1,1,3,4
18074,knifefighting,,1,1,1,2
18075,Brrr,,1,3,1,4
18076,mcrbids,,1,2,1,3
18077,soopsoopa,,1,4,2,6
18078,rdeml,,1,3,1,4
18079,aberant,,1,21,39,60
18080,crayz,,1,74,46,120
18081,bosse,,1,1,3,4
18082,thandar,,1,23,33,56
18083,aarbojohnson,,1,3,10,13
18084,drsco,,1,20,53,73
18085,tidder8,,1,5,1,6
18086,Emore,,1,12,8,20
18087,RamonaLittle,,1,10,11,21
18088,bobbybrown,,1,6,21,27
18089,erinosmon,,1,160,34,194
18090,debtkid,,1,243,21,264
18091,d166e8,,1,58,15,73
18092,owen454,,1,6,8,14
18093,blue148,,1,4,1,5
18094,spacepro,,1,1,1,2
18095,up234,,1,1,1,2
18096,brivera,,1,1,2,3
18097,kingnothing1,,1,4,9,13
18098,wenk,,1,2,1,3
18099,anon23452,,1,2,1,3
18100,Dudlington,,1,3,7,10
18101,robertbowerman,,1,4,4,8
18102,amore1,,1,4,2,6
18103,namin,,1,22,4,26
18104,thecmgeek,,1,5,4,9
18105,niyazpk,,1,39,5,44
18106,neilplatform1,,1,210,180,390
18107,sd2001,,1,1,2,3
18108,VinnyJents,,1,3,4,7
18109,sheepson_on_rails,,1,1,1,2
18110,mycatguinness,,1,8,2,10
18111,Monster10590,,1,1,10,11
18112,octophant,,1,7,4,11
18113,omnimon_X,,1,117,142,259
18114,explosion101,,1,4,9,13
18115,SaberTail,,1,2,6,8
18116,dcatalyst,,1,1,2,3
18117,Mietta2,,1,1,1,2
18118,flaminp00,,1,6,7,13
18119,ladypenelope,,1,3,1,4
18120,targetOO,,1,4,16,20
18121,PhntmStrke,,1,2,2,4
18122,ziiim,,1,7,9,16
18123,ryan251,,1,8,4,12
18124,bustlinSlug,,1,5,11,16
18125,Junyor,,1,2,1,3
18126,netsql2,,1,2,4,6
18127,gaberdine,,1,96,119,215
18128,Pawn05,,1,1,1,2
18129,Subnormal,,1,12,13,25
18130,MrOptimism,,1,2,7,9
18131,geekologist,,1,21,30,51
18132,recoil,,1,12,17,29
18133,eeeeeeeeeeeeeeeeeeee,,1,95,96,191
18134,donkeytime,,1,38,92,130
18135,jorgeortiz85,,1,4,4,8
18136,every,,1,2,1,3
18137,jebby,,1,8,18,26
18138,sbhansf,,1,13,3,16
18139,disinformationkiller,,1,2,14,16
18140,tweeks_3,,1,2,10,12
18141,Lineageholder,,1,1,1,2
18142,Adapter,,1,12,12,24
18143,xjarchaeologist,,1,16,35,51
18144,rhythmicidea,,1,481,555,1036
18145,n00blulz,,1,12,27,39
18146,IbnReddit,,1,300,180,480
18147,a9bejo,,1,59,3,62
18148,tme001,,1,18,39,57
18149,TheRoach,,1,7,8,15
18150,SgtGeek,,1,16,8,24
18151,sdfbaby,,1,32,16,48
18152,adkk,,1,11,11,22
18153,Skib,,1,23,29,52
18154,ghaitched,,1,322,43,365
18155,joshielevy,,1,2,1,3
18156,dorfsmay,,1,22,44,66
18157,discoraj,,1,1,2,3
18158,totalnutball,,1,1,4,5
18159,kcheng00,,1,1,3,4
18160,fuutott,,1,105,18,123
18161,quaterindie,,1,2,1,3
18162,hibernation9,,1,7,10,17
18163,JohnMichael,,1,1,1,2
18164,egypzee,,1,2,13,15
18165,simonmic,,1,2,2,4
18166,gduffy,,1,1,3,4
18167,Lizard,,1,400,404,804
18168,filterthing,,1,4,6,10
18169,plexxer,,1,10,12,22
18170,SubStack,,1,5,8,13
18171,rujadd,,1,3,6,9
18172,booyahweh,,1,36,2,38
18173,ryon,,1,3,1,4
18174,darktrge,,1,29,2,31
18175,deafmuteandretarded,,1,1,1,2
18176,punit,,1,3,2,5
18177,gekogeko,,1,1,3,4
18178,bball2,,1,7,11,18
18179,EmeraldGirl,,1,84,100,184
18180,venicerocco,,1,45,62,107
18181,Citizenchimp,,1,6,21,27
18182,goingtonycforbagels,,1,4,1,5
18183,dannyrelic,,1,21,1,22
18184,niggytardust2000,,1,151,306,457
18185,psychorabbit,,1,55,9,64
18186,torus,,1,6,9,15
18187,heavyrain,,1,102,149,251
18188,TBoneManBalls,,1,2,1,3
18189,JohnFrum,,1,64,87,151
18190,ereiter,,1,11,29,40
18191,bma,,1,2,5,7
18192,cToyos,,1,5,2,7
18193,frame,,1,4,14,18
18194,dergachev,,1,22,29,51
18195,Count_Fapula,,1,8,1,9
18196,rickysilk,,1,1,1,2
18197,tutash,,1,2,6,8
18198,jimarib,,1,13,27,40
18199,truebosko,,1,130,185,315
18200,bonyicecream,,1,30,34,64
18201,altrego99,,1,4,6,10
18202,tagiam,,1,1,1,2
18203,spilk,,1,545,861,1406
18204,fyl7999,,1,4,4,8
18205,khello,,1,39,38,77
18206,volida,,1,1,1,2
18207,ooooh_pick_me,,1,1,1,2
18208,MasterXen,,1,1,3,4
18209,gvim,,1,5,1,6
18210,karl-marks,,1,125,182,307
18211,savetheclocktower,,1,2,2,4
18212,refto,,1,25,38,63
18213,charlesd,,1,2,1,3
18214,crystalcastles,,1,57,114,171
18215,Smight,,1,984,1542,2526
18216,doomglobe,,1,20,40,60
18217,cyberandroid,,1,3,10,13
18218,gatorcountry,,1,57,60,117
18219,ryanchappell,,1,10,3,13
18220,watto,,1,46,4,50
18221,Captain-Obvious,,1,5,3,8
18222,e-string,,1,18,25,43
18223,sunkid,,1,847,229,1076
18224,spotta,,1,1,2,3
18225,DrK,,1,74,98,172
18226,DustD,,1,97,53,150
18227,NathanDavis,,1,39,6,45
18228,xtimesninety,,1,1,2,3
18229,gerald1,,1,17,3,20
18230,maxhully,,1,3,5,8
18231,anthonyflew,,1,7,7,14
18232,sybesis,,1,206,488,694
18233,norm_,,1,125,178,303
18234,MetroMPG,,1,1,4,5
18235,pagan_angel,,1,1,1,2
18236,gefla,,1,1,2,3
18237,nphinit,,1,35,48,83
18238,apatheticrebel,,1,7,11,18
18239,reddit_title_critic,,1,2,1,3
18240,Thinker10,,1,3,2,5
18241,MoebiusTripp,,1,47,91,138
18242,clemsonrocker,,1,1,3,4
18243,hashbrowncipher,,1,1,3,4
18244,kittyhawk,,1,2,2,4
18245,teddyrux,,1,31,46,77
18246,Notclevr,,1,66,85,151
18247,xsaac,,1,2,2,4
18248,Rothfeller,,1,5,12,17
18249,joe_pacific,,1,15,18,33
18250,zuff,,1,27,61,88
18251,radiosterilize,,1,6,5,11
18252,gordho,,1,16,30,46
18253,awblocker,,1,1,1,2
18254,SkeptiSys,,1,3,8,11
18255,porkrollrocket,,1,4,11,15
18256,technolope,,1,2,3,5
18257,btsdev,,1,1,1,2
18258,gabrielsaldana,,1,9,1,10
18259,Sovoobraznogo,,1,6,5,11
18260,ntlane2004,,1,68,102,170
18261,Vesonos,,1,181,93,274
18262,bl00w,,1,1,2,3
18263,davidpfitz,,1,23,26,49
18264,marlasinger,,1,2,4,6
18265,slapshot24,,1,1,5,6
18266,ri59,,1,64,75,139
18267,UnwashedMeme,,1,86,134,220
18268,BroadcastingBrain,,1,62,29,91
18269,mmoss181,,1,1,2,3
18270,gydhjihdr,,1,32,63,95
18271,MillardFillmore,,1,113,147,260
18272,Propaganja,,1,9,27,36
18273,boblk,,1,1,1,2
18274,volando34,,1,34,45,79
18275,Turd_Ferguson,,1,2,2,4
18276,Spl0it,,1,13,10,23
18277,epistemological,,1,10,5,15
18278,snapdeus,,1,3,5,8
18279,madhollywood,,1,50,17,67
18280,anglefire,,1,1,1,2
18281,sayslulu,,1,2,3,5
18282,atourino,,1,3,7,10
18283,redditors_unite,,1,2,1,3
18284,rogue,,1,8,13,21
18285,Code_Monkey,,1,54,74,128
18286,Drownthem,,1,48,76,124
18287,Jackyyy,,1,2,2,4
18288,gusevx,,1,66,122,188
18289,KimmoS,,1,9,19,28
18290,jenniwren,,1,4,2,6
18291,shark615,,1,163,185,348
18292,pfm,,1,1,1,2
18293,xurbia,,1,7,12,19
18294,figpetus,,1,151,243,394
18295,abillionistoomany,,1,163,150,313
18296,orbital,,1,42,65,107
18297,jkcunningham,,1,5,9,14
18298,janhamm3r,,1,37,78,115
18299,Snarky_Fucker,,1,3,2,5
18300,pertinentwires,,1,16,7,23
18301,ctown121,,1,16,31,47
18302,davidestroy,,1,3,4,7
18303,invisibleskydaddy,,1,1,2,3
18304,CaptainHaris,,1,2,1,3
18305,SnakeJG,,1,39,57,96
18306,clarkest,,1,4,5,9
18307,i_f_pillow_talk,,1,10,12,22
18308,mink78,,1,16,13,29
18309,Arkade,,1,9,18,27
18310,mossplant,,1,5,1,6
18311,vicaya,,1,32,35,67
18312,reverendchubbs,,1,5,3,8
18313,rogerallen,,1,7,8,15
18314,rulsky,,1,7,2,9
18315,percyx,,1,5,3,8
18316,MidKnight,,1,1,1,2
18317,danipen,,1,1,1,2
18318,astrobe,,1,11,28,39
18319,suaz4,,1,2,1,3
18320,wildmitchwalters,,1,5,8,13
18321,MrErr,,1,6,6,12
18322,steelaz,,1,3,4,7
18323,Klass,,1,18,26,44
18324,yozlet,,1,8,6,14
18325,Geraldine_Ferraro,,1,1,1,2
18326,marm0lade,,1,327,393,720
18327,Dallas442,,1,339,742,1081
18328,voilavoila,,1,186,89,275
18329,Vecheeso,,1,84,26,110
18330,Pacer,,1,87,94,181
18331,surfer6,,1,12,12,24
18332,TheCaterpillar,,1,81,117,198
18333,fubuvsfitch,,1,148,264,412
18334,Buck_MalibuLUVSDIK,,1,2,1,3
18335,rbridson,,1,1,1,2
18336,styxwade,,1,40,50,90
18337,AsianBoy,,1,3,1,4
18338,morleydresden,,1,34,38,72
18339,asdem,,1,1,1,2
18340,HyperSpaz,,1,47,75,122
18341,z00rat,,1,1,3,4
18342,gutflopper,,1,1,3,4
18343,Lycurgus,,1,7,16,23
18344,stretchpants,,1,2,2,4
18345,bcain,,1,8,9,17
18346,absurdity,,1,11,10,21
18347,RandomH3r0,,1,303,557,860
18348,earthtomb,,1,3,5,8
18349,tquiring,,1,3,3,6
18350,icechen1,,1,1,1,2
18351,jolpater,,1,1,1,2
18352,fulano,,1,4,3,7
18353,pslatt,,1,29,54,83
18354,skflead,,1,5,4,9
18355,killingthedream,,1,20,27,47
18356,Nurgle,,1,24,13,37
18357,drbrain,,1,27,43,70
18358,pbarmasher1,,1,2,1,3
18359,mike2312,,1,1,4,5
18360,dro0,,1,1,3,4
18361,felton9012,,1,2,1,3
18362,paloduro,,1,22,59,81
18363,VirSaturnA,,1,128,168,296
18364,ChancePhantasmo,,1,34,7,41
18365,2dimages,,1,1,1,2
18366,jda06,,1,2152,11,2163
18367,nraynaud,,1,21,30,51
18368,shivitz,,1,2,5,7
18369,rdunev,,1,2,3,5
18370,keanu-reeves,,1,1,1,2
18371,itail,,1,1,2,3
18372,pavi,,1,4,3,7
18373,pynewman,,1,9,20,29
18374,thematrix307,,1,35,3,38
18375,markreaves,,1,6,2,8
18376,redditer012,,1,2,1,3
18377,transparent,,1,10,14,24
18378,kraln,,1,39,15,54
18379,marcoil,,1,5,4,9
18380,FatPlastic,,1,2,1,3
18381,santo71,,1,80,47,127
18382,GORI_DUNK,,1,12,10,22
18383,Fanda,,1,4,5,9
18384,variods,,1,11,10,21
18385,epadafunk,,1,4,2,6
18386,iamp01,,1,28,42,70
18387,bflogeorge,,1,1,1,2
18388,djkillah,,1,3,3,6
18389,mrmessiah,,1,17,36,53
18390,walt87,,1,4,6,10
18391,bobbymcgee,,1,1,1,2
18392,doorrat,,1,97,26,123
18393,tony28,,1,170,224,394
18394,sammy_the_k,,1,29,57,86
18395,BoeV,,1,3,3,6
18396,zmaniacz,,1,27,43,70
18397,Vorlath,,1,24,42,66
18398,firewaterburns10,,1,1,3,4
18399,BarackOMoslem,,1,26,27,53
18400,bigj,,1,16,5,21
18401,nousplacidus,,1,10,2,12
18402,swinoner,,1,28,15,43
18403,galvana,,1,12,3,15
18404,BushmanBill,,1,2,8,10
18405,givanvliet,,1,2,1,3
18406,apathia,,1,5,7,12
18407,Aegelward,,1,4,6,10
18408,dante50,,1,296,181,477
18409,lumpycat,,1,5,10,15
18410,sir_real,,1,1,2,3
18411,jensbw,,1,7,1,8
18412,buffi,,1,295,321,616
18413,awesomo,,1,1,1,2
18414,javafreakin,,1,6,12,18
18415,mopheus,,1,131,46,177
18416,kvogt,,1,7,1,8
18417,spec209,,1,46,76,122
18418,redtuber420,,1,13,3,16
18419,HereBeDragons,,1,53,124,177
18420,SpiritBreaker,,1,16,9,25
18421,reasonb,,1,1,3,4
18422,pjcsoundsystem,,1,2,3,5
18423,death_egg,,1,44,48,92
18424,conman16x,,1,191,129,320
18425,MidnightTurdBurglar,,1,448,431,879
18426,forbin2k,,1,39,11,50
18427,Jonathan987,,1,2,5,7
18428,Hobart,,1,21,30,51
18429,phaylon,,1,42,101,143
18430,weiyin,,1,2,2,4
18431,j0d,,1,3,4,7
18432,Captanblue,,1,1,3,4
18433,nicesuckoutfish,,1,3,2,5
18434,redfox5,,1,4,5,9
18435,Maledictus,,1,1,1,2
18436,Kirsan,,1,1,1,2
18437,smek2,,1,748,882,1630
18438,JimboJet,,1,5,7,12
18439,jhnhines,,1,1,3,4
18440,evilsnail,,1,1,2,3
18441,ithasfourtoes,,1,11,14,25
18442,cooldude127,,1,11,22,33
18443,Insidium,,1,3,3,6
18444,stormers,,1,1,1,2
18445,eniko,,1,1,1,2
18446,arizona_man,,1,75,85,160
18447,HelpBeatCancer,,1,1,1,2
18448,bonerjams2k3,,1,157,397,554
18449,docforrester,,1,10,10,20
18450,pecunia,,1,1,1,2
18451,itisfritzz,,1,13,28,41
18452,ob_1,,1,2,1,3
18453,cicatrice,,1,2,1,3
18454,LordStrabo,,1,336,461,797
18455,monkeyshines,,1,102,29,131
18456,sfmission2001,,1,1,1,2
18457,zem,,1,1050,1845,2895
18458,masterbih,,1,30,2,32
18459,bodmodsnm,,1,1,10,11
18460,3434889,,1,118,117,235
18461,anthra22,,1,3,2,5
18462,MrsMicah,,1,29,9,38
18463,johnloves,,1,8,1,9
18464,clawoo,,1,364,88,452
18465,Spattie,,1,15,29,44
18466,ayanamifan,,1,13,15,28
18467,asymptotic,,1,21,32,53
18468,broon,,1,14,26,40
18469,masakatsu,,1,2,8,10
18470,Thehumanman,,1,1,2,3
18471,LeThor,,1,13,20,33
18472,Ba-Ba-Boosh,,1,105,28,133
18473,Weezer1223,,1,4,6,10
18474,ChrisHansenNBC,,1,1,1,2
18475,magnus91,,1,11,18,29
18476,arlanTLDR,,1,115,136,251
18477,moonzulu,,1,19,20,39
18478,fasteasyfree,,1,5,6,11
18479,anonymboy,,1,15,12,27
18480,KSpark,,1,90,97,187
18481,dunskwerk,,1,217,273,490
18482,kckman,,1,21,50,71
18483,nelsoncheung,,1,2,1,3
18484,newcows,,1,1,1,2
18485,StarCraft,,1,13,20,33
18486,dooresplat,,1,1,1,2
18487,dudemaster,,1,110,24,134
18488,edwardbc,,1,36,53,89
18489,dwelch91,,1,29,44,73
18490,fusedglass,,1,2,1,3
18491,manthrax,,1,517,1163,1680
18492,Palpz,,1,19,25,44
18493,tjdaybreak,,1,1,1,2
18494,ObamaRevolution,,1,2,1,3
18495,jedidave810,,1,1,2,3
18496,n4s33r,,1,22,15,37
18497,dradik,,1,3,2,5
18498,leevancleef,,1,122,182,304
18499,mrsample,,1,5,5,10
18500,koolkao,,1,36,45,81
18501,manila,,1,2,1,3
18502,truedoughca,,1,6,9,15
18503,Mindslide,,1,3,1,4
18504,newsfeed,,1,1,1,2
18505,pyoobs,,1,33,41,74
18506,alw111,,1,4,6,10
18507,grizdout,,1,24,2,26
18508,caramello623,,1,2,4,6
18509,ossworks,,1,1,1,2
18510,georgewashingtonblog,,1,4055,384,4439
18511,bj00rn,,1,18,34,52
18512,olivebeard,,1,5,2,7
18513,zephris,,1,22,34,56
18514,laffen,,1,4,3,7
18515,osipov,,1,450,189,639
18516,ThoughtNinja,,1,2,4,6
18517,homoiconic,,1,171,39,210
18518,ruined,,1,1,1,2
18519,twentyseventy,,1,10,14,24
18520,ghidra,,1,18,35,53
18521,olemissreb,,1,2,2,4
18522,mobiusrenoire,,1,1,3,4
18523,rocman9,,1,2,4,6
18524,seancanada,,1,1,1,2
18525,slizz,,1,17,4,21
18526,kingsqueen,,1,13,3,16
18527,a_little_perspective,,1,559,666,1225
18528,gaoshan,,1,431,433,864
18529,rhino369,,1,115,181,296
18530,angelessme,,1,29,42,71
18531,scottjames,,1,1,1,2
18532,oldmanHillarysbase,,1,3,1,4
18533,bg370,,1,83,109,192
18534,litosian,,1,1,1,2
18535,ziggyone,,1,3,2,5
18536,gabe_horn,,1,32,29,61
18537,diggapleaze,,1,24,2,26
18538,dimplemonkey,,1,44,88,132
18539,jzimo,,1,2,4,6
18540,integrii,,1,9,9,18
18541,oreonix,,1,2,2,4
18542,aresorli,,1,111,85,196
18543,heroofhyr,,1,4,6,10
18544,Gen_Jack_D_Ripper,,1,11,17,28
18545,braeden,,1,3,4,7
18546,ptarjan,,1,4,2,6
18547,cstew,,1,1,1,2
18548,beer_baron,,1,9,15,24
18549,pirsquared,,1,32,30,62
18550,jh0n,,1,13,12,25
18551,openedground,,1,4,10,14
18552,Thats_What_She_Said_,,1,2,1,3
18553,nononmous,,1,1,1,2
18554,c4g,,1,309,46,355
18555,Coffee2theorems,,1,24,29,53
18556,jjschnei,,1,251,202,453
18557,pbts27,,1,2,8,10
18558,dionidium,,1,13,11,24
18559,iobjectreality,,1,9,17,26
18560,abcdefghijklmn,,1,5,3,8
18561,muffin159,,1,2,1,3
18562,NinjaNine,,1,2,1,3
18563,epochcurrier,,1,6,7,13
18564,ziggity,,1,46,43,89
18565,rye419,,1,119,184,303
18566,jdot,,1,3,9,12
18567,chickensofdoom,,1,18,25,43
18568,treagan,,1,34,47,81
18569,neurad1,,1,27,53,80
18570,Garth28,,1,1,1,2
18571,greenstriper,,1,68,139,207
18572,dan16,,1,2,1,3
18573,Milo_OMalley,,1,62,24,86
18574,shatty56,,1,3,3,6
18575,pianowow,,1,3,5,8
18576,hoppersoft,,1,3,8,11
18577,Kaibot,,1,5,5,10
18578,chingalingaling,,1,4,4,8
18579,theinternet,,1,184,306,490
18580,djnasty,,1,3,2,5
18581,joazito,,1,23,49,72
18582,cnordholm,,1,24,19,43
18583,pcking1,,1,2,2,4
18584,CJBerri,,1,1,2,3
18585,dailyapplecrisp,,1,2,3,5
18586,phenom88,,1,2,4,6
18587,yellowdart,,1,66,58,124
18588,nerdymark,,1,33,33,66
18589,jux589,,1,28,23,51
18590,Kur0,,1,1,1,2
18591,WhiteWorm,,1,14,19,33
18592,ageddyn,,1,11,16,27
18593,TheCookieMonster,,1,55,67,122
18594,unk3mpt,,1,1,1,2
18595,timbur,,1,2,1,3
18596,trek42,,1,6,7,13
18597,norcalgordon,,1,3,6,9
18598,johonn,,1,15,25,40
18599,jeffiet,,1,4,2,6
18600,DEADB33F,,1,131,185,316
18601,goalieca,,1,274,385,659
18602,rtcrooks,,1,12,15,27
18603,Captain_Harlock,,1,51,144,195
18604,lardsink,,1,3,1,4
18605,rottle,,1,4,4,8
18606,velvetsmog,,1,1,4,5
18607,dawnerd,,1,247,440,687
18608,bbw1,,1,367,13,380
18609,munificent,,1,1170,1475,2645
18610,Britslayer,,1,629,1037,1666
18611,fontoon,,1,89,40,129
18612,yruoc,,1,26,39,65
18613,magpiesob,,1,2,10,12
18614,bfischer,,1,3,5,8
18615,goldfaber3012,,1,1,2,3
18616,hilaritydude,,1,3,1,4
18617,irishagua,,1,1,3,4
18618,flowlady,,1,1,1,2
18619,Wannamaker,,1,162,196,358
18620,matth1jd,,1,2,4,6
18621,zecob,,1,3,1,4
18622,DougBolivar,,1,1064,426,1490
18623,wnclittlelady,,1,1,1,2
18624,xxeyes,,1,231,102,333
18625,CaveHusband,,1,4,10,14
18626,anyonehearing,,1,1,1,2
18627,maybeyoushouldwork,,1,3,1,4
18628,djfrey,,1,28,27,55
18629,defska42,,1,1,2,3
18630,dqfriends,,1,4,21,25
18631,chmown,,1,142,98,240
18632,binderben,,1,5,7,12
18633,IAmWillIAm,,1,9,18,27
18634,TrailofDead,,1,28,26,54
18635,gersg,,1,1,1,2
18636,dbl5,,1,23,47,70
18637,NoHandle,,1,159,245,404
18638,alesine,,1,4,3,7
18639,muteh,,1,2,1,3
18640,unik,,1,1,2,3
18641,redvasily,,1,4,2,6
18642,Wizardface,,1,74,86,160
18643,fendale,,1,3,4,7
18644,DrShio,,1,28,4,32
18645,edmonal,,1,1,1,2
18646,Slavichild,,1,2,2,4
18647,syam1224,,1,45,9,54
18648,keystrokes,,1,19,1,20
18649,JZervas,,1,10,6,16
18650,muiknqa,,1,1,3,4
18651,Dwgystyl,,1,8,13,21
18652,boyy,,1,15,31,46
18653,somejan,,1,2,3,5
18654,dmiff,,1,468,703,1171
18655,praetorian42,,1,67,43,110
18656,fubarbaz,,1,105,160,265
18657,nic,,1,1,1,2
18658,BarackHObama,,1,1,1,2
18659,jonstark4,,1,133,202,335
18660,xXTDurdenXx,,1,1,1,2
18661,ddelrio,,1,28,46,74
18662,edpaget,,1,7,18,25
18663,Spike_Lee,,1,2,6,8
18664,ZeppelinJ0,,1,205,212,417
18665,o_0,,1,13,3,16
18666,enderpanda,,1,70,126,196
18667,parodygeek,,1,3,1,4
18668,BigStick,,1,35,18,53
18669,pkrel,,1,1,3,4
18670,rmtew,,1,3,14,17
18671,junkit33,,1,524,556,1080
18672,drdarkxl,,1,2,3,5
18673,Konquest,,1,23,14,37
18674,erik,,1,3,9,12
18675,bebopbalogna,,1,9,18,27
18676,irenedakota,,1,35,58,93
18677,disidentadvisor,,1,31,37,68
18678,Zero_Cool,,1,2,3,5
18679,Sadik,,1,146,271,417
18680,BLACKINFIDEL,,1,104,112,216
18681,Goonbaggins,,1,2,2,4
18682,rossini22,,1,5,4,9
18683,geofffox,,1,17,10,27
18684,witchwatchmom,,1,14,1,15
18685,andr3y,,1,27,66,93
18686,kolia_A,,1,17,16,33
18687,CreepyFootDr,,1,8,9,17
18688,bataggrant,,1,7,3,10
18689,colec,,1,22,19,41
18690,skycalling,,1,3,6,9
18691,I0I0I0I,,1,73,173,246
18692,UltraSlave,,1,5,1,6
18693,talibanjo,,1,36,39,75
18694,wonderworm,,1,55,113,168
18695,Rae-senpai,,1,16,26,42
18696,unknownsoldierx,,1,128,164,292
18697,ntewari,,1,3,1,4
18698,PetLvr,,1,45,5,50
18699,ArmenianBeardBuilder,,1,2,3,5
18700,hprry,,1,8,5,13
18701,0TheArtist,,1,2,2,4
18702,Pemulis,,1,4,3,7
18703,ecocentrik,,1,2,2,4
18704,penlies,,1,78,119,197
18705,jvin248,,1,1,2,3
18706,Hathery,,1,6,2,8
18707,Nefelia,,1,576,1161,1737
18708,MichaelsAMoron,,1,1,1,2
18709,windeva,,1,488,154,642
18710,antyg,,1,7,1,8
18711,DDDavinnn,,1,67,60,127
18712,maenor,,1,9,27,36
18713,secondkeeps,,1,7,1,8
18714,KickinPhresh,,1,4,4,8
18715,boxpop,,1,1,1,2
18716,YoungWise,,1,1,1,2
18717,the_amityville_fap,,1,3,1,4
18718,dudenotbombs,,1,15,14,29
18719,thedarkseid,,1,22,3,25
18720,madeinchina,,1,10,10,20
18721,Whitherby,,1,2,2,4
18722,rockefeller2,,1,155,172,327
18723,gunga,,1,4,10,14
18724,sweetdeals,,1,86,55,141
18725,calmlunatic,,1,2,7,9
18726,sandburn,,1,1,2,3
18727,Science_Rules,,1,6,5,11
18728,malderi,,1,6,4,10
18729,handlit33,,1,83,36,119
18730,MrSafe,,1,5,8,13
18731,michaelwong38,,1,70,75,145
18732,Yankeesfan,,1,15,1,16
18733,Jedit,,1,11,16,27
18734,anandy2,,1,1,1,2
18735,ToddieM,,1,3,2,5
18736,megagoosey,,1,46,56,102
18737,laurasmith76,,1,1,1,2
18738,cum_pussy_tits_ass,,1,46,61,107
18739,stubeloo,,1,17,23,40
18740,spyder99,,1,38,3,41
18741,nsfwalias,,1,1,1,2
18742,tripnik,,1,4,11,15
18743,archimboldo,,1,5,7,12
18744,Pimpwin,,1,4,8,12
18745,laughingboy1,,1,20,14,34
18746,painintheass,,1,4,2,6
18747,LadyLynn,,1,10,12,22
18748,Victor85,,1,3,3,6
18749,Montaz,,1,3,5,8
18750,futurcorerock,,1,10,8,18
18751,apple1nsider,,1,2,15,17
18752,kpanghmc,,1,9,1,10
18753,internet_outrage,,1,5,11,16
18754,flame,,1,6,1,7
18755,crane,,1,1,2,3
18756,brand_x,,1,2,1,3
18757,maddzy,,1,5,11,16
18758,paranox,,1,1,4,5
18759,manellis,,1,1,1,2
18760,andrewy,,1,8,5,13
18761,A_Thinker,,1,1,1,2
18762,SalahalDin,,1,33,64,97
18763,J_Moreau,,1,12,23,35
18764,monkeybomb,,1,44,77,121
18765,Eulogy,,1,74,36,110
18766,FeloniousHam,,1,1,2,3
18767,christianEarth,,1,2,2,4
18768,unearth52,,1,1,1,2
18769,tminionman,,1,16,19,35
18770,ThunderPreacher,,1,130,190,320
18771,MrAtheist,,1,1,1,2
18772,RebelWithoutASauce,,1,1,1,2
18773,gpalm,,1,29,54,83
18774,EGGPLANT12,,1,2,2,4
18775,Scully1981,,1,5,12,17
18776,siractsalot777,,1,4,7,11
18777,Fnerb,,1,21,8,29
18778,Atheist22,,1,80,94,174
18779,NunFur,,1,21,55,76
18780,macdermott,,1,1,1,2
18781,jtorjo,,1,2,1,3
18782,Ryveks,,1,37,36,73
18783,dildil,,1,1,2,3
18784,halcionDaze,,1,1,1,2
18785,justinlilysboss,,1,2,5,7
18786,georgeinwashington,,1,13,2,15
18787,TheWizard,,1,15,30,45
18788,viper565,,1,2,2,4
18789,photostyle,,1,1,1,2
18790,DetroitWonk,,1,3,1,4
18791,zzap,,1,2,5,7
18792,thomasthetanker,,1,86,83,169
18793,tundradesert,,1,1,1,2
18794,nation_nazi,,1,1,1,2
18795,ironman86,,1,5,10,15
18796,froggy000,,1,47,88,135
18797,extracelestial,,1,7,2,9
18798,Mextli,,1,13,28,41
18799,gmason007,,1,6,10,16
18800,ahavemeyer,,1,2,2,4
18801,taxman909,,1,7,1,8
18802,gunnarstaal,,1,1,1,2
18803,formerperson,,1,1,3,4
18804,hockeygoalie,,1,1,1,2
18805,pablosambuco,,1,1,1,2
18806,mommydaddy,,1,2,1,3
18807,anonposter1234,,1,2,2,4
18808,zgailgoodman,,1,1,1,2
18809,andiz,,1,26,27,53
18810,iubdfglisdubg,,1,10,11,21
18811,reveazure,,1,48,31,79
18812,Vincents_pistol,,1,1,1,2
18813,captbobalou,,1,16,22,38
18814,discy,,1,1,2,3
18815,buyutec,,1,10,9,19
18816,cAPTAINdYSLEXIC,,1,2,1,3
18817,natovision,,1,4,21,25
18818,meekamoo,,1,8,8,16
18819,Waterwoo,,1,2,1,3
18820,SellonQ,,1,1,1,2
18821,sarahcotto,,1,13,7,20
18822,TomA,,1,11,25,36
18823,ThatsPopetastic,,1,49,48,97
18824,souk,,1,5,7,12
18825,7805,,1,107,148,255
18826,darkskye,,1,2,1,3
18827,kingarooz,,1,20,48,68
18828,spiff142,,1,5,2,7
18829,mattmcknight,,1,1,1,2
18830,mOdQuArK,,1,376,685,1061
18831,ksan,,1,10,16,26
18832,capobodih,,1,49,7,56
18833,aretinoknows,,1,49,20,69
18834,Sylvyr,,1,3,6,9
18835,Pakars,,1,42,69,111
18836,djxanax,,1,2,3,5
18837,squaredup,,1,1,1,2
18838,stainlessnixon,,1,113,124,237
18839,valintin,,1,3,3,6
18840,dsmith49,,1,9,2,11
18841,heruz,,1,19,26,45
18842,maryummy,,1,17,2,19
18843,jbmigel,,1,10,16,26
18844,fidler,,1,2,7,9
18845,ltpl4y3r,,1,12,13,25
18846,LOLCAT,,1,20,59,79
18847,redalert,,1,264,18,282
18848,infamous,,1,16,33,49
18849,NiceGuyMike,,1,31,36,67
18850,crazedgremlin,,1,116,165,281
18851,benah188,,1,1,3,4
18852,mirkadel,,1,2,1,3
18853,lngshado,,1,1,1,2
18854,tehjarvis,,1,111,114,225
18855,rakeif,,1,8,8,16
18856,cartman81,,1,5,2,7
18857,dgmelski,,1,3,2,5
18858,Your_Boss,,1,1,1,2
18859,niftierthanthou,,1,5,4,9
18860,LegendOfHurleysGold,,1,6,11,17
18861,furyg3,,1,152,157,309
18862,azshade,,1,2,2,4
18863,geekhorde,,1,1,2,3
18864,ajamison,,1,3,3,6
18865,flybrand,,1,1,1,2
18866,stuhacking,,1,6,7,13
18867,shinyplasticbag,,1,17,33,50
18868,mdaconta,,1,5,2,7
18869,jhon2,,1,5,6,11
18870,paulajohnson,,1,47,26,73
18871,prox546,,1,44,65,109
18872,andrewinmelbourne,,1,345,535,880
18873,travis0868,,1,3,2,5
18874,J_McCain,,1,8,4,12
18875,truelements,,1,3,2,5
18876,davidsampson,,1,95,35,130
18877,Montyseven,,1,2,1,3
18878,jonnyhaze,,1,8,23,31
18879,bbmm,,1,11,15,26
18880,TVawser,,1,15,3,18
18881,ZOMG,,1,2,3,5
18882,sleastack,,1,91,150,241
18883,Corenth,,1,3,1,4
18884,Penrif,,1,7,19,26
18885,Invisiblechimp,,1,4,6,10
18886,battletoaster,,1,127,97,224
18887,pavlovs_dong,,1,1,8,9
18888,webtickle,,1,2,1,3
18889,interio,,1,8,4,12
18890,loser_the_user,,1,2,2,4
18891,DAllenJ,,1,27,20,47
18892,maltoodles,,1,3,1,4
18893,tenebrio_molitor,,1,3,8,11
18894,johnsgunn,,1,3,3,6
18895,Id-hit-it,,1,3,9,12
18896,thamiam,,1,7,7,14
18897,LouFigs13,,1,3,9,12
18898,stonelobster,,1,177,310,487
18899,mesjours,,1,36,2,38
18900,andrewl,,1,19,18,37
18901,jimmyikon,,1,1,2,3
18902,madhatter,,1,20,31,51
18903,nhall,,1,1,1,2
18904,jeserac,,1,89,1,90
18905,IntolerantFaith,,1,182,27,209
18906,SimonGray,,1,242,310,552
18907,leshiy,,1,434,590,1024
18908,dr_greenthumb,,1,8,7,15
18909,directrix1,,1,34,45,79
18910,tomatosoup,,1,77,90,167
18911,kevindicks,,1,8,1,9
18912,boothakr,,1,154,22,176
18913,Whig,,1,2,9,11
18914,5DGuy2,,1,3,6,9
18915,dredgedskeleton,,1,137,170,307
18916,nubbles,,1,1,8,9
18917,forumdrasl,,1,2,1,3
18918,RealEstateWiki,,1,9,14,23
18919,lalinoir,,1,7,12,19
18920,bradbrowndotcom,,1,48,90,138
18921,kramer99,,1,4,1,5
18922,periphery,,1,10,18,28
18923,dygital,,1,5,1,6
18924,plan17b1,,1,2,2,4
18925,sodaorseven,,1,8,4,12
18926,tedsan,,1,11,9,20
18927,ironictwist,,1,12,27,39
18928,blueboybob,,1,366,18,384
18929,unloud,,1,175,297,472
18930,daninjapan,,1,46,140,186
18931,Tir,,1,56,59,115
18932,allen3333,,1,18,13,31
18933,powercow,,1,37,57,94
18934,proinsias,,1,1,1,2
18935,Sentinell,,1,53,43,96
18936,achacha,,1,14,21,35
18937,johnnyq,,1,39,64,103
18938,mrdigital,,1,1,1,2
18939,daunas-daunelis,,1,1,2,3
18940,evilhero,,1,9,23,32
18941,vitalysh,,1,21,27,48
18942,zornedge,,1,17,23,40
18943,cescacosta,,1,2,1,3
18944,aname,,1,17,12,29
18945,rpfeynman,,1,4,5,9
18946,gregger101,,1,3,1,4
18947,brancamenta,,1,3,3,6
18948,rawl28,,1,10,5,15
18949,planck,,1,5,7,12
18950,Pixelpaws,,1,276,322,598
18951,Friedrich_Nietzsche,,1,2,6,8
18952,alnayyir,,1,8,15,23
18953,mileshalter,,1,12,7,19
18954,Vlux,,1,1,4,5
18955,FreddyT,,1,1,3,4
18956,zombiewat,,1,642,1169,1811
18957,ffaalzada,,1,29,3,32
18958,gpinn,,1,2,1,3
18959,jaredpar,,1,1,1,2
18960,alaskamiller,,1,1055,994,2049
18961,beatnik307,,1,25,31,56
18962,sam8854,,1,3,5,8
18963,TheArsenal,,1,48,7,55
18964,Le3f,,1,91,155,246
18965,meggersmeg,,1,6,3,9
18966,megerena,,1,1,3,4
18967,tssen,,1,3,10,13
18968,nny76,,1,31,51,82
18969,operatik,,1,1,1,2
18970,bombhand,,1,214,279,493
18971,rmeltg,,1,7,1,8
18972,MailShmail,,1,1,1,2
18973,freshest1,,1,2,1,3
18974,raspberry_bang,,1,1,1,2
18975,flyingcamel,,1,4,6,10
18976,dashx,,1,45,46,91
18977,OpenAlongEdge,,1,64,120,184
18978,RowingBear,,1,25,30,55
18979,digmark,,1,1,2,3
18980,StevoX,,1,4,1,5
18981,eightnine,,1,164,124,288
18982,blasphemonkey,,1,3,3,6
18983,thesinker,,1,38,60,98
18984,liquide820,,1,4,2,6
18985,kahirsch,,1,276,292,568
18986,godspeedandhow,,1,2,4,6
18987,philodox,,1,30,17,47
18988,suckpoppet,,1,42,58,100
18989,raiello,,1,44,70,114
18990,samzklub,,1,24,49,73
18991,diencephalon,,1,4,10,14
18992,Gioware,,1,53,83,136
18993,monkey0,,1,1,1,2
18994,Being_manny,,1,11,1,12
18995,gremlintaco,,1,8,5,13
18996,Anjin30,,1,7,3,10
18997,olivertweest,,1,1,1,2
18998,studioexpress,,1,1,2,3
18999,ndrury,,1,2,4,6
19000,Xig,,1,3,2,5
19001,AustinS,,1,4,8,12
19002,DnaDamage,,1,38,15,53
19003,mukiex,,1,17,27,44
19004,antoinehersen,,1,6,3,9
19005,tehpoopsmith,,1,107,58,165
19006,skigenator,,1,76,78,154
19007,nicliff,,1,1,1,2
19008,neverever,,1,137,211,348
19009,surleigh,,1,2,1,3
19010,thabc,,1,67,69,136
19011,lindsifer,,1,55,77,132
19012,adelosr1,,1,90,62,152
19013,statelypenguin,,1,2,2,4
19014,encryptor,,1,19,32,51
19015,Jonwilks,,1,3,7,10
19016,Trollkiller,,1,68,104,172
19017,daveGravell,,1,4,11,15
19018,LeGrandOiseau,,1,75,206,281
19019,xxrealmsxx,,1,24,38,62
19020,arudolph,,1,8,14,22
19021,thoph,,1,1,1,2
19022,kig0222,,1,5,8,13
19023,widmest,,1,2,4,6
19024,muddylemon,,1,1,13,14
19025,FearOfSuccess,,1,18,21,39
19026,fabiofzero,,1,17,35,52
19027,summerskl2,,1,2,1,3
19028,Samaal,,1,588,50,638
19029,IceAngels,,1,1,5,6
19030,wickermanstudios,,1,1,4,5
19031,SirCrumpet,,1,8,8,16
19032,jayk806,,1,4,3,7
19033,anonymousbiden,,1,53,32,85
19034,Osmondy,,1,15,1,16
19035,chimpo,,1,18,1,19
19036,modus,,1,66,112,178
19037,echeese,,1,15,23,38
19038,yoyoguy2,,1,5,1,6
19039,winmaclinblog,,1,3,1,4
19040,drewlew,,1,8,6,14
19041,newjob,,1,42,58,100
19042,cach-e,,1,23,38,61
19043,ahalenia,,1,2,5,7
19044,newzman,,1,43,1,44
19045,dt_vibe,,1,222,260,482
19046,facenoface,,1,15,1,16
19047,miameetza,,1,2,14,16
19048,eoddc5,,1,1,2,3
19049,hearmeroar,,1,3,10,13
19050,Duodecimal,,1,2,2,4
19051,nightoffire,,1,2,1,3
19052,Jumba,,1,5,15,20
19053,Je-pat,,1,7,1,8
19054,zakj,,1,1,2,3
19055,theQueenOfMelanesia,,1,1,5,6
19056,akalliaridis,,1,1,2,3
19057,CommentMan,,1,277,392,669
19058,dbchappell1,,1,45,25,70
19059,Darkmere,,1,14,17,31
19060,quassum,,1,1,1,2
19061,hpcolombia,,1,4,2,6
19062,magila,,1,38,47,85
19063,wild_magic430,,1,2,9,11
19064,cojerk,,1,5,8,13
19065,dione1200,,1,3,5,8
19066,avichayil,,1,1,4,5
19067,escalation,,1,35,123,158
19068,DrNuke,,1,9,17,26
19069,huntingwhale,,1,12,33,45
19070,ShutYourPieHole,,1,7,9,16
19071,cllewis,,1,3,2,5
19072,IanPower,,1,9,3,12
19073,jimb0,,1,3,2,5
19074,kevingillett,,1,45,4,49
19075,QuantumFTL,,1,2,5,7
19076,maxey,,1,13,36,49
19077,Boreal99,,1,7,8,15
19078,oppenberger,,1,4,1,5
19079,bstichbury,,1,6,6,12
19080,DennisBlazer,,1,4,2,6
19081,jasonskjonsby,,1,285,296,581
19082,unrealious,,1,421,1166,1587
19083,jefuchs,,1,120,104,224
19084,beatskin,,1,11,14,25
19085,noreg,,1,1,2,3
19086,spence2004,,1,1,1,2
19087,JMowery,,1,9,8,17
19088,xipietotec,,1,34,49,83
19089,de-passivator,,1,6,9,15
19090,CuteAlien,,1,139,193,332
19091,andr3,,1,4,4,8
19092,vsuontam,,1,68,54,122
19093,bomfog,,1,1,1,2
19094,miagaille,,1,1,1,2
19095,women_ARE_idiots,,1,1,1,2
19096,AtheistSpirit,,1,1,1,2
19097,kolm,,1,390,636,1026
19098,CydeWeys,,1,64,20,84
19099,Chakat_Sanddancer,,1,157,251,408
19100,lauraegilbert,,1,1,1,2
19101,anoopsaha,,1,66,17,83
19102,jadepanther,,1,40,78,118
19103,ajprax,,1,7,13,20
19104,allhands,,1,738,332,1070
19105,cantsay,,1,555,341,896
19106,privatehuff,,1,37,87,124
19107,azahi,,1,8,8,16
19108,auldnic,,1,66,164,230
19109,mhotel,,1,182,322,504
19110,itayx,,1,7,13,20
19111,granite-state,,1,2,3,5
19112,lawrencekhoo,,1,69,48,117
19113,bellanoelle126,,1,1,1,2
19114,facewarts,,1,64,124,188
19115,Chocobo812,,1,24,42,66
19116,NotTheDude,,1,13,27,40
19117,PrivatePyle,,1,9,6,15
19118,SHEEPL,,1,1,1,2
19119,slightlynew,,1,2,1,3
19120,nosht,,1,122,78,200
19121,chh,,1,21,20,41
19122,sukoi001,,1,2,4,6
19123,privatejoker86,,1,5,4,9
19124,Utopianow,,1,28,35,63
19125,pazzypunk,,1,60,9,69
19126,Bro666,,1,4,7,11
19127,inoeth,,1,11,17,28
19128,lytfyre,,1,13,36,49
19129,tehbored,,1,94,188,282
19130,TheOpenConspiracy,,1,1,1,2
19131,BionicBeefpile,,1,12,24,36
19132,Elethiomel,,1,1,2,3
19133,elabo,,1,143,151,294
19134,chrchr,,1,4,2,6
19135,marcelk72,,1,3,1,4
19136,jegub,,1,8,18,26
19137,ObamaGuy,,1,85,43,128
19138,mainmise,,1,16,33,49
19139,mel17,,1,64,1,65
19140,n3when,,1,322,59,381
19141,somewheregladlybyond,,1,3,4,7
19142,no-handlebars,,1,63,54,117
19143,scoffjaw,,1,11,11,22
19144,bumbleskull,,1,4,3,7
19145,tebeka,,1,1,3,4
19146,green538,,1,2,1,3
19147,billybantha,,1,2,5,7
19148,TL_DR,,1,82,136,218
19149,lil_rag_dolly,,1,8,20,28
19150,pfeester,,1,10,28,38
19151,wingman187,,1,102,27,129
19152,uspatentpending,,1,3,3,6
19153,jakoshako,,1,1,1,2
19154,arazzook,,1,4,5,9
19155,spyderman4g63,,1,20,36,56
19156,Badfaith,,1,14,25,39
19157,fydo,,1,3,2,5
19158,unshift,,1,17,18,35
19159,PennFarmer,,1,4,1,5
19160,gerfboy,,1,1,1,2
19161,grendelt,,1,205,196,401
19162,baltoo,,1,19,39,58
19163,sheepson_apprentice,,1,126,198,324
19164,semishock,,1,107,32,139
19165,smakusdod,,1,154,116,270
19166,HeyWoodJ,,1,3,9,12
19167,ArcoOost,,1,1,1,2
19168,millyuns1,,1,1,2,3
19169,J-Dubbs,,1,10,21,31
19170,shmikshmak,,1,5,4,9
19171,snowboard420,,1,3,2,5
19172,applematt389,,1,22,29,51
19173,derp_derp_derp,,1,34,71,105
19174,teebird150,,1,2,6,8
19175,34_cent_stampede,,1,1,2,3
19176,mpclark,,1,37,58,95
19177,spellboots,,1,5,7,12
19178,ivigurrl,,1,3,5,8
19179,delano,,1,3,1,4
19180,ciurana,,1,2,5,7
19181,simonofsocal,,1,22,16,38
19182,PanglossCalgary,,1,8,10,18
19183,venndiagram,,1,3,2,5
19184,JaneDoe7,,1,1,1,2
19185,misterPhyrePhox,,1,6,11,17
19186,w14,,1,16,3,19
19187,Muffaletta,,1,2,2,4
19188,voeslauer,,1,63,73,136
19189,redclit,,1,9,12,21
19190,Atheistkurd,,1,4,3,7
19191,fxjohn,,1,1,3,4
19192,coldbrook,,1,702,369,1071
19193,6553321,,1,101,193,294
19194,Rudy_Kazootie,,1,2,4,6
19195,just_saying,,1,1,1,2
19196,easytiger,,1,508,696,1204
19197,celebmonkey,,1,7,1,8
19198,skins,,1,3,1,4
19199,soniko,,1,1,1,2
19200,capsteve,,1,5,5,10
19201,Hoek,,1,2,2,4
19202,jlouis8,,1,6,17,23
19203,scbalazs,,1,70,10,80
19204,aunty_american,,1,5,18,23
19205,Monso,,1,57,143,200
19206,afd8856,,1,2,3,5
19207,krazzy4fun,,1,10,1,11
19208,Tombstone0,,1,1,1,2
19209,bagelfish,,1,14,26,40
19210,mufafa,,1,3,2,5
19211,crshngblks,,1,4,9,13
19212,HughDB,,1,10,2,12
19213,LocalScope,,1,11,13,24
19214,dbenbenn,,1,5,7,12
19215,jsprat,,1,7,13,20
19216,jjarvjp,,1,1,1,2
19217,ffrinch,,1,29,46,75
19218,rehwaldt,,1,13,3,16
19219,joshmatthews,,1,25,13,38
19220,aurifex,,1,19,37,56
19221,yortuk,,1,98,138,236
19222,ChairmanWow,,1,7,6,13
19223,dorlov,,1,12,29,41
19224,wekulm,,1,147,230,377
19225,bac9705,,1,32,34,66
19226,potacle,,1,2,5,7
19227,huy666,,1,125,190,315
19228,spiral773,,1,2,2,4
19229,DrCliffHuxtable,,1,3,1,4
19230,fractalman,,1,14,17,31
19231,postmodernist,,1,1,2,3
19232,rogue_1081,,1,12,29,41
19233,MrOrielly,,1,3,2,5
19234,schar,,1,91,32,123
19235,mrfoof82,,1,32,25,57
19236,walonline,,1,12,10,22
19237,alsosf,,1,59,10,69
19238,ButILoveSubmart,,1,1,2,3
19239,the_trve,,1,5,9,14
19240,jondayspring,,1,15,4,19
19241,paintballboi07,,1,6,4,10
19242,lhmerritt,,1,4,18,22
19243,RaduH,,1,1,1,2
19244,kajs,,1,4,1,5
19245,Drasla,,1,113,65,178
19246,tony-28,,1,523,731,1254
19247,wtf204,,1,1,1,2
19248,wellhell,,1,386,386,772
19249,Stomper---,,1,5,5,10
19250,Gontoran,,1,29,73,102
19251,ted_mielczarek,,1,2,3,5
19252,nkad,,1,1,1,2
19253,DotNetster,,1,9,18,27
19254,energyguy,,1,1,1,2
19255,dougbdl,,1,250,272,522
19256,GatesBill,,1,5,4,9
19257,gobrowns1,,1,9,10,19
19258,plat00n,,1,32,13,45
19259,thomasjpaine,,1,3,8,11
19260,yoghurt,,1,16,30,46
19261,onalark,,1,19,6,25
19262,x5315,,1,12,44,56
19263,meatrepeat,,1,1,3,4
19264,Stephy304,,1,13,1,14
19265,Rubbadubbabubba,,1,12,27,39
19266,dashik,,1,3,5,8
19267,exscape,,1,323,413,736
19268,new-frontier,,1,27,33,60
19269,ArtDeco,,1,1,3,4
19270,doubleplus_,,1,3,1,4
19271,socialexpert,,1,317,46,363
19272,random_dude,,1,12,4,16
19273,wilywampa,,1,7,13,20
19274,sbarnabas,,1,59,64,123
19275,f-uckyou,,1,1,3,4
19276,amielb,,1,2,1,3
19277,Lurcho,,1,27,42,69
19278,jasonbourne1,,1,1,4,5
19279,ke4mtg,,1,61,5,66
19280,grantrules,,1,102,117,219
19281,binarylogik,,1,172,283,455
19282,Workingspacepope,,1,27,41,68
19283,Rub3X,,1,3,6,9
19284,clonnus,,1,4,5,9
19285,sounddude,,1,39,41,80
19286,dataman85,,1,1,5,6
19287,badandy80,,1,5,1,6
19288,Notmyrealname,,1,1296,1464,2760
19289,anonymou5,,1,1,2,3
19290,zelladolphia,,1,4,3,7
19291,xing808,,1,33,56,89
19292,IAmGayForJesus,,1,5,7,12
19293,spastichabits,,1,313,21,334
19294,iwantthatpluginnow,,1,3,1,4
19295,fretn,,1,3,15,18
19296,Scabdates,,1,22,1,23
19297,rebug,,1,91,124,215
19298,EclipseGSX,,1,22,19,41
19299,tulita_pepsee,,1,1,4,5
19300,XyzzyYYZ,,1,1,1,2
19301,cyb3rdemon,,1,35,7,42
19302,vanitycrisis,,1,2,2,4
19303,fracatsa,,1,16,13,29
19304,quaju,,1,57,95,152
19305,runn1ng,,1,7,12,19
19306,borodino,,1,250,278,528
19307,DeadPharaoh,,1,22,1,23
19308,Stupid_Idiot,,1,44,130,174
19309,jetskibob,,1,8,6,14
19310,tcardone05,,1,20,8,28
19311,BadAstronomer,,1,3,2,5
19312,panga,,1,3,3,6
19313,Paper_Doll,,1,1,1,2
19314,rascal_the_cat,,1,9,4,13
19315,harshadsharma,,1,1,5,6
19316,swe39,,1,52,92,144
19317,bigred9,,1,24,53,77
19318,natural_smurf,,1,33,52,85
19319,battlebeans33,,1,8,20,28
19320,dackmilliken,,1,3,6,9
19321,georgedonnelly,,1,205,105,310
19322,omelettedufromage,,1,21,25,46
19323,robreact,,1,33,2,35
19324,SKULL_FUCK_HILLARY_C,,1,12,32,44
19325,las3rjock,,1,3,5,8
19326,SpookyPossum,,1,1,2,3
19327,taeth11,,1,2,3,5
19328,shrekie,,1,68,13,81
19329,TOWINGISRUNBYTHEGOVT,,1,3,2,5
19330,Sadist,,1,61,121,182
19331,duwanis,,1,1,2,3
19332,Dr_Teeth,,1,22,37,59
19333,sucinimad,,1,38,60,98
19334,phillyrocks,,1,10,1,11
19335,generic230,,1,40,64,104
19336,sqlrargif,,1,1,1,2
19337,saudade,,1,55,64,119
19338,TheBluesman,,1,131,195,326
19339,theidiot,,1,18,23,41
19340,sheerpanic,,1,2,3,5
19341,montanodiana,,1,2,1,3
19342,Fedorr,,1,39,13,52
19343,cbapel,,1,34,54,88
19344,evilbunny,,1,107,138,245
19345,doctorcurly,,1,4,5,9
19346,kking,,1,591,24,615
19347,mtfmtfmtfmtf,,1,15,26,41
19348,npatu,,1,4,3,7
19349,mbrodge,,1,69,143,212
19350,leon1725,,1,5,15,20
19351,TheIDontGetItGuy,,1,1,1,2
19352,geoff4222,,1,1,1,2
19353,philogb,,1,28,16,44
19354,eugenegamma,,1,1,2,3
19355,cshivers,,1,102,90,192
19356,WillSmits,,1,80,4,84
19357,revella,,1,2,1,3
19358,xachro,,1,90,86,176
19359,mattomatic,,1,1,1,2
19360,jeniferlopaz,,1,1,1,2
19361,rubygeek,,1,115,208,323
19362,Neuroomg,,1,34,49,83
19363,snowmew,,1,14,11,25
19364,joevans,,1,1,2,3
19365,feelsgoodman,,1,1,3,4
19366,itsdrw,,1,4,21,25
19367,john9539,,1,1,1,2
19368,nicholeluvsya,,1,1,1,2
19369,forgetnight,,1,4,8,12
19370,kruz11,,1,3,1,4
19371,dan1980ct,,1,38,61,99
19372,abc2008,,1,29,25,54
19373,breakbeat,,1,26,12,38
19374,formido,,1,297,359,656
19375,blaheeek,,1,1,1,2
19376,BraveSirRobin,,1,1804,2860,4664
19377,tldr,,1,3,6,9
19378,VAMPIRE_BITER,,1,1,1,2
19379,andakawa,,1,5,14,19
19380,zidium,,1,1,1,2
19381,olr,,1,2,3,5
19382,relocopter,,1,125,77,202
19383,kimmh,,1,2,2,4
19384,hm2k,,1,43,82,125
19385,williamsinister,,1,1,4,5
19386,darreld,,1,1,3,4
19387,glui2001,,1,9,18,27
19388,faitswulff,,1,5,8,13
19389,danoo,,1,45,52,97
19390,o_creat,,1,7,18,25
19391,arthurs,,1,1,1,2
19392,ptman,,1,17,41,58
19393,acoustix,,1,71,5,76
19394,anon1984,,1,46,57,103
19395,blacksuit02,,1,15,18,33
19396,theshadow,,1,2,6,8
19397,xMop,,1,1,3,4
19398,Florianr,,1,25,28,53
19399,hugoz,,1,1,1,2
19400,technotronic5678,,1,27,10,37
19401,spetsacdc,,1,11,5,16
19402,senny,,1,2,4,6
19403,juniormints,,1,27,22,49
19404,Codaflow,,1,2,1,3
19405,nicholasblue,,3,2,4,6
19406,BridgeBum,,1,234,398,632
19407,ldbobby,,1,1,2,3
19408,jrmonaghan,,1,34,27,61
19409,LAXTravelGuru,,1,2,2,4
19410,kingofqueenS60,,1,37,2,39
19411,agerbombmsu13,,1,5,5,10
19412,delkes,,1,1,1,2
19413,garryconn,,1,5,6,11
19414,vanekl,,1,286,454,740
19415,LenIV,,1,1,1,2
19416,nonameidea,,1,3,2,5
19417,theironwok,,1,2,1,3
19418,tkhan456,,1,53,79,132
19419,etoncisum,,1,2,1,3
19420,akittenone,,1,4,1,5
19421,rslarkin,,1,1,1,2
19422,rmcrob,,1,61,72,133
19423,tomj,,1,72,33,105
19424,GustoGaiden,,1,110,52,162
19425,soopaflysam,,1,1,2,3
19426,jaxparrothead,,1,11,18,29
19427,cheez,,1,6,8,14
19428,lafayette0508,,1,69,116,185
19429,netghost,,1,25,32,57
19430,FollowSteph,,1,2,1,3
19431,whitesanjuro,,1,5,9,14
19432,jaw896,,1,1,1,2
19433,chetsss2033,,1,1,1,2
19434,TheManInTheMoon,,1,2,7,9
19435,Alphaquark,,1,3,5,8
19436,mehh,,1,18,15,33
19437,uwcsc,,1,1,2,3
19438,jamespatrick82,,1,16,6,22
19439,akjfd,,1,4,5,9
19440,cerealman,,1,6,8,14
19441,onoodle,,1,1,1,2
19442,markbowman,,1,16,36,52
19443,chocolatechunks,,1,83,132,215
19444,reagan_conservative,,1,20,49,69
19445,porti,,1,54,4,58
19446,shinynew,,1,965,1572,2537
19447,earthnative,,1,9,8,17
19448,TinWoodman,,1,12,2,14
19449,ohai,,1,106,230,336
19450,Vesalius,,1,2,2,4
19451,bewo,,1,16,5,21
19452,haakon,,1,125,152,277
19453,roju,,1,19,40,59
19454,easye,,1,1,2,3
19455,augustss,,1,95,136,231
19456,Dooley,,1,28,53,81
19457,prodigal-sunburn,,1,75,105,180
19458,thethreemoths,,1,2,14,16
19459,lovelight,,1,2,2,4
19460,Tampert,,1,91,169,260
19461,gamersdad,,1,22,3,25
19462,nazirene,,1,1,2,3
19463,john_b,,1,202,258,460
19464,watt,,1,4,9,13
19465,ca98am79,,1,13,4,17
19466,Damietta,,1,12,8,20
19467,fuxsit,,1,14,1,15
19468,Demonot,,1,1,1,2
19469,Damanta,,1,1,1,2
19470,briantt,,1,6,4,10
19471,kohlerm,,1,1,1,2
19472,BorockObomo,,1,4,3,7
19473,lazyhaze,,1,1,1,2
19474,Lumiis,,1,7,3,10
19475,911_was_a_coup_detat,,1,1,1,2
19476,darbar13,,1,3,1,4
19477,michaelbrando,,1,2,1,3
19478,gjs278,,1,243,160,403
19479,ozmars,,1,5,10,15
19480,bOOkwurm,,1,8,13,21
19481,bobbox,,1,5,15,20
19482,JGrind,,1,1,1,2
19483,diebold,,1,3,4,7
19484,fyl5000,,1,2,2,4
19485,RobWtzl,,1,1,1,2
19486,FixingConsultant,,1,15,26,41
19487,LRAD,,1,7,10,17
19488,angrytroll,,1,70,113,183
19489,BaronVonMannsechs,,1,285,437,722
19490,Icewind,,1,5,11,16
19491,Maglgooglarf,,1,3,15,18
19492,Naumadd,,1,2,7,9
19493,phillycheesesteak,,1,1,2,3
19494,sociopath,,1,1,1,2
19495,joedog2112,,1,3,1,4
19496,deralaand,,1,1,3,4
19497,ProudRedneck,,1,1,3,4
19498,ztyler90,,1,87,4,91
19499,deskplant,,1,1,1,2
19500,kyt,,1,1,1,2
19501,Edgeworth,,1,1,1,2
19502,lollers,,1,3,5,8
19503,MrHanky,,1,5,3,8
19504,mclovin23,,1,1,1,2
19505,ftard,,1,1,2,3
19506,sheepdays,,1,18,15,33
19507,Jonnny,,1,6,9,15
19508,mattomatica,,1,8,17,25
19509,chaztized,,1,39,68,107
19510,sense,,1,642,251,893
19511,Chetan7,,1,253,58,311
19512,reddit_ro2,,1,46,125,171
19513,public_nme,,1,30,58,88
19514,tHePeOPle,,1,172,244,416
19515,kissthering,,1,3,4,7
19516,JimMarch,,1,50,39,89
19517,Babooboo,,1,1,2,3
19518,redmosquito,,1,65,130,195
19519,villainintheirowneye,,1,3,2,5
19520,sextusempiricus,,1,151,190,341
19521,smokeykongjr,,1,1,1,2
19522,tk423,,1,35,37,72
19523,jlbraun,,1,307,445,752
19524,n3verm0re,,1,12,4,16
19525,Gnillort,,1,4,6,10
19526,analboy,,1,1,2,3
19527,sambo357,,1,45,90,135
19528,zerny,,1,2,4,6
19529,latenightcoder,,1,2,6,8
19530,dwomick,,1,1,2,3
19531,marcg,,1,2,3,5
19532,Ratel,,1,27,50,77
19533,CaraDame,,1,1,1,2
19534,verstohlen,,1,234,357,591
19535,thingie1234,,1,1,1,2
19536,Archz714,,1,15,19,34
19537,byron000,,1,1,3,4
19538,jjzeidner,,1,78,104,182
19539,delicat,,1,45,47,92
19540,grapplerke,,1,18,33,51
19541,lewism101,,1,4,5,9
19542,jrmy,,1,11,20,31
19543,GreenSmith,,1,3,1,4
19544,Excilsploft,,1,1,1,2
19545,Leonard_PriceIsRight,,1,1,1,2
19546,stevedekorte,,1,10,13,23
19547,trashhalo,,1,10,1,11
19548,halcyonw,,1,2,3,5
19549,Alyre,,1,11,16,27
19550,glyph42,,1,69,116,185
19551,Rigd,,1,11,24,35
19552,lemonodor,,1,2,2,4
19553,ivanmt42,,1,2,1,3
19554,redditdna,,1,15,16,31
19555,MrSt1lbak,,1,2,2,4
19556,monkeypizza,,1,3,8,11
19557,heresjohnny,,1,1,1,2
19558,Demosthenes_,,1,50,35,85
19559,MarkWalberg,,1,5,2,7
19560,hektor_rah,,1,1,1,2
19561,tierrie,,1,17,22,39
19562,charlie6,,1,2,4,6
19563,kaudavis,,1,30,62,92
19564,onethumb,,1,2,1,3
19565,joearnold,,1,1,1,2
19566,electric_mouse,,1,4,9,13
19567,steve_holt,,1,2,1,3
19568,veganbikepunk,,1,196,172,368
19569,lambert,,1,7,2,9
19570,braclayrab,,1,59,77,136
19571,treytech,,1,6,8,14
19572,kle,,1,25,29,54
19573,tjkamp,,1,1,1,2
19574,declercq,,1,14,1,15
19575,collintc,,1,1,2,3
19576,imtyler,,1,1,1,2
19577,billisdog,,1,12,4,16
19578,ceramicsbd,,1,4,4,8
19579,terwin,,1,42,65,107
19580,hockeyboss77,,1,11,10,21
19581,joeldevahl,,1,51,69,120
19582,stevekeene,,1,5,13,18
19583,Kennosuke,,1,9,5,14
19584,roven,,1,3,1,4
19585,mctk,,1,5,1,6
19586,Startt,,1,9,1,10
19587,chargeboo,,1,1,4,5
19588,uedauhes,,1,18,27,45
19589,firehazard07,,1,17,29,46
19590,adx,,1,30,14,44
19591,zepolen,,1,112,116,228
19592,BronzeG3,,1,2,4,6
19593,sndtech,,1,14,20,34
19594,staskies,,1,4,6,10
19595,Kaer,,1,564,315,879
19596,iwantonetoo,,1,1,7,8
19597,Sledge420,,1,2,4,6
19598,tsuga,,1,16,7,23
19599,welliamwallace,,1,9,17,26
19600,RayWestWife,,1,1,1,2
19601,somedude0101,,1,1,1,2
19602,implausibleusername,,1,65,109,174
19603,gronkpan,,1,3,9,12
19604,NoComment7,,1,251,161,412
19605,tadmad,,1,17,1,18
19606,frotz,,1,4,4,8
19607,shiftylonghorn,,1,11,39,50
19608,TheHarlequin,,1,1,1,2
19609,residentskitz,,1,72,79,151
19610,brochi11,,1,2,2,4
19611,davids,,1,1,6,7
19612,slidinglight,,1,146,178,324
19613,MrGrover,,1,2,2,4
19614,tikhonov,,1,65,33,98
19615,tribalwaif,,1,1,4,5
19616,Icefox2k,,1,24,20,44
19617,hiddenone51,,1,1,1,2
19618,tehinternetpolicia,,1,8,11,19
19619,trippit,,1,11,1,12
19620,schmigeggyrules,,1,1,1,2
19621,l3v1,,1,1,2,3
19622,friendly_fire29,,1,2,4,6
19623,hamster101,,1,20,41,61
19624,isr,,1,1,1,2
19625,hansahni,,1,4,6,10
19626,CrotchStomper,,1,13,3,16
19627,tommyrxc,,1,26,14,40
19628,barkusmuhl,,1,1,1,2
19629,IsThatLatin,,1,7,1,8
19630,kingkoopa,,1,3,2,5
19631,jamesblonde,,1,68,225,293
19632,Halcyon3,,1,1,1,2
19633,WIR,,1,3,2,5
19634,mattizmyname,,1,1,1,2
19635,Dr_Horrible,,1,1,6,7
19636,Austechnic,,1,101,227,328
19637,chaos5482,,1,1,1,2
19638,brttf3,,1,31,34,65
19639,inotocracy,,1,4,19,23
19640,Darven_Marvin,,1,2,2,4
19641,tincanorange,,1,2,2,4
19642,ntz,,1,1,1,2
19643,kmully,,1,80,36,116
19644,matt_rudo,,1,40,89,129
19645,ramshackle,,1,16,4,20
19646,frukt,,1,795,756,1551
19647,marlow-huxley,,1,4,4,8
19648,stevedclarke,,1,255,686,941
19649,okkoto,,1,359,276,635
19650,exedore,,1,1,2,3
19651,Cat-Hax,,1,1,4,5
19652,jbrendel,,1,12,6,18
19653,shannonGB,,1,2,2,4
19654,happyax,,1,64,69,133
19655,c_dugan,,1,4,8,12
19656,dbeach24,,1,2,3,5
19657,asdfgasf2ds22,,1,3,4,7
19658,meatmcgee,,1,5,2,7
19659,margol,,1,1,1,2
19660,styphan,,1,2,4,6
19661,GINTER,,1,41,103,144
19662,ayuh,,1,2,2,4
19663,rottenchester,,1,5,1,6
19664,joeware,,1,1,4,5
19665,RaulDeLa,,1,1,1,2
19666,wacrover,,1,441,199,640
19667,mthe0ry,,1,162,257,419
19668,teatree,,1,2,4,6
19669,vanostran,,1,368,709,1077
19670,KoldKompress,,1,152,251,403
19671,kmshiva,,1,5,12,17
19672,the4nimal,,1,2,8,10
19673,ryy0,,1,7,13,20
19674,cheesemoose,,1,7,19,26
19675,The_old_rambler,,1,8,11,19
19676,Spik3balloon,,1,8,9,17
19677,super_man_dat_ho,,1,11,11,22
19678,profoundwhatever,,1,1,3,4
19679,snikkerz,,1,16,30,46
19680,Chairboy,,1,182,166,348
19681,wireduse,,1,4,11,15
19682,wurzelg,,1,9,6,15
19683,indigochild,,1,59,135,194
19684,watever,,1,3,2,5
19685,halthouse1,,1,7,1,8
19686,OliveDiPace,,1,2,1,3
19687,DesertTripper,,1,2,2,4
19688,turlian,,1,1,6,7
19689,HoorayForCancer,,1,3,12,15
19690,disposableaccount99,,1,2,1,3
19691,centrx,,1,37,63,100
19692,Timeinvestor,,1,14,6,20
19693,PinBallEffect,,1,26,71,97
19694,mortbort,,1,2,2,4
19695,swblackwood,,1,11,10,21
19696,szza,,1,8,9,17
19697,pierretrudeau,,1,1,2,3
19698,KalalauKind,,1,9,8,17
19699,drunknomad,,1,7,7,14
19700,odstwar,,1,7,2,9
19701,jswoods7,,1,19,2,21
19702,buddhazen,,1,199,124,323
19703,jskulski,,1,8,10,18
19704,wwusnobrdr,,1,3,2,5
19705,alrexx,,1,5,30,35
19706,Philosoraptor,,1,12,14,26
19707,spiltoil,,1,1,1,2
19708,rseymour,,1,39,89,128
19709,Wesa,,1,1,4,5
19710,canyouhearme,,1,307,221,528
19711,bishop1847,,1,20,17,37
19712,ter-kee-ber-gers,,1,1,5,6
19713,CatCatCat,,1,45,34,79
19714,CommentsAboutBlimp,,1,2,17,19
19715,EricTheR3d,,1,3,7,10
19716,Bowinja,,1,2,8,10
19717,vamoose,,1,2,1,3
19718,vianetman,,1,1,1,2
19719,tidderdit,,1,124,59,183
19720,rfugger,,1,209,221,430
19721,beelzebobby,,1,168,331,499
19722,thebeanseller,,1,7,12,19
19723,Charismaticmegafauna,,1,22,17,39
19724,yk_42,,1,5,6,11
19725,mojowind,,1,1,1,2
19726,duvel,,1,28,27,55
19727,mars33,,1,7,18,25
19728,TuringExaminer,,1,42,33,75
19729,octopush,,1,5,8,13
19730,nekron,,1,3,1,4
19731,cDc-Arrakis,,1,10,4,14
19732,balkotn2,,1,2,2,4
19733,pookiesdame,,1,99,19,118
19734,udelstudent,,1,1,1,2
19735,anamanaman,,1,6,5,11
19736,chickenblender,,1,7,16,23
19737,le_cheese,,1,24,108,132
19738,kbrower,,1,79,22,101
19739,TheNorris,,1,19,30,49
19740,optimisticnothopeful,,1,3,5,8
19741,TwoAndOut,,1,1,1,2
19742,beltenebros,,1,57,75,132
19743,i_h8_r3dd1t_3,,1,10,10,20
19744,funtodo1,,1,3,3,6
19745,Derosa6037,,1,106,212,318
19746,flipdagger,,1,3,5,8
19747,Quacks,,1,3,1,4
19748,chumsley,,1,1,2,3
19749,muneeb1k,,1,1,1,2
19750,naptime,,1,1,1,2
19751,fishmonger,,1,61,36,97
19752,suedehead,,1,1,2,3
19753,ph0rque,,1,47,49,96
19754,tvon,,1,59,66,125
19755,LeonidWA,,1,1,5,6
19756,BurningShed,,1,9,18,27
19757,Hank_Hill,,1,16,4,20
19758,bdb,,1,2,4,6
19759,Rhole_1983,,1,9,16,25
19760,brinkly,,1,4,2,6
19761,iamdreamydave,,1,21,24,45
19762,foreignape,,1,5,10,15
19763,pythonpatrol,,1,1,2,3
19764,steerpike404,,1,31,21,52
19765,gregwalker,,1,378,49,427
19766,IsForGrammarNaziThe,,1,1,1,2
19767,jakechance,,1,5,11,16
19768,fragilemachinery,,1,85,137,222
19769,checkonetwo,,1,24,36,60
19770,noxville,,1,1,1,2
19771,goodgord,,1,1,6,7
19772,robotfossil,,1,4,9,13
19773,Husio,,1,2,3,5
19774,Indierocka,,1,29,33,62
19775,user2171828,,1,3,5,8
19776,ITakePostsLiterally,,1,1,1,2
19777,rgelhau,,1,2,1,3
19778,jerohm,,1,1,2,3
19779,hypnopompia,,1,5,6,11
19780,dazb84,,1,3,1,4
19781,tpschi,,1,4,4,8
19782,zoli,,1,49,9,58
19783,sumgai,,1,331,576,907
19784,ryanbooker,,1,3,7,10
19785,lxbruce,,1,3,2,5
19786,tlc,,1,146,34,180
19787,Zenquin,,1,2,2,4
19788,dragonfish,,1,34,3,37
19789,lenst,,1,1,1,2
19790,savestheday,,1,1,2,3
19791,PotatoBasket,,1,56,55,111
19792,MrDubious,,1,106,196,302
19793,perposterone,,1,25,13,38
19794,Izanaki,,1,4,4,8
19795,pomf-studios,,1,9,20,29
19796,1van,,1,2,3,5
19797,xsspider,,1,156,325,481
19798,bigredcat731,,1,42,3,45
19799,vampirical,,1,10,16,26
19800,digeridooo,,1,2,1,3
19801,csimms,,1,9,3,12
19802,pyroguy56011,,1,67,17,84
19803,smoke-n-mirrors,,1,6,6,12
19804,BreastfedQuakeBaby,,1,1,1,2
19805,Paulinker,,1,1,2,3
19806,monamol,,1,10,3,13
19807,obtuse,,1,105,62,167
19808,m4rc,,1,379,50,429
19809,dirckb,,1,7,6,13
19810,ruperp,,1,1,1,2
19811,greefus,,1,1,1,2
19812,kurtseifried,,1,51,64,115
19813,dumper,,1,10,28,38
19814,illuminatedtiger,,1,2,10,12
19815,justinjest,,1,84,173,257
19816,bardak,,1,110,159,269
19817,yaw,,1,18,18,36
19818,jskinner,,1,25,7,32
19819,flaggy,,1,1,2,3
19820,asw66,,1,35,23,58
19821,gnac,,1,3,1,4
19822,yakimushi,,1,3,7,10
19823,FruityRudy,,1,2,2,4
19824,waxpoet,,1,491,124,615
19825,thtroyer,,1,5,2,7
19826,jjsixty6,,1,30,13,43
19827,palindromic,,1,3,1,4
19828,Echospree,,1,163,171,334
19829,fnord23,,1,31,21,52
19830,roulder,,1,7,10,17
19831,joehouse,,1,83,81,164
19832,pokeyman,,1,12,6,18
19833,jjo_chicago,,1,5,4,9
19834,HoneyBaked,,1,4,11,15
19835,ailuromaniac,,1,4,4,8
19836,nickfox,,1,2,2,4
19837,Kry2727,,1,6,9,15
19838,zumbi,,1,32,27,59
19839,spinned,,1,2,3,5
19840,ijontichy,,1,48,109,157
19841,xcsdm,,1,1,1,2
19842,elnefasto,,1,93,86,179
19843,yo-less,,1,1,2,3
19844,icefreez,,1,2,3,5
19845,wexpen,,1,11,9,20
19846,stankaaron,,1,9,8,17
19847,cwhite54,,1,24,39,63
19848,srbrower,,1,1,1,2
19849,pooltable,,1,53,13,66
19850,connerfer,,1,9,10,19
19851,cencio,,1,3,3,6
19852,kuboaa,,1,1,4,5
19853,superdelegate,,1,26,6,32
19854,joeyguerra,,1,3,5,8
19855,flyinglunatic,,1,83,92,175
19856,oomiak,,1,99,15,114
19857,duckfighter,,1,4,5,9
19858,imagif,,1,11,13,24
19859,death2hypocrisy,,1,536,409,945
19860,mikenice1,,1,389,246,635
19861,adansko,,1,11,15,26
19862,Rhonse,,1,1,8,9
19863,iregretnothing,,1,3,1,4
19864,Jezon,,1,1,4,5
19865,raavi,,1,6,7,13
19866,snotmonster,,1,1,1,2
19867,gangstalking,,1,1,1,2
19868,Mashni,,1,6,10,16
19869,garthzares,,1,2,2,4
19870,phmfthacim,,1,176,279,455
19871,ldsgems,,1,526,148,674
19872,ScreamingVeggies,,1,1,6,7
19873,cyn42,,1,2,2,4
19874,hungryhungryhorus,,1,89,153,242
19875,_Mazza_,,1,35,16,51
19876,rwaltz,,1,10,9,19
19877,gnick,,1,45,14,59
19878,yuubi,,1,27,57,84
19879,oilgarch,,1,3,3,6
19880,futsal,,1,9,21,30
19881,108Rats,,1,32,17,49
19882,numballover,,1,1,5,6
19883,gar37bic,,1,24,55,79
19884,ArmandoPenblade,,1,14,18,32
19885,madrone,,1,4,5,9
19886,Bob3333,,1,7,8,15
19887,clslaw,,1,6,1,7
19888,ddigger,,1,97,39,136
19889,LineNoise,,1,33,28,61
19890,technoman,,1,2,4,6
19891,raptorshadow,,1,39,69,108
19892,jcargoo,,1,16,4,20
19893,ToCatchAPredator,,1,9,14,23
19894,cloch,,1,1,1,2
19895,putainsdetoiles,,1,28,37,65
19896,demosthenes226,,1,1,4,5
19897,JStar,,1,29,38,67
19898,gid13,,1,764,779,1543
19899,jhidekim,,1,17,24,41
19900,luminance,,1,26,38,64
19901,shizukanikudasai,,1,8,13,21
19902,sweetjuniper,,1,4,2,6
19903,_omestes_,,1,18,14,32
19904,bouncingsoul,,1,40,12,52
19905,Himbury,,1,11,34,45
19906,ricecake,,1,206,268,474
19907,lizacolby,,1,1,2,3
19908,bmorris,,1,145,52,197
19909,T-Head,,1,1,2,3
19910,C0y0t3,,1,21,22,43
19911,cunning001,,1,1,2,3
19912,moji,,1,35,37,72
19913,brendastarr,,1,5,18,23
19914,Freonce,,1,112,147,259
19915,ekahs,,1,2,2,4
19916,antisvin,,1,1,3,4
19917,average-guy,,1,22,13,35
19918,mielles,,1,115,4,119
19919,nynjagrrl2k8,,1,1,7,8
19920,ecran,,1,16,2,18
19921,moveyourcar1891,,1,2,1,3
19922,major_malfunction,,1,1,1,2
19923,foldl,,1,263,384,647
19924,tellmesomething,,1,8,1,9
19925,leavenisaplace,,1,14,40,54
19926,fullinfinity,,1,2,9,11
19927,purplegrog,,1,12,21,33
19928,DeadRooster,,1,27,7,34
19929,steveketchen,,1,36,72,108
19930,matoto,,1,9,5,14
19931,tripdub,,1,78,126,204
19932,DLWormwood,,1,229,429,658
19933,LeoPanthera,,1,11,7,18
19934,booly3412,,1,47,3,50
19935,rubygirl,,1,6,2,8
19936,netsql,,1,38,74,112
19937,vTwoPoint,,1,1,1,2
19938,gnupate,,1,17,3,20
19939,baxissimo,,1,5,11,16
19940,BeardBeeman,,1,4,9,13
19941,willcodeforfoo,,1,11,5,16
19942,blowcarrot,,1,5,2,7
19943,traphicone,,1,53,40,93
19944,prozackills,,1,2,1,3
19945,volta,,1,85,97,182
19946,emortio,,1,11,6,17
19947,manifestdustiny,,1,14,18,32
19948,harlos,,1,25,37,62
19949,darkbob,,1,102,84,186
19950,ruesdedr,,1,383,702,1085
19951,opethfan,,1,4,1,5
19952,FiredFox,,1,95,112,207
19953,jrifkin,,1,1,10,11
19954,kaioti,,1,24,68,92
19955,forlong,,1,13,4,17
19956,dustyRods,,1,1,1,2
19957,padt,,1,7,7,14
19958,gravity,,1,128,179,307
19959,anshou,,1,41,4,45
19960,catnutter,,1,22,29,51
19961,Ahri,,1,4,17,21
19962,bjtitus,,1,18,34,52
19963,dentz1,,1,1,2,3
19964,TheAbominableDavid,,1,16,15,31
19965,EpaL,,1,2,1,3
19966,r0botluv,,1,13,12,25
19967,neouser99,,1,3,10,13
19968,rpatel10,,1,224,11,235
19969,osoese,,1,22,41,63
19970,GrowSomeBallzz842,,1,1,1,2
19971,Dorkster,,1,1,1,2
19972,aphall,,1,6,12,18
19973,Mitch_Bolling,,1,4,4,8
19974,dshah,,1,7,3,10
19975,exmor,,1,3,8,11
19976,Dafuzz,,1,272,442,714
19977,knockingononions,,1,10,5,15
19978,glbtrottr,,1,15,1,16
19979,ritubpant,,1,433,21,454
19980,Recondite,,1,3,2,5
19981,critsalot,,1,13,25,38
19982,yarriofultramar,,1,1,4,5
19983,rkh,,1,5,8,13
19984,boundlessgravity,,1,5,3,8
19985,ahnold,,1,12,2,14
19986,Griffix01,,1,8,1,9
19987,r3m0t,,1,182,252,434
19988,trackerbishop,,1,561,525,1086
19989,robvert,,1,7,6,13
19990,jarocho,,1,10,22,32
19991,jonathan_rass,,1,1,1,2
19992,salad,,1,3,5,8
19993,cweathers,,1,92,1,93
19994,hobe,,1,46,40,86
19995,aidanpryde18,,1,1,1,2
19996,Slartibartfasst,,1,1,1,2
19997,nicku,,1,1,3,4
19998,Quel,,1,392,454,846
19999,slugsly,,1,7,8,15
20000,ighost,,1,70,96,166
20001,robreim,,1,74,111,185
20002,mattg1138,,1,1,1,2
20003,drcoppersmith,,1,4,11,15
20004,dittoalex,,1,30,38,68
20005,bigmac,,1,124,9,133
20006,jumping_hump,,1,11,16,27
20007,Maxcactus,,1,1208,434,1642
20008,gtod,,1,4,1,5
20009,deshi,,1,3,7,10
20010,IFapThereforeIAm,,1,2,1,3
20011,P_Crow,,1,14,40,54
20012,semanticprecision,,1,86,103,189
20013,chile,,1,1,2,3
20014,BelindaMarie,,1,42,33,75
20015,pawpaw,,1,18,11,29
20016,whereiswooby,,1,9,16,25
20017,onepage,,1,2,1,3
20018,MarcHausman,,1,3,1,4
20019,puserht,,1,4,2,6
20020,jovensdisciple,,1,14,13,27
20021,Dresta,,1,14,9,23
20022,waffleking,,1,11,13,24
20023,B_Cannon,,1,7,6,13
20024,sn76477,,1,7,5,12
20025,sugarandice,,1,15,32,47
20026,apeman32,,1,1,2,3
20027,Jemvolution,,1,16,53,69
20028,McMarthy_was_Liberal,,1,2,1,3
20029,steaprok,,1,139,8,147
20030,Holyhabanero,,1,3,1,4
20031,chaospherezero,,1,20,13,33
20032,antlovesraj,,1,3,2,5
20033,r3al1tych3ck,,1,2,1,3
20034,rustintable,,1,1,1,2
20035,Geek_tank,,1,21,87,108
20036,ryani,,1,6,7,13
20037,RideTheBigWave,,1,36,58,94
20038,noneofthat,,1,1,2,3
20039,slyspred,,1,2,11,13
20040,Waterstraal,,1,4,4,8
20041,paintedshadows,,1,2,1,3
20042,EggplantWizard,,1,82,98,180
20043,gamoholic,,1,142,2,144
20044,cathpah,,1,2,6,8
20045,cavu,,1,1,1,2
20046,wnoise,,1,183,405,588
20047,swinghammer,,1,26,42,68
20048,EvilStreaks,,1,1,2,3
20049,anti-socia,,1,2,1,3
20050,peter_p_s,,1,1,1,2
20051,milkmandan,,1,236,89,325
20052,lingonsylt,,1,1,1,2
20053,gustavo1999,,1,2,3,5
20054,wet_ripper,,1,1,1,2
20055,justbeachy,,1,37,6,43
20056,sosuke,,1,44,32,76
20057,SicTim,,1,103,208,311
20058,fjr1966,,1,2,2,4
20059,blablablablabla78,,1,61,93,154
20060,ElMoog,,1,2,1,3
20061,the_first_rule,,1,225,214,439
20062,ccb0101001,,1,1,2,3
20063,19quest64,,1,1,5,6
20064,sw3t,,1,1,3,4
20065,Marietto,,1,6,11,17
20066,aaronpowell,,1,32,6,38
20067,wangphoebe,,1,1,1,2
20068,amassivetree,,1,35,41,76
20069,HarryWatson00,,1,15,15,30
20070,nanothief,,1,3,6,9
20071,yelsgib,,1,35,39,74
20072,theanswer,,1,9,5,14
20073,chjunior,,1,2,1,3
20074,grendel266,,1,9,1,10
20075,lgc90,,1,29,35,64
20076,charliepark,,1,1,3,4
20077,spinguru,,1,3,16,19
20078,jtmWIEN,,1,26,19,45
20079,havox,,1,8,16,24
20080,mungojelly,,1,25,37,62
20081,savanttm,,1,42,85,127
20082,Boffy31,,1,14,1,15
20083,shanebroue,,1,1,1,2
20084,orbit1979,,1,18,26,44
20085,Pupuluru,,1,1,1,2
20086,rachet,,1,70,26,96
20087,carefulclaire,,1,5,6,11
20088,JakePM,,1,1,1,2
20089,walksonground,,1,508,378,886
20090,remyduvalle,,1,22,49,71
20091,jsrn,,1,28,4,32
20092,cliffy2000,,1,107,6,113
20093,haoest,,1,845,877,1722
20094,ryangreenberg,,1,1,5,6
20095,warnerrr,,1,77,73,150
20096,iigloo,,1,94,134,228
20097,Catchwa,,1,1,1,2
20098,TundraWolf_,,1,42,62,104
20099,watoad,,1,3,8,11
20100,Birdoftruth,,1,66,54,120
20101,tobidope,,1,4,2,6
20102,wlovins,,1,17,8,25
20103,cobras36,,1,1,3,4
20104,sumzup,,1,67,79,146
20105,gjwatersjr,,1,72,111,183
20106,Bobagonoush,,1,6,16,22
20107,markus40,,1,3,9,12
20108,2014,,1,2,1,3
20109,acataleptic,,1,10,8,18
20110,bigbird123,,1,1,1,2
20111,djrubbie,,1,17,28,45
20112,Mother_Nature,,1,1,1,2
20113,aliasmark,,1,2,2,4
20114,pragmattica,,1,2,2,4
20115,badgetbaster,,1,26,1,27
20116,ziyue,,1,7,21,28
20117,Moogy,,1,108,47,155
20118,mark_rogers,,1,1,13,14
20119,pisstoff,,1,1,1,2
20120,Bertez,,1,2,9,11
20121,fricken,,1,47,48,95
20122,pb1x,,1,525,323,848
20123,phath0m,,1,1,4,5
20124,samdude1400,,1,5,6,11
20125,abortions_for_jesus,,1,9,12,21
20126,djr123456,,1,1,3,4
20127,Quibbler,,1,1,5,6
20128,0tehHum4n1ty,,1,20,10,30
20129,casicatracha,,1,311,475,786
20130,yiyus,,1,3,12,15
20131,Spacecow,,1,152,156,308
20132,RoboBama,,1,82,64,146
20133,bpsarch,,1,1,1,2
20134,KurtC,,1,7,1,8
20135,Ozob,,1,162,24,186
20136,DobBobbs,,1,14,17,31
20137,slappyotoole,,1,6,8,14
20138,samamama,,1,3,4,7
20139,serverslayer,,1,17,24,41
20140,trackstr,,1,1,1,2
20141,tvshopceo,,1,396,484,880
20142,mavrc,,1,57,72,129
20143,reeses,,1,15,15,30
20144,irina_ooo,,1,1,1,2
20145,LordGarak,,1,27,43,70
20146,theDavidMartin,,1,3,9,12
20147,engrams187,,1,3,3,6
20148,luiohh,,1,11,10,21
20149,apollo,,1,257,294,551
20150,Smoogy,,1,5,13,18
20151,ShabbyDoo,,1,29,32,61
20152,uncalm,,1,3,2,5
20153,noorits,,1,152,120,272
20154,deflowd,,1,141,199,340
20155,Tblue,,1,30,3,33
20156,rhymantha,,1,5,4,9
20157,venetianbears,,1,5,6,11
20158,violetplanet,,1,381,35,416
20159,johnhutch,,1,199,283,482
20160,zingyo,,1,2,1,3
20161,thirdoffive,,1,248,257,505
20162,hatekillpuke,,1,423,570,993
20163,goldenflaw,,1,1,2,3
20164,4FourtyTwo2,,1,9,10,19
20165,4zimuth,,1,1,3,4
20166,givemesomespamplease,,1,1,4,5
20167,MuckyMuck,,1,12,20,32
20168,mplshawk,,1,1,1,2
20169,corevirus,,1,222,221,443
20170,eerock,,1,9,18,27
20171,ginormous,,1,3,7,10
20172,howardthegeek,,1,1,2,3
20173,ncbutters,,1,2,1,3
20174,phoenix96,,1,8,4,12
20175,context,,1,4,4,8
20176,wantwealth,,1,18,25,43
20177,maniaq,,1,191,428,619
20178,iStoner,,1,146,178,324
20179,Golfo,,1,148,294,442
20180,dpseymour,,1,1,2,3
20181,MrSplashyPants,,1,2,1,3
20182,BenHanby,,1,35,55,90
20183,required2,,1,16,29,45
20184,thespag,,1,69,84,153
20185,martinezgeovani,,1,1,3,4
20186,metroman1,,1,24,28,52
20187,notlem,,1,4,5,9
20188,aadsm,,1,1,1,2
20189,IrvingMorningstar,,1,16,11,27
20190,bamboobay,,1,14,2,16
20191,fenderlespaul,,1,1,3,4
20192,jedberg_future,,1,1,1,2
20193,Shadok,,1,4,7,11
20194,jakefff,,1,5,2,7
20195,sloat,,1,42,52,94
20196,Corazon-Ray,,1,1,5,6
20197,ikegami--,,1,1,1,2
20198,Klonoa,,1,15,2,17
20199,kalamay,,1,6,6,12
20200,chedstone,,1,1,2,3
20201,squiggly,,1,22,22,44
20202,kingbling,,1,1,2,3
20203,CaffiendCA,,1,223,171,394
20204,Shalmanese,,1,84,15,99
20205,moomoocow1,,1,1,4,5
20206,AndreTheMidget,,1,4,8,12
20207,Sventheimpailer,,1,20,31,51
20208,zepp157,,1,1,2,3
20209,Xochipilli,,1,57,13,70
20210,vichyssoise,,1,14,2,16
20211,anotherkeebler,,1,1,1,2
20212,r_dr_r,,1,127,10,137
20213,dylanmcd,,1,21,40,61
20214,fas2,,1,3,4,7
20215,UDub9,,1,512,156,668
20216,ukiro,,1,6,7,13
20217,burmask,,1,79,30,109
20218,trhaynes,,1,70,107,177
20219,probablyoffensive,,1,62,127,189
20220,chicklette,,1,4,4,8
20221,minestrone11,,1,138,110,248
20222,plun9,,1,149,144,293
20223,jacktt,,1,12,16,28
20224,tms,,1,45,46,91
20225,gyronic,,1,11,27,38
20226,Beebe_Gallini,,1,1,2,3
20227,yirush,,1,2,5,7
20228,octordoctopus,,1,23,22,45
20229,pixdamix,,1,1,5,6
20230,Swordsmanus,,1,13,28,41
20231,Kimosabe,,1,5,6,11
20232,pantastitic,,1,1,1,2
20233,joshzilla,,1,39,27,66
20234,freetolio,,1,82,132,214
20235,flak,,1,1,3,4
20236,kanile,,1,4,10,14
20237,cdarwin,,1,27,57,84
20238,nitpickki,,1,3,1,4
20239,AmericanNinja,,1,2,1,3
20240,Wordie,,1,717,436,1153
20241,Powel,,1,41,95,136
20242,4598588,,1,3,5,8
20243,matthewmcvickar,,1,4,1,5
20244,invalid_user_name,,1,370,509,879
20245,99sono,,1,1,2,3
20246,thevaw,,1,4,3,7
20247,bendygirl,,1,1,7,8
20248,PersonX2,,1,2,2,4
20249,AprilFools,,1,1,6,7
20250,tomosaki,,1,1,1,2
20251,krogger,,1,4,13,17
20252,jatwood,,1,1,1,2
20253,kodozoku,,1,2,2,4
20254,pfork,,1,41,24,65
20255,patrickgun,,1,11,28,39
20256,awwaiid,,1,2,5,7
20257,hncnscr,,1,21,15,36
20258,redleader,,1,154,148,302
20259,timbrux,,2,1,2,3
20260,aposter,,1,51,104,155
20261,thrashertm,,1,273,409,682
20262,British_Pride,,1,3,3,6
20263,fofo13,,1,61,6,67
20264,1jb1,,1,53,39,92
20265,samsm,,1,22,33,55
20266,ptcbus,,1,1,1,2
20267,neoabraxas,,1,909,466,1375
20268,spockit,,1,1,1,2
20269,liquidcola,,1,234,297,531
20270,gaygeekdude,,1,2,6,8
20271,Yarbles,,1,148,374,522
20272,DoubleDown,,1,111,177,288
20273,qfe0,,1,16,9,25
20274,mindlessrabble,,1,96,30,126
20275,mhawley,,1,1,1,2
20276,thedeevolution,,1,246,236,482
20277,jlv,,1,7,9,16
20278,keepmathy,,1,3,1,4
20279,doink123,,1,11,3,14
20280,grommit,,1,50,4,54
20281,SecretSnack,,1,47,6,53
20282,sergeo_syd,,1,23,31,54
20283,CaptainHex,,1,3,4,7
20284,Taragine,,1,5,4,9
20285,subtractington,,1,103,106,209
20286,alitanveer,,1,1,1,2
20287,davewashere,,1,83,88,171
20288,AbouBenAdhem,,1,343,450,793
20289,Rokka,,1,3,3,6
20290,greymundo,,1,23,53,76
20291,worst,,1,31,16,47
20292,NAUGHTYJONNY,,1,9,26,35
20293,datacaliber,,1,1,4,5
20294,abc2009,,1,10,17,27
20295,amnichols,,1,2,1,3
20296,yellowking,,1,1499,1669,3168
20297,lifeat24fps,,1,177,61,238
20298,tgilbert328,,1,2,3,5
20299,andrejbauer,,1,1,1,2
20300,notdrinkingtoomuch,,1,12,14,26
20301,pointman,,1,328,271,599
20302,flipflopontop,,1,13,38,51
20303,President_Camacho,,1,4,3,7
20304,smackanickatwice,,1,3,10,13
20305,65ghz,,1,1,1,2
20306,eangel,,1,55,81,136
20307,svott,,1,5,6,11
20308,jmolleru,,1,19,28,47
20309,vtmn,,1,3,4,7
20310,bornarchitect,,1,66,4,70
20311,icandothat,,1,1,3,4
20312,Cashing,,1,3,1,4
20313,Muleburner,,1,81,128,209
20314,JeanneP,,1,18,42,60
20315,ahosni,,1,1,1,2
20316,rylblu59,,2,4,1,5
20317,noisesmith,,1,23,29,52
20318,jbowtie,,1,9,12,21
20319,pestilence,,1,41,48,89
20320,richarddawkins,,1,32,5,37
20321,jnewbern,,1,7,3,10
20322,rjcb,,1,2,2,4
20323,articlab,,1,4,13,17
20324,mommathecat,,1,141,193,334
20325,derfasaurus,,1,99,136,235
20326,ernestkinnison,,1,1,1,2
20327,wilfridcyrus,,1,2,10,12
20328,rheasparrow,,1,1,2,3
20329,lor4x,,1,16,27,43
20330,existentist,,1,73,83,156
20331,Zaskoda,,1,10,1,11
20332,jace319,,1,26,29,55
20333,biv,,1,60,47,107
20334,overhang,,1,3,7,10
20335,galeon,,1,8,7,15
20336,Sinz,,1,7,3,10
20337,joedipilato,,1,1,2,3
20338,Fondateur0426,,1,6,8,14
20339,alach11,,1,3,2,5
20340,angrywhiteboy,,1,1,6,7
20341,royozin,,1,16,8,24
20342,reauxgg,,1,5,3,8
20343,hardtoexplain,,1,8,1,9
20344,kochichka,,1,2,2,4
20345,alphus,,1,1,1,2
20346,yeoman8,,1,1,2,3
20347,drewyates,,1,38,22,60
20348,launchncast,,1,1,1,2
20349,SuperGrade,,1,77,116,193
20350,desquared,,1,12,24,36
20351,tw3k,,1,2,8,10
20352,chwolfe,,1,2,6,8
20353,soegaard,,1,18,16,34
20354,animalaffinity,,1,5,2,7
20355,OomplexBOompound,,1,18,14,32
20356,samolito,,1,2,2,4
20357,zero5549,,1,4,13,17
20358,nonstop87,,1,2,1,3
20359,static_silence,,1,258,44,302
20360,ajslater,,1,6,18,24
20361,j1123r727,,1,3,1,4
20362,sshconnection,,1,2,6,8
20363,hackcess,,1,2,2,4
20364,trickos,,1,29,32,61
20365,ndsprang,,1,1,2,3
20366,rockyfied,,1,3,2,5
20367,wang-bangers_mom,,1,1,1,2
20368,maraino,,1,6,3,9
20369,adelynnsmommy,,1,4,4,8
20370,PockyBum522,,1,25,35,60
20371,DafyddLlyr,,1,8,7,15
20372,ipsofact0,,1,2,1,3
20373,curryloke,,1,3,1,4
20374,mandelbrothel,,1,4,2,6
20375,rexdog,,1,10,17,27
20376,DingleberrySurprise,,1,34,28,62
20377,MashDownBabylon,,1,48,35,83
20378,Sprydoctor,,1,6,3,9
20379,cryptoz,,1,667,368,1035
20380,bigheadarmy,,1,1,2,3
20381,mercyseat,,1,9,3,12
20382,Octoploid,,1,8,2,10
20383,mamarati,,1,2,1,3
20384,steve435,,1,1,1,2
20385,pentium4borg,,1,1,1,2
20386,hinterteile,,1,20,37,57
20387,lordmutt,,1,27,49,76
20388,deinst,,1,27,24,51
20389,DickandSharon,,1,135,14,149
20390,already_reddit,,1,54,51,105
20391,voodookiss,,1,1,2,3
20392,javreddit,,1,100,9,109
20393,ochuuzu1,,1,14,24,38
20394,VectrexGamer,,1,2,1,3
20395,auca9sd8,,1,2,1,3
20396,myusernamewastaken,,1,77,115,192
20397,ColonelFuckface,,1,342,301,643
20398,Nimue,,1,1,4,5
20399,almostagreed,,1,7,4,11
20400,keylogthis,,1,103,190,293
20401,johat,,1,27,27,54
20402,tardibear,,1,19,42,61
20403,skt2k4,,1,74,169,243
20404,mitreddit,,1,10,10,20
20405,Kryz167,,1,26,40,66
20406,mensrea,,1,187,208,395
20407,drawingthesun,,1,7,14,21
20408,huggyprimate,,1,9,15,24
20409,kskulski,,1,1,1,2
20410,ffgff4g3,,1,1,1,2
20411,honodk,,1,162,34,196
20412,richardharrington,,1,8,9,17
20413,dreamer98,,1,9,17,26
20414,chubs,,1,43,22,65
20415,FakeLouDobbs,,1,1,1,2
20416,acro,,1,1,1,2
20417,spacekraken,,1,8,15,23
20418,desman10143,,1,14,24,38
20419,fross,,1,35,24,59
20420,fel,,1,1,2,3
20421,thirtysixbelow,,1,13,5,18
20422,x5400,,1,3,2,5
20423,waylander632,,1,2,4,6
20424,DavidDavidson,,1,10,5,15
20425,NutritionFacts,,1,14,20,34
20426,bstares,,1,3,6,9
20427,millertime83,,1,1,1,2
20428,MikeGravel,,1,2,2,4
20429,UndeadTonySnow,,1,1,1,2
20430,daze99,,1,4,2,6
20431,huinan,,1,4,4,8
20432,filterspam,,1,129,255,384
20433,storysparrow,,1,1,1,2
20434,Boerta,,1,5,13,18
20435,bboychuk,,1,17,7,24
20436,kingwala,,1,202,24,226
20437,syntax,,1,149,163,312
20438,brendaneich,,1,1,1,2
20439,DoctorRonPaul08,,1,1,2,3
20440,clearlynot,,1,46,59,105
20441,calvin43,,1,24,56,80
20442,apdicaprio,,1,19,30,49
20443,icosa,,1,11,19,30
20444,fidmart85,,1,38,67,105
20445,danblanchard,,1,4,3,7
20446,nunb,,1,15,35,50
20447,the6thReplicant,,1,124,168,292
20448,eftresq,,1,17,30,47
20449,taxcheat,,1,5,2,7
20450,ickingfudiot,,1,19,21,40
20451,mtrimpe,,1,17,27,44
20452,tripsuncatchfire,,1,27,68,95
20453,spongy,,1,1,1,2
20454,mezzaluna,,1,9,18,27
20455,grassmunk,,1,12,10,22
20456,koent,,1,17,44,61
20457,TrishaMacmillan,,1,172,225,397
20458,kilomang,,1,2,3,5
20459,JimH10,,1,71,147,218
20460,MrG,,1,367,351,718
20461,michaelnighttime,,1,1,2,3
20462,eserikto,,1,3,1,4
20463,mogwai72,,1,1,3,4
20464,eflouret,,1,27,9,36
20465,mybuddychrist,,1,2,1,3
20466,MechWiredNet,,1,5,1,6
20467,omitraffic,,1,24,21,45
20468,drbunny,,1,4,5,9
20469,Sineeze,,1,2,1,3
20470,soundbyter,,1,2,5,7
20471,deejayqueue,,1,3,3,6
20472,skeesicks,,1,38,54,92
20473,flinchn,,1,8,11,19
20474,a_bad_martini,,1,100,172,272
20475,blackfrances,,1,110,132,242
20476,someNOOB,,1,1,5,6
20477,libertythor,,1,6,1,7
20478,faysy,,1,1,1,2
20479,netsirk,,1,2,5,7
20480,Funkyy,,1,3,2,5
20481,RobSpewack,,1,2,3,5
20482,karlkraus,,1,3,1,4
20483,mlasky,,1,6,9,15
20484,tek-ops,,1,78,111,189
20485,terrymr,,1,36,44,80
20486,cardsfan12,,1,3,4,7
20487,aephoenix,,1,100,166,266
20488,yeziam,,1,6,11,17
20489,fr3ddie,,1,83,141,224
20490,hiS_oWn,,1,1258,1501,2759
20491,umcjdf,,1,3,11,14
20492,talikk,,1,13,21,34
20493,mpredosin,,1,15,30,45
20494,kskolano,,1,1,1,2
20495,psiph,,1,56,26,82
20496,sfanetti,,1,170,230,400
20497,DirtyHerring,,1,309,442,751
20498,banderlog,,1,9,7,16
20499,Semi_Flaccid_State,,1,14,8,22
20500,not_programmer,,1,8,69,77
20501,jayofdoom,,1,14,10,24
20502,SelfIndulging,,1,14,10,24
20503,nykiwi,,1,53,93,146
20504,davesmylie,,1,4,2,6
20505,Kaptain,,1,62,84,146
20506,marlotuck,,1,1,2,3
20507,to-be-exterminated,,1,1,2,3
20508,celoyd,,1,35,53,88
20509,CindyThomas,,1,32,13,45
20510,wiinix,,1,1,1,2
20511,iamgit,,1,2,6,8
20512,saraaaahhhhhh,,1,35,54,89
20513,leftmoon,,1,4,5,9
20514,MattD,,1,60,57,117
20515,jayayeem,,1,202,327,529
20516,Qlassic,,1,14,10,24
20517,hackdaddy,,1,1,8,9
20518,nfulton,,1,652,926,1578
20519,Lendolar,,1,1,2,3
20520,ind3lible,,1,4,3,7
20521,corruptedness,,1,1,2,3
20522,gypsymoon921,,1,18,19,37
20523,richdinatlanta,,1,14,16,30
20524,mizar99,,1,6,4,10
20525,junglist313,,1,186,167,353
20526,Nick4753,,1,72,59,131
20527,jdmx,,1,14,8,22
20528,adrian67,,1,147,4,151
20529,Fabien3,,1,140,204,344
20530,paulieL,,1,1,2,3
20531,FunFact,,1,144,224,368
20532,sunchat,,1,1,2,3
20533,twiztedd,,1,1,1,2
20534,maxwellhill,,1,4683,44,4727
20535,herugrim,,1,5,8,13
20536,dhintze10,,1,6,7,13
20537,MRRoberts,,1,103,167,270
20538,B_C_,,1,117,180,297
20539,scalemodlgiant,,1,22,37,59
20540,deejne,,1,30,4,34
20541,Revoletion,,1,1,3,4
20542,graealex,,1,34,56,90
20543,harlequinSmurf,,1,4,6,10
20544,baantacron,,1,2,1,3
20545,huuhuu,,1,2,4,6
20546,babytrosc,,1,7,1,8
20547,ethelstan,,1,1,1,2
20548,libertynow,,1,1,1,2
20549,B5_til_i_die,,1,1,1,2
20550,monnayage,,1,49,145,194
20551,tommis,,1,103,174,277
20552,criticasartist,,1,2,2,4
20553,Topper_1,,1,12,9,21
20554,myshrm,,1,37,161,198
20555,DougDante,,1,176,164,340
20556,Ceasadh,,1,123,153,276
20557,plong0,,1,213,467,680
20558,Mellany777,,1,4,1,5
20559,Eddih,,1,1,1,2
20560,billturner,,1,8,6,14
20561,ratnakarpagar,,1,1,1,2
20562,sirkit,,1,17,27,44
20563,russianout,,1,22,43,65
20564,joeyslack,,1,274,388,662
20565,phattwizat,,1,4,6,10
20566,fizzbuzz,,1,3,1,4
20567,ubihard,,1,1,1,2
20568,thegravity,,1,1,2,3
20569,Zarutian,,1,231,481,712
20570,mrwizard14,,1,2,2,4
20571,ILikeChickILikeLiver,,1,3,5,8
20572,khir4n0,,1,2,2,4
20573,devpotato,,1,6,4,10
20574,nojoy,,1,1,2,3
20575,KiRyah,,1,52,56,108
20576,penty,,1,9,13,22
20577,golubovsky,,1,1,7,8
20578,shebe,,1,2,1,3
20579,ecg,,1,1,3,4
20580,permeke,,1,49,22,71
20581,freakk123,,1,1,1,2
20582,Willravel,,1,26,35,61
20583,FriedChicken,,1,2,2,4
20584,BiggotHunter,,1,19,2,21
20585,s1m0n,,1,2,7,9
20586,BigGreenSticky,,1,296,221,517
20587,theflightless,,1,4,8,12
20588,quto,,1,14,23,37
20589,Findeton,,1,1,1,2
20590,jrhoward,,1,19,49,68
20591,shuael,,1,36,39,75
20592,Idownmodeveryone,,1,1,1,2
20593,jem71,,1,2,1,3
20594,Bairen,,1,3,3,6
20595,alex90210,,1,18,18,36
20596,katsap,,1,339,435,774
20597,VCGRIFFIN,,1,8,13,21
20598,Pronell,,1,3,3,6
20599,ksondere,,1,3,3,6
20600,steers82,,1,9,6,15
20601,harvesterofsorrow,,1,1,1,2
20602,alphagettijoe,,1,3,3,6
20603,TeamMeh,,1,1,2,3
20604,voyager86,,1,5,6,11
20605,acusticthoughts,,1,40,41,81
20606,medusam,,1,15,56,71
20607,Kirbside,,1,3,12,15
20608,ricklight,,1,6,6,12
20609,Stubb,,1,231,74,305
20610,ak474all,,1,1,4,5
20611,vario,,1,2,1,3
20612,maximusrex,,1,7,8,15
20613,avarus,,1,5,11,16
20614,Gneognosis,,1,2,1,3
20615,isearch,,1,56,37,93
20616,dbrand,,1,68,25,93
20617,The_Seeker,,1,7,17,24
20618,nealibob,,1,13,12,25
20619,Dr_Frankenstein,,1,1,1,2
20620,sanity2u,,1,1,2,3
20621,macoafi,,1,5,7,12
20622,rakusuira,,1,21,3,24
20623,danno18,,1,3,2,5
20624,broman55,,1,22,25,47
20625,mercurysquad,,1,775,739,1514
20626,fantasticjon,,1,47,47,94
20627,paradoxical,,1,4,5,9
20628,jstampf,,1,3,1,4
20629,splim,,1,227,203,430
20630,datawaslost,,1,10,13,23
20631,FDL1,,1,2,5,7
20632,giornalettismo,,1,4,3,7
20633,Oleg1,,1,5,2,7
20634,brotherbob,,1,29,4,33
20635,poptosis,,1,7,11,18
20636,hre,,1,3,2,5
20637,jammyjam,,1,6,5,11
20638,TheDirector,,1,37,58,95
20639,leoinca,,1,112,4,116
20640,fkn_amerikkkans,,1,4,1,5
20641,cooljoebob64,,1,34,59,93
20642,Trainwrek,,1,8,12,20
20643,cwikked,,1,1,1,2
20644,indurain,,1,3,5,8
20645,correspondence,,1,11,1,12
20646,onewing,,1,2,3,5
20647,uberdanky,,1,1,1,2
20648,SpiritThief,,1,5,10,15
20649,Carnage4Life,,1,65,23,88
20650,Blike_Moomberg,,1,1,3,4
20651,kenlubin,,1,269,523,792
20652,Celes69,,1,6,3,9
20653,frice,,1,1,2,3
20654,SilverFox,,1,110,118,228
20655,jkarson88,,1,1,3,4
20656,bobisoft2k5,,1,7,6,13
20657,DoItYourself,,1,3,6,9
20658,skyfex,,1,3,3,6
20659,frankenlinks,,1,4,1,5
20660,PunAndRun,,1,2,2,4
20661,rlynaghshannon,,1,23,31,54
20662,oliware,,1,7,27,34
20663,worldwalker,,1,1,3,4
20664,Kel-lr,,1,4,6,10
20665,eugrl,,1,7,5,12
20666,superfluous,,1,126,221,347
20667,braamlg,,1,3,2,5
20668,hllclmbr,,1,25,13,38
20669,mcgoverp,,1,4,6,10
20670,ihatetomarnold,,1,1,1,2
20671,steakknife,,1,5,2,7
20672,spamfake,,1,20,22,42
20673,h3rald,,1,15,14,29
20674,hansip,,1,4,19,23
20675,ugolino91,,1,1,1,2
20676,DoublePlusMeh,,1,22,60,82
20677,Empact,,1,1,3,4
20678,bootstompingonaface,,1,6,9,15
20679,krik1,,1,1,4,5
20680,novagenesis,,1,7,16,23
20681,dasil003,,1,61,118,179
20682,hawk2119,,1,145,6,151
20683,geegnome,,1,8,5,13
20684,dontmatta,,1,16,11,27
20685,ChefEspeff,,1,97,31,128
20686,krumbs,,1,362,372,734
20687,the_wondering_jew,,1,4,7,11
20688,bSimmons666,,1,605,514,1119
20689,kz00,,1,4,1,5
20690,uberboot,,1,7,16,23
20691,omarciddo,,1,20,28,48
20692,Dustinland,,1,2,1,3
20693,Bean888,,1,19,25,44
20694,dj1200techniques,,1,129,148,277
20695,tlarkin,,1,1,1,2
20696,OldakQuill,,1,145,125,270
20697,f009,,1,2,1,3
20698,Aviator,,1,103,87,190
20699,shelton8706,,1,1,1,2
20700,yourfiredpal,,1,1,3,4
20701,luisrd,,1,89,5,94
20702,aloofschipperke,,1,1,1,2
20703,aletoledo,,1,1762,2561,4323
20704,pretzel,,1,159,99,258
20705,steven_h,,1,57,70,127
20706,melissamelissa,,1,70,55,125
20707,vexu,,1,7,11,18
20708,nonredditor,,1,1,6,7
20709,kappuru,,1,3,3,6
20710,patmac531,,1,3,4,7
20711,jxmitchell,,1,272,83,355
20712,Ivan_A_DMocracy,,1,18,33,51
20713,thisisbullshit,,1,2,1,3
20714,zmcgrew,,1,4,5,9
20715,cjanssen,,1,1,1,2
20716,sensical,,1,193,188,381
20717,kairos,,1,34,62,96
20718,AnteChronos,,1,2145,2095,4240
20719,hsshibley,,1,4,2,6
20720,Ishkabible,,1,2,6,8
20721,Lagavulin,,1,13,8,21
20722,mca592,,1,13,19,32
20723,caffeine314,,1,15,14,29
20724,kevinardo,,1,2,18,20
20725,blame20,,1,2,5,7
20726,psibe,,1,40,72,112
20727,jnfr,,1,27,20,47
20728,phragg,,1,16,11,27
20729,ALoucarch,,1,1,2,3
20730,antikythera,,1,6,4,10
20731,Ocseemorahn,,1,1,1,2
20732,i_only_upmod_idiots,,1,3,2,5
20733,ElRomno,,1,1,1,2
20734,mracer,,1,13,7,20
20735,manu3000,,1,2,11,13
20736,tri000,,1,5,6,11
20737,TheBobMcCormick,,1,34,50,84
20738,andrewq,,1,20,33,53
20739,gotnate,,1,15,23,38
20740,bdifc,,1,6,4,10
20741,angeleus09,,1,10,19,29
20742,oatsy,,1,8,25,33
20743,yggdrasilly,,1,53,39,92
20744,FrankExchangeOfViews,,1,9,18,27
20745,hortont424,,1,38,35,73
20746,penispic,,1,4,2,6
20747,EnigmaCurry,,1,2,5,7
20748,click2803,,1,36,18,54
20749,CWRandall,,1,1,3,4
20750,GrammarBureaucrat,,1,4,4,8
20751,banjeed,,1,1,2,3
20752,newsgirl,,1,5,1,6
20753,exbzurg,,1,12,21,33
20754,damnitdaniel,,1,1,2,3
20755,JesusChristSonOfMan,,1,1,4,5
20756,deMVK,,1,7,13,20
20757,thepensivepoet,,1,659,827,1486
20758,jedileet,,1,26,6,32
20759,spotcatbug,,1,95,139,234
20760,stormandstress,,1,85,79,164
20761,EverybodysAnAsshole,,1,49,61,110
20762,mhoffma,,1,151,63,214
20763,PaladinZ06,,1,4,5,9
20764,dotcam9,,1,4,11,15
20765,aussie151,,1,6,7,13
20766,yakyakyak,,1,88,82,170
20767,duketime,,1,3,4,7
20768,samblesj,,1,213,3,216
20769,JNGilman,,1,50,33,83
20770,mickbuddha,,1,15,26,41
20771,ironclad,,1,40,79,119
20772,Steinburg,,1,23,20,43
20773,HOTORTILLAS,,1,92,88,180
20774,firgnus,,1,5,3,8
20775,cel83,,1,2,1,3
20776,MarkFreedman,,1,1,1,2
20777,tundranerd,,1,11,18,29
20778,traflac,,1,4,15,19
20779,columbian_supreme,,1,32,93,125
20780,berlinbrown,,1,1379,1005,2384
20781,daevlong,,1,3,7,10
20782,DisabledChildrenLive,,1,1,2,3
20783,sardonyx,,1,1,1,2
20784,DedHeD,,1,55,100,155
20785,offtoChile,,1,14,6,20
20786,MenthalMenthos,,1,11,12,23
20787,jroller,,1,27,41,68
20788,danmaitlandsmith,,1,4,8,12
20789,RoboticCoder,,1,14,9,23
20790,Bujanx,,1,249,298,547
20791,dean888,,1,17,18,35
20792,Gatohnegro,,1,151,73,224
20793,musellama,,1,1,1,2
20794,Forrest319,,1,55,103,158
20795,stox,,1,98,161,259
20796,squeaker,,1,138,63,201
20797,bitobaco,,1,42,53,95
20798,woooooooooooooooosh,,1,1,1,2
20799,daisy0808,,1,645,784,1429
20800,fragm,,1,2,1,3
20801,vivvvvic,,1,11,22,33
20802,orcdork,,1,5,4,9
20803,Xyc0,,1,2,1,3
20804,playingreprise,,1,8,6,14
20805,dmaclay,,1,96,98,194
20806,cluck,,1,1,1,2
20807,hondajvx,,1,131,187,318
20808,darth-Tater,,1,12,5,17
20809,oscargang,,1,34,2,36
20810,Paisleyfrog,,1,93,150,243
20811,evaunit517,,1,11,12,23
20812,johnnyh749,,1,9,4,13
20813,nbakshi,,1,4,8,12
20814,DROWE859,,1,17,21,38
20815,cubedweller,,1,54,76,130
20816,shrimpanzee,,1,19,7,26
20817,twitchymart,,1,14,9,23
20818,fishyf,,1,20,44,64
20819,fraying,,1,2,1,3
20820,Orion_FE,,1,1,2,3
20821,Xaboomers,,1,33,2,35
20822,i_think_i_am_crazy,,1,29,26,55
20823,bassman123,,1,30,33,63
20824,rckstdy,,1,12,10,22
20825,nsfmc,,1,17,8,25
20826,Jedravent,,1,382,188,570
20827,JollyJeff,,1,156,266,422
20828,nglynn,,1,283,327,610
20829,peanutbrittle,,1,1,2,3
20830,GodHatesFigs,,1,247,336,583
20831,C8H10N4O2,,1,3,3,6
20832,arkistan,,1,4,4,8
20833,mrken,,1,1,1,2
20834,randyco,,1,3,1,4
20835,trech,,1,7,13,20
20836,lizblue,,3,1,1,2
20837,bnolsen,,1,35,43,78
20838,sickmind,,1,593,53,646
20839,Brain_statiC,,1,16,32,48
20840,bunkre,,1,1,7,8
20841,hustler,,1,13,16,29
20842,hhymcq,,1,1,1,2
20843,guhoya11,,1,1,1,2
20844,yoaliens,,1,25,36,61
20845,Dast,,1,10,12,22
20846,plantro,,1,1,1,2
20847,junpei,,1,4,12,16
20848,dbanerjee,,1,59,61,120
20849,amellor,,1,105,54,159
20850,GimmickAccount,,1,1,1,2
20851,XanXiran,,1,2,5,7
20852,Calm_Pear,,1,2,2,4
20853,timwatly,,1,23,17,40
20854,emgairplay,,1,5,2,7
20855,bstrand,,1,6,10,16
20856,doihaveto,,1,4,4,8
20857,Aka-Ice,,1,3,1,4
20858,eddof13,,1,7,15,22
20859,linkedlist,,1,2246,2090,4336
20860,reginalduk,,1,170,257,427
20861,WebZen,,1,605,624,1229
20862,Shadowhand,,1,15,18,33
20863,doronbc,,1,3,3,6
20864,solitariadolores,,1,1,1,2
20865,avro,,1,24,3,27
20866,InconsideratePrick,,1,24,8,32
20867,Grums,,1,12,22,34
20868,theorpheus,,1,52,7,59
20869,TheSummarizer,,1,11,18,29
20870,plinko92,,1,2,2,4
20871,c3o,,1,6,8,14
20872,ericwong,,1,1,3,4
20873,bakert,,1,24,18,42
20874,humans,,1,3,3,6
20875,ndimos,,1,1,1,2
20876,cynope,,1,94,95,189
20877,hooter523,,1,1,1,2
20878,HomelandSecurity,,1,1,11,12
20879,thebootydontstop,,1,1,2,3
20880,giik,,1,6,5,11
20881,carpenter,,1,30,3,33
20882,edydantes,,1,33,76,109
20883,craineum,,1,8,6,14
20884,testing_timing,,1,1,1,2
20885,thirdworldlover,,1,1,1,2
20886,fakepolitik,,1,138,93,231
20887,TheEvilPenguin,,1,1,1,2
20888,thegoodideaman,,1,2,2,4
20889,Metroid4Life,,1,36,3,39
20890,tangentstorm,,1,61,12,73
20891,onyxdale,,1,11,11,22
20892,bstein80,,1,11,1,12
20893,moarslaw,,1,11,6,17
20894,IHaveCookies,,1,96,79,175
20895,elsombrero,,1,21,36,57
20896,IngeniousTimeTravell,,1,3,2,5
20897,igeldard,,1,2061,108,2169
20898,ia3n,,1,2,1,3
20899,pastymage,,1,64,11,75
20900,hzin,,1,26,1,27
20901,jous,,1,17,5,22
20902,phpkid,,1,4,2,6
20903,mmelton,,1,2,2,4
20904,meatsack80,,1,1,1,2
20905,YoungVoter,,1,29,1,30
20906,brewtalizer,,1,11,16,27
20907,epchris,,1,19,3,22
20908,motorists,,1,164,2,166
20909,JoeIrvine,,1,4,5,9
20910,JohnnyTsunami,,1,1,1,2
20911,kihaji,,1,152,161,313
20912,spamboolimbo,,1,1,1,2
20913,fengshui,,1,2,1,3
20914,nathaner,,1,51,93,144
20915,intrepion,,1,21,55,76
20916,fdb,,1,1,1,2
20917,scruffie,,1,29,15,44
20918,latida,,1,3,1,4
20919,Tacoby,,1,1,1,2
20920,xxdbxx,,1,1,1,2
20921,melink14,,1,21,35,56
20922,Sawta,,1,131,257,388
20923,klauskinski,,1,296,736,1032
20924,chemicalkook,,1,5,2,7
20925,crenbots,,1,19,7,26
20926,madronedorf,,1,323,435,758
20927,anybuzz,,1,49,10,59
20928,helloolleh,,1,1,1,2
20929,smowe,,1,7,1,8
20930,misterFR33ZE,,1,56,108,164
20931,beefanator0,,1,9,18,27
20932,mcbush,,1,766,135,901
20933,garythellama,,1,12,5,17
20934,icychilly,,1,1,1,2
20935,Toppy,,1,1,1,2
20936,allforumer,,1,106,192,298
20937,political-animal,,1,3,6,9
20938,whatfun2,,1,1,7,8
20939,tjl2015,,1,74,8,82
20940,tmh,,1,2,2,4
20941,Beezer,,1,2,1,3
20942,markwebb,,1,1,7,8
20943,hriwo,,1,26,15,41
20944,jungturk,,1,242,351,593
20945,fggfghjjk,,1,3,5,8
20946,cbarge,,1,37,70,107
20947,leno123,,1,2,7,9
20948,Vanhandle,,1,29,36,65
20949,grendel9,,1,39,64,103
20950,4days,,1,1,2,3
20951,Jessegr,,1,1,1,2
20952,robrobrobot,,1,305,172,477
20953,hounddoglgs,,1,4,4,8
20954,dk9000,,1,6,5,11
20955,mosephine,,1,2,2,4
20956,scooterMD,,1,8,22,30
20957,dcxb,,1,1,1,2
20958,spugnugget,,1,20,8,28
20959,iregistered4this,,1,91,92,183
20960,CNBemis,,1,21,9,30
20961,blaze4metal,,1,567,783,1350
20962,icepack,,1,5,9,14
20963,EGKW,,1,3,5,8
20964,dietcocaine,,1,12,27,39
20965,fae4fds,,1,4,1,5
20966,cofol,,1,1,2,3
20967,neilroberts,,1,26,4,30
20968,HoboClownChorus,,1,4,1,5
20969,AntonOlsen,,1,15,12,27
20970,Bahro,,1,86,86,172
20971,mtlea,,1,6,6,12
20972,ukroni,,1,6,3,9
20973,musicphreak252,,1,51,81,132
20974,theuncover,,1,13,18,31
20975,philler,,1,79,24,103
20976,orangecrush,,1,1,3,4
20977,beatnuts96,,1,1,3,4
20978,InspectorJavert,,1,11,20,31
20979,GeeksSpeakFont,,1,161,26,187
20980,mgates,,1,1,1,2
20981,apollinax,,1,2,2,4
20982,goofporter,,1,8,6,14
20983,lexchou,,1,5,8,13
20984,vamonos,,1,59,16,75
20985,wmil,,1,10,16,26
20986,bumblebeecuz,,1,1,3,4
20987,spurion,,1,43,68,111
20988,bardamu2,,1,3,2,5
20989,reapsos,,1,1,2,3
20990,leonardsliver,,1,2,4,6
20991,shakeyjake,,1,15,21,36
20992,danigaswholuvu,,1,89,6,95
20993,trigger0219,,1,162,191,353
20994,cardinalgill,,1,13,10,23
20995,franniemeow07,,1,10,1,11
20996,cutlerchris,,1,15,27,42
20997,justagirl05,,1,2,4,6
20998,ttam,,1,13,11,24
20999,tbwcr,,1,14,6,20
21000,prop74,,1,1,1,2
21001,g_ford,,1,3,4,7
21002,Nomad559,,1,12,8,20
21003,crazysheit,,1,4,2,6
21004,bashamer,,1,2,1,3
21005,slut,,1,3,1,4
21006,mer1,,1,8,12,20
21007,onionose,,1,4,9,13
21008,steeef,,1,11,8,19
21009,acon89,,1,37,5,42
21010,voqk,,1,6,8,14
21011,irsmert,,1,53,99,152
21012,suehuss,,1,1,1,2
21013,solidhayter,,1,59,99,158
21014,johnji,,1,6,19,25
21015,optimalscrew,,1,4,1,5
21016,zby,,1,10,13,23
21017,VapidTeenageGirl,,1,1,1,2
21018,kerklein2,,1,325,358,683
21019,robbyslaughter,,1,12,9,21
21020,ekabanov,,1,47,26,73
21021,no_one,,1,21,37,58
21022,rotterdam,,1,2,4,6
21023,SalParadise,,1,100,27,127
21024,pointerweb,,1,1,1,2
21025,alwaysdeparting,,1,7,1,8
21026,MicrophoneAssassin,,1,1,3,4
21027,catdad,,1,1,2,3
21028,Dr_House,,1,1,2,3
21029,dukeminster,,1,2,4,6
21030,noise-nut,,1,24,9,33
21031,elcheapo,,1,16,13,29
21032,juanclaudius,,1,1,1,2
21033,Johnny_H,,1,10,9,19
21034,bugrit,,1,25,33,58
21035,Slactor,,1,51,56,107
21036,gforce42,,1,1,2,3
21037,girlzero,,1,127,11,138
21038,goonigoogoo,,1,2,3,5
21039,freemorons,,1,42,84,126
21040,zocrates,,1,7,5,12
21041,reedsmomishot,,1,10,13,23
21042,blackandred,,1,527,19,546
21043,sarahelecko,,1,1,1,2
21044,spaceknarf,,1,143,107,250
21045,FutureMajority,,1,11,2,13
21046,hunkydude,,1,1094,45,1139
21047,harlows_monkeys,,1,510,318,828
21048,Align,,1,3,6,9
21049,makeinstall,,1,17,12,29
21050,ekatya,,1,80,85,165
21051,zmann,,1,20,38,58
21052,cyantist,,1,147,291,438
21053,dtweney,,1,8,1,9
21054,redRob,,1,8,3,11
21055,Kaganovich,,1,7,6,13
21056,chipr,,1,1,1,2
21057,ludditte,,1,41,67,108
21058,kjkldsjlksdjlksdjl,,1,1,1,2
21059,hamutaro,,1,4,5,9
21060,codepoet,,1,1134,1457,2591
21061,mm262a1,,1,6,7,13
21062,bogosj,,1,21,2,23
21063,CrimsonSun99,,1,389,626,1015
21064,umilmi81,,1,670,703,1373
21065,jtempleton2006,,1,2,6,8
21066,KingFrek,,1,2,1,3
21067,TKOslam,,1,15,8,23
21068,shazzdeeds,,1,7,18,25
21069,ferality,,1,131,22,153
21070,shujaa,,1,122,156,278
21071,peraspera,,1,46,3,49
21072,JohnSanford,,1,4,8,12
21073,pirana0,,1,1,4,5
21074,tinfrog,,1,17,24,41
21075,lonb,,1,17,5,22
21076,faulkner01,,1,1,3,4
21077,Zak,,1,120,125,245
21078,CDLTO,,1,12,18,30
21079,afton,,1,5,9,14
21080,tracyreed,,1,4,2,6
21081,remix,,1,11,22,33
21082,cityhigh,,1,2,6,8
21083,speeditonline,,1,79,5,84
21084,Eso,,1,62,108,170
21085,mybaseballcardspace,,1,13,11,24
21086,workingmom,,1,5,2,7
21087,m0122,,1,13,22,35
21088,Neuticals,,1,27,50,77
21089,shortbaldman,,1,21,38,59
21090,tehyosh,,1,66,99,165
21091,50-50-Bar,,1,3,5,8
21092,Spazsquatch,,1,589,961,1550
21093,cunt_sneeze,,1,7,15,22
21094,fwinter2,,1,1,3,4
21095,2legit2kwit,,1,95,196,291
21096,koryakm,,1,1,2,3
21097,jt004c,,1,195,323,518
21098,maplecustom,,1,1,3,4
21099,adrienne__g,,1,1,2,3
21100,Diogee,,1,1,3,4
21101,aMomentOfZen,,1,6,6,12
21102,lincolnquirk,,1,17,14,31
21103,akula,,1,7,21,28
21104,mervyn101,,1,3,8,11
21105,miniman,,1,1,3,4
21106,Scriptorius,,1,63,75,138
21107,illuminea,,1,1,1,2
21108,mikeybender,,1,1,3,4
21109,motrbotr,,1,21,38,59
21110,dgridley,,1,79,76,155
21111,vecter,,1,181,163,344
21112,vote_up,,1,59,75,134
21113,antonyr,,1,1,10,11
21114,lzylinepainter,,1,10,11,21
21115,pmussoni,,1,9,6,15
21116,bhmt,,1,1,1,2
21117,revertTS,,1,6,15,21
21118,gtxy20,,1,1,1,2
21119,vardhan,,1,231,258,489
21120,metamorphosis,,1,34,45,79
21121,Erf,,1,7,11,18
21122,spinnelein,,1,3,8,11
21123,maxi_taxi,,1,3,1,4
21124,wrighter_is_n_asshat,,1,4,7,11
21125,maseno,,1,60,65,125
21126,dannykarnage,,1,23,2,25
21127,bstaff1901,,1,2,2,4
21128,AnAppleSnail,,1,22,24,46
21129,dinkinflicka,,1,1,1,2
21130,pito,,1,7,7,14
21131,pstuifzand,,1,2,3,5
21132,Amathaine,,1,51,91,142
21133,Boreal,,1,130,202,332
21134,Snaf,,1,6,12,18
21135,k-bunny,,1,1,2,3
21136,classics,,1,1,1,2
21137,banelos,,1,29,77,106
21138,aperson,,1,454,381,835
21139,ruffi,,1,2,6,8
21140,DrSilverworm,,1,3,6,9
21141,cgb,,1,2,3,5
21142,macournoyer,,1,6,5,11
21143,CMH05,,1,16,21,37
21144,crackcat,,1,2,4,6
21145,paulbunyon956,,1,3,5,8
21146,Zombie-Squirrel,,1,7,3,10
21147,analogtyler,,1,46,68,114
21148,restrik,,1,19,28,47
21149,selectorsam,,1,1,2,3
21150,doyle828,,1,7,7,14
21151,pihkal,,1,7,18,25
21152,zaanpenguin,,1,2,2,4
21153,hopper,,1,135,234,369
21154,ethanator,,1,37,23,60
21155,daniel001,,1,36,23,59
21156,madmarigold,,1,38,72,110
21157,misterorange,,1,5,6,11
21158,grapejuice,,1,2,1,3
21159,quietsolutions,,1,2,2,4
21160,butterbutterbutter,,1,1,1,2
21161,Reg_Spyder,,1,262,432,694
21162,lindb291,,1,2,3,5
21163,gibs,,1,50,46,96
21164,Fedquip,,1,88,23,111
21165,gilgam3sh,,1,16,49,65
21166,trevorpinzon,,1,45,45,90
21167,Guderian,,1,14,6,20
21168,casbboy,,1,32,7,39
21169,me2maam,,1,9,10,19
21170,SenorG,,1,1,3,4
21171,mumbojumbo,,1,1,2,3
21172,Sean_Connery,,1,5,3,8
21173,animalbmx,,1,107,55,162
21174,megamark16,,1,4,4,8
21175,t4stringer,,1,4,15,19
21176,chutzpah,,1,40,41,81
21177,colinsyme,,1,136,335,471
21178,frecklefaerie,,1,8,11,19
21179,Siven,,1,2,1,3
21180,TheDaveBoy,,1,6,3,9
21181,myra_reigns,,1,2,3,5
21182,me2plsthx,,1,54,42,96
21183,martinbrickthrower,,1,41,62,103
21184,adent1066,,1,2,1,3
21185,jccarr,,1,7,27,34
21186,yorgan23,,1,41,10,51
21187,hijimayor,,1,3,1,4
21188,sublemon,,1,19,23,42
21189,bobuser,,1,24,45,69
21190,21uda,,1,3,1,4
21191,aflag,,1,22,47,69
21192,Andys,,1,130,208,338
21193,ionblue,,1,34,30,64
21194,sonnymark,,1,8,19,27
21195,theinklein,,1,155,51,206
21196,dannywoodz,,1,1,2,3
21197,hiccuprates,,1,19,25,44
21198,anonbanon,,1,5,5,10
21199,enculturation,,1,1,4,5
21200,alextr,,1,2,2,4
21201,boby4444,,1,5,5,10
21202,Glamdering,,1,305,214,519
21203,kcoll98,,1,1,2,3
21204,openborder,,1,122,7,129
21205,Gandysampras,,1,11,1,12
21206,mdwyer,,1,138,216,354
21207,vincenz,,1,23,20,43
21208,slyguy183,,1,105,250,355
21209,werdanel,,1,70,77,147
21210,mulletmusketeer,,1,9,7,16
21211,jawa,,1,23,57,80
21212,DrDoctorGivemethenew,,1,1,1,2
21213,Randinn,,1,49,110,159
21214,nosoynadie,,1,2,5,7
21215,a-redneck,,1,1,1,2
21216,thraxil,,1,3,4,7
21217,aphrodite2,,1,2,1,3
21218,olsondc,,1,1,1,2
21219,christielynn,,1,39,27,66
21220,sfg,,1,13,17,30
21221,NyMet,,1,48,2,50
21222,FTroop09,,1,21,13,34
21223,louiedog,,1,69,74,143
21224,MR_Rictus,,1,5,3,8
21225,GeorgeThurogood,,1,1,1,2
21226,cvoid,,1,1,1,2
21227,parafinalia,,1,4,11,15
21228,player101,,1,178,35,213
21229,cynix,,1,1,1,2
21230,Zed,,1,24,20,44
21231,jooes,,1,15,14,29
21232,verbosus,,1,10,10,20
21233,sajal,,1,10,1,11
21234,jchoe,,1,1,1,2
21235,thewaywardson,,1,306,450,756
21236,ehitze,,1,29,47,76
21237,FEED_ME,,1,1,3,4
21238,slaphappy,,1,5,20,25
21239,flailking,,1,38,79,117
21240,womanistmusings,,1,236,91,327
21241,amirk1983,,1,4,2,6
21242,uwc,,1,12,13,25
21243,chalk46,,1,32,86,118
21244,reddan,,1,13,18,31
21245,BuffMom,,1,1,2,3
21246,travmatron86,,1,12,12,24
21247,tomboessel,,1,1,8,9
21248,littleriver1,,1,67,73,140
21249,dudesparo,,1,3,5,8
21250,sfxazure,,1,5,7,12
21251,EggCoroner,,1,182,191,373
21252,gowerski,,1,7,11,18
21253,liesen,,1,1,1,2
21254,alexkehr,,1,498,41,539
21255,jormungandr,,1,1,5,6
21256,justinb,,1,1,1,2
21257,majdeath,,1,5,4,9
21258,gaiusparx,,1,2,1,3
21259,absolutelyamazed,,1,150,124,274
21260,RomneyWhisperer,,1,3,8,11
21261,radialmonster,,1,22,34,56
21262,Squee69777,,1,11,27,38
21263,ssylvan,,1,130,198,328
21264,zorro99,,1,9,14,23
21265,benjaminck,,1,6,7,13
21266,kykid,,1,211,69,280
21267,darlantan,,1,271,408,679
21268,daballer2005,,1,7,5,12
21269,skydivingdutch,,1,157,207,364
21270,tupal,,1,1,3,4
21271,theredkap,,1,43,79,122
21272,Lazymath,,1,25,41,66
21273,gblosser,,1,12,9,21
21274,AN0NYM0US,,1,1,1,2
21275,casualbattery,,1,2,3,5
21276,canadiense,,1,1,1,2
21277,TheProphetMohammed,,1,2,4,6
21278,moadm3,,1,3,2,5
21279,Zeider,,1,2,3,5
21280,miyamotofreak,,1,29,24,53
21281,michaelgburton,,1,1,2,3
21282,mojool,,1,30,78,108
21283,Davo69,,1,12,23,35
21284,doublepow,,1,1,4,5
21285,zenclick,,1,3,2,5
21286,strangerdream,,1,13,5,18
21287,Impudence,,1,17,15,32
21288,StarSirius,,1,15,2,17
21289,anarchman,,1,240,295,535
21290,derrelicte,,1,29,37,66
21291,beammeup,,1,4,1,5
21292,lispism,,1,2,3,5
21293,ctown1,,1,86,16,102
21294,Syltprinsen,,1,2,3,5
21295,willbb,,1,5,5,10
21296,funhouse,,1,107,5,112
21297,dandanielson,,1,51,81,132
21298,underjc,,1,2,6,8
21299,hox,,1,52,89,141
21300,auto98,,1,12,22,34
21301,JohnnieAysgarth,,1,5,8,13
21302,polydorus,,1,41,33,74
21303,imxrq,,1,2,3,5
21304,itsnotabigtruck,,1,14,17,31
21305,meatpiesnorkle,,1,10,4,14
21306,echoes1234,,1,1,1,2
21307,NextQuestion,,1,1,2,3
21308,andrewxhill,,1,5,6,11
21309,SavetheWheel,,1,3,2,5
21310,iamsmrtk,,1,15,8,23
21311,dairyair,,1,3,9,12
21312,dgermain,,1,2,2,4
21313,TwoFourSixOhOne,,1,3,8,11
21314,barnacle999,,1,8,9,17
21315,ajlhahjsdhad,,1,6,7,13
21316,unkle,,1,7,12,19
21317,wafla,,1,4,8,12
21318,lordie,,1,11,1,12
21319,crowe1130,,1,52,18,70
21320,Paperweight,,1,211,203,414
21321,Alexandraf,,1,2,3,5
21322,Haroshia,,1,305,327,632
21323,happygolucky,,1,2,1,3
21324,topderek,,1,3,5,8
21325,rjones2818,,1,93,10,103
21326,5m10y,,1,172,74,246
21327,rplzoom,,1,9,4,13
21328,FreakCERS,,1,29,46,75
21329,jason0802,,1,2,1,3
21330,viewer82,,1,7,5,12
21331,pi_neutrino,,1,2,6,8
21332,rorleth,,1,4,1,5
21333,madhighlandcow,,1,21,43,64
21334,jlabr,,1,87,61,148
21335,phrakture,,1,101,109,210
21336,marshull,,1,144,282,426
21337,Autumnfox,,1,1,1,2
21338,parislemon,,1,127,7,134
21339,infil,,1,515,910,1425
21340,xiaobaitu,,1,1,1,2
21341,anewman11,,1,252,295,547
21342,cornucopia,,1,104,144,248
21343,justech3,,1,1,9,10
21344,chadlerh,,1,1,2,3
21345,bugdozer,,1,2,5,7
21346,MasterMahan,,1,62,46,108
21347,haws,,1,1,2,3
21348,truepatriot2184,,1,1,1,2
21349,brekisback,,1,31,6,37
21350,ajwans,,1,1,2,3
21351,iedroe,,1,4,7,11
21352,cwzwarich,,1,106,137,243
21353,samria,,1,4,15,19
21354,Innogen,,1,1,1,2
21355,erikbra81,,1,368,325,693
21356,Checkit,,1,13,1,14
21357,capn,,1,1,1,2
21358,shanangreen,,3,2,2,4
21359,broken_hand,,1,74,23,97
21360,picred,,1,1,1,2
21361,valdemaximus,,1,27,1,28
21362,miratom,,1,14,26,40
21363,parkedr,,1,23,8,31
21364,hfc,,1,124,5,129
21365,ifnot4u,,1,8,1,9
21366,eVizitei,,1,1,1,2
21367,redditworldtree,,1,3,1,4
21368,ABWORD74,,1,1,1,2
21369,coocha,,1,10,21,31
21370,tungsten3695,,1,1,1,2
21371,lurkinin,,1,28,24,52
21372,yvrview,,1,19,14,33
21373,Coretracker,,1,2,1,3
21374,hickory,,1,22,3,25
21375,bellesole,,1,14,21,35
21376,klaarn,,1,26,7,33
21377,marvik,,1,33,2,35
21378,tripppp,,1,1,3,4
21379,peewinkle,,1,275,200,475
21380,wparsons,,1,88,195,283
21381,jdnx429,,1,5,3,8
21382,getmorepc,,1,5,2,7
21383,egypturnash,,1,83,156,239
21384,adamcar,,1,1,1,2
21385,Borkz,,1,55,93,148
21386,Jimjim201,,1,1,1,2
21387,question_4_seopher,,1,1,1,2
21388,lmdocherty,,1,3,6,9
21389,orangecrushucf,,1,6,9,15
21390,aletornw,,1,2,2,4
21391,Akhkharu,,1,1,1,2
21392,jakefl04,,1,130,114,244
21393,funkydragon2005,,1,6,20,26
21394,mutantediez,,1,3,5,8
21395,benthomasson,,1,2,1,3
21396,carlosh,,1,21,16,37
21397,strangeelement,,1,42,12,54
21398,ThisIsDave,,1,1134,1463,2597
21399,krix,,1,2,3,5
21400,dobaksa,,1,1,1,2
21401,johnjoe,,1,1,1,2
21402,saulhoward,,1,1,2,3
21403,harrisxml,,1,1,1,2
21404,stefanve,,1,1,1,2
21405,ecaradec,,1,1,1,2
21406,justin7,,1,1,1,2
21407,msamericanpie,,1,5,4,9
21408,BurtYoungsters,,1,4,2,6
21409,ftcnt,,1,342,11,353
21410,morigoli28,,1,8,3,11
21411,jjmc123a,,1,24,59,83
21412,inkedmn,,1,11,2,13
21413,jetsetsc,,1,1,4,5
21414,SoysauceMafia,,1,49,82,131
21415,asegura,,1,37,14,51
21416,demian64,,1,74,127,201
21417,Trexdacy,,1,98,90,188
21418,anthrodocZ,,1,96,177,273
21419,TobyDumb,,1,111,262,373
21420,REBELYELLoz,,1,298,238,536
21421,SilverPaladin,,1,16,42,58
21422,xvs,,1,40,60,100
21423,chaopsychochick,,1,1,5,6
21424,combover,,1,86,148,234
21425,FiL-dUbz,,1,171,343,514
21426,argr,,1,3,2,5
21427,BottleRocket,,1,1,1,2
21428,tfm,,1,53,90,143
21429,tito184,,1,11,33,44
21430,javaru,,1,84,139,223
21431,stack_smasher,,1,2,2,4
21432,hitmonval,,1,395,583,978
21433,keithb,,1,125,188,313
21434,jimstr,,1,1,7,8
21435,VirginiaDare,,1,14,4,18
21436,scriggities,,1,166,164,330
21437,SewerHorse,,1,7,3,10
21438,rebelwithacause,,1,1,3,4
21439,ade,,1,15,1,16
21440,digitalmanifesto,,1,3,12,15
21441,cubiccavepearls,,1,28,6,34
21442,johnonly,,1,3,2,5
21443,jmm8,,1,6,3,9
21444,capecodcarl,,1,567,464,1031
21445,JohnSteel,,1,7,11,18
21446,NilObject,,1,68,74,142
21447,patheticfallacy,,1,4,1,5
21448,hagrin,,1,1,2,3
21449,raymondreams,,1,3,14,17
21450,kelaking,,1,4,7,11
21451,bluematter,,1,10,2,12
21452,grs2,,1,2,4,6
21453,WildeIdeas,,1,3,3,6
21454,AndreasBWagner,,1,433,112,545
21455,dt40,,1,7,3,10
21456,nocoolname_tom,,1,1,1,2
21457,infosec,,1,20,2,22
21458,toblotron,,1,14,4,18
21459,deepbrown,,1,29,7,36
21460,bullet19465,,1,19,20,39
21461,knobtwiddler,,1,30,40,70
21462,lonekorean,,1,36,54,90
21463,hubrisjebris,,1,11,10,21
21464,caferrell,,1,83,46,129
21465,aranyx,,1,7,8,15
21466,King_Leonidas,,1,178,420,598
21467,ahtnamas,,1,1,4,5
21468,sprycansht,,1,1,2,3
21469,JackSpratts,,1,5,5,10
21470,cecil4ever2000,,1,26,19,45
21471,AggroBoy,,1,2,1,3
21472,drexo,,1,17,2,19
21473,arebop,,1,53,65,118
21474,jamonterrell,,1,7,8,15
21475,Dice_for_Death_,,1,4,8,12
21476,doubleUsquared,,1,1,1,2
21477,wchogg,,1,3,11,14
21478,tc110407,,1,3,1,4
21479,stetson9,,1,3,2,5
21480,CaptainCranberry,,1,9,2,11
21481,rmosler,,1,125,104,229
21482,pucklermuskau,,1,1,1,2
21483,gcubed,,1,2,2,4
21484,cinnamon_graham,,1,5,5,10
21485,nakejnick,,1,100,5,105
21486,marvinddmartian,,1,33,14,47
21487,ringmod,,1,19,20,39
21488,tundratess,,1,15,31,46
21489,LindaJM,,1,1,1,2
21490,areh,,1,6,5,11
21491,jual,,1,3,10,13
21492,silverstrike,,1,36,11,47
21493,bmdmbphd001,,1,4,10,14
21494,biotmessiah,,1,1,2,3
21495,ruutanansissi,,1,2,1,3
21496,molnatisi,,1,188,3,191
21497,Ferguson1015,,1,35,1,36
21498,Kerrbear,,1,3,1,4
21499,mch,,1,634,1764,2398
21500,tlack,,1,109,173,282
21501,mgodave,,1,1,1,2
21502,Gizmod,,1,1,1,2
21503,cah1277,,1,5,3,8
21504,guyzero,,1,19,31,50
21505,lovegoodisgay,,1,1,1,2
21506,JesseOnReddit,,1,1,1,2
21507,dbcalo,,1,21,59,80
21508,grz,,1,8,12,20
21509,ColdCowboy,,1,4,4,8
21510,satorobamazombie,,1,5,1,6
21511,dfens,,1,18,33,51
21512,cazabam,,1,9,15,24
21513,jng,,1,21,20,41
21514,gilgoomesh,,1,92,101,193
21515,seemsartless,,1,2,1,3
21516,Nedemon,,1,2,1,3
21517,georgeb,,1,256,21,277
21518,clever-username,,1,2,1,3
21519,bdugas,,1,55,17,72
21520,Ermenwyr,,1,65,16,81
21521,sluggg,,1,3,4,7
21522,justincouch,,1,67,122,189
21523,veggiesoup,,1,11,18,29
21524,FleaBittenFreakShow,,1,3,4,7
21525,another_account,,1,1,2,3
21526,threeinthemorning,,1,3,6,9
21527,proudfoot,,1,1,1,2
21528,goldie04,,1,2,1,3
21529,squalk,,1,2,3,5
21530,jonathon1977,,1,82,2,84
21531,waggawagga,,1,823,134,957
21532,klui,,1,7,13,20
21533,benitohoover,,1,21,15,36
21534,koryk,,1,211,116,327
21535,celestialaria,,1,1,1,2
21536,Strauss_ismy_Grandpa,,1,85,30,115
21537,rutiene,,1,3,2,5
21538,reddit0ralpha,,1,4,6,10
21539,jlnotsobad,,1,4,5,9
21540,peterzuni,,1,8,22,30
21541,kinneys,,1,30,52,82
21542,runamok1,,1,111,161,272
21543,max15,,1,6,5,11
21544,buckeyetimmy,,1,24,1,25
21545,danielbuchanan,,1,41,75,116
21546,fredstidston,,1,3,11,14
21547,Entercom,,1,4,6,10
21548,diulv,,1,10,4,14
21549,umarboy,,1,432,58,490
21550,TheDreadedThommo,,1,5,3,8
21551,rnelsonee,,1,139,170,309
21552,yoric,,1,34,25,59
21553,csl110,,1,3,4,7
21554,maxcorp,,1,4,8,12
21555,akfidjeland,,1,1,1,2
21556,dearsomething,,1,70,134,204
21557,flangle1,,1,17,46,63
21558,SkeeterVT,,1,22,1,23
21559,JoshFiles,,1,34,7,41
21560,dilldoe,,1,1,1,2
21561,rhouston,,1,8,10,18
21562,mbouchard,,1,4,5,9
21563,rapidsea,,1,8,2,10
21564,reku,,1,10,17,27
21565,detroitsgoingtowork,,1,5,3,8
21566,hhh333,,1,635,571,1206
21567,dalmuti,,1,1,4,5
21568,goodbandnamefinder,,1,2,3,5
21569,gerbel01,,1,5,1,6
21570,discospank,,1,1,1,2
21571,saveuglyfish,,1,4,2,6
21572,Jodin,,1,175,12,187
21573,gameshot911,,1,301,183,484
21574,donhamon,,1,33,40,73
21575,euicho,,1,1,1,2
21576,vahnsin,,1,173,238,411
21577,paperzinorder,,1,1,3,4
21578,IOU12,,1,15,12,27
21579,ivrydov,,1,66,52,118
21580,SupremeNova,,1,1,1,2
21581,FreeManAndHisDog,,1,9,16,25
21582,kaitos,,1,14,16,30
21583,taptriv,,1,2,1,3
21584,GlueBoy,,1,332,317,649
21585,go_go_creationistas,,1,4,2,6
21586,kittyxiii,,1,42,26,68
21587,kahwee,,1,4,1,5
21588,politicalobserver,,1,10,2,12
21589,agentace,,1,85,189,274
21590,comechao,,1,3,1,4
21591,ashot,,1,29,27,56
21592,crm114,,1,173,56,229
21593,deosone,,1,2,2,4
21594,binarychimera,,1,1,1,2
21595,yourblues,,1,1,1,2
21596,mrsanchez,,1,64,96,160
21597,GuySmilee,,1,15,7,22
21598,nrfinney,,1,4,2,6
21599,BuckBuckBang,,1,1,11,12
21600,asdren,,1,6,6,12
21601,fitzgerald11,,1,1,1,2
21602,lembasbread,,1,200,284,484
21603,rodneykm,,1,38,92,130
21604,bludo,,1,9,13,22
21605,eieio,,1,3,8,11
21606,redmiss,,1,1,1,2
21607,aileana61702,,1,1,1,2
21608,rhlowe,,1,338,281,619
21609,Dunhamzzz,,1,3,4,7
21610,sionar,,1,32,14,46
21611,OVERM1ND,,1,2,5,7
21612,ironylocks,,1,37,40,77
21613,Thundercats_Hooo,,1,1,2,3
21614,OvrLpdIO,,1,5,1,6
21615,ixxy,,1,3,2,5
21616,orangepeel,,1,21,26,47
21617,Jay27,,1,24,32,56
21618,gustavopr,,1,13,19,32
21619,jawknee530,,1,8,16,24
21620,ratdogs,,1,10,2,12
21621,kaythetall,,1,14,15,29
21622,jng855,,1,3,4,7
21623,Summariser,,1,28,45,73
21624,Chrystala,,1,1,1,2
21625,zsombor,,1,7,7,14
21626,betasheep,,1,3,1,4
21627,jeremywc,,1,1,3,4
21628,johnsolo,,1,9,13,22
21629,EntropyG,,1,2,3,5
21630,worldpeacenow,,1,60,12,72
21631,whyamidoingthis,,1,3,1,4
21632,lbiewald,,1,24,1,25
21633,dcradler,,1,1,1,2
21634,mindofgenius,,1,11,3,14
21635,FarmerPete,,1,37,50,87
21636,chryler,,1,8,6,14
21637,moriya,,1,466,448,914
21638,mrtich,,1,1,3,4
21639,commieneko,,1,6,15,21
21640,koolaidman,,1,1,4,5
21641,tomhajdu,,1,85,4,89
21642,acab,,1,1,1,2
21643,anaranjaded,,1,46,34,80
21644,hootdoodie,,1,15,35,50
21645,darknessallaround,,1,18,6,24
21646,pnz,,1,5,5,10
21647,gdshephe88,,1,21,23,44
21648,sheeple-NH507,,1,3,1,4
21649,alsoodani,,1,147,174,321
21650,Zrimmy,,1,31,38,69
21651,feissner,,1,1,3,4
21652,McGruff-the-CrimeDog,,1,1,1,2
21653,mahoua,,1,2,4,6
21654,seddit999,,1,8,6,14
21655,Endura,,1,10,23,33
21656,shru,,1,69,2,71
21657,d_arvind,,1,6,6,12
21658,brother-seamus,,1,118,179,297
21659,hartmoney,,1,5,7,12
21660,rivercheng,,1,8,10,18
21661,Rivensteel,,1,30,15,45
21662,zakalwe,,1,4,1,5
21663,seven5,,1,1,7,8
21664,rabiddachshund,,1,226,361,587
21665,flyingblind,,1,1,3,4
21666,walrus99,,1,202,238,440
21667,unripegreenbanana,,1,216,120,336
21668,mbravenboer,,1,1,2,3
21669,rglullis,,1,5,1,6
21670,kanebosom,,1,5,15,20
21671,mysteri0usdrx,,1,188,233,421
21672,rabidmonkey1,,1,59,28,87
21673,patchwork,,1,307,258,565
21674,svantuss,,1,93,91,184
21675,charrom,,1,1,1,2
21676,White_Sox,,1,12,4,16
21677,krishnamurthy1,,1,11,8,19
21678,silva42,,1,3,4,7
21679,eyal0,,1,2,6,8
21680,effoveks,,1,1,2,3
21681,opkopk,,1,2,3,5
21682,littletamale,,1,29,39,68
21683,Project3,,1,2,6,8
21684,pugh,,1,3,2,5
21685,beeUnit,,1,117,277,394
21686,dognoir,,1,3,4,7
21687,QFever,,1,14,3,17
21688,joemart,,1,64,19,83
21689,clavalle,,1,6,13,19
21690,kadmia,,1,12,15,27
21691,OMGIAMSOANGRY,,1,19,15,34
21692,pwbdecker,,1,14,18,32
21693,giogreen,,3,2,2,4
21694,CletusTSJY,,1,5,13,18
21695,mcrosby,,1,7,3,10
21696,KaizerOumft,,1,2,5,7
21697,hepkat,,1,22,26,48
21698,nelsonjs,,1,2101,125,2226
21699,piranhoiac,,1,11,5,16
21700,Lostinservice,,1,41,56,97
21701,erikgil,,1,2,3,5
21702,gloveworld,,1,2,3,5
21703,Hypx,,1,56,10,66
21704,azitis,,1,5,2,7
21705,flashboy131,,1,9,5,14
21706,sappyheed,,1,1,2,3
21707,Rommel76,,1,1,1,2
21708,reethianaj,,1,11,6,17
21709,dice4death,,1,8,7,15
21710,atticusfinch1970,,1,48,98,146
21711,kaikaifi,,1,1,1,2
21712,jjiggajouncer,,1,3,2,5
21713,whitnone,,1,4,2,6
21714,dwayn3,,1,4,6,10
21715,Pfhreak,,1,2,1,3
21716,sydlab,,1,1,1,2
21717,Imperaclesw,,1,36,13,49
21718,AmazingTechProducts,,1,16,8,24
21719,rgristroph,,1,6,11,17
21720,wack_job,,1,9,6,15
21721,ace_wolfgang,,1,332,886,1218
21722,sigzero,,1,452,598,1050
21723,Pinetrees,,1,1,1,2
21724,jjgames,,1,20,12,32
21725,MeanOldTeacher,,1,2,2,4
21726,mquane,,1,48,8,56
21727,IveBeenEz,,1,13,19,32
21728,PhineusQButterfat,,1,4,2,6
21729,senjin,,1,13,16,29
21730,thelogicalsmoker,,1,26,3,29
21731,caadr,,1,2,2,4
21732,phnx0221,,1,1,2,3
21733,sadiq229,,1,139,7,146
21734,raskalz,,1,495,324,819
21735,mlclau,,1,2,10,12
21736,abstrusegoose,,1,46,3,49
21737,godzawor,,1,13,20,33
21738,adherent,,1,4,5,9
21739,pvg,,1,20,11,31
21740,kelmr2003,,1,162,271,433
21741,bd808,,1,1,1,2
21742,gernika,,1,14,21,35
21743,Huwcol,,1,7,9,16
21744,random_ms_dev,,1,1,1,2
21745,pageonehundredone,,1,3,2,5
21746,kidatheart,,1,16,22,38
21747,jordanst10,,1,1,1,2
21748,schuylercat,,1,1,10,11
21749,yourheadlinesucks,,1,1,1,2
21750,dougmachutta,,1,18,10,28
21751,FizZle,,1,62,53,115
21752,automatedresponse,,1,350,769,1119
21753,bryn,,1,41,108,149
21754,heisenbergs,,1,3,1,4
21755,I-heart-boobs,,1,1,3,4
21756,drewc,,1,101,140,241
21757,raf797,,1,50,30,80
21758,ladyles15,,1,22,30,52
21759,plbogen,,1,566,1071,1637
21760,baru,,1,7,1,8
21761,Mtrain,,1,165,145,310
21762,TheGreenBastard2,,1,2,7,9
21763,Stiltskin,,1,26,37,63
21764,callius,,1,45,84,129
21765,bipolarrogue,,1,21,7,28
21766,Lazrath,,1,58,118,176
21767,rynvndrp,,1,404,516,920
21768,modal,,1,1,3,4
21769,kepik99,,1,2,2,4
21770,CowardiceIsFrench,,1,5,3,8
21771,Disparity,,1,50,67,117
21772,mutantdad,,1,2,1,3
21773,jsheeran,,1,11,7,18
21774,RichardByrd,,1,1,1,2
21775,darkgatherer,,1,575,704,1279
21776,lizard_almighty,,1,1,1,2
21777,chiswede,,1,3,8,11
21778,hilandhall,,1,9,16,25
21779,lagattack,,1,8,7,15
21780,bamobrien,,1,261,515,776
21781,wjv,,1,121,46,167
21782,jlobes,,1,21,28,49
21783,blaaargh,,1,46,36,82
21784,Arctica,,1,103,32,135
21785,akcom,,1,2,2,4
21786,captainabab,,1,9,9,18
21787,kdesu,,1,27,31,58
21788,ShenaniganCannon,,1,22,49,71
21789,iamseb,,1,3,2,5
21790,jczerg68,,1,16,24,40
21791,Latvious,,1,54,51,105
21792,ManiacMunson,,1,50,10,60
21793,edenicholas,,1,4,3,7
21794,ak217,,1,2,3,5
21795,MesaDixon,,1,62,141,203
21796,corvenus,,1,120,232,352
21797,dr_vertigo,,1,53,36,89
21798,jlc,,1,11,15,26
21799,jedcaum,,1,32,58,90
21800,thaworldhaswarpedme,,1,1,1,2
21801,azrolboyz,,1,2,3,5
21802,TheSuperficial,,1,28,47,75
21803,cp1134,,1,14,3,17
21804,apolloandi,,1,8,18,26
21805,dregle,,1,123,108,231
21806,Xenogyst,,1,5,10,15
21807,h-town,,1,672,623,1295
21808,IwillUpmodAnything,,1,29,4,33
21809,toupeira,,1,87,113,200
21810,anais9000,,1,6,11,17
21811,nashy,,1,1,1,2
21812,jaba1337,,1,38,50,88
21813,5cf5e83a,,1,134,158,292
21814,BookWormPride,,1,319,1,320
21815,Pinecone,,1,93,151,244
21816,ddp,,1,9,33,42
21817,fadain,,1,1,1,2
21818,Nouareii,,1,100,17,117
21819,The_Dude,,1,5,8,13
21820,fatmaggot,,1,3,8,11
21821,Whatta,,1,2,1,3
21822,ritteh,,1,20,21,41
21823,hasty_d,,1,5,4,9
21824,Rozen,,1,213,404,617
21825,alex14,,1,15,23,38
21826,COLORED_MAJORITY,,1,3,4,7
21827,JaredTizzle,,1,82,17,99
21828,cico71,,1,1,2,3
21829,NoUnderbites,,1,22,27,49
21830,Lexarius,,1,303,442,745
21831,parkerknoll,,1,116,127,243
21832,Lancose,,1,3,3,6
21833,republicus,,1,68,5,73
21834,Benjaphar,,1,199,200,399
21835,gramie,,1,1,2,3
21836,shutr,,1,45,87,132
21837,antharjalaya,,1,43,4,47
21838,stealthburger,,1,1,5,6
21839,fragmede,,1,21,15,36
21840,trojan7815,,1,152,53,205
21841,allliam,,1,36,47,83
21842,wazzadoin,,1,163,227,390
21843,partysnatcher,,1,3,3,6
21844,onehandhigh,,1,1,6,7
21845,hp0,,1,289,466,755
21846,mickael,,1,15,8,23
21847,eovery,,1,1,4,5
21848,Coriform,,1,49,54,103
21849,kapc,,1,1,2,3
21850,johnrover,,1,6,9,15
21851,johndear3,,1,5,11,16
21852,Blu-Aardvark,,1,1,1,2
21853,FiberOptics,,1,2,21,23
21854,sekritkoad,,1,75,110,185
21855,richtone,,1,1,1,2
21856,dirtracerswife7,,1,1,1,2
21857,sevencorvina,,1,14,24,38
21858,nickstatus,,1,1,5,6
21859,smayland,,1,16,48,64
21860,Gop3588,,1,74,49,123
21861,redherring84,,1,60,121,181
21862,snaps4darienfoo,,1,1,1,2
21863,Metalevel,,1,2,1,3
21864,gwheeler,,1,13,19,32
21865,mccafferty,,1,1,1,2
21866,hwaite,,1,5,8,13
21867,Telekinesis,,1,2,3,5
21868,Penseur85,,1,4,1,5
21869,sickoo,,1,1459,56,1515
21870,ComradeUSA,,1,206,23,229
21871,sonar1,,1,102,129,231
21872,boxofish,,1,1,4,5
21873,darkies,,1,1,1,2
21874,clarion,,1,109,212,321
21875,jelasher,,1,130,75,205
21876,jgodt,,1,46,30,76
21877,billthelizard,,1,1,1,2
21878,frito47,,1,1,4,5
21879,luke_s,,1,4,5,9
21880,tairygreene,,1,8,44,52
21881,tummala,,1,2,1,3
21882,fedy22,,1,9,8,17
21883,ece421,,1,6,21,27
21884,kencam,,1,136,281,417
21885,alanjcfs,,1,1,1,2
21886,skimitar,,1,165,89,254
21887,chimchunk,,1,1,4,5
21888,critik,,1,18,45,63
21889,mughlibuc,,1,27,4,31
21890,dave138h,,1,15,25,40
21891,razaeli,,1,4,14,18
21892,DaylightAtheism,,1,43,2,45
21893,Woody45,,1,1,1,2
21894,HypoLuxa,,1,173,290,463
21895,sixothree,,1,266,543,809
21896,adc,,1,6,5,11
21897,gasjews,,1,2,1,3
21898,Bodhi1,,1,8,3,11
21899,gimiv,,1,7,6,13
21900,herkguy,,1,53,70,123
21901,Notnasiul,,1,5,7,12
21902,horia314,,1,10,9,19
21903,searine,,1,10,14,24
21904,chunjae,,1,191,21,212
21905,Brandbla8,,1,11,1,12
21906,Diffus,,1,3,4,7
21907,zeroclash,,1,6,3,9
21908,Fradgers,,1,19,38,57
21909,boagreus,,1,35,33,68
21910,bishney,,1,73,59,132
21911,petrov76,,1,192,132,324
21912,liquorlunchbox,,1,26,33,59
21913,ryanryguy,,1,1,1,2
21914,danbmil99,,1,1,2,3
21915,RexEast,,1,1,1,2
21916,dicedice,,1,1,1,2
21917,zzzz2008,,1,37,22,59
21918,thunderkat,,1,73,129,202
21919,kb63108,,1,6,14,20
21920,Dasmitch,,1,159,159,318
21921,ollokot,,1,8,14,22
21922,wadet,,1,4,3,7
21923,gregjsmith,,1,1,1,2
21924,bytesmythe,,1,8,11,19
21925,sufo,,1,10,8,18
21926,ThyLabyrinth,,1,235,381,616
21927,niller8p,,1,49,28,77
21928,Janderwastaken,,1,8,19,27
21929,lemz,,1,34,35,69
21930,turmoil,,1,2,1,3
21931,VerbalAbility,,1,1,2,3
21932,susanrae,,1,6,24,30
21933,Blarbo,,1,2,5,7
21934,j0e,,1,1,1,2
21935,ontarioemperor,,1,1,2,3
21936,wormnut,,1,55,170,225
21937,willis3000,,1,43,75,118
21938,jennifer2002,,1,1,1,2
21939,TimMensch,,1,3,6,9
21940,rafishtut,,1,4,7,11
21941,shal0819,,1,108,117,225
21942,egarson,,1,2,6,8
21943,AmenBreak,,1,22,17,39
21944,fredhsu,,1,1,4,5
21945,diogenes,,1,44,38,82
21946,Arcosim,,1,11,7,18
21947,NoSpiderEatBird,,1,2,1,3
21948,Nancy_Pelosi,,1,10,29,39
21949,kidcorporeal,,1,123,160,283
21950,jvcvhs0123,,1,11,5,16
21951,exogen,,1,20,13,33
21952,mrautomatic,,1,1,1,2
21953,stinkyface,,1,3,9,12
21954,9GWQ6bfi,,1,4,9,13
21955,chaconj,,1,1,1,2
21956,wbond,,1,26,4,30
21957,galactic_hitchhiker,,1,1,1,2
21958,sanepsychotic,,1,7,3,10
21959,bigjoe13,,1,26,32,58
21960,voteforamerica,,1,43,1,44
21961,endo,,1,16,21,37
21962,9xX,,1,5,8,13
21963,AriG,,1,9,8,17
21964,nimbl,,1,1,2,3
21965,najcix,,1,40,1,41
21966,busblog,,1,1,2,3
21967,dcontrol,,1,1,1,2
21968,Astronoid,,1,325,382,707
21969,violizard,,1,41,67,108
21970,t_man700,,1,1,2,3
21971,subhub,,1,7,1,8
21972,QuietDestroyer77,,1,23,56,79
21973,toinfinitiandbeyond,,1,11,4,15
21974,softslinger,,1,20,19,39
21975,lkasndfnk,,1,1,1,2
21976,Joneth,,1,112,159,271
21977,bair422,,1,4,6,10
21978,mannytabloid,,1,10,13,23
21979,Astrus,,1,15,5,20
21980,contentoverclarity,,1,4,1,5
21981,cbender35,,1,885,248,1133
21982,jasonm23,,1,1,1,2
21983,vk2sky,,1,7,16,23
21984,darthseb,,1,2,2,4
21985,logus,,1,1,1,2
21986,Dorian_at_Reddit,,1,2,3,5
21987,axiomnow,,1,1,7,8
21988,HybridVigor,,1,1,1,2
21989,lloydxmas,,1,107,243,350
21990,CorporalClegg,,1,2,8,10
21991,queisser,,1,3,8,11
21992,digg1980,,1,7,2,9
21993,lapo3399,,1,134,117,251
21994,sweetlove,,1,136,211,347
21995,glitch13,,1,23,15,38
21996,neokoros,,1,29,81,110
21997,ajoakim,,1,6,7,13
21998,Cyrius,,1,335,633,968
21999,jkustalicious,,1,19,4,23
22000,21jack21,,1,3,1,4
22001,Slick_42,,1,7,9,16
22002,barbieri,,1,3,3,6
22003,feignman,,1,3,2,5
22004,russwbernstein,,1,3,13,16
22005,caulder,,1,4,5,9
22006,mugproject,,1,11,3,14
22007,axonrg,,1,1,1,2
22008,badasslingo,,1,1,1,2
22009,theram4,,1,123,121,244
22010,HextorFreebish,,1,133,230,363
22011,dds,,1,3,5,8
22012,Ben_Ben,,1,9,4,13
22013,homeaccount,,1,5,6,11
22014,CaptainCrunch,,1,340,433,773
22015,soots,,1,1,1,2
22016,Ein2015,,1,32,24,56
22017,sicgamer,,1,180,111,291
22018,b-spline,,1,1,1,2
22019,Comedian,,1,16,22,38
22020,StRophia,,1,3,1,4
22021,foos,,1,9,23,32
22022,MediumRare,,1,9,7,16
22023,nfk,,1,3,2,5
22024,smithysmitherson,,1,46,73,119
22025,sefie,,1,1,2,3
22026,jmsaunders,,1,8,15,23
22027,User_Agreement,,1,94,10,104
22028,lkilcher,,1,1,1,2
22029,JoeHerrick,,1,1,1,2
22030,Helcionelloida,,1,12,2,14
22031,beerwineliquor,,1,17,79,96
22032,ryanpc,,1,3,8,11
22033,mckirsch,,1,37,71,108
22034,Vetsin,,1,27,59,86
22035,qazxsw43,,1,34,1,35
22036,totalof,,1,9,21,30
22037,crazygates,,1,3,2,5
22038,devonRT,,1,1,2,3
22039,chromehorserace,,1,3,5,8
22040,noname99,,1,5791,188,5979
22041,sbender,,1,4,6,10
22042,nadaclue2,,1,3,12,15
22043,JackNobbins,,1,1,2,3
22044,sass-buttes-org,,1,2,1,3
22045,t-dar,,1,3,2,5
22046,Hal9001,,1,6,8,14
22047,sasharocks,,1,17,16,33
22048,kickme444,,1,613,61,674
22049,segfaultxr7,,1,142,136,278
22050,nbloomf,,1,157,266,423
22051,doodlebugger,,1,7,19,26
22052,AverageCanadian,,1,6,3,9
22053,psyllogism,,1,15,4,19
22054,vetinari,,1,15,20,35
22055,000xxx000,,1,171,285,456
22056,europeman,,1,1,3,4
22057,TobascoMan,,1,2,2,4
22058,darrendloux,,1,23,24,47
22059,giovannib,,1,11,13,24
22060,mhmitszach,,1,5,2,7
22061,Mr_Randy_Watson,,1,314,575,889
22062,joandarque,,1,1,2,3
22063,weretheman,,1,8,4,12
22064,pimpampoum,,1,10,17,27
22065,eyekantspel,,1,16,25,41
22066,lerouxb,,1,6,7,13
22067,confidentmeus,,1,1,1,2
22068,brufleth,,1,853,1343,2196
22069,peanutboy,,1,64,142,206
22070,snusmumriken,,1,2,13,15
22071,themullet,,1,4,10,14
22072,gtolson,,1,28,27,55
22073,Violator99,,1,3,2,5
22074,gst,,1,4906,3,4909
22075,flourpour,,1,1,1,2
22076,StopMcCainWhoosit,,1,69,36,105
22077,lisarhianne,,1,7,4,11
22078,wyfflemunky,,1,49,77,126
22079,circusgeek,,1,4,3,7
22080,Red_Wind,,1,3,3,6
22081,stonkin,,1,17,12,29
22082,NoComment,,1,77,13,90
22083,elebrio,,1,36,51,87
22084,JayCTN,,1,19,2,21
22085,rasheemo,,1,40,59,99
22086,ttom,,1,2,4,6
22087,humppapappavaan,,1,59,106,165
22088,frubru,,1,1,3,4
22089,kobs,,1,6,10,16
22090,pbx,,1,127,75,202
22091,zonindehemel,,1,4,2,6
22092,rs85,,1,12,19,31
22093,potyl,,1,3,4,7
22094,smitty13,,1,20,32,52
22095,FlimtotheFlam,,1,30,50,80
22096,getsmartgal,,1,58,32,90
22097,PelonPeloRico,,1,1,2,3
22098,send9,,1,7,9,16
22099,stephencwebster,,1,309,2,311
22100,articleCK,,1,2,1,3
22101,Jedimushroom,,1,26,50,76
22102,ArmedJimmy,,1,15,21,36
22103,deniall,,1,2,3,5
22104,RugerRedhawk,,1,1691,2818,4509
22105,fantagrape,,1,20,19,39
22106,Steve16384,,1,488,609,1097
22107,JessicaLaurie,,1,1349,34,1383
22108,rkstiner,,1,1,2,3
22109,gormer,,1,1,1,2
22110,siliconsnake,,1,1,1,2
22111,uckevin111,,1,6,1,7
22112,fallfornaught,,1,138,107,245
22113,Figs,,1,881,1276,2157
22114,manniac,,1,29,60,89
22115,jarklejam,,1,48,39,87
22116,jollygreengiant,,1,14,28,42
22117,psmith,,1,2,2,4
22118,sarotu,,1,2,3,5
22119,fuzzcat,,1,31,37,68
22120,krammark23,,1,1,1,2
22121,raju1kabir,,1,3,11,14
22122,Pyorrhea,,1,49,77,126
22123,pfairley,,1,22,1,23
22124,Stucco_x,,1,8,10,18
22125,catilac,,1,1,2,3
22126,ransom_phantom,,1,3,4,7
22127,billybobjoe71588,,1,1,3,4
22128,Masonry,,1,2,5,7
22129,Worstcasescenario,,1,134,118,252
22130,queus,,1,262,383,645
22131,sovereignmatt,,1,168,98,266
22132,sadrius,,1,30,49,79
22133,cevven,,1,44,83,127
22134,dalke,,1,2,4,6
22135,Governor00,,1,2,2,4
22136,Neumann347,,1,1,4,5
22137,craigatkinson,,1,2,1,3
22138,demet8,,1,3,5,8
22139,gimme909,,1,1,1,2
22140,NixonsHead,,1,2,1,3
22141,Altazar,,1,14,10,24
22142,eAi,,1,4,1,5
22143,PsychoKiller,,1,1,2,3
22144,shp,,1,2,2,4
22145,aphedox,,1,3,11,14
22146,eoin63,,1,1,3,4
22147,Lagz,,1,27,37,64
22148,lynl,,1,22,27,49
22149,mikegimik,,1,2,6,8
22150,JesseLee,,1,2,2,4
22151,pjenvey,,1,2,1,3
22152,Dummies102,,1,22,44,66
22153,Hawkeye05,,1,138,77,215
22154,beniro,,1,19,24,43
22155,hoxer,,1,6,8,14
22156,asdidi,,1,5,17,22
22157,luke_,,1,1,2,3
22158,rabel,,1,50,68,118
22159,Absolutely_,,1,1,1,2
22160,godeva,,1,1,1,2
22161,innervision,,1,14,30,44
22162,scottmonty,,1,10,2,12
22163,kanon,,1,5,4,9
22164,drupalnub,,1,3,2,5
22165,debney,,1,23,14,37
22166,sosondowah,,1,20,12,32
22167,foogar,,1,3,4,7
22168,justthefacts127,,1,1,1,2
22169,jarhowa,,1,2,1,3
22170,fredzoorzz,,1,1,1,2
22171,kn0thing,,1,649,228,877
22172,suchmann,,1,2,4,6
22173,narwhals,,1,2,3,5
22174,eromitlab,,1,504,959,1463
22175,TheLtOfInishmore,,1,14,30,44
22176,DownedForOverposting,,1,3,12,15
22177,ghflyfk,,1,1,1,2
22178,parboman,,1,9,8,17
22179,voiceofra,,1,12,31,43
22180,signeduptopost-this,,1,4,1,5
22181,dmron,,1,2,6,8
22182,Satanscock,,1,340,669,1009
22183,ryanhughes,,1,16,1,17
22184,somedoody,,1,466,638,1104
22185,Janischambers,,1,1,1,2
22186,eyeshield21,,1,18,11,29
22187,Nysul,,1,40,57,97
22188,bolivarbum,,1,41,62,103
22189,AndruLuvisi,,1,4,1,5
22190,jawz101,,1,53,127,180
22191,xyggyx,,1,3,3,6
22192,redfiretrucker,,1,3,1,4
22193,lost_stranger,,1,9,8,17
22194,tynman,,1,5,1,6
22195,hazardperry,,1,53,64,117
22196,sociallyinept,,1,92,23,115
22197,OrangeTux,,1,22,27,49
22198,seiken,,1,99,139,238
22199,Anon2321,,1,1,1,2
22200,stevengg,,1,64,12,76
22201,skbharman,,1,106,94,200
22202,Doodly,,1,26,28,54
22203,tonfa,,1,82,64,146
22204,pferdestarke,,1,1,2,3
22205,simucal,,1,2,2,4
22206,vthlr,,1,4,7,11
22207,stubbornbelle,,1,218,143,361
22208,spdly,,1,1,2,3
22209,Sasquatchy,,1,1,1,2
22210,Rtbriggs,,1,249,374,623
22211,hillman,,1,1,3,4
22212,angusmcflurry,,1,32,63,95
22213,PPB,,1,7,8,15
22214,amps11,,1,2,5,7
22215,RichMiserable,,1,1,1,2
22216,damvan,,1,15,21,36
22217,mr6275,,1,17,30,47
22218,duskglow,,1,971,789,1760
22219,arvixx,,1,32,13,45
22220,phlyingpenguin,,1,13,38,51
22221,ideaman21,,1,2,1,3
22222,Nokade,,1,50,91,141
22223,gordonlbuchanan,,1,3,1,4
22224,Pepper3333,,1,1,1,2
22225,embretr,,1,92,248,340
22226,cessu,,1,1,4,5
22227,Sabaron,,1,24,41,65
22228,hylje,,1,274,501,775
22229,SilentlyScreaming,,1,2,1,3
22230,thelonegunmen,,1,1,2,3
22231,jonaku,,1,17,1,18
22232,chickens,,1,2,3,5
22233,tfvdw2at,,1,2,3,5
22234,chronicmasturbater,,1,1,1,2
22235,katstar873,,1,48,67,115
22236,pr1m3,,1,7,1,8
22237,TheLegionnaire,,1,50,21,71
22238,blackrockcoast,,1,5,1,6
22239,hexley,,1,5,12,17
22240,Tigereyz,,1,36,21,57
22241,f8ster,,1,3,2,5
22242,EatGreenHumans,,1,5,1,6
22243,toddmfay,,1,18,8,26
22244,Fuk_Boonyalls,,1,3,3,6
22245,Prendeghast,,1,1,2,3
22246,rspeer,,1,10,15,25
22247,broderizdreagan,,1,10,13,23
22248,SpacePirate,,1,21,28,49
22249,few,,1,10,8,18
22250,kevingoodsell,,1,28,41,69
22251,remembercrunchy,,1,2,1,3
22252,anonfornow,,1,1,2,3
22253,jonnybryce,,1,24,35,59
22254,blackrobot,,1,19,7,26
22255,iuferky0,,1,1,3,4
22256,ohuyel,,1,4,3,7
22257,alizaki,,1,69,41,110
22258,mlouie728,,1,3,13,16
22259,OGMO,,1,2,1,3
22260,vapblack,,1,258,246,504
22261,Th3_C0bra,,1,357,340,697
22262,TommyCarcetti,,1,1,1,2
22263,timetofly,,1,7,17,24
22264,ringelingeling,,1,13,8,21
22265,duchesskat,,1,2,1,3
22266,ElectricSol,,1,371,535,906
22267,ryancote,,1,6,1,7
22268,lighthill,,1,7,3,10
22269,wipeout,,1,1,1,2
22270,notloste,,1,1,4,5
22271,Anonymous1234,,1,1,3,4
22272,hashinclude,,1,6,1,7
22273,Dreadgoat,,1,2,1,3
22274,blm126,,1,1,2,3
22275,politalk,,1,13,2,15
22276,chrisporter,,1,4,4,8
22277,acerman99,,1,1,1,2
22278,michelson01,,1,4,1,5
22279,PimpFTRCC,,1,84,3,87
22280,dalbert,,1,234,33,267
22281,trakker,,1,1,3,4
22282,buscuta,,1,4,7,11
22283,fgsdfrtb,,1,23,11,34
22284,UnderwaterJones,,1,165,245,410
22285,sdmx,,1,8,4,12
22286,csonger,,1,1,4,5
22287,woodsier,,1,348,628,976
22288,wushi,,1,70,116,186
22289,JacobB,,1,1,4,5
22290,bahollan,,1,81,120,201
22291,jab-programming,,1,1,8,9
22292,Hobo740,,1,25,69,94
22293,darkesnow,,1,2,7,9
22294,aZoo,,1,2,10,12
22295,dontevenfucwitme,,1,2,3,5
22296,Prom_STar,,1,16,27,43
22297,try_chackson,,1,75,2,77
22298,lukemcr,,1,228,207,435
22299,Krippy,,1,18,41,59
22300,typon,,1,359,381,740
22301,plasticswirl,,1,13,30,43
22302,saadkamal,,1,33,2,35
22303,Skatcho,,1,22,27,49
22304,islandjoe,,1,1,1,2
22305,germ666,,1,42,13,55
22306,ribbiter,,1,31,51,82
22307,swanc,,1,4,3,7
22308,diggum,,1,130,210,340
22309,Gommle,,1,6,6,12
22310,luciferin,,1,1,1,2
22311,mr_visible,,1,2,3,5
22312,oconostota,,1,506,940,1446
22313,linkhunter,,1,7,1,8
22314,miho99,,1,11,19,30
22315,h3st,,1,31,64,95
22316,apdt,,1,1,4,5
22317,xaustinx,,1,2,3,5
22318,GotEmLookin,,1,44,59,103
22319,jgiesinger,,1,7,25,32
22320,rzwitserloot,,1,21,14,35
22321,JManuelD,,1,1,2,3
22322,kd_royal,,1,10,28,38
22323,gx6wxwb,,1,12,21,33
22324,mixx941,,1,2,2,4
22325,bonzinip,,1,414,478,892
22326,aedes,,1,2228,1062,3290
22327,Thelonious_Cube,,1,56,87,143
22328,keebiejeebie,,1,29,69,98
22329,xuttmi,,1,29,29,58
22330,douched,,1,31,69,100
22331,ZuchinniOne,,1,40,35,75
22332,mankin,,1,5,1,6
22333,sacrimony,,1,84,98,182
22334,BlazinEurasian,,1,445,633,1078
22335,bobloco76,,1,2,2,4
22336,tach,,1,243,339,582
22337,cdesignproponentsist,,1,303,591,894
22338,jebreject,,1,1,2,3
22339,0x10,,1,4,9,13
22340,floop,,1,1,3,4
22341,Silentium,,1,5,13,18
22342,Arsthena,,1,5,6,11
22343,R7-D1,,1,32,17,49
22344,drturvy,,1,13,15,28
22345,thatpirategirl,,1,4,3,7
22346,anoraq,,1,67,113,180
22347,zhangsen,,1,2,1,3
22348,hooplow,,1,80,8,88
22349,bigtoga,,1,32,53,85
22350,lenovo,,1,74,136,210
22351,dbenhur,,1,551,373,924
22352,adrian,,1,111,9,120
22353,chunkyks,,1,2,5,7
22354,austinb,,1,2,2,4
22355,Nerdlinger,,1,46,79,125
22356,gfxlonghorn,,1,109,158,267
22357,moocowheff,,1,3,1,4
22358,willem,,1,7,12,19
22359,dcx,,1,5,9,14
22360,Andoo,,1,3,4,7
22361,mibarra,,1,17,4,21
22362,thecapitalc,,1,79,101,180
22363,aussiebb,,1,8,2,10
22364,DarthTater,,1,10,1,11
22365,atothez,,1,2,2,4
22366,PeninsulaGuy,,1,1,11,12
22367,yzerfontein,,1,1,1,2
22368,captainstabb,,1,5,6,11
22369,ajwarren,,1,425,529,954
22370,Reporter,,1,348,631,979
22371,lowenheim,,1,313,271,584
22372,AmyR,,1,1,1,2
22373,paulmalo,,1,2,4,6
22374,dubbleenerd,,1,379,218,597
22375,CorpT,,1,81,70,151
22376,airplane,,1,13,25,38
22377,mcaruso,,1,57,26,83
22378,rywalker,,1,22,10,32
22379,rodle,,1,1,1,2
22380,my_reddit,,1,301,2,303
22381,reddit_ore,,1,20,50,70
22382,meeks,,1,19,29,48
22383,nikopol,,1,2,6,8
22384,marglexx,,1,144,217,361
22385,mintsource,,1,1,1,2
22386,stimples,,1,1,1,2
22387,wiachy,,1,60,63,123
22388,biobio,,1,1,1,2
22389,mineh,,1,1,1,2
22390,IamJoethePlumber,,1,36,22,58
22391,rbsftw,,1,1,2,3
22392,junke_3,,1,30,42,72
22393,mjl5629,,1,10,20,30
22394,goomboss,,1,1,3,4
22395,freshyill,,1,3,7,10
22396,TexasCanuck,,1,63,105,168
22397,bski1776,,1,71,109,180
22398,doctor_subtilis,,1,6,15,21
22399,barnabymeller,,1,1,1,2
22400,cranium,,1,508,57,565
22401,fjhqjv,,1,941,1316,2257
22402,BadBoyNDSU,,1,182,280,462
22403,Willtingle,,1,11,16,27
22404,mushmouph,,1,37,2,39
22405,soulhacker,,1,1,6,7
22406,d3mag0gu3,,1,54,54,108
22407,blender3000,,1,1,2,3
22408,swupuws,,1,14,12,26
22409,zombieaynrand,,1,441,357,798
22410,Geckoman,,1,3,1,4
22411,bulio,,1,16,1,17
22412,grt,,1,1,1,2
22413,nollek,,1,2,2,4
22414,wrngway,,1,3,4,7
22415,mlk,,1,653,547,1200
22416,frozendevil,,1,2,2,4
22417,eldentisto,,1,10,4,14
22418,JimmyJamesMac,,1,18,56,74
22419,nate94gt,,1,1,1,2
22420,joker10687,,1,131,196,327
22421,stormzebastille,,1,18,43,61
22422,barvazim,,1,83,17,100
22423,m-p-3,,1,7,23,30
22424,hphp,,1,14,17,31
22425,raarky,,1,33,49,82
22426,lotu,,1,43,62,105
22427,kpierre,,1,23,14,37
22428,wiseleyb,,1,17,23,40
22429,sirlearnsalot,,1,140,242,382
22430,alexmat,,1,25,24,49
22431,Chamanzan,,1,353,308,661
22432,Arxilca,,1,45,26,71
22433,jamesman,,1,2,1,3
22434,CG10277,,1,74,1,75
22435,otterdam,,1,588,817,1405
22436,squatto,,1,5,3,8
22437,socialguytoy,,1,1,3,4
22438,sunburnt,,1,13,5,18
22439,zacroy,,1,3,4,7
22440,Slashered,,1,123,7,130
22441,DevilsAdv0cate,,1,19,13,32
22442,badmadbob,,1,1,1,2
22443,alekseykorzun,,1,2,1,3
22444,dlew,,1,1,1,2
22445,5thape,,1,8,13,21
22446,PJinAK,,1,1,1,2
22447,tesseract_rider,,1,11,5,16
22448,middayminer,,1,25,42,67
22449,rdpriest,,1,3,1,4
22450,Knapsack,,1,47,75,122
22451,brksy,,1,26,43,69
22452,derkieselgarten,,1,2,1,3
22453,Shananra,,1,6,9,15
22454,professorcreep,,1,4,4,8
22455,punzak,,1,5,12,17
22456,nandolvvlln,,1,2,1,3
22457,kcnchfan,,1,494,232,726
22458,yorian,,1,266,64,330
22459,rasta999,,1,4,5,9
22460,blue_entropy,,1,9,7,16
22461,AlbertGramatico,,1,10,18,28
22462,aboothe726,,1,212,159,371
22463,jimgardner1973,,1,6,4,10
22464,titaniumdecoy,,1,4,11,15
22465,harvester,,1,142,32,174
22466,md5,,1,25,28,53
22467,stantz,,1,12,12,24
22468,tacoswild,,1,6,9,15
22469,dufour,,1,18,24,42
22470,AlexeyMK,,1,185,154,339
22471,hypocondrite,,1,3,4,7
22472,neb,,1,1,1,2
22473,mikepurvis,,1,468,499,967
22474,mhaggag,,1,49,60,109
22475,jimmick,,1,187,145,332
22476,psycho_cat,,1,1,1,2
22477,castanova,,1,328,7,335
22478,andknitting,,1,10,21,31
22479,pragdave,,1,1,1,2
22480,bonerjones,,1,43,105,148
22481,misterpantsz,,1,50,9,59
22482,InWhatRespectCharlie,,1,5,7,12
22483,tflynch,,1,7,11,18
22484,kimmyd,,1,2,2,4
22485,ChinesePropaganda,,1,8,7,15
22486,Ingenium21,,1,25,41,66
22487,burying_luck,,1,4,2,6
22488,sighkobabel,,1,34,59,93
22489,alandy25,,1,2,2,4
22490,setrajonas,,1,3,7,10
22491,majorwtf,,1,437,27,464
22492,piquana,,1,31,3,34
22493,proteinstainedpants,,1,2,1,3
22494,gatey,,1,2,3,5
22495,icecow,,1,7,7,14
22496,estutius,,1,133,118,251
22497,OhioDuran,,1,1,2,3
22498,nrx22,,1,19,3,22
22499,pastr,,1,66,14,80
22500,futz,,1,1,2,3
22501,bobbmalooga,,1,8,5,13
22502,ColeSQ,,1,11,11,22
22503,faultywiring,,1,10,15,25
22504,sassinator,,1,56,11,67
22505,KingNothing,,1,123,169,292
22506,Silver_,,1,119,256,375
22507,inspekt0rgadget,,1,18,19,37
22508,skoll,,1,90,90,180
22509,txstoploss,,1,261,344,605
22510,benjiz,,1,25,14,39
22511,Autodidactic,,1,21,9,30
22512,reddddditer,,1,6,16,22
22513,Armageddon85,,1,3,2,5
22514,cuteman,,1,139,236,375
22515,spondee,,1,14,16,30
22516,mobzoe,,1,3,3,6
22517,Damon29,,1,2,1,3
22518,Entropy_Man,,1,2,3,5
22519,L2182,,1,19,1,20
22520,biskithead,,1,5,1,6
22521,xarcos,,1,10,12,22
22522,estacado,,1,32,34,66
22523,youboozeyoulose,,1,2,4,6
22524,beardedrooster,,1,19,51,70
22525,mbrophy,,1,1,1,2
22526,Greengages,,1,451,803,1254
22527,potemkin,,1,1,2,3
22528,tylermenezes,,1,187,307,494
22529,FCI,,1,6,9,15
22530,bill_o_r,,1,1,1,2
22531,Apple_Dave,,1,95,91,186
22532,jessek,,1,159,180,339
22533,MasterRex,,1,7,10,17
22534,jamesgolick,,1,87,7,94
22535,BeShirtHappy,,1,5,14,19
22536,skepticsglobal,,1,5,12,17
22537,growlypants,,1,2,2,4
22538,rq60,,1,71,128,199
22539,kapetanaki,,1,27,32,59
22540,whdevo,,1,13,12,25
22541,zilx,,1,4,5,9
22542,on_surfaces,,1,1,1,2
22543,supercargo,,1,113,198,311
22544,yeskia,,1,74,70,144
22545,chendoguy,,1,12,12,24
22546,Johnbrad34,,1,93,10,103
22547,djolemcloud,,1,12,1,13
22548,maxwell_smart,,1,29,45,74
22549,pfroo40,,1,1,1,2
22550,SniftyIsATard,,1,1,1,2
22551,errant,,1,19,28,47
22552,firepacket,,1,152,165,317
22553,wiccanflame,,1,13,14,27
22554,Capi77,,1,30,39,69
22555,fann,,1,41,11,52
22556,hybridxdawn,,1,1,2,3
22557,RCA,,1,2,3,5
22558,giancarlo84,,1,18,32,50
22559,chieftechdude,,1,1,1,2
22560,peter1402,,1,13,11,24
22561,defenestrate,,1,110,70,180
22562,adolfojp,,1,169,268,437
22563,magnusjonsson,,1,13,14,27
22564,Krapulator,,1,11,12,23
22565,stick_figure,,1,13,6,19
22566,PaulT23,,1,2,1,3
22567,WomenAreBitches,,1,1,2,3
22568,hugyftdrt,,1,1,1,2
22569,chriscrewdson,,1,5,5,10
22570,pencapchew_3,,1,68,59,127
22571,morkork,,1,19,6,25
22572,bsonk,,1,31,35,66
22573,mattslo,,1,12,19,31
22574,dybber,,1,67,68,135
22575,utnapistim,,1,8,12,20
22576,CAD420,,1,1,1,2
22577,darthabraham,,1,31,45,76
22578,aboutblank,,1,31,66,97
22579,cntzero,,1,14,11,25
22580,rozarsmahkco,,1,2,1,3
22581,KimonoThief,,1,3,9,12
22582,RichG13,,1,1,2,3
22583,Sivart13,,1,3,9,12
22584,jopa666,,1,5,16,21
22585,netactor,,1,59,65,124
22586,kleevr,,1,1,1,2
22587,GeneralVartanian,,1,25,47,72
22588,TRUCK,,1,1,1,2
22589,pegothejerk,,1,11,22,33
22590,OffByPi,,1,1,1,2
22591,twinkie,,1,5,5,10
22592,Odysseus,,1,228,330,558
22593,mriutta,,1,1,1,2
22594,BRizzy80,,1,50,26,76
22595,misho1,,1,70,112,182
22596,geehugo,,1,1,1,2
22597,dobson187,,1,38,55,93
22598,kuratkull,,1,1,3,4
22599,barryfm,,1,139,16,155
22600,evilstickman,,1,9,7,16
22601,hectavex,,1,3,7,10
22602,registerin,,1,1,1,2
22603,taylorham,,1,10,11,21
22604,CallMeZoot,,1,126,179,305
22605,mkayohwell,,1,1,1,2
22606,huda210,,1,10,22,32
22607,trickonion,,1,30,36,66
22608,Fragsworth,,1,343,140,483
22609,joann2,,1,2,5,7
22610,benlan,,1,4,6,10
22611,ecorazzi,,1,53,2,55
22612,sheep1e,,1,404,789,1193
22613,gregsaliva,,1,1,1,2
22614,stephenstephen,,1,1,4,5
22615,lysozyme,,1,2,3,5
22616,CharmQuark,,1,38,1,39
22617,humbleservant56,,1,2,3,5
22618,hanki,,1,17,29,46
22619,albertine,,1,14,1,15
22620,morgid,,1,4,1,5
22621,im_cool_imo,,1,5,4,9
22622,m8ncman,,1,2,3,5
22623,hornlo,,1,1,2,3
22624,OldLifeForm,,1,141,269,410
22625,the_war_won,,1,14,29,43
22626,tehcypress,,1,5,27,32
22627,serivers,,1,1,1,2
22628,Punian,,1,14,2,16
22629,Aikidi,,1,669,993,1662
22630,bdehora,,1,2,2,4
22631,neshel,,1,1,1,2
22632,mcshaken,,1,11,10,21
22633,321fire,,1,3,2,5
22634,BadDreams27,,1,12,2,14
22635,vincit-omnia-amor,,1,1,1,2
22636,woodsmit1,,1,1,1,2
22637,BeeGirl,,1,2,1,3
22638,resiros,,1,1,1,2
22639,STOpandthink,,1,71,92,163
22640,ajw1976,,1,2,1,3
22641,xynxx,,1,19,30,49
22642,bcbcb,,1,55,11,66
22643,FONHoter,,1,2,1,3
22644,Rhettsta,,1,72,108,180
22645,columbine,,1,237,255,492
22646,CptRysdale,,1,2,1,3
22647,stirgeon,,1,2,3,5
22648,fawkesisgay,,1,1,1,2
22649,kerm,,1,38,21,59
22650,davidswayze,,1,1,3,4
22651,corduroy,,1,4,9,13
22652,diot,,1,2,6,8
22653,Animated_effigy,,1,37,77,114
22654,KidBoffo,,1,4,8,12
22655,one2k,,1,118,2,120
22656,DevastatorIIC,,1,28,30,58
22657,unitarder,,1,2,4,6
22658,bobtheplanet,,1,29,66,95
22659,groumph,,1,2,3,5
22660,Woblium,,1,1,1,2
22661,ariacode,,1,15,23,38
22662,dogburp,,1,3,7,10
22663,isandro,,1,1,1,2
22664,Kvindkr,,1,5,1,6
22665,gamefreak6401,,1,1,5,6
22666,guriboysf,,1,1852,750,2602
22667,maina231,,1,3,7,10
22668,dustinbz,,1,5,4,9
22669,xmaspoo,,1,10,7,17
22670,serial_liar,,1,1,1,2
22671,manefraim,,1,3,2,5
22672,tekumse,,1,48,61,109
22673,pseudar,,1,2,7,9
22674,JViz,,1,122,162,284
22675,mmckenna86,,1,11,13,24
22676,ythomas,,1,212,111,323
22677,AdamAtlas,,1,20,23,43
22678,NotAName,,1,52,35,87
22679,DannoHung,,1,286,397,683
22680,cynoclast,,1,48,67,115
22681,ihavenomp,,1,112,86,198
22682,aureve,,1,3,4,7
22683,mrshall08,,1,2,2,4
22684,SanjayM,,1,4,4,8
22685,wpgreenway,,1,29,29,58
22686,accelas,,1,19,10,29
22687,jarrodlb,,1,2,1,3
22688,Watcher1,,1,38,51,89
22689,veritaze,,1,721,1034,1755
22690,Spitfire75,,1,48,73,121
22691,syrisgone,,1,32,45,77
22692,ethyl_mercaptain,,1,4,1,5
22693,1sthealth,,1,8,4,12
22694,peterba,,1,12,4,16
22695,kyokpae,,1,8,6,14
22696,random_indian_dude,,1,1,2,3
22697,reez,,1,45,1,46
22698,gay_defender,,1,1,1,2
22699,ohstrangeone,,1,149,50,199
22700,girlogames,,1,2,2,4
22701,praetorblue,,1,4,1,5
22702,twofrontwar,,1,7,1,8
22703,McBamaFTW,,1,24,35,59
22704,LudoA,,1,596,492,1088
22705,jfowler27,,1,121,200,321
22706,aperturist,,1,42,39,81
22707,klaiere,,1,1,2,3
22708,Modificador,,1,1,1,2
22709,jesus___christ,,1,4,5,9
22710,jguidry,,1,3,2,5
22711,flowtron,,1,1,2,3
22712,newredditsucks,,1,1,4,5
22713,Z_Man,,1,2,3,5
22714,GovBlack,,1,10,18,28
22715,markmuetz,,1,21,8,29
22716,braxley,,1,10,3,13
22717,Nothingatall,,1,27,40,67
22718,davemak,,1,3,9,12
22719,Thinkman,,1,1,1,2
22720,mokki,,1,53,1,54
22721,yumyym,,1,4,6,10
22722,11-26was_aninsidejob,,1,1,1,2
22723,maxxtraxx,,1,7,9,16
22724,dranged,,1,7,4,11
22725,bunz,,1,11,9,20
22726,vinadetta,,1,33,50,83
22727,dkjamez,,1,50,110,160
22728,megoencrzy,,1,1,2,3
22729,sheebz,,1,77,25,102
22730,rydwi,,1,2,6,8
22731,Aldrenean,,1,59,115,174
22732,olsonick,,1,4,22,26
22733,maxthemuss,,1,14,8,22
22734,karakor,,1,172,14,186
22735,orata,,1,2,2,4
22736,fstorino,,1,451,493,944
22737,jm4,,1,3,8,11
22738,victoryisle,,1,1,1,2
22739,deusexnox,,1,6,11,17
22740,fabieen,,1,7,12,19
22741,glothin,,1,1,1,2
22742,SimonS,,1,71,95,166
22743,koreth,,1,162,193,355
22744,shadow2531,,1,33,51,84
22745,bobspirit,,1,4,5,9
22746,jerf,,1,575,738,1313
22747,flatland_skier,,1,1,3,4
22748,Matamua,,1,37,52,89
22749,tjbrace,,1,17,12,29
22750,ellieD,,1,70,148,218
22751,Terentius,,1,3,5,8
22752,medianmode,,1,31,16,47
22753,mark_in_bc,,1,6,9,15
22754,kahureads,,1,2,4,6
22755,whitslack,,1,2,1,3
22756,andra_j,,1,1,2,3
22757,YamiNoSenshi,,1,19,25,44
22758,jdz,,1,13,65,78
22759,angrybrit,,1,7,15,22
22760,CanoeGuru,,1,53,54,107
22761,WhyCause,,1,14,27,41
22762,nemesiscw,,1,17,29,46
22763,ehnus,,1,14,23,37
22764,sais,,1,47,5,52
22765,exersci,,1,2,1,3
22766,iepurilah,,1,281,10,291
22767,triptrap,,1,3,2,5
22768,Raisedshoulder,,1,7,6,13
22769,CharlieSpankface,,1,7,11,18
22770,milkish,,1,1,4,5
22771,xiaoli,,1,1,2,3
22772,explortainment,,1,5,3,8
22773,me_again,,1,5,7,12
22774,cjc155,,1,1,3,4
22775,MaxPayneX,,1,3,2,5
22776,8RANDONBLUE,,3,2,1,3
22777,jwr,,1,17,15,32
22778,katyg,,1,22,23,45
22779,bestbuyslave13,,1,2,6,8
22780,cavtroop,,1,1,2,3
22781,terpmeister,,1,7,8,15
22782,Zahrah,,1,18,26,44
22783,franoso,,1,1,1,2
22784,LoyalRedditUser,,1,7,1,8
22785,stroud,,1,139,168,307
22786,abutchart,,1,33,42,75
22787,alopez,,1,1,1,2
22788,DingBat99999,,1,3,1,4
22789,katana,,1,9,7,16
22790,rickrw26,,1,10,11,21
22791,m4design,,1,14,22,36
22792,boa13,,1,269,311,580
22793,jbrjake,,1,31,23,54
22794,chrisdamato,,1,13,19,32
22795,kensho,,1,2,3,5
22796,OinkersBoinkers,,1,41,33,74
22797,banana_pancakes,,1,1,1,2
22798,TrinityinZion,,1,129,157,286
22799,DBCoopers_Voice,,1,11,13,24
22800,WarEmblem,,1,3,2,5
22801,tatooine,,1,270,358,628
22802,mlurker,,1,1,2,3
22803,JesusXP,,1,18,9,27
22804,i_call_bs,,1,4,10,14
22805,abandonment,,1,4,3,7
22806,IWelsh,,1,51,2,53
22807,jasonebrooks,,1,41,51,92
22808,DavesNotHere,,1,19,25,44
22809,peredecho,,1,1,4,5
22810,kmartburrito,,1,17,16,33
22811,mene,,1,84,159,243
22812,ckwoo,,1,5,2,7
22813,TheCancerofReddit,,1,12,26,38
22814,polymath22,,1,1063,712,1775
22815,zdub,,1,7,13,20
22816,jaredb,,1,295,366,661
22817,yacheritsi,,1,20,19,39
22818,greenw40,,1,126,223,349
22819,blaxter,,1,4,5,9
22820,Destined86,,1,1,1,2
22821,redditnoob,,1,319,405,724
22822,motox004,,1,6,1,7
22823,JulianMorrison,,1,633,869,1502
22824,polyparadigm,,1,441,1165,1606
22825,smeefydeef,,1,4,6,10
22826,leahcimic,,1,1,1,2
22827,azfhkm,,1,2,7,9
22828,tallicast,,1,37,20,57
22829,ss88,,1,2,2,4
22830,commernie,,1,1,2,3
22831,chipwhisperer,,1,221,28,249
22832,briankwest,,1,16,10,26
22833,FatherVic,,1,13,10,23
22834,mkshoox,,1,1,7,8
22835,seeeymour,,1,1,5,6
22836,WintermuteHun,,1,1,1,2
22837,redding44,,1,10,26,36
22838,tojojo,,1,3,1,4
22839,annish33,,1,3,2,5
22840,grando205,,1,3,2,5
22841,oddoddities,,1,1,1,2
22842,rsthiotimoline,,1,6,8,14
22843,sysreq2,,1,15,10,25
22844,579_was_an_odd_job,,1,1,1,2
22845,SharkAttack,,1,6,2,8
22846,rg3design,,1,5,10,15
22847,ewok251,,1,14,30,44
22848,IAmperfectlyCalm,,1,3375,17,3392
22849,Klowner,,1,116,198,314
22850,sydfish,,1,1,1,2
22851,dfplace,,1,1,1,2
22852,goneskiing_42,,1,37,29,66
22853,Alanna,,1,26,12,38
22854,matthewt,,1,5,10,15
22855,flip69,,1,21,39,60
22856,spivey378,,1,97,165,262
22857,umbama,,1,235,331,566
22858,afsd,,1,4,15,19
22859,church-lady,,1,1,1,2
22860,robinbal,,1,380,26,406
22861,factchecker,,1,6,8,14
22862,SteveyDevey,,1,17,22,39
22863,johnny_blaze108,,1,90,66,156
22864,death_to_kittens,,1,2,1,3
22865,vennilapdy,,1,1,1,2
22866,zeej,,1,8,8,16
22867,scottklarr,,1,37,102,139
22868,ispiked,,1,1,1,2
22869,rainx5,,1,1,2,3
22870,davidpbrown,,1,160,295,455
22871,sdmath,,1,9,2,11
22872,Zarathustra,,1,1,5,6
22873,massacre11,,1,2,7,9
22874,mozz85,,1,20,27,47
22875,towelled,,1,7,5,12
22876,wpentland,,1,195,14,209
22877,qengho,,1,28,47,75
22878,kaethre,,1,63,84,147
22879,thepoo,,1,190,184,374
22880,imatalibrary,,1,1,1,2
22881,petrasbut,,1,1,3,4
22882,xutopia,,1,398,481,879
22883,ne0nominator,,1,2,1,3
22884,multi_touch,,1,25,38,63
22885,Pulch,,1,5,10,15
22886,helloandy,,1,3,4,7
22887,alfseegert,,1,5,1,6
22888,jrhanak,,1,4,3,7
22889,AmazingSyco,,1,142,107,249
22890,AgentConundrum,,1,1,7,8
22891,haveacowman,,1,2,3,5
22892,yoshitomi,,1,88,32,120
22893,ToddDavis,,1,1,1,2
22894,ashabot,,1,75,207,282
22895,keg98,,1,2,1,3
22896,admplaceholder,,1,31,42,73
22897,rukubites,,1,108,165,273
22898,TheOldBroad,,1,17,7,24
22899,fps81,,1,2,3,5
22900,solitair,,1,4,11,15
22901,akkartik,,1,30,28,58
22902,musashix90,,1,2,3,5
22903,elcerdoquerie,,1,41,10,51
22904,whatthe2,,1,38,51,89
22905,ziporim,,1,20,6,26
22906,jebiv,,1,143,233,376
22907,cultural_sublimation,,1,12,10,22
22908,powatom,,1,1,2,3
22909,KPMGGGGGGG,,1,3,10,13
22910,turkishrevenge,,1,6,14,20
22911,bocanegra,,1,96,122,218
22912,greg94080,,1,41,106,147
22913,L1ndsay,,1,9,6,15
22914,NonHomogenized,,1,26,58,84
22915,prospero,,1,9,7,16
22916,aardvarkads,,1,1,1,2
22917,sasmccrass,,1,3,3,6
22918,skepticcook,,1,1,1,2
22919,mmmcake,,1,43,14,57
22920,thatgirlismine,,1,45,49,94
22921,goguvasile,,1,3,5,8
22922,rhyso,,1,3,7,10
22923,anonyred,,1,30,32,62
22924,TryingHarder,,1,3,6,9
22925,jamesalexander,,1,1,1,2
22926,SaraFist,,1,5,10,15
22927,mazinlarry,,1,1,2,3
22928,skuk,,1,7,16,23
22929,mernen,,1,148,245,393
22930,pwbringside,,1,4,2,6
22931,treef,,1,20,19,39
22932,chasstor,,1,4,3,7
22933,superdude264,,1,35,52,87
22934,lostdog,,1,12,14,26
22935,i_am_giuliani,,1,2,1,3
22936,ibarrac,,1,6,6,12
22937,mefm247,,1,180,51,231
22938,viper0,,1,1,3,4
22939,kagevf,,1,11,17,28
22940,unbibium,,1,42,68,110
22941,phoebefitz,,1,2,1,3
22942,JasonDJ,,1,1581,2101,3682
22943,rehx,,1,145,89,234
22944,michaelfeathers,,1,56,55,111
22945,ducktyped,,1,7,9,16
22946,helenonfire,,1,109,59,168
22947,niccamarie,,1,8,7,15
22948,bardeen2,,1,1,1,2
22949,samurai_jack,,1,1,1,2
22950,QcUser,,1,2,1,3
22951,fIshstIckfish,,1,2,1,3
22952,kevincolby,,1,136,14,150
22953,sapiophile,,1,18,20,38
22954,Pict,,1,88,100,188
22955,dvdcpu,,1,4,12,16
22956,brfox,,1,67,37,104
22957,julesjules,,1,13,18,31
22958,poxiemuff,,1,3,1,4
22959,Aissen,,1,9,8,17
22960,pakfur,,1,1,1,2
22961,lifeguard1999,,1,20,1,21
22962,MinoMinoMino,,1,27,48,75
22963,kalaine,,1,1,2,3
22964,jcblitz,,1,14,21,35
22965,reddit-mandingo,,1,24,41,65
22966,unidentified_cow,,1,19,25,44
22967,urno,,1,5,5,10
22968,bgroodog,,1,2,7,9
22969,vladd,,1,5,4,9
22970,TimeCube,,1,1,2,3
22971,rick-victor,,1,92,233,325
22972,fuzzybunn,,1,464,648,1112
22973,renegade4ever,,1,4,2,6
22974,Macinposh,,1,47,6,53
22975,somegeekintn,,1,5,5,10
22976,orochidp,,1,132,164,296
22977,clamag,,1,1,1,2
22978,genejockey,,1,3,8,11
22979,goodasyou,,1,2,2,4
22980,mpeppers,,1,149,189,338
22981,gabrielbenjamin,,1,28,58,86
22982,FatHat,,1,28,3,31
22983,skinnys,,1,1,1,2
22984,jterrill,,1,4,1,5
22985,jacl3,,1,6,2,8
22986,mayqueen,,1,12,2,14
22987,Cthulhu_u2,,1,3,4,7
22988,DeliaVelda,,1,2,3,5
22989,jmathai,,1,89,35,124
22990,uleekunkel,,1,4,1,5
22991,alextrafford,,1,2,6,8
22992,geoken,,1,4,6,10
22993,Capnshavahoe,,1,1,1,2
22994,njoubert,,1,16,5,21
22995,wickedsun,,1,7,12,19
22996,cheesegoat,,1,18,1,19
22997,unboring,,1,23,10,33
22998,miamidolfan13,,1,1,1,2
22999,FunnyHat,,1,29,25,54
23000,jkr0sc0,,1,95,69,164
23001,apear,,1,103,23,126
23002,paws,,1,1,2,3
23003,waesrdtf,,1,29,73,102
23004,jighead,,1,16,30,46
23005,Ronald_Reagan,,1,1,1,2
23006,anotheraddict,,1,47,114,161
23007,bradl3y,,1,11,13,24
23008,bazzam,,1,3,1,4
23009,coltafever,,1,8,5,13
23010,budgetsaresexy,,1,2,1,3
23011,bejackson,,1,1,4,5
23012,SpudgeBoy,,1,404,654,1058
23013,RandomChance,,1,5,8,13
23014,RickyRage,,1,30,14,44
23015,imccuaig,,1,2,6,8
23016,draynen,,1,151,130,281
23017,aeschenbach,,1,1,1,2
23018,nik_doof,,1,19,45,64
23019,RagingBigot,,1,1,2,3
23020,kakker,,1,1,1,2
23021,nixonrichard,,1,2789,3142,5931
23022,bloodbrothers,,1,13,1,14
23023,g00sebump,,1,1,1,2
23024,aadvaark,,1,5,2,7
23025,redditcdm,,1,3,8,11
23026,imaclurg,,1,12,8,20
23027,lukey,,1,3,6,9
23028,michaeljmcd,,1,1,1,2
23029,wags83,,1,80,91,171
23030,dmehrtash,,1,145,162,307
23031,wrathofg0d,,1,6,15,21
23032,314159,,1,73,56,129
23033,cannelbrae,,1,44,42,86
23034,caleb555,,1,76,93,169
23035,crosbyface,,1,337,178,515
23036,BrambleQuest,,1,7,8,15
23037,MoogleGunner,,1,38,42,80
23038,ckelso,,1,1,1,2
23039,nedski,,1,2,2,4
23040,cjet79,,1,8,14,22
23041,chrisjoy,,1,1,2,3
23042,megasean,,1,19,16,35
23043,jwhardcastle,,1,24,13,37
23044,xanderdad,,1,33,28,61
23045,Bart__,,1,2,3,5
23046,PStamatiou,,1,2,3,5
23047,tbk123,,1,12,26,38
23048,szer0,,1,10,4,14
23049,tin_the_fatty,,1,1,3,4
23050,knox203,,1,1,1,2
23051,DayVDave,,1,26,22,48
23052,dskoziol,,1,14,16,30
23053,ZorkTheAlmighty,,1,1,2,3
23054,worthlesstrivia,,1,12,20,32
23055,yourereallydumb,,1,1,1,2
23056,Debs68,,1,1,1,2
23057,InvestorGadget,,1,35,38,73
23058,kpflynn,,1,12,3,15
23059,namegoeshere,,1,5,7,12
23060,dsn0wman,,1,13,12,25
23061,delayclose,,1,4,11,15
23062,nebbish,,1,202,460,662
23063,xelfer,,1,751,135,886
23064,FiestaJunction,,1,65,69,134
23065,wil,,1,313,76,389
23066,onfires,,1,2,6,8
23067,AlteredQ,,1,5,4,9
23068,azerkainen,,1,2,6,8
23069,booksnbabies,,1,7,15,22
23070,lobsterGun,,1,1,2,3
23071,ZhongHuaRising,,1,134,19,153
23072,algebra,,1,4,9,13
23073,jackman,,1,6,3,9
23074,mobilexile,,1,4,16,20
23075,SkippyKilamanjaro,,1,1,4,5
23076,papipablo,,1,17,26,43
23077,kalven,,1,67,53,120
23078,deanoplex,,1,438,549,987
23079,twothenthree,,1,1,1,2
23080,steampunks,,1,2,2,4
23081,micklstint,,1,5,9,14
23082,corentin,,1,241,344,585
23083,Wildcard86,,1,16,18,34
23084,BritishEnglishPolice,,1,1700,1195,2895
23085,arewethatstupid,,1,2,1,3
23086,albino1,,1,1,1,2
23087,ali-o,,1,1,1,2
23088,stiggle,,1,8,13,21
23089,encephlavator,,1,82,116,198
23090,SceneScenery,,1,46,88,134
23091,JamieLewisUK,,1,1,1,2
23092,VBS,,1,1,1,2
23093,gt1987,,1,338,30,368
23094,naughtyottsel,,1,29,43,72
23095,Weyland-Yutani,,1,38,45,83
23096,superkash,,1,1,4,5
23097,paulg,,1,4,12,16
23098,puppycrack,,1,30,17,47
23099,sdgsdgsd,,1,50,37,87
23100,podRZA,,1,153,226,379
23101,Anon65536,,1,2,1,3
23102,SkuttleSkuttle,,1,95,193,288
23103,dg172306,,1,23,1,24
23104,Letharis,,1,4,5,9
23105,Ayn_Rand,,1,40,44,84
23106,pnmnl,,1,10,1,11
23107,quitabandita,,1,10,24,34
23108,Raoul_Duke,,1,1,4,5
23109,derby,,1,15,9,24
23110,codybrom,,1,24,40,64
23111,enisoc,,1,2,2,4
23112,victimeofXsyndrome,,1,9,26,35
23113,davidhallstrom,,1,73,10,83
23114,alienfluid,,1,49,4,53
23115,apollo13,,1,1,1,2
23116,ellingtond,,1,7,3,10
23117,pjharvey,,1,68,136,204
23118,levilarrington,,1,112,176,288
23119,chaelosmvoice,,1,71,9,80
23120,Zarouhi,,1,1,2,3
23121,funkomoto,,1,19,6,25
23122,kizzbizz,,1,20,22,42
23123,ominous,,1,193,276,469
23124,mglasspo,,1,16,19,35
23125,habilis,,1,11,1,12
23126,John-McCain,,1,4,3,7
23127,itwontbeeasy,,1,28,37,65
23128,heurrgh,,1,15,23,38
23129,noj,,1,3,6,9
23130,chonny69,,1,6,2,8
23131,Diced,,1,7,7,14
23132,dustbot,,1,5,1,6
23133,AlphaSquad7,,1,19,31,50
23134,Daylight_Again,,1,6,1,7
23135,ElGatoPescado,,1,4,4,8
23136,thestace,,1,2,2,4
23137,jvnburrito,,1,5,2,7
23138,xinship,,1,131,1,132
23139,Titans86,,1,1,1,2
23140,ACoelacanth,,1,3,1,4
23141,livewire-reddit,,1,3,5,8
23142,lowdown,,1,278,400,678
23143,Mad_Gouki,,1,342,497,839
23144,setatakahashi,,1,7,5,12
23145,bobbythebuilder,,1,14,5,19
23146,robpfeifer,,1,3,2,5
23147,ohphuckit,,1,1,2,3
23148,brtw,,1,856,907,1763
23149,doccrow,,1,1,1,2
23150,dowhat,,1,9,14,23
23151,adelutza,,1,19,9,28
23152,obastard,,1,1,2,3
23153,thomash,,1,24,30,54
23154,Federico_AB,,1,2,1,3
23155,johnnyutah97,,1,1,2,3
23156,Wanderer69,,1,7,10,17
23157,killerkarlyle,,1,10,8,18
23158,giosico,,1,7,9,16
23159,L_K,,1,1,2,3
23160,Jacques7,,1,1,7,8
23161,crusader561,,1,29,47,76
23162,dhc23,,1,283,131,414
23163,tluyben2,,1,40,52,92
23164,Monk_NT,,1,1,8,9
23165,danstheman,,1,2,2,4
23166,Mike112233,,1,56,55,111
23167,sid13,,1,1370,9,1379
23168,Kerrminater,,1,6,8,14
23169,andycapp614,,1,1,1,2
23170,ohitsme,,1,1,1,2
23171,kenshi,,1,2,2,4
23172,Ma_chine,,1,72,80,152
23173,aptmunich,,1,7,4,11
23174,rocktopotomus,,1,1,2,3
23175,buffer,,1,19,35,54
23176,runaro,,1,10,17,27
23177,inqurious,,1,23,34,57
23178,abc2010,,1,19,18,37
23179,Toploader,,1,21,7,28
23180,josernanza,,1,4,2,6
23181,m5driver,,1,1,2,3
23182,jnikouy,,1,2,5,7
23183,BenArmston,,1,1,4,5
23184,seraphseven,,1,54,51,105
23185,matkam,,1,2,2,4
23186,Snowboardyn,,1,75,23,98
23187,playback,,1,5,1,6
23188,cydwatts,,1,23,33,56
23189,alanlight,,1,6,4,10
23190,rogerothornhill,,1,66,3,69
23191,scootermcgavin,,1,1,6,7
23192,theshua,,1,53,53,106
23193,dougtheslud,,1,1,1,2
23194,aloch_rye,,1,2,1,3
23195,tirdun,,1,257,340,597
23196,ton210,,1,20,6,26
23197,Mr_False_Facts,,1,5,10,15
23198,sunkencity,,1,2,3,5
23199,WipeHandsOnPants,,1,472,586,1058
23200,blargsoup,,1,4,1,5
23201,trickygrin,,1,1,3,4
23202,hybird607,,1,1,1,2
23203,Dr_Dre,,1,1,2,3
23204,eddiebenton,,1,1,3,4
23205,randybrown,,1,1,1,2
23206,joopndufus,,1,9,17,26
23207,Beltran22,,1,62,62,124
23208,MaxTerry,,1,13,2,15
23209,Redditsleo,,1,7,1,8
23210,garhem,,1,3,2,5
23211,Wynner3,,1,52,120,172
23212,hollaworld,,1,1,2,3
23213,dkol97,,1,1,1,2
23214,Very_Short_Man,,1,1,2,3
23215,Alth,,1,1,2,3
23216,sleet01,,1,19,43,62
23217,caramal,,1,38,38,76
23218,ferdylantz,,1,11,12,23
23219,protaku,,1,57,17,74
23220,N3v3rm0r,,1,3,4,7
23221,thomashauk,,1,135,291,426
23222,Eugi,,1,638,795,1433
23223,Th17kit,,1,10,15,25
23224,test88,,1,1,1,2
23225,mlibby,,1,39,59,98
23226,RockinMoe,,1,13,30,43
23227,lukeman,,1,2,6,8
23228,njaard,,1,36,23,59
23229,dgentry,,1,16,5,21
23230,jazzilliognito,,1,222,186,408
23231,defacto,,1,1,3,4
23232,kovert,,1,36,52,88
23233,sake2me,,1,3,2,5
23234,saxamaphone,,1,2,2,4
23235,qbert555,,1,1,1,2
23236,Nall,,1,188,224,412
23237,ToolBoxes,,1,2,2,4
23238,frothywalrus,,1,9,4,13
23239,hacman,,1,2,4,6
23240,insertclevernamehere,,1,13,5,18
23241,shinybeast,,1,29,6,35
23242,punk27,,1,75,41,116
23243,self,,1,296,42,338
23244,T618,,1,9,4,13
23245,elunico35,,1,4,5,9
23246,Lupus,,1,162,61,223
23247,joecomputer,,1,2,2,4
23248,omiethenull,,1,1,4,5
23249,IkkeDikke,,1,1,2,3
23250,JoeThePlumber,,1,1,1,2
23251,mikejna,,1,11,17,28
23252,bender,,1,4,1,5
23253,choochoose,,1,1,1,2
23254,doskir,,1,4,7,11
23255,blinks,,1,23,18,41
23256,truly_anonymous,,1,1,1,2
23257,ScrewDriver,,1,1098,250,1348
23258,wickedcold,,1,850,796,1646
23259,theCroc,,1,99,178,277
23260,Nonperson,,1,3,1,4
23261,mjagger,,1,3,1,4
23262,ericarlen,,1,122,55,177
23263,fkenned1,,1,4,3,7
23264,achroma,,1,23,39,62
23265,longshot789,,1,28,36,64
23266,charliewoo,,1,2,1,3
23267,TheYank17,,1,21,48,69
23268,socialsocial,,1,3,5,8
23269,bEastie,,1,1,4,5
23270,aweraw,,1,14,19,33
23271,snipe8709,,1,48,76,124
23272,lexicon,,1,3,3,6
23273,currentlyunemployed,,1,1,1,2
23274,snorgsniffer,,1,75,55,130
23275,farnsworth,,1,470,301,771
23276,1812overture,,1,586,900,1486
23277,ItsAConspiracy,,1,388,498,886
23278,hey_suz,,1,8,2,10
23279,weeblewobble,,1,25,18,43
23280,stevegao,,1,1,3,4
23281,sarkera,,1,17,20,37
23282,Akamaru,,1,42,78,120
23283,MorticiaAddams,,1,1,2,3
23284,jokemon,,1,2,3,5
23285,thugok,,1,19,34,53
23286,pkonink,,1,192,313,505
23287,__david__,,1,163,130,293
23288,SgtPsycho,,1,16,36,52
23289,shaen,,1,2,1,3
23290,unsteady21,,1,11,14,25
23291,garryknight,,1,1,4,5
23292,GaboonViper,,1,1,1,2
23293,Vortex851,,1,2,1,3
23294,csman,,1,1,4,5
23295,dtrav001,,1,53,109,162
23296,dailyfill,,1,1,3,4
23297,willikins_bear,,1,9,11,20
23298,nagual,,1,1,2,3
23299,leftist,,1,11,1,12
23300,unrealtrip,,1,21,19,40
23301,sadforamerica,,1,2,2,4
23302,mpreda,,1,1,1,2
23303,y0uth,,1,2,2,4
23304,whererush,,1,1,1,2
23305,kranse,,1,8,15,23
23306,splaspood,,1,3,11,14
23307,andreasvc,,1,139,258,397
23308,u233,,1,2,2,4
23309,Datrio,,1,12,8,20
23310,reinaldomunoz,,1,27,2,29
23311,jcbolduc,,1,3,3,6
23312,Mooo1,,1,7,8,15
23313,lostcheshire,,1,1,1,2
23314,aprz43,,1,15,7,22
23315,yahol,,1,1,2,3
23316,TheGr8Revealing,,1,2,2,4
23317,sjbaue,,1,6,5,11
23318,hnyakwai,,1,26,20,46
23319,HomelandInsecurity,,1,42,56,98
23320,thbb,,1,3,5,8
23321,beardedroman,,1,2,1,3
23322,madmonky1,,1,1,2,3
23323,Truthiness88,,1,5,19,24
23324,craigory,,1,10,7,17
23325,mrcheezy503,,1,2,7,9
23326,sheephead,,1,1,1,2
23327,logician2,,1,10,11,21
23328,petedmeat,,1,1,2,3
23329,craigckc,,1,3,5,8
23330,rob45742,,1,2,2,4
23331,babaghanoush,,1,1,4,5
23332,rooseve,,1,4,1,5
23333,KyndCulture,,1,1,3,4
23334,borlak,,1,125,157,282
23335,wellstone,,1,16,14,30
23336,menwithoutoil,,1,1,1,2
23337,stuckpixel,,1,18,25,43
23338,Godthealmighty,,1,1,1,2
23339,jfarquhar,,1,9,7,16
23340,oh_bruddah,,1,34,44,78
23341,radcopter2,,1,18,9,27
23342,yazik,,1,39,18,57
23343,pizmooz,,1,1,1,2
23344,litelity,,1,1,1,2
23345,tevi,,1,420,200,620
23346,EternalNY1,,1,242,271,513
23347,lpetrazickis,,1,84,137,221
23348,gmarceau,,1,68,16,84
23349,ranautricularia,,1,8,3,11
23350,braeden0613,,1,9,10,19
23351,rosho,,1,3,7,10
23352,anticitizen_1,,1,8,11,19
23353,rothsbane,,1,22,46,68
23354,amandoo,,1,1,1,2
23355,fiskekjorke,,1,6,8,14
23356,Ackeron,,1,1,1,2
23357,bantam,,1,128,196,324
23358,peadar,,1,2,2,4
23359,mvferrer,,1,63,50,113
23360,severianx,,1,1,1,2
23361,Trimbak,,1,2,1,3
23362,gayjustice,,1,9,6,15
23363,precursive,,1,24,37,61
23364,TheDevilChicken,,1,1,1,2
23365,luizlizard,,1,1,1,2
23366,rramdin,,1,2,1,3
23367,strangerthanfiction,,1,5,18,23
23368,hvidgaard,,1,2,5,7
23369,kcnickerson,,1,2,2,4
23370,mtarascio,,1,2,1,3
23371,pirratez,,1,1,1,2
23372,ohdeargod,,1,240,280,520
23373,smearypixels,,1,1,1,2
23374,kyledance,,1,9,4,13
23375,dictum,,1,380,384,764
23376,toomuchsnow,,1,1,1,2
23377,eleitl,,1,1150,2349,3499
23378,lojt,,1,7,3,10
23379,noseeme,,1,709,1209,1918
23380,King_Midas,,1,7,8,15
23381,duncman,,1,3,3,6
23382,nrg13,,1,32,56,88
23383,thedeiningers,,1,1,4,5
23384,Charybdis,,1,23,24,47
23385,weemadarthur2,,1,58,35,93
23386,elevendog,,1,5,7,12
23387,40ozphil,,1,9,32,41
23388,TiredoftheWhining,,1,9,12,21
23389,mojitz,,1,4,3,7
23390,kschrader,,1,3,3,6
23391,thebigslide,,1,3,5,8
23392,pbwhiteskies,,1,1,1,2
23393,Rubythursday,,1,4,3,7
23394,mr-ron,,1,49,40,89
23395,detestrian,,1,119,121,240
23396,jphofmann,,1,13,8,21
23397,pastanoose,,1,605,1013,1618
23398,rfreytag,,1,54,79,133
23399,Condoleezza_Rice,,1,68,102,170
23400,laughingboy,,1,311,281,592
23401,pompanobeach,,1,2,2,4
23402,rambo3060,,1,9,9,18
23403,FierceWords,,1,1,1,2
23404,followthesinner,,1,46,61,107
23405,jhnewt,,1,15,22,37
23406,justleaveme,,1,10,8,18
23407,Boab1917,,1,34,113,147
23408,domer,,1,28,8,36
23409,baddox,,1,167,256,423
23410,magicalsamurai,,1,1,1,2
23411,jedediah,,1,10,13,23
23412,who_the_fuck,,1,1,2,3
23413,hifidigitalboy,,1,1,3,4
23414,raygomer,,1,2,3,5
23415,journeymaan,,1,3,1,4
23416,ultralame,,1,139,191,330
23417,saw2239,,1,14,18,32
23418,beatlawrence,,1,64,5,69
23419,brox,,1,1,1,2
23420,itstriz,,1,5,8,13
23421,louiebaur,,1,392,64,456
23422,Dreamerr,,1,1,1,2
23423,thisisgraffiti,,1,93,62,155
23424,stesch,,1,2086,1438,3524
23425,dcsterlin,,1,9,2,11
23426,ragnarock,,1,13,33,46
23427,mustamike,,1,25,33,58
23428,Engineer1973,,1,2,2,4
23429,opinion_not_fact,,1,14,18,32
23430,joshuatree,,1,21,20,41
23431,drmomentum,,1,3,7,10
23432,drkevorkian,,1,4,12,16
23433,jwmida,,1,5,8,13
23434,Frobozz,,1,35,16,51
23435,panfist,,1,82,91,173
23436,daydreamdrunk,,1,1,2,3
23437,zedstream,,1,81,193,274
23438,counterpup2,,1,1,1,2
23439,rigun,,1,7,9,16
23440,subzer0fun,,1,1,9,10
23441,adamd84,,1,6,21,27
23442,trimalchio,,1,79,181,260
23443,rojaz,,1,1,1,2
23444,ruxxell,,1,19,30,49
23445,azureice,,1,27,35,62
23446,roguehunter,,1,2,7,9
23447,sivadwnitsuj,,1,1,1,2
23448,Rasheeke,,1,179,214,393
23449,deeter,,1,12,14,26
23450,degustiairforceone,,1,37,39,76
23451,marishaLOVESTHECOCK,,1,1,1,2
23452,sephcast,,1,5,4,9
23453,seedy,,1,35,35,70
23454,ConnorSmith,,1,3,6,9
23455,Fantasysage,,1,70,82,152
23456,emailingRob,,1,11,9,20
23457,Andrew_Z,,1,2,8,10
23458,blergh-,,1,12,16,28
23459,bobsaget06,,1,11,5,16
23460,stealthboy,,1,9,4,13
23461,jrazavian,,1,20,13,33
23462,archemedes_rex,,1,172,352,524
23463,mooocow,,1,35,28,63
23464,sonotme,,1,12,12,24
23465,ssmoot,,1,1,3,4
23466,alpha7158,,1,1,2,3
23467,dropshadow,,1,6,4,10
23468,sethew,,1,1,2,3
23469,theguardian512,,1,1,2,3
23470,nikdahl,,1,297,573,870
23471,Vivaa,,1,15,12,27
23472,simosameh,,1,1,1,2
23473,Sec_Henry_Paulson,,1,9,13,22
23474,skink,,1,6,5,11
23475,internauta,,1,16,1,17
23476,Sheamus,,1,252,262,514
23477,billbose,,1,6,8,14
23478,maxs,,1,2,1,3
23479,immymwa,,1,2,2,4
23480,bbulkow,,1,4,7,11
23481,richards1052,,1,27,4,31
23482,Explained,,1,3,1,4
23483,Jafari,,1,1,3,4
23484,ewen,,1,15,26,41
23485,madderhatter,,1,1,2,3
23486,rydudero,,1,1,1,2
23487,hukedonfonix,,1,227,344,571
23488,kooberdeath,,1,1,1,2
23489,ermine,,1,208,394,602
23490,porniac,,1,159,334,493
23491,motophiliac,,1,35,37,72
23492,tyjk9,,1,2,7,9
23493,jjasmine,,1,1,2,3
23494,kkolish,,1,6,8,14
23495,erydo,,1,55,96,151
23496,monks7ue,,1,4,2,6
23497,TehMuffinMan,,1,284,386,670
23498,ASKlein,,1,1,4,5
23499,lylia,,1,1315,102,1417
23500,mrsheep,,1,7,5,12
23501,jstlerce,,1,24,39,63
23502,tievape,,1,7,7,14
23503,dutty_d,,1,33,1,34
23504,jwilson1891,,1,2,7,9
23505,reverend_paco,,1,2,3,5
23506,w00zy33,,1,4,2,6
23507,savannahsavannah,,1,1,5,6
23508,aeacides,,1,5,14,19
23509,skypie888,,1,2,1,3
23510,screeeam,,1,1,1,2
23511,warbiscuit,,1,28,33,61
23512,kaketoe,,1,11,11,22
23513,wojtekk,,1,1,1,2
23514,falconsprint,,1,5,4,9
23515,jivebotic,,1,85,26,111
23516,1esproc,,1,554,524,1078
23517,buzzkelly,,1,1,2,3
23518,cdvallee,,1,20,34,54
23519,rtperson,,1,23,29,52
23520,tien10,,1,2,2,4
23521,reddibama,,1,15,3,18
23522,Trolloholic,,1,9,10,19
23523,JasonWi,,1,1,1,2
23524,Less_fewer_police,,1,1,1,2
23525,Ringdingcoder,,1,6,4,10
23526,kryptn,,1,56,15,71
23527,cal3b,,1,2,4,6
23528,kungfooey,,1,107,26,133
23529,WillToHave2,,1,3,5,8
23530,devbalt,,1,3,3,6
23531,pattyyoung,,1,1,1,2
23532,Dinosars,,1,4,5,9
23533,tomlu709,,1,60,67,127
23534,StOnge,,1,5,13,18
23535,kinglupid,,1,25,48,73
23536,megafan,,1,1,1,2
23537,andymatic,,1,15,8,23
23538,hoosabrat,,1,2,3,5
23539,mohawk,,1,7,10,17
23540,EwanG,,1,29,41,70
23541,H8r,,1,37,38,75
23542,ubiquitous,,1,1,3,4
23543,speling_nazi,,1,2,2,4
23544,Drakia,,1,15,16,31
23545,rozbryzg,,1,1,5,6
23546,officemonkey,,1,1620,1957,3577
23547,charun,,1,88,119,207
23548,idogcow,,1,1,2,3
23549,megaman369,,1,2,11,13
23550,fanboisrule,,1,7,17,24
23551,digitaldavegordon,,1,11,12,23
23552,Trace,,1,248,368,616
23553,AdolfHitler45,,1,3,2,5
23554,xleighx,,1,1,4,5
23555,corevette,,1,217,73,290
23556,Ognad,,1,1,5,6
23557,theclamps,,1,14,24,38
23558,rahearn,,1,1,1,2
23559,skobie7,,1,4,7,11
23560,vare2,,1,14,2,16
23561,Nicholai,,1,8,13,21
23562,acidburner,,1,2,5,7
23563,themightylime,,1,38,23,61
23564,nzgizmoguy,,1,4,2,6
23565,Jive_q,,1,5,4,9
23566,noideareally,,1,9,8,17
23567,mmmf,,1,7,8,15
23568,GtownResider,,1,1,3,4
23569,Fyodor007,,1,70,7,77
23570,RedditGuy24,,1,6,6,12
23571,wolfier,,1,161,284,445
23572,get_over_it,,1,6,1,7
23573,flungdung,,1,4,5,9
23574,blacksquare,,1,10,2,12
23575,Kieslar,,1,3,1,4
23576,spaceflunky,,1,13,23,36
23577,anbeh,,1,48,21,69
23578,technex,,1,31,1,32
23579,Colbert22,,1,34,3,37
23580,fuhgeddaboutit,,1,16,39,55
23581,DropkickM16,,1,10,20,30
23582,arthur_dent,,1,14,10,24
23583,KombatKat,,1,1,1,2
23584,hypntize,,1,4,5,9
23585,AnTyx,,1,3,5,8
23586,ReapingWildOats,,1,209,362,571
23587,anteater_sa,,1,74,48,122
23588,WinterAyars,,1,590,1208,1798
23589,asdflksajdflkasjdfl,,1,1,1,2
23590,MrTJC,,1,4,3,7
23591,beefgun,,1,186,188,374
23592,ANTIHUMORBOT,,1,3,4,7
23593,twism242,,1,1,2,3
23594,kraftwerk2020,,1,1,2,3
23595,tastyrerun,,1,2,1,3
23596,_will,,1,8,3,11
23597,thewishfulwriterblog,,1,15,11,26
23598,ubae,,1,1,1,2
23599,jonathont22,,1,19,17,36
23600,broadbean,,1,21,31,52
23601,Gud84,,1,27,76,103
23602,frumiousb,,1,7,9,16
23603,arcims,,1,6,4,10
23604,pintachio,,1,82,122,204
23605,leaves4chonies,,1,17,43,60
23606,cookie__monster,,1,2,1,3
23607,Enzondio,,1,19,13,32
23608,decker,,1,18,48,66
23609,seang,,1,7,9,16
23610,doctorsound,,1,72,51,123
23611,goodnevilguy,,1,14,14,28
23612,jamt9000,,1,20,16,36
23613,kudu,,1,7,14,21
23614,crayola3,,1,19,13,32
23615,insomniak,,1,9,34,43
23616,Ass4ssinX,,1,4,6,10
23617,fuqdub,,1,15,18,33
23618,DocXango2,,1,1,1,2
23619,itworks,,1,1,6,7
23620,repunctuator,,1,5,8,13
23621,IMJGalt,,1,311,395,706
23622,checkstep,,1,54,8,62
23623,risingasia,,1,16,1,17
23624,Phil_Sebben,,1,2,3,5
23625,speedwank,,1,6,32,38
23626,environment_dollars,,1,1,1,2
23627,nsummy,,1,16,7,23
23628,servilla,,1,9,17,26
23629,RAISEStheQuestion,,1,15,21,36
23630,moriki,,1,51,75,126
23631,TwoMinutesToMidnight,,1,14,6,20
23632,SimpleAnswer,,1,30,38,68
23633,1776patriot,,1,3,3,6
23634,KingSky,,1,1,1,2
23635,asthomps,,1,14,8,22
23636,jetteroheller,,1,1,1,2
23637,idiocracy,,1,3,3,6
23638,momzilla54,,1,1,1,2
23639,neon_eddy,,1,6,10,16
23640,michelemarie,,1,2,1,3
23641,DeathPenalty,,1,4,11,15
23642,Liebot1,,1,4,7,11
23643,nlbctim,,1,1,3,4
23644,trilokjyu,,1,12,2,14
23645,TreatInfamy,,1,1,1,2
23646,curiouscat,,1,18,18,36
23647,scottbre,,1,5,4,9
23648,lobrien,,1,1,1,2
23649,3dom,,1,90,70,160
23650,dirk_funk,,1,77,157,234
23651,Analblazzer,,1,2,4,6
23652,metacircular,,1,3,2,5
23653,rcglinsk,,1,466,820,1286
23654,liberalj23,,1,1,4,5
23655,Inverter,,1,30,32,62
23656,borez,,1,2,2,4
23657,Acewrap,,1,118,203,321
23658,JaneBriefcase,,1,43,8,51
23659,partyonaisle7,,1,73,13,86
23660,aenea,,1,2234,1167,3401
23661,soands0,,1,15,7,22
23662,Robert_Bork,,1,2,4,6
23663,murder,,1,5,16,21
23664,beef2k,,1,45,16,61
23665,SventheWonderDog,,1,6,8,14
23666,Tank-Man,,1,2,2,4
23667,roxyoresox,,1,7,9,16
23668,abisurd,,1,3,8,11
23669,Dr_Jekyll,,1,41,15,56
23670,keopskeops,,1,11,20,31
23671,iNNeRKaoS,,1,115,276,391
23672,rubikscubefreak,,1,78,60,138
23673,SnattoGarro,,1,3,12,15
23674,zundra,,1,41,59,100
23675,wabber,,1,15,10,25
23676,Mitchellonfire,,1,4,3,7
23677,deasmi,,1,87,4,91
23678,bolshovv,,1,1,2,3
23679,RMessmann,,1,1,2,3
23680,wootobama,,1,3,3,6
23681,gamzehyaavor,,1,38,50,88
23682,stolid_agnostic,,1,2,4,6
23683,pzone,,1,5,7,12
23684,SeanClarity,,1,6,4,10
23685,schwartzwithyou,,1,1,1,2
23686,bazzoola,,1,2,2,4
23687,chiggers,,1,7,9,16
23688,fuzzy_one,,1,32,93,125
23689,jshen,,1,151,172,323
23690,Tiarlynn,,1,67,83,150
23691,fishyfishy,,1,3,5,8
23692,volume11,,1,1,1,2
23693,dort,,1,7,5,12
23694,smasm,,1,74,101,175
23695,dylanbob,,1,10,13,23
23696,gilesdudgeon,,1,77,185,262
23697,andrew80,,1,3,5,8
23698,epukinsk,,1,7,2,9
23699,fokov,,1,161,196,357
23700,qred,,1,3,1,4
23701,mee_k,,1,68,91,159
23702,CarlH,,1,360,493,853
23703,workinghard9,,1,2,4,6
23704,hilesb,,1,6,1,7
23705,flaflashr,,1,30,22,52
23706,Sabe,,1,2,7,9
23707,masterlink43,,1,80,123,203
23708,xxxander,,1,1,1,2
23709,msummers,,1,1,4,5
23710,CookieDuster,,1,5,5,10
23711,2leftnutz,,1,81,60,141
23712,josh6499,,1,9,18,27
23713,no1joel,,1,17,35,52
23714,sapphosyne,,1,2,5,7
23715,johnny5ive,,1,82,9,91
23716,themetricsystem,,1,15,30,45
23717,jgot,,1,1,1,2
23718,jpmax,,1,7,1,8
23719,miri_sweety,,1,1,1,2
23720,mrfabbri,,1,9,8,17
23721,shallah,,1,377,32,409
23722,mash4,,1,95,28,123
23723,ejackman,,1,2,2,4
23724,N0CTURN3,,1,42,35,77
23725,nomoremermaids,,1,27,66,93
23726,CaptainTightPants,,1,1,1,2
23727,somekindazombie,,1,1,1,2
23728,kivimaki,,1,1,2,3
23729,Mr_Pessimist,,1,6,12,18
23730,oaklandgrown,,1,1,2,3
23731,pmbuko,,1,44,49,93
23732,anniemelon,,1,1,1,2
23733,palsh7,,1,70,38,108
23734,TimeistheDiamond,,1,4,4,8
23735,hewn,,1,1,2,3
23736,inua,,1,5,2,7
23737,jbz,,1,43,67,110
23738,imsomeonesangel,,1,19,31,50
23739,malik,,1,4,16,20
23740,krushgroove,,1,1,2,3
23741,spacedebris,,1,6,20,26
23742,rinnip,,1,2,2,4
23743,plytheman,,1,186,236,422
23744,lolcats,,1,176,292,468
23745,frodcore,,1,4,8,12
23746,BonzoMadrid,,1,10,13,23
23747,robbansworld,,1,1,1,2
23748,nuprana,,1,25,1,26
23749,Isuck,,1,1,4,5
23750,siddboots,,1,49,67,116
23751,Kamicolo,,1,145,32,177
23752,electronicdream,,1,8,16,24
23753,nattress,,1,14,20,34
23754,bry512,,1,5,3,8
23755,mkrueger,,1,1,2,3
23756,CollinT65,,1,5,2,7
23757,thatdamncat,,1,1,2,3
23758,hippyup,,1,56,52,108
23759,runT1ME,,1,26,34,60
23760,bratterscain,,1,7,25,32
23761,RSquared,,1,206,311,517
23762,moneypej,,1,35,69,104
23763,ParanoidPete,,1,49,25,74
23764,NurseGirl,,1,215,328,543
23765,mucky,,1,3,1,4
23766,epic_thread,,1,2,1,3
23767,samwise99,,1,1,2,3
23768,benreeper,,1,26,26,52
23769,KOOL-AIDMan,,1,6,5,11
23770,xbmodder,,1,66,93,159
23771,steelpitt,,1,6,6,12
23772,halfsleepy,,1,2,1,3
23773,lokizero,,1,4,4,8
23774,oxen88,,1,21,2,23
23775,InfomercialDoctor,,1,1,1,2
23776,seanodonnell,,1,42,53,95
23777,GeekPatrol,,1,40,63,103
23778,ralphie_wiggam,,1,8,20,28
23779,sunsurfin,,1,1,2,3
23780,GeoAtreides,,1,512,484,996
23781,GeorgeWBush,,1,594,1300,1894
23782,exaakax,,1,3,5,8
23783,hmaugans,,1,256,20,276
23784,xiyi,,1,1,1,2
23785,konakevin,,1,5,7,12
23786,eldigg,,1,281,394,675
23787,mintman,,1,1,4,5
23788,jonaizen,,1,24,15,39
23789,Section_9,,1,3,7,10
23790,codyg1985,,1,90,43,133
23791,fecklicious,,1,1,1,2
23792,Derringer2k8,,1,11,12,23
23793,insertAlias,,1,3,3,6
23794,glassware,,1,33,53,86
23795,jackasspenguin,,1,4,10,14
23796,nickf,,1,4,7,11
23797,Wobbly-Dave,,1,9,12,21
23798,fredred,,1,4,10,14
23799,elburto,,1,55,83,138
23800,djsteveoid,,1,2,3,5
23801,jrray,,1,1,4,5
23802,jamesmyname,,1,5,1,6
23803,PrecociousChild,,1,33,55,88
23804,shutupjoey,,1,85,175,260
23805,ajduncan,,1,1,3,4
23806,abeceda,,1,278,2,280
23807,AvvocatoDiabolico,,1,2,7,9
23808,racist_troll,,1,11,36,47
23809,lowgas,,1,2,2,4
23810,joltage,,1,1,4,5
23811,infernon,,1,7,2,9
23812,gigamonkey,,1,4,2,6
23813,Slapstick,,1,13,3,16
23814,900910,,1,2,3,5
23815,gcmjsmkr,,1,3,5,8
23816,erinseale,,1,26,3,29
23817,MrFlowers,,1,27,34,61
23818,snayan,,1,65,12,77
23819,neilk,,1,93,85,178
23820,localeyes,,1,222,1,223
23821,beforeseven,,1,6,7,13
23822,dansmeek,,1,10,9,19
23823,samcrut,,1,7,13,20
23824,Tommstein,,1,350,718,1068
23825,steelflames,,1,34,19,53
23826,beamin2,,1,1,2,3
23827,SniperXPX,,1,10,4,14
23828,NastyGash,,1,1,1,2
23829,musiquedame,,1,2,2,4
23830,hitler_rape_abortion,,1,31,23,54
23831,CaptainOptimist,,1,3,4,7
23832,mattme,,1,1,1,2
23833,godzilka,,1,1,1,2
23834,JClibane,,1,89,17,106
23835,9fZZ776O,,1,86,16,102
23836,allboyshatebras,,1,23,18,41
23837,dcooper,,1,2,6,8
23838,tajitj,,1,2,8,10
23839,lemurc,,1,2,10,12
23840,TheMidwest,,1,10,3,13
23841,dgbarnett,,1,3,2,5
23842,modernguy,,1,1,2,3
23843,elguercoterco,,1,240,23,263
23844,jpdaigle,,1,4,1,5
23845,sili,,1,3,8,11
23846,toyboat,,1,180,234,414
23847,johnsonmx,,1,1,1,2
23848,gobias,,1,3,5,8
23849,Eymapoophace,,1,1,1,2
23850,kieranbenton,,1,3,3,6
23851,Slowlearner,,1,8,11,19
23852,adecruza,,1,7,6,13
23853,vw63,,1,1,1,2
23854,shibumi,,1,119,171,290
23855,ronaldm201,,1,10,14,24
23856,Yakalam,,1,1,2,3
23857,oasisinet,,1,168,4,172
23858,pepparkaka,,1,156,452,608
23859,utunga,,1,19,46,65
23860,hollywoodcole,,1,4,2,6
23861,harda,,1,6,10,16
23862,autodidacticus,,1,1,1,2
23863,alexeyr,,1,73,70,143
23864,bubonic311,,1,7,3,10
23865,norinme,,1,82,9,91
23866,jugz,,1,12,21,33
23867,ahmedbilal,,1,150,6,156
23868,buddhainabucket,,1,33,7,40
23869,shnubert,,1,212,401,613
23870,serge_the_coder,,1,11,2,13
23871,WorkingDead,,1,37,54,91
23872,MimiK,,1,2,7,9
23873,alexandreracine,,1,150,140,290
23874,ethbone,,1,27,24,51
23875,RiffRandle,,1,1,2,3
23876,micheshi,,1,48,71,119
23877,indgosky,,1,16,13,29
23878,leavingharvard,,1,10,26,36
23879,darksofa,,1,14,24,38
23880,fishbert,,1,273,379,652
23881,bdy99,,1,1,2,3
23882,freakball,,1,228,276,504
23883,opti,,1,1,1,2
23884,whiteghetto,,1,5,17,22
23885,eightiesguy,,1,29,33,62
23886,balidad,,1,4,1,5
23887,jpfromjp,,1,1,1,2
23888,Skandrannon21,,1,5,5,10
23889,dudecthar,,1,3,1,4
23890,boomba111,,1,7,1,8
23891,limprichard,,1,94,194,288
23892,fantasyfinch,,1,24,1,25
23893,TheTonkaTruck,,1,80,89,169
23894,atolley,,1,4,1,5
23895,jadecristal,,1,99,200,299
23896,SlugFight,,1,102,216,318
23897,tirpse77,,1,111,5,116
23898,kolia,,1,8,4,12
23899,WestStreetWalker,,1,66,25,91
23900,phobophobia,,1,49,144,193
23901,stbby,,1,18,1,19
23902,dbzer0,,1,340,293,633
23903,graphsuck,,1,1,1,2
23904,kbilling,,1,1,4,5
23905,jackshit,,1,5,2,7
23906,nutron,,1,17,29,46
23907,thegadfly,,1,5,14,19
23908,ilostmypassword,,1,22,3,25
23909,lunchboxg4,,1,3,5,8
23910,anshulk,,1,9,5,14
23911,LittleBaby,,1,2,3,5
23912,cyclopsface,,1,19,20,39
23913,noone187,,1,5,1,6
23914,freddunkle,,1,49,49,98
23915,theodorictheamal,,1,3,2,5
23916,dwi,,1,63,80,143
23917,woosh,,1,5,13,18
23918,Encore65651,,1,1,1,2
23919,armbo,,1,1,1,2
23920,monger00,,1,69,12,81
23921,jeremedia,,1,1,4,5
23922,lost_in_space,,1,1,3,4
23923,kalemba,,1,43,59,102
23924,j3wmanji,,1,6,16,22
23925,NightGolfer,,1,404,417,821
23926,bambino_tostare,,1,1,1,2
23927,professorShrike,,1,1,2,3
23928,mikelevins,,1,4,2,6
23929,ribbit76,,1,1,1,2
23930,xoai,,1,3,3,6
23931,vininim,,1,5,6,11
23932,tanvach,,1,13,6,19
23933,dinasec,,1,2,2,4
23934,greenlantern33,,1,31,37,68
23935,polarizer,,1,2,5,7
23936,m0m0,,1,29,54,83
23937,fiestylilkim,,1,2,2,4
23938,capnmariam,,1,6,7,13
23939,Fairytaleguy,,1,1,1,2
23940,Raeapteek,,1,35,1,36
23941,ratebeer,,1,887,96,983
23942,jleard,,1,2,3,5
23943,masterleep,,1,5,2,7
23944,masseyis,,1,25,36,61
23945,k3n0b1,,1,83,143,226
23946,fart-man,,1,129,20,149
23947,chejrw21,,1,1,1,2
23948,fdksjahfdsa,,1,20,40,60
23949,ibangpots,,1,1,2,3
23950,pentupentropy,,1,60,30,90
23951,alfinoba,,1,2,1,3
23952,biatx,,1,1,1,2
23953,necroturd,,1,33,55,88
23954,liberatedword,,1,294,598,892
23955,scornflake,,1,10,6,16
23956,sagev_efil,,1,4,9,13
23957,zappepcs,,1,18,42,60
23958,doublestodtington,,1,5,8,13
23959,Rosco7,,1,25,20,45
23960,kupopo1,,1,6,5,11
23961,saxmaster,,1,1,1,2
23962,MithrasLives,,1,4,2,6
23963,jcanfield,,1,3,1,4
23964,bandwagon,,1,97,104,201
23965,Mansn,,1,52,63,115
23966,ZanThrax,,1,291,487,778
23967,think3737,,1,1,1,2
23968,p1234,,1,95,6,101
23969,Boreas74,,1,9,1,10
23970,hoijarvi,,1,81,120,201
23971,iSteve,,1,5,17,22
23972,stillwaters,,1,73,128,201
23973,chompsky,,1,53,56,109
23974,labgeek,,1,18,52,70
23975,jesusabdullah,,1,30,88,118
23976,fionbio,,1,31,40,71
23977,b34ch3r,,1,1,2,3
23978,lava444,,1,1,3,4
23979,AllenHarkleroad,,1,9,13,22
23980,SteJules,,1,94,11,105
23981,PoodleSmuggler,,1,6,5,11
23982,mattthetalker,,1,8,4,12
23983,4shane76,,1,22,56,78
23984,freddic,,1,2,3,5
23985,w2d,,1,8,8,16
23986,djbuzzkill,,1,9,4,13
23987,mr_chromatic,,1,257,328,585
23988,Orbitaldecay,,1,22,6,28
23989,tinfoilhat911,,1,1,2,3
23990,thecrazyD,,1,44,49,93
23991,schonchin,,1,3,4,7
23992,trowserwowser,,1,37,74,111
23993,sleen,,1,5,5,10
23994,wepto,,1,1,2,3
23995,ivorjawa,,1,94,68,162
23996,greenjenny,,1,6,5,11
23997,imposs,,1,5,8,13
23998,pemboa,,1,310,430,740
23999,jacker,,1,1,1,2
24000,JordanF98765,,1,100,90,190
24001,mypetrobot,,1,4,1,5
24002,siliconglen,,1,24,5,29
24003,jack_nz,,1,8,7,15
24004,egzthunder1,,1,162,194,356
24005,nevarforget,,1,1,5,6
24006,hain,,1,101,106,207
24007,ccharles,,1,260,193,453
24008,wanpage,,1,1,3,4
24009,boldbonvivant,,1,12,13,25
24010,Bigred,,1,13,18,31
24011,mastery,,1,1,1,2
24012,MaybeTomorrow,,1,15,36,51
24013,anonymous410,,1,1,1,2
24014,PoopsMcG,,1,78,79,157
24015,nfkiller,,1,11,10,21
24016,hokeypokey,,1,1,1,2
24017,Selmerboy,,1,1,6,7
24018,pretzelcuatl,,1,31,7,38
24019,skysee,,1,3,1,4
24020,SittingBull,,1,102,50,152
24021,rotten777,,1,22,38,60
24022,linus_rules,,1,13,18,31
24023,sn0re,,1,1249,1849,3098
24024,confuc,,1,106,4,110
24025,InternetOfficer,,1,1,2,3
24026,nefariousninja,,1,49,50,99
24027,Widget05,,1,9,17,26
24028,bboomslang,,1,3,4,7
24029,cvos,,1,1,1,2
24030,Flyen,,1,174,202,376
24031,DanAndJenn,,1,4,1,5
24032,skyekilaen,,1,2,7,9
24033,Metasheep,,1,60,57,117
24034,se7en,,1,13,6,19
24035,ansgenius,,1,7,13,20
24036,jeh506,,1,56,23,79
24037,up_the_irons,,1,6,1,7
24038,nautimike,,1,12,6,18
24039,jayw,,1,35,72,107
24040,nobodyrp,,1,43,54,97
24041,da_bears_rule,,1,1,1,2
24042,phredtheterrorist,,1,6,7,13
24043,Joose,,1,2,2,4
24044,zzzeek,,1,77,98,175
24045,br1,,1,5,4,9
24046,mgslol,,1,15,10,25
24047,alextp,,1,16,17,33
24048,retidder,,1,33,33,66
24049,GeorgeDubyaBush,,1,4,4,8
24050,cefcm,,1,1,1,2
24051,jgwong,,1,1,1,2
24052,Tolaria,,1,4,6,10
24053,lgastako,,1,1,5,6
24054,UCB,,1,5,3,8
24055,jmijor,,1,3,1,4
24056,Rawrawr,,1,1,1,2
24057,haagmm,,1,13,21,34
24058,quillian,,1,6,5,11
24059,kiku,,1,1,1,2
24060,SesseSekko,,1,4,5,9
24061,lepoulet,,1,3,2,5
24062,goodcopbadcop,,1,2,2,4
24063,majoogybobber,,1,145,69,214
24064,fringsphysiclwrld,,1,18,35,53
24065,edeninchains,,1,17,4,21
24066,sirdonut,,1,6,4,10
24067,zakcroy,,1,1,1,2
24068,praveenpious,,1,43,7,50
24069,good_doctor,,1,8,14,22
24070,infosnax,,1,277,276,553
24071,mdickw,,1,204,108,312
24072,neatorama,,1,1,1,2
24073,klocksib,,1,9,28,37
24074,mistera,,1,40,32,72
24075,cush,,1,139,124,263
24076,MagicGate,,1,9,6,15
24077,gilf,,1,13,8,21
24078,nanbot,,1,9,7,16
24079,dwillington,,1,31,42,73
24080,tolworthy,,1,2,1,3
24081,keyrat,,1,130,122,252
24082,tihp,,1,1,1,2
24083,DvorakUser,,1,2,3,5
24084,opk,,1,35,17,52
24085,chrisbaskind,,1,1,10,11
24086,Zunger,,1,1,2,3
24087,delecti,,1,1,2,3
24088,dberis,,1,196,256,452
24089,thxi1xa,,1,1,1,2
24090,Moxie1,,1,2,2,4
24091,ralmeida,,1,5,6,11
24092,RICKARD5,,1,103,209,312
24093,sumeetjain,,1,8,6,14
24094,OldGreyTroll,,1,1,2,3
24095,quattrofan,,1,71,140,211
24096,derupert,,1,47,74,121
24097,bradtgmurray,,1,4,3,7
24098,downgoesfrazier,,1,155,4,159
24099,sniggity,,1,57,153,210
24100,smift,,1,2,14,16
24101,laurarachel,,1,45,30,75
24102,kay63,,1,1,2,3
24103,dning,,1,17,3,20
24104,Tigaj,,1,7,1,8
24105,mejlkungen,,1,14,24,38
24106,timealterer,,1,42,4,46
24107,timster,,1,21,26,47
24108,beppu,,1,6,27,33
24109,bunfunbun,,1,21,34,55
24110,gasfggjj,,1,1,1,2
24111,YoavShapira,,1,1,1,2
24112,Lifted,,1,14,35,49
24113,roll3r,,1,20,26,46
24114,allanmac00,,1,11,15,26
24115,wikk3d,,1,13,27,40
24116,Akhel,,1,79,76,155
24117,andycarlson,,1,1,1,2
24118,swac,,1,40,14,54
24119,finisterra,,1,242,387,629
24120,veridatis,,1,2,4,6
24121,jangchoe,,1,95,14,109
24122,RicoX9,,1,32,27,59
24123,Eizz,,1,16,22,38
24124,paul_mendoza,,1,47,89,136
24125,dotancohen,,1,40,22,62
24126,mrpickleby,,1,29,50,79
24127,asdf1341,,1,10,14,24
24128,apos,,1,1,2,3
24129,Mkcornick,,1,32,17,49
24130,bambin0,,1,52,64,116
24131,BlackStrain,,1,4,2,6
24132,Tsukuyomi,,1,1,3,4
24133,2solitudes,,1,3,3,6
24134,crimius,,1,3,12,15
24135,ProfessorM,,1,70,100,170
24136,jjray7,,1,98,57,155
24137,tclark,,1,42,79,121
24138,dsk,,1,528,575,1103
24139,cute_kiddo_fury,,1,4,5,9
24140,DzGuy,,1,2,1,3
24141,rrusilowicz,,1,5,10,15
24142,PostingPolice,,1,11,24,35
24143,tampink,,3,1,1,2
24144,quantumamy,,1,1,1,2
24145,oq2,,1,16,39,55
24146,gibsiin,,1,2,2,4
24147,CafeAss,,1,1,4,5
24148,actionboy,,1,19,34,53
24149,emTel,,1,22,12,34
24150,OuchLOLcom,,1,75,3,78
24151,Garbo,,1,22,42,64
24152,joblessjunkie,,1,89,74,163
24153,j1mcamp,,1,6,13,19
24154,fnazeeri,,1,2,1,3
24155,elmer_thudd,,1,1,1,2
24156,Reive,,1,9,23,32
24157,Oz-Batty,,1,5,5,10
24158,ratsbane,,1,7,10,17
24159,dominicc,,1,1,1,2
24160,isthisdigg,,1,9,4,13
24161,alvaai,,1,1,4,5
24162,whiteyfresh,,1,360,510,870
24163,brasso,,1,17,33,50
24164,uglyluvr,,1,2,5,7
24165,hohums,,1,1,1,2
24166,Confinium,,1,9,9,18
24167,jordancaleb,,1,143,190,333
24168,omtw,,1,22,32,54
24169,nightofgrim,,1,49,94,143
24170,shawna_m,,1,45,44,89
24171,eloop,,1,13,2,15
24172,protossss,,1,2,2,4
24173,Chx,,1,91,157,248
24174,workerdaemon,,1,256,407,663
24175,mayonesa,,1,944,352,1296
24176,King_Lem,,1,2,5,7
24177,slgalt,,1,1,1,2
24178,magikid,,1,4,7,11
24179,mightyfin,,1,16,23,39
24180,staxbrix,,1,15,2,17
24181,idiotsmile,,1,2,3,5
24182,12StepAgnostic,,1,1,1,2
24183,ThinkItOver,,1,139,76,215
24184,schnook,,1,1,3,4
24185,complex,,1,4,8,12
24186,DaemonR,,1,16,37,53
24187,djdefekt,,1,9,7,16
24188,O_Gruesome_One,,1,3,1,4
24189,Romandante,,1,1,2,3
24190,OUPrice08,,1,2,2,4
24191,nictiwn,,1,1,1,2
24192,haskellist,,1,48,56,104
24193,hkyoda,,1,1,1,2
24194,middleperson,,1,1,1,2
24195,arcoma,,1,1,4,5
24196,Yaker,,1,19,19,38
24197,Independent24,,1,11,2,13
24198,betrothtypist,,1,3,3,6
24199,gpww,,1,6,3,9
24200,argarararar,,1,6,4,10
24201,Palquito,,1,5,5,10
24202,honc,,1,2,1,3
24203,tmw1488,,1,93,269,362
24204,LesbianHan,,1,1,1,2
24205,cycnus,,1,2,3,5
24206,bigjoe699,,1,1,1,2
24207,HowlingWolf,,1,17,21,38
24208,RedneckForObama,,1,3,2,5
24209,hueristic,,1,24,23,47
24210,thetrivialsublime,,1,2,1,3
24211,darmog,,1,4,7,11
24212,Wisco,,1,378,223,601
24213,mathgeek,,1,48,31,79
24214,kingjames128,,1,27,6,33
24215,Gentle_Ben,,1,2,3,5
24216,junkmale,,1,1043,700,1743
24217,HalleBerry,,1,3,1,4
24218,ChunkyLaFunga,,1,880,1230,2110
24219,eridius,,1,366,415,781
24220,brandnewredditor,,1,6,8,14
24221,pcflet01,,1,38,14,52
24222,GOjeff,,1,116,34,150
24223,rockwellian,,1,5,7,12
24224,raginole,,1,1,1,2
24225,looklookatme,,1,2,4,6
24226,bwells78,,1,1,2,3
24227,hehdot,,1,24,21,45
24228,rue,,1,4,2,6
24229,gjbloom,,1,3,2,5
24230,lawrencetureaud,,1,5,22,27
24231,veritech,,1,27,43,70
24232,thefnord,,1,2,3,5
24233,mizunoX,,1,1,1,2
24234,radical,,1,60,60,120
24235,freedomwv,,1,6,16,22
24236,havocist,,1,111,94,205
24237,zilentbob,,1,3,5,8
24238,thunderballfists,,1,13,35,48
24239,jaalin,,1,167,261,428
24240,wadfasdfaw,,1,2,1,3
24241,eldridgea,,1,20,29,49
24242,TheLastUsername,,1,2,1,3
24243,urso,,1,2,4,6
24244,An_Sheeple,,1,1,1,2
24245,mxyzptlk,,1,45,96,141
24246,qmx,,1,1,3,4
24247,IOIOOIIOIO,,1,349,771,1120
24248,workaholic23,,1,4,6,10
24249,hattmoward,,1,32,56,88
24250,theunixgeek,,1,2,1,3
24251,7952,,1,32,43,75
24252,jimjohn,,1,2,3,5
24253,clownshoes,,1,89,83,172
24254,12Iceman,,1,143,117,260
24255,abc2011,,1,10,8,18
24256,dailyn,,1,766,193,959
24257,sock_muppetis,,1,1,1,2
24258,pmr,,1,5,7,12
24259,notle,,1,4,3,7
24260,spikeparker,,1,11,33,44
24261,snowhite12,,1,204,2,206
24262,bingcognito,,1,28,41,69
24263,randomafk,,1,6,11,17
24264,rjn945,,1,2,4,6
24265,lexpython,,1,31,33,64
24266,weaselonfire,,1,850,361,1211
24267,bena_dc,,1,26,2,28
24268,neurot,,1,56,65,121
24269,VAPerson,,1,79,132,211
24270,happywaffle,,1,300,326,626
24271,thebillmac3,,1,470,894,1364
24272,kidfay,,1,29,31,60
24273,cthibaut,,1,6,11,17
24274,d1257,,1,19,35,54
24275,tinha,,1,14,26,40
24276,modusop,,1,1,1,2
24277,grelphy,,1,723,863,1586
24278,didimaumusic,,1,4,2,6
24279,little_mei,,1,13,18,31
24280,Kapitalism,,1,7,10,17
24281,exportgoldman,,1,1,1,2
24282,rudolfschmidt,,1,1,1,2
24283,Agret,,1,11,13,24
24284,Cthonic,,1,7,17,24
24285,Johio,,1,51,15,66
24286,phil_g,,1,105,86,191
24287,crushd62497,,1,1,1,2
24288,Weeperblast,,1,11,10,21
24289,scrby,,1,37,5,42
24290,bikini_bible,,1,13,20,33
24291,huangyi,,1,1,2,3
24292,gardengnomic,,1,21,37,58
24293,gabtinha,,1,67,29,96
24294,moe_va,,1,1,1,2
24295,osborned,,1,2,1,3
24296,moses1400,,1,3,6,9
24297,hiphopmusiq,,1,138,109,247
24298,jayskew,,1,8,12,20
24299,chaosZombie,,1,2,3,5
24300,brilliance,,1,22,37,59
24301,bobappleyard,,1,74,145,219
24302,fnork77,,1,30,52,82
24303,twisted2253,,1,1,2,3
24304,leslieb310,,1,3,2,5
24305,Etab,,1,624,900,1524
24306,thebandit87,,1,10,30,40
24307,cowdogk,,1,55,37,92
24308,rabidstoat,,1,14,30,44
24309,killerkadoogan,,1,11,19,30
24310,ginaav,,1,132,1,133
24311,cirquelar,,1,63,143,206
24312,JonathanBlow,,1,4,1,5
24313,gebruikersnaam,,1,4,2,6
24314,joonix,,1,1088,684,1772
24315,doone,,1,23,2,25
24316,socratesocks,,1,16,20,36
24317,TopRamen713,,1,728,872,1600
24318,34o1055,,1,2,2,4
24319,kristinsj,,1,2,1,3
24320,orgadam,,1,23,28,51
24321,aandronov,,1,3,3,6
24322,akise,,1,5,15,20
24323,effedup,,1,4,8,12
24324,exegesisClique,,1,49,80,129
24325,reticulatedspline,,1,45,63,108
24326,barfolomew,,1,207,309,516
24327,swiftest,,1,4,2,6
24328,Drakooola,,1,7,9,16
24329,CanadianTire,,1,2,1,3
24330,capital_idea,,1,8,12,20
24331,oldredditor,,1,2,5,7
24332,Fara17,,1,39,52,91
24333,ddavev,,1,70,61,131
24334,the_seanald,,1,105,158,263
24335,alaris,,1,1,2,3
24336,papillon24,,1,163,177,340
24337,tjasond,,1,3,2,5
24338,Trauma,,1,2,3,5
24339,Axius,,1,2,5,7
24340,write_in,,1,3,2,5
24341,numlok,,1,407,239,646
24342,foobazco,,1,4,4,8
24343,foofightrs777,,1,18,22,40
24344,tessfeb01,,1,36,44,80
24345,tapesmith,,1,1,1,2
24346,mrl215,,1,24,31,55
24347,lfcgoreds,,1,1,1,2
24348,RealFriendlyGuy,,1,2,4,6
24349,drgori,,1,18,10,28
24350,coolchickk,,1,8,1,9
24351,garytehs,,1,8,1,9
24352,gakman,,1,12,1,13
24353,joforedditin,,1,22,23,45
24354,cag_ii,,1,307,73,380
24355,earthinaword,,1,3,2,5
24356,dhaggerfin,,1,80,135,215
24357,arohner,,1,27,14,41
24358,hindesky,,1,92,184,276
24359,bigscott0026,,1,1,2,3
24360,FlorenceW,,1,301,1,302
24361,cruijff,,1,4,1,5
24362,jips,,1,819,1,820
24363,racerx52,,1,7,26,33
24364,wgl,,1,10,34,44
24365,putgirl,,1,1,2,3
24366,Fountaine,,1,3,10,13
24367,hassanibraheem,,1,29,2,31
24368,Garbagio,,1,219,411,630
24369,HXC_SHMARDCORE,,1,1,2,3
24370,phillapier,,1,33,2,35
24371,chrisskinr,,1,50,112,162
24372,smacktoward,,1,3,3,6
24373,gratsonbad,,1,13,15,28
24374,Borkachev,,1,182,162,344
24375,Y2Cajun,,1,5,22,27
24376,specmiata,,1,5,3,8
24377,dorock,,1,6,12,18
24378,eshop600,,1,5,9,14
24379,kensingtonvictoria,,1,1,1,2
24380,AhmedF,,1,22,31,53
24381,ctffmike,,1,2,2,4
24382,wafflesrevenge,,1,1,1,2
24383,cashcow,,1,17,6,23
24384,romanoke,,1,2,3,5
24385,nextpage,,1,5,1,6
24386,isnthatheway,,1,8,27,35
24387,juliawise,,1,2,2,4
24388,ironypolice,,1,68,94,162
24389,xflhbs,,1,5,4,9
24390,mooli,,1,302,370,672
24391,tsfrankie,,1,43,14,57
24392,leopoldo,,1,464,18,482
24393,stormopen,,1,2,4,6
24394,jgood2709,,1,1,1,2
24395,zenzizi,,1,104,165,269
24396,wayno007,,1,4,8,12
24397,notahippie76,,1,368,372,740
24398,PipsDayOut,,1,90,58,148
24399,Vash265,,1,700,772,1472
24400,natrius,,1,726,713,1439
24401,bs0101,,1,14,30,44
24402,saucier23,,1,48,55,103
24403,iceix,,1,22,19,41
24404,blunted,,1,43,92,135
24405,CaptainDubious,,1,1,4,5
24406,feckoffcup,,1,2,3,5
24407,kingjafee,,1,400,20,420
24408,michaeb,,1,6,2,8
24409,kmoore,,1,5,14,19
24410,mattso,,1,4,8,12
24411,leftthebox,,1,13,2,15
24412,rad_thundercat,,1,62,63,125
24413,CAPSLOCKBIGCOCK,,1,2,1,3
24414,YourTechSupport,,1,44,80,124
24415,SHEEPLE__,,1,8,8,16
24416,jnana,,1,35,68,103
24417,juliusseizure,,1,99,147,246
24418,buckrogers,,1,1,4,5
24419,bundublog,,1,1,1,2
24420,TheMindFlayer,,1,7,2,9
24421,sensen411,,1,34,55,89
24422,monkeybreath,,1,295,436,731
24423,DavidinBoston,,1,1,1,2
24424,duckrogers,,1,13,18,31
24425,serenecloud,,1,1,3,4
24426,AusIV,,1,251,368,619
24427,Them,,1,1,4,5
24428,House_Playa,,1,4,3,7
24429,intellectual,,1,608,736,1344
24430,Angel1379,,1,165,14,179
24431,elysiand,,1,28,30,58
24432,mully,,1,1,1,2
24433,translucent,,1,9,9,18
24434,weblypistol,,1,2,1,3
24435,jinglebells,,1,168,163,331
24436,channyboy,,1,17,27,44
24437,crankybadger,,1,2,4,6
24438,Wyatt22,,1,124,62,186
24439,turungan,,1,3,7,10
24440,thedarkhaze,,1,9,10,19
24441,surrenderyourduck,,1,5,3,8
24442,rams,,1,71,7,78
24443,Snyper718,,1,1,7,8
24444,usernameispassword,,1,4,1,5
24445,Thursty,,1,18,27,45
24446,ilude,,1,3,2,5
24447,gururickri,,1,21,4,25
24448,duopixel,,1,8,4,12
24449,lamaraju,,1,2,2,4
24450,arrival77,,1,44,50,94
24451,CosmicBard,,1,31,93,124
24452,europeiscrowded,,1,3,3,6
24453,masterJ,,1,60,52,112
24454,Kcar,,1,1,1,2
24455,BTV,,1,26,39,65
24456,pepethecow,,1,1,1,2
24457,tienlex,,1,2,2,4
24458,collegedropout,,1,14,24,38
24459,tndal,,1,12,13,25
24460,mylastbreath,,1,6,10,16
24461,Anon23,,1,1,1,2
24462,madkitty,,1,2,1,3
24463,RonPaul_is_Taleban,,1,1,1,2
24464,BinaryShadow,,1,510,696,1206
24465,benbetso,,1,3,4,7
24466,komacan,,1,1,2,3
24467,thorax,,1,58,91,149
24468,quickie,,1,14,15,29
24469,ramius,,1,1,1,2
24470,El_Guapo,,1,349,505,854
24471,AllenVarney,,1,3,2,5
24472,Shindig,,1,4,5,9
24473,crescentfresh,,1,42,56,98
24474,ride,,1,153,218,371
24475,mw44118,,1,41,7,48
24476,metalmutt,,1,1,2,3
24477,rollingdivision,,1,20,20,40
24478,api,,1,722,674,1396
24479,spoogle,,1,1,2,3
24480,gavinhudson1,,1,37,26,63
24481,dumis,,1,34,12,46
24482,richard_stone,,1,8,10,18
24483,psrivats,,1,1,7,8
24484,donaldrobertsoniii,,1,356,192,548
24485,CoffeeJones,,1,1,2,3
24486,pordante,,1,4,14,18
24487,spaceddaisy,,1,1,2,3
24488,y2k_propaganda,,1,22,10,32
24489,starfocus,,1,64,18,82
24490,turtlesallthewaydown,,1,84,65,149
24491,comob74,,1,1,1,2
24492,anotherDocObVious,,1,24,73,97
24493,thepdxbikerboy,,1,4,11,15
24494,johanneskepler,,1,11,13,24
24495,hinterlander,,1,1,1,2
24496,CapitalIdea,,1,23,31,54
24497,mttprrish,,1,10,12,22
24498,pinano,,1,2,2,4
24499,evergreenamerica,,1,5,7,12
24500,andsmi,,1,46,1,47
24501,deepscene,,1,2,2,4
24502,yes2134sdfsg,,1,6,3,9
24503,presoblu,,1,94,85,179
24504,cysun,,1,112,97,209
24505,sirvesa,,1,6,5,11
24506,antisoshal,,1,9,6,15
24507,lazer,,1,5,11,16
24508,jessta,,1,9,10,19
24509,marquinhocb,,1,6,1,7
24510,LaZerguy,,1,43,88,131
24511,joharilanng,,1,31,30,61
24512,jailbird4444,,1,5,2,7
24513,mattdhorstman,,1,2,2,4
24514,safety_otter,,1,2,6,8
24515,bkmrkr2,,1,5,7,12
24516,PocketWatched,,1,5,9,14
24517,Evilsoup,,1,4,2,6
24518,hotcakes,,1,180,58,238
24519,miGlanz,,1,8,9,17
24520,THE_RIAA,,1,1,1,2
24521,bazzatuk,,1,1,1,2
24522,apuent,,1,10,16,26
24523,mrpony,,1,2,5,7
24524,rook2pawn,,1,620,595,1215
24525,jenhsun,,1,2,1,3
24526,yuckatan,,1,9,42,51
24527,jayc,,1,34,34,68
24528,okhelo,,1,1,1,2
24529,mike689,,1,3,4,7
24530,jcarr,,1,75,52,127
24531,rollerbob,,1,58,46,104
24532,orbiscerbus,,1,13,19,32
24533,citydweller,,1,22,13,35
24534,drexhex,,1,24,16,40
24535,cactusthesaint,,1,5,7,12
24536,renani07,,1,7,11,18
24537,ARDComics,,1,1,2,3
24538,nexus2xl,,1,298,478,776
24539,wisamc,,1,6,11,17
24540,jeff0,,1,74,94,168
24541,maxharris,,1,12,14,26
24542,ktusznio,,1,36,46,82
24543,fredscereal,,1,1,11,12
24544,toekk,,1,2,3,5
24545,PhirePhly,,1,6,5,11
24546,dry_green_tea,,1,255,47,302
24547,af_fox,,1,4,2,6
24548,carmen2007,,1,17,2,19
24549,kukhuvudet,,1,5,5,10
24550,michaelok,,1,10,17,27
24551,raleighwhite,,1,2,2,4
24552,scyrius,,1,1,1,2
24553,some_dude,,1,6,2,8
24554,a0t0f,,1,76,85,161
24555,stevewmn,,1,15,7,22
24556,twiglatte,,1,20,16,36
24557,sgorf,,1,40,38,78
24558,nontheist,,1,10,10,20
24559,jimbo345,,1,1,7,8
24560,spam_rocket,,1,19,11,30
24561,neondemon,,1,2,1,3
24562,satorusan,,1,3,17,20
24563,jaxxon,,1,5,7,12
24564,VerticalEvent,,1,2,1,3
24565,ImmigratingToCanada,,1,1,1,2
24566,sukirnii,,1,5,3,8
24567,adelman890,,1,5,5,10
24568,HolyHandGrenade,,1,2,1,3
24569,calbach,,1,5,3,8
24570,boss1345,,1,13,2,15
24571,MonoApe,,1,192,346,538
24572,djfanon,,1,4,1,5
24573,mmmdelishus,,1,1,2,3
24574,scaevolus,,1,1,2,3
24575,noormuhammad,,1,1,5,6
24576,hbweb500,,1,106,84,190
24577,StachesnMullets,,1,15,2,17
24578,tugboatking,,1,4,9,13
24579,ingle,,1,2,2,4
24580,Captain_Cunning,,1,3,8,11
24581,tjones_2005a,,1,65,142,207
24582,substrate,,1,29,42,71
24583,panzerfinder15,,1,13,12,25
24584,lstorie1971,,1,1,1,2
24585,taylorcomm,,1,5,2,7
24586,pudquick,,1,48,61,109
24587,rhcpds7,,1,40,13,53
24588,zheisey,,1,8,15,23
24589,Bloodtrocuter,,1,8,28,36
24590,mauriceroman,,1,2,2,4
24591,Skee,,1,89,44,133
24592,marydaze,,1,82,131,213
24593,czul1,,1,1,3,4
24594,Srsly666,,1,21,52,73
24595,condensate17,,1,11,8,19
24596,markashton,,1,1,1,2
24597,eco_was_taken,,1,146,182,328
24598,triggler,,1,2,5,7
24599,frazer2669,,1,2,2,4
24600,TheHarvester,,1,15,6,21
24601,skizza,,1,4,4,8
24602,superfreak7,,1,2,1,3
24603,vlad_tepes,,1,250,369,619
24604,tj9582,,1,3,2,5
24605,polaralex,,1,1,3,4
24606,GoldUser,,1,14,7,21
24607,baseball83,,1,1,2,3
24608,LOL_CAT,,1,28,21,49
24609,wreelp,,1,14,17,31
24610,opentruth,,1,195,30,225
24611,Phylodome,,1,9,8,17
24612,avdi,,1,75,14,89
24613,alan_dulles,,1,2,1,3
24614,ruodo,,1,150,218,368
24615,Reporting,,1,41,1,42
24616,bkdelong,,1,1,1,2
24617,zoo3000,,1,3,5,8
24618,zyclonis,,1,118,215,333
24619,ogercaveman,,1,1,1,2
24620,MEME-KILLER,,1,1,1,2
24621,jambarama,,1,91,155,246
24622,Shellack,,1,2,1,3
24623,trancertong,,1,229,91,320
24624,cthielen,,1,143,113,256
24625,plagues,,1,1,1,2
24626,sarotara,,1,43,46,89
24627,jotux,,1,25,34,59
24628,libfree,,1,205,59,264
24629,Percara,,1,3,13,16
24630,stalcottsmith,,1,143,193,336
24631,mushpot_net,,1,5,3,8
24632,cliff_bisch,,1,17,15,32
24633,Mongoloid,,1,1,1,2
24634,CounterBreak,,1,1,3,4
24635,nursewithprostate,,1,44,73,117
24636,lepton3,,1,24,16,40
24637,NicNicNic,,1,72,196,268
24638,phybere,,1,25,34,59
24639,Brokebackcasket,,1,1,9,10
24640,GoateusMaximus,,1,17,20,37
24641,blendo,,1,9,13,22
24642,theframeproblem,,1,6,1,7
24643,kirby9,,1,12,4,16
24644,BrianBoyko,,1,522,559,1081
24645,aturley,,1,6,6,12
24646,csmillichap,,1,144,175,319
24647,Dontgotocollege,,1,4,1,5
24648,martyville,,1,25,25,50
24649,shyneclinton,,1,1,1,2
24650,brushbox,,1,78,118,196
24651,wegin,,1,2,1,3
24652,NotlufNorserp,,1,4,4,8
24653,goshorty,,1,1,1,2
24654,deadparrot28,,1,12,2,14
24655,snoobie,,1,2,4,6
24656,blarney_77,,1,3,2,5
24657,SemanticStallion,,1,1,1,2
24658,tobrien,,1,235,74,309
24659,bassomatic,,1,414,237,651
24660,qulic1968,,1,9,8,17
24661,atlasbound,,1,3,3,6
24662,qyasogk,,1,6,6,12
24663,EggbertPraetorius,,1,6,6,12
24664,firelight,,1,24,32,56
24665,richmcl,,1,4,10,14
24666,wmaustin5,,1,1,1,2
24667,Decoy9,,1,37,4,41
24668,Help_Im_A_Rock,,1,1,3,4
24669,ahhoosha,,1,12,25,37
24670,commonkey,,1,2,1,3
24671,tuan,,1,2,4,6
24672,shazbotter,,1,29,29,58
24673,drugstorecowboy,,1,2,1,3
24674,DrCheezburger,,1,42,64,106
24675,bennythekid1,,1,4,11,15
24676,postertorn,,1,2,1,3
24677,jaunti,,1,6,2,8
24678,El_Forko,,1,3,9,12
24679,hacksoncode,,1,11,12,23
24680,samuek,,1,24,32,56
24681,VerteDinde,,1,61,86,147
24682,deezeejoey,,1,1,1,2
24683,angch,,1,19,46,65
24684,funkadelik,,1,3,1,4
24685,kat,,1,1,2,3
24686,dsacks,,1,1,1,2
24687,Kjjkh_Jkhjkk,,1,1,1,2
24688,csandb,,1,1,1,2
24689,davejohncole,,1,2,1,3
24690,InterrobangProponent,,1,2,2,4
24691,aleutian,,1,6,6,12
24692,alampros,,1,1,2,3
24693,kruegs,,1,1,2,3
24694,joshtempte,,1,3,2,5
24695,stassats,,1,8,12,20
24696,Rick-Astley,,1,12,16,28
24697,robert644,,1,19,41,60
24698,razorhack,,1,4,16,20
24699,Brolee,,1,17,67,84
24700,jclassracer,,1,3,21,24
24701,HarryTruman,,1,20,27,47
24702,daigoba66,,1,10,5,15
24703,m_erik_mason,,1,2,1,3
24704,theguffer,,1,23,21,44
24705,hashmalum,,1,4,7,11
24706,noel,,1,1,1,2
24707,mathgladiator,,1,1,2,3
24708,mojonixon,,1,1,4,5
24709,pandamander,,1,1,1,2
24710,wnose,,1,43,37,80
24711,excession,,1,14,8,22
24712,jncraton,,1,7,4,11
24713,tehjess,,1,8,10,18
24714,verveonica,,1,3,16,19
24715,georgiabiker,,1,9,26,35
24716,foxymoron,,1,28,78,106
24717,directionzero,,1,28,19,47
24718,jonw,,1,108,23,131
24719,smkyle1,,1,55,6,61
24720,SwankyJ,,1,16,1,17
24721,iwata,,1,13,6,19
24722,unanimus,,1,1,2,3
24723,TheirOwnMedicine,,1,5,1,6
24724,MoralHazard,,1,12,10,22
24725,jibbybonk,,1,2,1,3
24726,fffangold,,1,28,4,32
24727,roblef,,1,2,1,3
24728,pkkid,,1,7,7,14
24729,buleball,,1,1,1,2
24730,sternenator,,1,16,8,24
24731,kimberann,,1,73,9,82
24732,opseudo,,1,5,4,9
24733,sagerage,,1,4,1,5
24734,kpezkpez,,1,1,2,3
24735,colinnwn,,1,75,117,192
24736,agentbad,,1,106,381,487
24737,danger_tank,,1,11,10,21
24738,moosehockey23,,1,65,19,84
24739,nerftoe,,1,65,98,163
24740,CaptainInaccurate,,1,15,11,26
24741,404NameNotFound,,1,2,3,5
24742,TheBigRedDog,,1,54,11,65
24743,new_england,,1,16,9,25
24744,sparko,,1,3,2,5
24745,superwhateverman,,1,1,1,2
24746,adamvarga,,1,111,9,120
24747,cha12ly,,1,2,1,3
24748,escartist,,1,21,9,30
24749,Chroko,,1,197,184,381
24750,jursun,,1,4,4,8
24751,LoopHead,,1,259,331,590
24752,zataang,,1,1,5,6
24753,sebso,,1,6,2,8
24754,ensvensk,,1,2,1,3
24755,JinMarui,,1,232,533,765
24756,Ceph,,1,4,8,12
24757,gehlen,,1,6,9,15
24758,okcmaniac2,,1,1,1,2
24759,danny291,,1,9,19,28
24760,sn3098,,1,1,1,2
24761,taigaV,,1,6,12,18
24762,rossalgondamer,,1,30,84,114
24763,jade1yn,,1,3,6,9
24764,RMB123,,1,11,1,12
24765,eventhough,,1,42,14,56
24766,t-shirt-in-a-can,,1,3,16,19
24767,mattmentecky,,1,182,149,331
24768,meatpie,,1,3,4,7
24769,TexDen,,1,37,102,139
24770,zaretina,,1,91,69,160
24771,biggav,,1,18,10,28
24772,AOCsense,,1,4,1,5
24773,pageonenewsfan,,1,1,1,2
24774,Laconicus,,1,2,1,3
24775,pastyface,,1,1,1,2
24776,Thee_Internet,,1,5,3,8
24777,youngtomorrow,,1,1,1,2
24778,ngngboone,,1,452,604,1056
24779,CheeseSandwich,,1,1,2,3
24780,rusty_trombone,,1,8,16,24
24781,chivalry,,1,6,2,8
24782,mindspread,,1,117,43,160
24783,sbhdawn,,1,123,91,214
24784,meistergrado,,1,72,170,242
24785,BestServedCold,,1,281,337,618
24786,Automaton-o-mation,,1,2,1,3
24787,parl,,1,2,8,10
24788,dmarinescu,,1,2,4,6
24789,zaha,,1,1,2,3
24790,queenofspainsbeard,,1,6,2,8
24791,reddragon,,1,4,6,10
24792,dimonolog,,1,2,6,8
24793,GoHealthyGoFit,,1,4,2,6
24794,ddjango,,1,7,9,16
24795,deadliftpookie,,1,7,14,21
24796,umjames,,1,2,10,12
24797,bigtoe416,,1,40,30,70
24798,crazyfingers3,,1,1,1,2
24799,ihadanidea,,1,141,264,405
24800,X-Wes,,1,5,5,10
24801,_greg,,1,34,21,55
24802,Lilis78,,1,1,1,2
24803,WarzoneOfDefecation,,1,49,77,126
24804,AK1RA07,,1,31,36,67
24805,sethspeaks,,1,17,15,32
24806,BradLeclerc,,1,7,5,12
24807,explorer1972,,1,64,106,170
24808,3fingers,,1,14,28,42
24809,BenBaril,,1,2,4,6
24810,nootopian,,1,11,2,13
24811,barcuda,,1,1,1,2
24812,notfromphilly,,1,1,1,2
24813,cpruitt,,1,98,14,112
24814,samiamtoo,,1,8,2,10
24815,2880,,1,1,5,6
24816,mokerrr,,1,3,1,4
24817,cldellow,,1,2,3,5
24818,illymcflow,,1,1,2,3
24819,jaobrien6,,1,7,11,18
24820,moreminimal,,1,27,9,36
24821,cgod,,1,14,19,33
24822,heavyal,,1,1,1,2
24823,LibertyBoy,,1,1,3,4
24824,off8eat,,1,1,1,2
24825,ProgrammingAce,,1,10,1,11
24826,sidianmsjones,,1,15,5,20
24827,CIA_Guy,,1,1,3,4
24828,rebeccahutton,,1,3,5,8
24829,vvpan,,1,101,99,200
24830,milnivek,,1,3,1,4
24831,jasonthemason,,1,22,42,64
24832,halfjoking,,1,21,8,29
24833,RandomName321,,1,3,5,8
24834,squirrels_are_cool,,1,2,1,3
24835,rolmos,,1,91,96,187
24836,mattiast,,1,4,5,9
24837,TwoBit,,1,1,1,2
24838,jperras,,1,24,23,47
24839,darthmiho,,1,29,85,114
24840,tomg555,,1,49,65,114
24841,tedtedted,,1,1,3,4
24842,tetrachromatic,,1,12,15,27
24843,Salsa_Carlion,,1,1,1,2
24844,lasenorita,,1,44,87,131
24845,bsingle,,1,1,1,2
24846,pumo,,1,74,50,124
24847,rytis,,1,80,16,96
24848,oopsla,,1,6,6,12
24849,piroplex,,1,48,70,118
24850,mustpax,,1,2,3,5
24851,spongebob,,1,5,7,12
24852,MrPig,,1,13,10,23
24853,jmuintx,,1,1,1,2
24854,magicmario,,1,1,2,3
24855,kounavi,,1,175,286,461
24856,ableman,,1,3,2,5
24857,dher405,,1,2,1,3
24858,frodo77,,1,13,11,24
24859,dakine100,,1,4,4,8
24860,LiveLucid,,1,27,29,56
24861,pirate_reddit_arrrr,,1,5,2,7
24862,webology,,1,3,2,5
24863,propel,,1,140,93,233
24864,chonger,,1,14,34,48
24865,46and2,,1,1,1,2
24866,norxh,,1,5,2,7
24867,fireberts,,1,3,5,8
24868,Carpfish,,1,7,13,20
24869,quickpost,,1,226,87,313
24870,CaptMandrake,,1,14,19,33
24871,lliw,,1,2,3,5
24872,grotbot,,1,1,5,6
24873,respite,,1,45,75,120
24874,teratomato,,1,51,45,96
24875,BrucePlayne,,1,23,13,36
24876,shellfish,,1,28,31,59
24877,anvilchor,,1,13,14,27
24878,mooksas,,1,5,3,8
24879,democritus2,,1,69,106,175
24880,aerextraho,,1,346,540,886
24881,powerpants,,1,487,565,1052
24882,mortiferous,,1,1,3,4
24883,DigitAl56K,,1,1,3,4
24884,fawkinay,,1,7,8,15
24885,bradentucky941,,1,3,13,16
24886,0xDEADBEEF,,1,1,1,2
24887,Aarmed,,1,11,4,15
24888,melby901,,1,28,1,29
24889,SuperFrankie,,1,58,42,100
24890,johnmudd,,1,400,381,781
24891,sanders5x,,1,5,9,14
24892,mgsloan,,1,37,52,89
24893,rtfm,,1,3,1,4
24894,leph,,1,6,2,8
24895,ninja-wage-slave,,1,28,36,64
24896,pop345,,1,5,5,10
24897,josher565,,1,2,5,7
24898,sea_wall,,1,1260,6,1266
24899,ScurvyDawg,,1,6,13,19
24900,Porpus,,1,5,1,6
24901,pstnotpd,,1,4,2,6
24902,JennyCide,,1,2,3,5
24903,thabman,,1,34,37,71
24904,janxspirit,,1,2,7,9
24905,_pixie,,1,1,2,3
24906,oppenheimerschmidt,,1,1,1,2
24907,ihasreddit,,1,22,11,33
24908,mobiuszero,,1,1,4,5
24909,pfo,,1,6,2,8
24910,thecreativeblog,,1,60,33,93
24911,grillcover,,1,6,13,19
24912,NightNightly,,1,5,1,6
24913,xlacdn,,1,3,6,9
24914,DaBritishRCuming,,1,3,1,4
24915,toooooooobs,,1,136,142,278
24916,violettestar,,1,2,4,6
24917,comiksguy,,1,1,2,3
24918,ibetom,,1,4,2,6
24919,ibbyD,,1,2,1,3
24920,nm1000,,1,1,4,5
24921,pTymN,,1,125,144,269
24922,agnoster,,1,73,82,155
24923,tingrin87,,1,1,5,6
24924,jennybant,,1,1,1,2
24925,kuranda,,1,2,2,4
24926,tubelight,,1,20,4,24
24927,paul_harrison,,1,25,39,64
24928,10poundBrizown,,1,1,1,2
24929,grecka,,1,9,17,26
24930,acwegner,,1,88,6,94
24931,qualiarunner,,1,2,3,5
24932,sammyQc,,1,3,8,11
24933,agent_uno,,1,4,4,8
24934,elsaturnino,,1,29,39,68
24935,d0kd0k,,1,10,13,23
24936,samerh,,1,1,4,5
24937,plexi,,1,227,250,477
24938,zwily,,1,1,3,4
24939,bobiam,,1,4,24,28
24940,SidRoberts,,1,3,1,4
24941,CartilageHead,,1,9,15,24
24942,chechex,,1,6,4,10
24943,ShezFrando,,1,1,2,3
24944,DLX,,1,35,29,64
24945,lukins,,1,1,3,4
24946,jhvoodooss,,1,2,1,3
24947,TheLastFreeMan,,1,96,142,238
24948,jbsibley,,1,4,3,7
24949,Socialism,,1,59,78,137
24950,kavalier,,1,67,8,75
24951,phoenixtx,,1,1,1,2
24952,AnneDorte,,1,1,7,8
24953,blangopolis,,1,2,2,4
24954,reachamanda,,1,7,7,14
24955,baryon,,1,6,5,11
24956,AngryPurpleMushroom,,1,5,7,12
24957,intrinsicchaos,,1,61,13,74
24958,Angry_Activist,,1,22,2,24
24959,Tankdoc,,1,8,6,14
24960,intersection,,1,2,7,9
24961,misternuge,,1,303,140,443
24962,Suppafly,,1,4,10,14
24963,jlakely,,1,67,2,69
24964,puckthecat,,1,68,82,150
24965,bongole,,1,12,3,15
24966,Yukos,,1,4,6,10
24967,RossMasters,,1,18,43,61
24968,grasspo,,1,2,1,3
24969,McCourt,,1,191,241,432
24970,hitmonval_is_a_dick,,1,1,1,2
24971,diroussel,,1,5,13,18
24972,ewdurbin,,1,31,21,52
24973,theglassishalf,,1,61,52,113
24974,Captain_Obvius,,1,2,1,3
24975,your_momma,,1,5,2,7
24976,arcele,,1,3,14,17
24977,pansypatrol,,1,29,3,32
24978,SaysWho,,1,1,2,3
24979,blatant_user,,1,11,25,36
24980,lepton,,1,16,7,23
24981,arunvr,,1,20,21,41
24982,m30000,,1,48,20,68
24983,tatofoo,,1,3,3,6
24984,i_did_it,,1,3,3,6
24985,futuresenator83,,1,1,1,2
24986,kiranhk,,1,2,3,5
24987,Bellhsst,,1,8,16,24
24988,The_Milkman,,1,6,2,8
24989,richie_ny,,1,6,2,8
24990,rightontime13,,1,4,2,6
24991,bakstuh,,1,23,25,48
24992,flaregun,,1,5,1,6
24993,Jabronious,,1,1,1,2
24994,amit78,,1,4,5,9
24995,sblue7,,1,10,2,12
24996,cmotdibbler,,1,53,103,156
24997,flatland,,1,2,2,4
24998,Eatingdogs,,1,19,18,37
24999,teamyamahablue,,1,2,1,3
25000,techiesouls,,1,1,1,2
25001,lvovsky,,1,85,9,94
25002,maximuszen,,1,7,13,20
25003,Combat_Deity,,1,10,1,11
25004,swaroopb,,1,15,21,36
25005,what3v3r,,1,141,33,174
25006,weixiyen,,1,25,64,89
25007,phedre,,1,258,284,542
25008,Impact0115,,1,2,1,3
25009,dillikibilli,,1,436,383,819
25010,James,,1,29,19,48
25011,kinbote,,1,2,5,7
25012,jyewnidt,,1,1,2,3
25013,uwiger,,1,1,3,4
25014,fenderjazz,,1,1,1,2
25015,trenobus,,1,3,6,9
25016,braindrane,,1,810,2352,3162
25017,jgotts,,1,2,8,10
25018,cmaxim,,1,3,3,6
25019,GibZilla,,1,6,8,14
25020,barbosa,,1,31,54,85
25021,mrjast,,1,21,14,35
25022,ddavis101,,1,12,1,13
25023,Antidote,,1,133,167,300
25024,see0red,,1,273,525,798
25025,karmadillo,,1,1236,558,1794
25026,agent_langley,,1,66,1,67
25027,grandczar,,1,22,33,55
25028,ozh,,1,101,46,147
25029,opi,,1,59,75,134
25030,d0wnward_spiral,,1,1,1,2
25031,Lerc,,1,152,156,308
25032,steveyu85,,1,6,2,8
25033,runeh,,1,4,8,12
25034,lasthemy,,1,1,1,2
25035,gsg_,,1,7,10,17
25036,FedUpWithYouIdiots,,1,2,1,3
25037,mx_reddit,,1,12,16,28
25038,MondoHawkins,,1,8,11,19
25039,gregrittchen,,1,3,2,5
25040,alyx,,1,15,10,25
25041,smarmygit,,1,2,5,7
25042,pound,,1,1,1,2
25043,maverick777,,1,1,1,2
25044,Deadend,,1,26,2,28
25045,Robertrc,,1,1,1,2
25046,Interzone_sheriff,,1,17,22,39
25047,masgrada,,1,2,1,3
25048,Comkeen,,1,8,9,17
25049,insyte,,1,1,3,4
25050,uoykcuf,,1,9,9,18
25051,dambo29,,1,2,3,5
25052,phillydawg68,,1,50,72,122
25053,bg_,,1,44,31,75
25054,Battlefieldjack,,1,3,5,8
25055,mmmpld,,1,1,4,5
25056,perciva,,1,58,18,76
25057,buckyrower,,1,7,12,19
25058,EveW,,1,179,25,204
25059,pheel_more,,1,2,4,6
25060,dman636,,1,4,7,11
25061,Ilyanep,,1,29,30,59
25062,jrich013,,1,2,6,8
25063,rizkyw,,1,1,1,2
25064,frontdesk,,1,8,5,13
25065,timmy334,,1,16,30,46
25066,Officer_Hard-On,,1,1,1,2
25067,NickGe,,1,7,11,18
25068,karmakat,,1,5,12,17
25069,niwde,,1,25,28,53
25070,typesblkura,,1,1,4,5
25071,changewecanbelievein,,1,30,62,92
25072,ramunasg,,1,21,20,41
25073,WhammyBar,,1,23,27,50
25074,stone2020,,1,4,6,10
25075,simscitizen,,1,18,27,45
25076,fancytalk,,1,8,18,26
25077,cthulahoops,,1,3,2,5
25078,sarngiber,,1,5,4,9
25079,Grimoire,,1,9,8,17
25080,eshap,,1,13,19,32
25081,jheylin,,1,1,3,4
25082,chimaera102,,1,6,13,19
25083,hauer,,1,2,1,3
25084,arhuaco,,1,11,24,35
25085,andrewrocks,,1,14,17,31
25086,jtp8736,,1,12,14,26
25087,HoodCrowd,,1,20,15,35
25088,sclv,,1,123,154,277
25089,newyawkah,,1,1,2,3
25090,fernandofmarte,,1,4,4,8
25091,dustyd63,,1,9,12,21
25092,Chronicss,,1,117,125,242
25093,bstudio,,1,1,1,2
25094,NastyConde,,1,327,233,560
25095,sourc3,,1,1,1,2
25096,195531,,1,2,1,3
25097,fabian17,,1,116,83,199
25098,anonlawstudent,,1,91,44,135
25099,jagbot,,1,5,4,9
25100,blefescu,,1,33,42,75
25101,mexicangoat,,1,3,2,5
25102,xerus,,1,86,62,148
25103,Galted,,1,7,13,20
25104,cathcacr,,1,57,105,162
25105,realdoozy,,1,2,2,4
25106,akh,,1,3,5,8
25107,jesuswilkinson,,1,4,1,5
25108,WhatDidntDiddyDo,,1,48,43,91
25109,kopophex,,1,15,9,24
25110,sfoulkes,,1,8,5,13
25111,adamdavid85,,1,47,63,110
25112,jch24,,1,27,20,47
25113,chakalakasp,,1,1264,210,1474
25114,otherwhitemeat,,1,1,1,2
25115,russbus,,1,7,2,9
25116,pseudoesque,,1,3,5,8
25117,qazcde,,1,17,2,19
25118,ndoz,,1,6,1,7
25119,JavaLavaJoe,,1,2,5,7
25120,Fecal_Vision,,1,2,2,4
25121,krsjuan,,1,7,2,9
25122,moted,,1,38,30,68
25123,3L1T3,,1,53,54,107
25124,gtalias,,1,8,3,11
25125,shovelingtom,,1,42,96,138
25126,claye,,1,4,4,8
25127,wyomandi,,1,4,22,26
25128,PostHumanBibliophile,,1,3,3,6
25129,sniloc,,1,8,9,17
25130,Giblaz,,1,33,23,56
25131,superrcat,,1,31,11,42
25132,sheafification,,1,15,28,43
25133,lbruno,,1,50,145,195
25134,5r4r3r2r1r,,1,3,4,7
25135,sensate,,1,13,2,15
25136,roxxe,,1,106,101,207
25137,BambooToo,,1,13,16,29
25138,zzleeper,,1,61,112,173
25139,glueandglitter,,1,1,1,2
25140,Jakkers,,1,114,71,185
25141,niels_olson,,1,114,66,180
25142,chaze007,,1,1,5,6
25143,relic91,,1,1,1,2
25144,vayk,,1,4,2,6
25145,TetraCW,,1,2,4,6
25146,thesmartlife,,1,2,5,7
25147,lajaw,,1,1,2,3
25148,danielrhodes,,1,14,13,27
25149,allocate,,1,17,35,52
25150,_bram_,,1,5,9,14
25151,smalldu,,1,33,22,55
25152,sickr,,1,4,4,8
25153,bhamfree,,1,3,5,8
25154,depthomesec,,1,3,5,8
25155,laughattheleader,,1,170,240,410
25156,krisssy,,1,1,2,3
25157,latortuga,,1,85,118,203
25158,idclev,,1,3,3,6
25159,turbov21,,1,19,32,51
25160,andme,,1,1,3,4
25161,hampus,,1,2,3,5
25162,rationalmind,,1,2,1,3
25163,substr,,1,2,9,11
25164,infectoid,,1,7,15,22
25165,stii,,1,8,1,9
25166,SgtSausage,,1,400,562,962
25167,BingoJ,,1,10,9,19
25168,nick_danger,,1,2,2,4
25169,drigz,,1,89,113,202
25170,jjduke,,1,23,20,43
25171,jiznakefoo,,1,5,1,6
25172,garywang,,1,13,21,34
25173,tempest135,,1,5,8,13
25174,LiamHP,,1,1,1,2
25175,r0bw,,1,39,68,107
25176,dafrimp,,1,48,61,109
25177,jongaynor,,1,2,4,6
25178,TheMulletBurden,,1,513,150,663
25179,hatecoach,,1,6,6,12
25180,Snorelock,,1,2,1,3
25181,TheEnigma1313,,1,8,7,15
25182,solquin,,1,1,2,3
25183,arsehelmet,,1,2,4,6
25184,unsurmountable,,1,2,4,6
25185,SwedginWuHangDai,,1,3,1,4
25186,isalpha,,1,281,274,555
25187,turiya,,1,6,2,8
25188,HunterBriley,,1,1,2,3
25189,pipedings,,1,6,14,20
25190,semperviren75,,1,1,3,4
25191,CowWithBeef,,1,53,58,111
25192,oakland94618,,1,1,1,2
25193,fernandomaximus,,1,1,1,2
25194,bplud,,1,1,1,2
25195,redfirewolf,,1,16,19,35
25196,markco,,1,2,1,3
25197,knullare,,1,151,208,359
25198,c4sh,,1,13,22,35
25199,baloghblog,,1,24,2,26
25200,tiklik,,1,2,2,4
25201,skripture,,1,12,5,17
25202,scorpan,,1,9,21,30
25203,tooldvn,,1,3,7,10
25204,leafjumper,,1,45,12,57
25205,sahilamin,,1,57,65,122
25206,charmhaste,,1,4,2,6
25207,gauharjk,,1,2,1,3
25208,fluxdrip,,1,3,1,4
25209,postmodern,,1,2,8,10
25210,soupnatzi,,1,157,225,382
25211,TheWama,,1,205,285,490
25212,Rollic,,1,23,25,48
25213,evilmatt535,,1,1,2,3
25214,scrove,,1,1,7,8
25215,rexxar,,1,35,31,66
25216,Kfresh34,,1,5,9,14
25217,mrmworth,,1,7,5,12
25218,_tweaks,,1,15,21,36
25219,manageMyRights,,1,2,4,6
25220,Head,,1,41,18,59
25221,jaafit,,1,88,72,160
25222,mrallen86,,1,191,226,417
25223,CanPuck,,1,5,8,13
25224,scooby111,,1,77,72,149
25225,rezo,,1,2,5,7
25226,colione,,1,14,4,18
25227,glengyron,,1,1588,2255,3843
25228,spacepope,,1,42,43,85
25229,MichaelJN2008,,1,19,20,39
25230,wrighter,,1,89,91,180
25231,toomuchbtchn,,1,2,2,4
25232,angryvigilante,,1,32,52,84
25233,unchow,,1,447,571,1018
25234,binek86,,1,2,1,3
25235,abbot,,1,17,17,34
25236,ilushkin,,1,19,2,21
25237,safaci2000,,1,2,1,3
25238,pottery59,,1,7,11,18
25239,Apie,,1,2,2,4
25240,Peter_j_r,,1,4,1,5
25241,taikotiger,,1,168,228,396
25242,chillbeast,,1,11,16,27
25243,raevnos,,1,1,1,2
25244,jackthecoiner,,1,30,27,57
25245,bbrueggemeyer,,1,13,2,15
25246,reiichiroh,,1,2,1,3
25247,randomtask,,1,24,38,62
25248,tinshed,,1,1,2,3
25249,a_mused,,1,1,2,3
25250,BlunderTwins,,1,1,1,2
25251,vermontbobcat,,1,44,24,68
25252,Adman65,,1,171,262,433
25253,BenedictKenny,,1,14,39,53
25254,tpk5010,,1,2,9,11
25255,aureliano_babilonia,,1,22,40,62
25256,crystalmethbreakfast,,1,9,12,21
25257,edknaves,,1,2,11,13
25258,stfu_ymf,,1,1,1,2
25259,daniga,,1,3,1,4
25260,Inquisitr,,1,2,1,3
25261,tomsdiggname,,1,1,3,4
25262,maryelen,,1,2,3,5
25263,w3weasel,,1,193,284,477
25264,whit98c,,1,8,18,26
25265,mbatterham,,1,1,1,2
25266,blaablaa,,1,8,3,11
25267,antihero,,1,5,11,16
25268,moongorf,,1,47,2,49
25269,INTPLibrarian,,1,259,207,466
25270,miikE,,1,14,60,74
25271,dnifdoog,,1,56,51,107
25272,arseiam,,1,11,20,31
25273,xaos11,,1,10,28,38
25274,ij00mini,,1,11,17,28
25275,HaMMeReD,,1,337,529,866
25276,brienf,,1,1,2,3
25277,mookeddit,,1,78,65,143
25278,lambofdog,,1,10,16,26
25279,Sanctimonious,,1,83,96,179
25280,C4RLO5,,1,2,1,3
25281,gaviaimmer,,1,2,4,6
25282,soundacious,,1,161,214,375
25283,lbft,,1,174,188,362
25284,mattiasl,,1,31,35,66
25285,tenfive,,1,5,2,7
25286,niksko,,1,5,9,14
25287,shmaelius,,1,1,1,2
25288,Yasas,,1,1,1,2
25289,travelingman74,,1,68,2,70
25290,lijamez,,1,3,8,11
25291,MrThunderRolls,,1,1,7,8
25292,lovestosploodge,,1,1,1,2
25293,johnskiddles,,1,9,2,11
25294,linchiwo,,1,2,3,5
25295,flwombat,,1,2,3,5
25296,manvsbear,,1,154,229,383
25297,photosahni,,1,77,1,78
25298,ignatious,,1,6,5,11
25299,wicked,,1,237,303,540
25300,mikey2600,,1,38,66,104
25301,QuestionBoy,,1,3,1,4
25302,JustDroppingBy,,1,102,129,231
25303,dabdiputs,,1,12,13,25
25304,EndTimer,,1,18,23,41
25305,peterwemm,,1,1,1,2
25306,isitmoi,,1,106,20,126
25307,CognitiveAssonance,,1,4,6,10
25308,Joe_Clark,,1,13,15,28
25309,zvikara,,1,224,138,362
25310,bluess,,1,14,16,30
25311,Nekrahm,,1,1,1,2
25312,jasonhaley,,1,13,11,24
25313,zith,,1,3,4,7
25314,ileftreddit,,1,16,32,48
25315,Hatred,,1,4,5,9
25316,derekaw,,1,30,64,94
25317,BaronBic,,1,69,121,190
25318,jblifestyles,,1,2,6,8
25319,adamhayek,,1,2,3,5
25320,dbhaley,,1,43,44,87
25321,ralphiebacch,,1,7,17,24
25322,iamonadiet,,1,2,1,3
25323,DeafScribe,,1,3,3,6
25324,happycustomer,,1,5,9,14
25325,Ekipstonmai,,1,12,8,20
25326,vadikunc,,1,2,1,3
25327,trumpcard,,1,1,3,4
25328,ElephantRider,,1,142,251,393
25329,czarj,,1,2,2,4
25330,worldestroyer,,1,3,3,6
25331,squiddyphotog,,1,1,1,2
25332,Facepuncher,,1,742,392,1134
25333,Oolong111,,1,1,2,3
25334,13billy,,1,9,8,17
25335,elwood731,,1,112,6,118
25336,cro_mag_non,,1,28,48,76
25337,perrygeo,,1,45,34,79
25338,d2kd3k,,1,393,69,462
25339,bearncze,,1,3,11,14
25340,RST100,,1,1,2,3
25341,ndmitchell,,1,9,19,28
25342,LeBrad,,1,23,19,42
25343,mlambir,,1,1,8,9
25344,gordito,,1,1,2,3
25345,morrisom,,1,5,6,11
25346,nellonoma,,1,5,4,9
25347,hsim3,,1,7,7,14
25348,fatcobra7,,1,9,12,21
25349,hifigi,,1,16,30,46
25350,randombit,,1,20,12,32
25351,wellington_grey,,1,15,4,19
25352,btnheazy03,,1,68,148,216
25353,qazqaz7k,,1,42,57,99
25354,floydianslip,,1,1,2,3
25355,kenij,,1,19,25,44
25356,vasyl83,,1,5,14,19
25357,mrkipling,,1,194,193,387
25358,infinityis,,1,13,15,28
25359,FotoMatt,,1,1,4,5
25360,didntyouhear,,1,2,1,3
25361,jmzook,,1,13,23,36
25362,HYPEractive,,1,58,95,153
25363,dfa,,1,32,48,80
25364,Marsharks,,1,3,8,11
25365,nooffense,,1,2,2,4
25366,mornel,,1,55,57,112
25367,Marlzzz,,1,96,45,141
25368,TimStewart,,1,2,4,6
25369,Jaland,,1,4,3,7
25370,linuxpunk81,,1,64,65,129
25371,jjme,,1,235,187,422
25372,PrincessCake,,1,339,363,702
25373,gibb,,1,1,2,3
25374,haak,,1,1,2,3
25375,pwkk,,1,7,17,24
25376,escher2008,,1,6,4,10
25377,kristakahashi,,1,23,44,67
25378,hash_oil,,1,57,73,130
25379,teff,,1,3,6,9
25380,shadyrudy,,1,12,18,30
25381,Astroboy14,,1,1,5,6
25382,irate314rate,,1,111,45,156
25383,NinetiesGuy,,1,9,5,14
25384,JUDGE_DREDD,,1,7,8,15
25385,pot_o_gold,,1,77,74,151
25386,commandos,,1,2,2,4
25387,otisnixon,,1,44,68,112
25388,neilc,,1,18,31,49
25389,kerosenehalo,,1,3,4,7
25390,fusama,,1,22,6,28
25391,Johny_Cash,,1,523,601,1124
25392,ellisr29,,1,26,18,44
25393,Wolfbagger,,1,5,13,18
25394,Antisthenes,,1,3,2,5
25395,jimmulligan,,1,1,1,2
25396,Tonb,,1,13,9,22
25397,captain_abstinence,,1,37,18,55
25398,keit_shifter,,1,4,1,5
25399,peepsalot,,1,219,297,516
25400,sammyf,,1,4,6,10
25401,tom101,,1,62,74,136
25402,truenorth,,1,3,15,18
25403,richjm,,1,63,2,65
25404,scribbles,,1,91,123,214
25405,merper,,1,469,596,1065
25406,lofi76,,1,289,366,655
25407,blacktarjeta,,1,1,2,3
25408,kingofarts,,1,10,13,23
25409,ActionAuto,,1,29,23,52
25410,lugfish,,1,188,82,270
25411,thomble,,1,20,22,42
25412,LostFloyd,,1,1,3,4
25413,pixelgrunt,,1,4,8,12
25414,ImAReasonableMan,,1,13,13,26
25415,milo3600,,1,73,66,139
25416,mattyrules,,1,590,48,638
25417,Hengist,,1,14,9,23
25418,AprilEthereal,,1,29,6,35
25419,Cajun,,1,62,82,144
25420,Baconfat,,1,3,9,12
25421,danbillings,,1,13,18,31
25422,thehypnotoad,,1,3,3,6
25423,saoretone,,1,6,2,8
25424,crimeariver,,1,52,95,147
25425,micahfk,,1,1,1,2
25426,loz618,,1,11,27,38
25427,SilverEagle,,1,4,9,13
25428,spartag00se,,1,26,30,56
25429,sparkytime,,1,175,10,185
25430,Dashd,,1,84,91,175
25431,DSchmitt,,1,10,13,23
25432,c-ray,,1,18,20,38
25433,chaosrabbit,,1,1,4,5
25434,ObamaamaMMuslim,,1,67,52,119
25435,djkaos,,1,1,1,2
25436,socket0,,1,57,9,66
25437,jordanonorth,,1,41,93,134
25438,port,,1,2,2,4
25439,pragmatist,,1,1,2,3
25440,jimmcjim,,1,2,1,3
25441,lindgree,,1,30,12,42
25442,vozzer,,1,17,4,21
25443,catlebrity,,1,776,1022,1798
25444,Aiwanei,,1,4,10,14
25445,q-_-b,,1,4,2,6
25446,creator100,,1,251,3,254
25447,endperform,,1,10,20,30
25448,subnubus,,1,7,4,11
25449,lyrae,,1,18,2,20
25450,stupidfpp,,1,7,5,12
25451,asciident,,1,2,4,6
25452,bogdon6,,1,17,14,31
25453,Vomit_Sandwich,,1,253,299,552
25454,whiteligthing,,1,3,3,6
25455,clicky,,1,9,16,25
25456,birkenfeld,,1,2,1,3
25457,kakboy,,1,2,2,4
25458,i_h8_r3dd1t_5,,1,2,1,3
25459,kbk,,1,3,10,13
25460,nomdeplume123,,1,13,33,46
25461,AmericaLover,,1,2,3,5
25462,Ardentfrost,,1,32,51,83
25463,uxjackson,,1,30,73,103
25464,chinachina,,1,3,1,4
25465,interbeing,,1,3,5,8
25466,cod68,,1,2,2,4
25467,omgpro,,1,13,14,27
25468,iwasdj,,1,2,2,4
25469,suomipoika,,1,2,2,4
25470,dokumentamarble,,1,99,101,200
25471,kahotep,,1,3,2,5
25472,toconnor,,1,5,4,9
25473,IndeXinn,,1,5,3,8
25474,xkillx,,1,111,78,189
25475,rpd9803,,1,7,12,19
25476,cassman,,1,4,4,8
25477,zvarnell,,1,2,2,4
25478,teessidedazza,,1,5,5,10
25479,ratbastid,,1,10,6,16
25480,impious,,1,2,1,3
25481,anomalous,,1,19,17,36
25482,trollingisfun,,1,4,8,12
25483,fuzzna,,1,1,9,10
25484,utore,,1,81,50,131
25485,jhl,,1,3,6,9
25486,saratogacv60,,1,1,1,2
25487,celastrus,,1,21,31,52
25488,frane,,1,1,1,2
25489,karmos,,1,1,3,4
25490,Chillee,,1,6,26,32
25491,ebzlo,,1,27,37,64
25492,v13,,1,1,12,13
25493,afscott,,1,44,7,51
25494,jonessodaholic,,1,4,1,5
25495,pete_m,,1,126,139,265
25496,chreekat,,1,9,8,17
25497,St_Anky,,1,82,177,259
25498,ergotine,,1,1,2,3
25499,corradoslc,,1,1,2,3
25500,LExaLu,,1,1,1,2
25501,vader101,,1,9,13,22
25502,miklernout,,1,7,1,8
25503,zippy,,1,1,2,3
25504,mcamaj,,1,11,12,23
25505,DustinR,,1,10,8,18
25506,matthew,,1,19,9,28
25507,monkeyman1140,,1,29,66,95
25508,dm3,,1,1,1,2
25509,temjrpgh,,1,151,275,426
25510,modderphucker,,1,5,7,12
25511,nuncanada,,1,12,11,23
25512,shaolinpunks,,1,3,8,11
25513,Randall_Flagg,,1,3,3,6
25514,initforthewaffles,,1,16,13,29
25515,bripod,,1,2,6,8
25516,Jay180,,1,4,4,8
25517,purplenat,,1,2,3,5
25518,shermange,,1,6,3,9
25519,sudentas,,1,2,1,3
25520,lordlawler,,1,2,7,9
25521,chiliu78,,1,1,2,3
25522,zuloon,,1,36,47,83
25523,DontRapeMeInTehButt,,1,3,4,7
25524,tendrils666,,1,3,4,7
25525,gwern,,1,364,630,994
25526,eduffy,,1,78,63,141
25527,Troopr420,,1,3,1,4
25528,jp2,,1,174,31,205
25529,wildleaf,,1,5,10,15
25530,chungmaster,,1,3,1,4
25531,busfahrer,,1,152,217,369
25532,superboyblue,,1,18,23,41
25533,bajsejohannes,,1,70,96,166
25534,Sadie,,1,293,8,301
25535,rj7jr37,,1,1,1,2
25536,pitchblende,,1,2,5,7
25537,badfish401,,1,23,12,35
25538,Owlie,,1,9,6,15
25539,thr3ddy,,1,2,1,3
25540,heybro,,1,15,17,32
25541,vice69,,1,1,2,3
25542,mdfcdr,,1,3,1,4
25543,svinoski,,1,1,2,3
25544,ctshaf02,,1,32,48,80
25545,DeathByDiagnosis,,1,21,33,54
25546,erfi,,1,70,68,138
25547,dinggus,,1,10,18,28
25548,thekenzidelx,,1,4,4,8
25549,aeon2012,,1,606,895,1501
25550,danbot,,1,11,17,28
25551,Captain_Irrelevant,,1,1,1,2
25552,scsibug,,1,2,3,5
25553,veskpk,,1,3,1,4
25554,fairtrialforw,,1,155,134,289
25555,wensing,,1,1,3,4
25556,pwiedel,,1,24,8,32
25557,ufris,,1,16,20,36
25558,138,,1,185,238,423
25559,gloom,,1,2,4,6
25560,kylejennings,,1,9,8,17
25561,amigo7,,1,8,6,14
25562,OniKudaki,,1,8,18,26
25563,jayhawk2008,,1,1,1,2
25564,Popper252,,1,31,30,61
25565,helly1223,,1,2,3,5
25566,k_vladimirov,,1,17,42,59
25567,microfish,,1,1,2,3
25568,YUL89YYZ,,1,2,2,4
25569,SnrBlkCorrespondent,,1,1,2,3
25570,outsider,,1,254,394,648
25571,editor3638,,1,1,1,2
25572,chestyle,,1,10,2,12
25573,defireman,,1,2,4,6
25574,EmpiresCrumble,,1,419,504,923
25575,jtsod73,,1,3,1,4
25576,yesimahuman,,1,91,109,200
25577,letsbelogical,,1,2,2,4
25578,realgenius,,1,34,18,52
25579,tds70,,1,26,22,48
25580,ilikesteak,,1,1,2,3
25581,wonglik,,1,134,79,213
25582,Earsucker,,1,5,1,6
25583,BobHHowell,,1,16,37,53
25584,cLFlaVA,,1,1054,507,1561
25585,moskie,,1,201,165,366
25586,wbdowns,,1,1,1,2
25587,jempina,,1,8,2,10
25588,SpikeSpiegal22,,1,3,4,7
25589,Dr_Mic,,1,7,13,20
25590,boryas,,1,20,25,45
25591,tamoneya,,1,60,14,74
25592,myrtlebeachbums,,1,2,2,4
25593,gjcarew,,1,2,1,3
25594,imagenda,,1,6,8,14
25595,FlyingAvatar,,1,17,21,38
25596,greendigit,,1,61,32,93
25597,MambooMama,,1,17,10,27
25598,mercurialohearn,,1,324,677,1001
25599,lance_,,1,29,24,53
25600,mightycontest,,1,84,25,109
25601,IMSargon,,1,1,1,2
25602,jscimeca715,,1,11,10,21
25603,go-ahead-downvote,,1,199,359,558
25604,sam19435,,1,6,2,8
25605,topherdavis,,1,220,27,247
25606,deller85,,1,21,7,28
25607,mitcharoni,,1,27,32,59
25608,yallizfunny,,1,1,1,2
25609,artvark,,1,8,28,36
25610,johnlunney,,1,1,1,2
25611,randomjackass,,1,13,30,43
25612,bill_tampa,,1,1,6,7
25613,whiteskwirl2,,1,158,196,354
25614,cludwin,,1,8,8,16
25615,Crockadile,,1,1,1,2
25616,tomatopaste,,1,142,224,366
25617,riorage,,1,1,4,5
25618,testudo2002,,1,4,8,12
25619,kremonte,,1,6,12,18
25620,benzu,,1,1,2,3
25621,ghazwozza,,1,5,16,21
25622,soomprimal,,1,8,20,28
25623,20081115,,1,24,3,27
25624,cc22022cc,,1,3,3,6
25625,Ado42,,1,1,1,2
25626,monkeygod,,1,1,2,3
25627,obchase,,1,13,17,30
25628,bottomquark,,1,6,4,10
25629,adm1,,1,6,2,8
25630,duffy100,,1,1,1,2
25631,kbennett73,,1,15,11,26
25632,TruthinessHurts,,1,300,363,663
25633,tinker123,,1,2,6,8
25634,-scout-,,1,15,7,22
25635,hollyblue,,1,3,9,12
25636,sysstemlord,,1,18,21,39
25637,NothingIsReal74,,1,80,241,321
25638,jhdwg,,1,7,3,10
25639,yogachef,,1,7,8,15
25640,coronai1,,3,1,1,2
25641,ahl0003,,1,4,2,6
25642,kalmar,,1,4,3,7
25643,vodkafuel,,1,11,16,27
25644,devisional,,1,75,90,165
25645,mandel_macaque,,1,6,13,19
25646,jppuerta,,1,1,6,7
25647,rexsilex,,1,1,1,2
25648,kenliu,,1,1,2,3
25649,Ognian,,1,14,32,46
25650,bennybuckethead,,1,4,5,9
25651,darknut,,1,7,2,9
25652,HillaryClintonFan,,1,81,28,109
25653,CaptainNSFW,,1,6,4,10
25654,benedict101,,1,2,1,3
25655,lizardqueen,,1,1,1,2
25656,AnotherCanadian,,1,4,7,11
25657,So1618e,,1,8,6,14
25658,khperkins,,1,48,22,70
25659,cryptonium,,1,130,18,148
25660,Buzzard,,1,10,18,28
25661,matlesiouxx,,1,2,2,4
25662,robertgentel,,1,9,5,14
25663,secretdark,,1,12,26,38
25664,FrancoisTremblay,,1,2,3,5
25665,rotatedline,,1,2,3,5
25666,downen,,1,10,6,16
25667,rredit,,1,1,2,3
25668,hawaii,,1,2,1,3
25669,imdwalrus,,1,5,4,9
25670,aheno,,1,12,7,19
25671,Cbeck527,,1,5,4,9
25672,teh_Rabbit,,1,33,69,102
25673,wonkifier,,1,465,744,1209
25674,FataL,,1,15,5,20
25675,sergiomenezes,,1,5,3,8
25676,pestario,,1,203,44,247
25677,tendimensions,,1,66,100,166
25678,zorak8me,,1,107,71,178
25679,thekrone,,1,760,1089,1849
25680,MissCarlaPauline,,1,33,73,106
25681,mumblemumble,,1,2,1,3
25682,tvu,,1,30,63,93
25683,superpowers,,1,2,2,4
25684,gregK,,1,514,670,1184
25685,Kthulu,,1,4,13,17
25686,dash101,,1,409,363,772
25687,carllerche,,1,13,1,14
25688,metapede,,1,1,5,6
25689,Antiuniverse,,1,176,106,282
25690,john_butts,,1,28,13,41
25691,ElanVital,,1,1,7,8
25692,afschmidt,,1,6,18,24
25693,kspec1212,,1,22,1,23
25694,t35t0r,,1,142,165,307
25695,crypticfortune,,1,96,113,209
25696,dotnet4ever,,1,1,6,7
25697,gronx,,1,1,3,4
25698,andrewcatton,,1,1,1,2
25699,goldcup,,1,1,2,3
25700,HolmesSPH,,1,20,16,36
25701,mak12,,1,106,79,185
25702,bwkeller,,1,1,1,2
25703,anonymvs,,1,2,3,5
25704,anthonyhong,,1,3,3,6
25705,countonlosing,,1,12,2,14
25706,llamakoolaid,,1,28,82,110
25707,erasedeny,,1,183,110,293
25708,jasdonle,,1,54,80,134
25709,datn,,1,4,6,10
25710,viscerathighs,,1,2,1,3
25711,gld13,,1,3,5,8
25712,jacada885,,1,2,2,4
25713,stevePallmer,,1,12,7,19
25714,mingdamirthless,,1,115,172,287
25715,mikevalstar,,1,4,9,13
25716,argongas2006,,1,99,73,172
25717,snoopfrog,,1,1,4,5
25718,greim,,1,126,111,237
25719,hazilla,,1,26,8,34
25720,mestguy182,,1,9,5,14
25721,jenred,,1,1,1,2
25722,pizzatime,,1,992,683,1675
25723,allak,,1,2,9,11
25724,dufff,,1,1,2,3
25725,redditers_untie,,1,10,28,38
25726,tristan211,,1,3,5,8
25727,prototype_,,1,2,1,3
25728,Russkie177,,1,12,27,39
25729,diclemad,,1,20,23,43
25730,fap3,,1,2,1,3
25731,kisscool321,,1,1,1,2
25732,cpthw,,1,1,1,2
25733,peterdangit,,1,3,1,4
25734,dean_shan,,1,2,2,4
25735,goober537,,1,2,1,3
25736,alkamist,,1,1,2,3
25737,aoeufx,,1,6,2,8
25738,safeness,,1,44,56,100
25739,mrigor,,1,90,12,102
25740,Raphae1,,1,9,7,16
25741,hopefulsane,,1,2,4,6
25742,orbat,,1,1,1,2
25743,tcervl,,1,1,1,2
25744,grrtt_green,,1,1,1,2
25745,Hippi3,,1,1,3,4
25746,cyberianpan,,1,6,2,8
25747,_______,,1,10,16,26
25748,jedi_aka,,1,123,69,192
25749,jonnyvice,,1,7,23,30
25750,coyasun,,1,19,6,25
25751,wowmir,,1,1,8,9
25752,datagrok,,1,5,8,13
25753,telemachuszero,,1,2,4,6
25754,Reverberant,,1,50,40,90
25755,ben51959,,1,1,2,3
25756,ilcylic,,1,4,2,6
25757,Mask_of_Destiny,,1,44,52,96
25758,mprovost,,1,17,6,23
25759,goerz,,1,15,10,25
25760,qopqo7,,1,1,2,3
25761,hashishi,,1,19,25,44
25762,Subacious,,1,258,252,510
25763,cohbra,,1,1,1,2
25764,BenjaminBunny,,1,39,69,108
25765,SlowOnTheUptake,,1,4,6,10
25766,annon2001,,1,27,2,29
25767,wowrob,,1,16,30,46
25768,peeryeri,,1,8,4,12
25769,modernhero,,1,8,9,17
25770,NJerseyGuy,,1,2,2,4
25771,Mantorok,,1,2,3,5
25772,Subway,,1,113,198,311
25773,jeremygin,,1,4,1,5
25774,Sysiphuslove,,1,85,118,203
25775,BeanTownKid,,1,82,89,171
25776,Jimmerz,,1,1,2,3
25777,freakon,,1,2,1,3
25778,bug_mama_G,,1,229,158,387
25779,SoHereIAm,,1,2,2,4
25780,tsuyoshi,,1,3,3,6
25781,TerrorByte,,1,1,1,2
25782,paddy_m,,1,4,8,12
25783,discuit,,1,2,1,3
25784,Sardonapalus,,1,51,36,87
25785,MobyDobie,,1,27,15,42
25786,grilled_ch33z,,1,264,292,556
25787,mascarenhas,,1,21,16,37
25788,koanman,,1,2,13,15
25789,eeePPP,,1,1,8,9
25790,rootbitch,,1,4,3,7
25791,Democrat08,,1,82,67,149
25792,ghettobob,,1,46,14,60
25793,MUSTBEBOBBY,,1,1,1,2
25794,kremfjes,,1,39,34,73
25795,abrahamsen,,1,401,532,933
25796,Doozer,,1,40,62,102
25797,Gorthal,,1,1,1,2
25798,lucasvb,,1,18,3,21
25799,jchrismac,,1,1,2,3
25800,Jade456,,1,1,1,2
25801,Phreno,,1,9,19,28
25802,ChingChangCharlie,,1,128,220,348
25803,borocks,,1,1,1,2
25804,bloops,,1,2,1,3
25805,Kisil,,1,26,35,61
25806,RussellSprout,,1,6,2,8
25807,gamezor,,1,38,15,53
25808,pressuretobear,,1,36,43,79
25809,Mop,,1,4,7,11
25810,Truthbot,,1,12,30,42
25811,Yohnstoppable,,1,196,292,488
25812,johnHF,,1,5,3,8
25813,poetspirit,,1,4,1,5
25814,tubbycow,,1,4,3,7
25815,TheRedditPolice,,1,1,1,2
25816,seaseme,,1,52,69,121
25817,musturbatingmonkey,,1,1,1,2
25818,vidude,,1,124,197,321
25819,daehrednud,,1,3,3,6
25820,jdeeth,,1,6,40,46
25821,zimzallabim,,1,1,2,3
25822,osirisx11,,1,225,276,501
25823,Happy_Man,,1,13,18,31
25824,Davezter,,1,2,3,5
25825,illu45,,1,32,65,97
25826,new_zealander,,1,1,1,2
25827,somekindofride,,1,33,60,93
25828,PoopDoctor,,1,1,1,2
25829,schm00,,1,31,12,43
25830,david_bv,,1,11,3,14
25831,wabut,,1,1,1,2
25832,dramamoose,,1,51,48,99
25833,ansible,,1,140,152,292
25834,tinkerbellcottontoes,,1,1,3,4
25835,artofstarving,,1,33,70,103
25836,zef,,1,2,3,5
25837,tranceboy81,,1,15,3,18
25838,nbblk33,,1,7,9,16
25839,mugshoot,,1,50,6,56
25840,non-sequitur,,1,1,4,5
25841,pjohns24,,1,70,61,131
25842,erikbryan,,1,1,4,5
25843,DamnLogins,,1,6,1,7
25844,stephy_buttons,,1,175,256,431
25845,rabidgnat,,1,58,52,110
25846,GhostCow,,1,1,1,2
25847,rickyisawesome,,1,1,1,2
25848,Temporary00111,,1,3,1,4
25849,rsynnott,,1,11,15,26
25850,muskymaxmax,,1,13,8,21
25851,Harrygldfarb,,1,41,48,89
25852,breeLimeGreen,,3,1,3,4
25853,savedetroit,,1,6,1,7
25854,wanted_nz,,1,7,9,16
25855,james428,,1,4,1,5
25856,lameth,,1,194,346,540
25857,Michelle-Hayes,,1,2,1,3
25858,saconnel,,1,174,20,194
25859,slumslum,,1,60,4,64
25860,nicoletta123,,1,5,2,7
25861,alinpopa,,1,1,1,2
25862,melanthius,,1,48,110,158
25863,iheartbeer,,1,131,157,288
25864,omik,,1,1,1,2
25865,soyjaguar,,1,4,7,11
25866,TruthOasis,,1,31,25,56
25867,Acrinimiril,,1,2,1,3
25868,Riovanes,,1,77,107,184
25869,Loverman,,1,1,1,2
25870,kr1sp,,1,11,6,17
25871,sheeves,,1,17,25,42
25872,ubuntuguy,,1,164,128,292
25873,woodieuk,,1,4,4,8
25874,cbower01,,1,2,1,3
25875,FURBjr,,1,1,1,2
25876,slydee,,1,170,188,358
25877,dmcorp,,1,1,1,2
25878,jeremysiron,,1,2,1,3
25879,akbars,,1,1,1,2
25880,intercityfirm,,1,1,1,2
25881,themagikarp,,1,5,2,7
25882,pws1970,,1,4,4,8
25883,backelie,,1,43,67,110
25884,flox232,,1,41,39,80
25885,thefngoon,,1,28,5,33
25886,blindeye0,,1,61,62,123
25887,ProspectorJoe,,1,3,3,6
25888,ryanmickle,,1,1,5,6
25889,passwordispassword3,,1,4,2,6
25890,mrzubi,,1,79,53,132
25891,monsterflake,,1,3,2,5
25892,pzang,,1,7,16,23
25893,drdewm,,1,156,282,438
25894,bairy,,1,19,17,36
25895,Tsalagi,,1,2,9,11
25896,hwestbrook,,1,2,2,4
25897,andyxyxy,,1,25,59,84
25898,carrotderek,,1,20,23,43
25899,schwickies,,1,3,7,10
25900,glockops,,1,10,5,15
25901,fcplm,,1,1,6,7
25902,frolib,,1,104,142,246
25903,riggsninja,,1,2,3,5
25904,funkpucker,,1,307,493,800
25905,Detry,,1,161,85,246
25906,RoryQ,,1,122,134,256
25907,xenya,,1,212,300,512
25908,blossom14,,1,5,5,10
25909,Basse82,,1,4,3,7
25910,dsokol,,1,26,49,75
25911,jamie939,,1,48,11,59
25912,AlterNate,,1,14,17,31
25913,the_deprecaterer,,1,3,5,8
25914,cheezebubba,,1,2,1,3
25915,chazburgr,,1,9,8,17
25916,mikepence,,1,10,6,16
25917,MichaelScott,,1,2,1,3
25918,2stupid,,1,23,62,85
25919,KaCzach,,1,7,2,9
25920,chungfuduck,,1,22,36,58
25921,likeahurricane,,1,34,34,68
25922,imediabox,,1,4,3,7
25923,threeseed,,1,9,6,15
25924,warmfuzzykitten,,1,163,362,525
25925,chrishuch,,1,11,5,16
25926,rainmannn,,1,1,1,2
25927,netgeek06,,1,162,15,177
25928,catcher6250,,1,7,17,24
25929,EarPlugs,,1,2,1,3
25930,risomt,,1,5,3,8
25931,madwormer2,,1,8,16,24
25932,lojomofo,,1,32,58,90
25933,lushootseed,,1,7,10,17
25934,dorait,,1,6,6,12
25935,wejash,,1,550,1506,2056
25936,clickcookplay,,1,94,167,261
25937,uddincomm,,1,19,9,28
25938,swtsuthrngurl,,1,2,4,6
25939,zphobic,,1,58,88,146
25940,whatsrequired,,1,27,17,44
25941,sheridbm,,1,18,28,46
25942,CannedResponse,,1,22,35,57
25943,Tynado,,1,9,26,35
25944,ubermonkey,,1,5,6,11
25945,mer-mer-mer-mer-mer,,1,36,50,86
25946,bryan_wheelock,,1,28,36,64
25947,seaniep,,1,1,1,2
25948,askthetrainer,,1,103,13,116
25949,eipipuz,,1,72,82,154
25950,mavrevMatt,,1,2,6,8
25951,anddisaid,,1,36,29,65
25952,demoss,,1,5,9,14
25953,ungage,,1,5,11,16
25954,ladon86,,1,18,31,49
25955,avantol,,1,1,3,4
25956,slayersa,,1,16,25,41
25957,trenchfever,,1,713,988,1701
25958,floatnsink,,1,83,146,229
25959,andrew311,,1,5,3,8
25960,joe90210,,1,281,292,573
25961,bernardi,,1,6,2,8
25962,kzeon,,1,17,10,27
25963,wileyc,,1,1,1,2
25964,circular230,,1,169,180,349
25965,mediapl0y,,1,69,127,196
25966,jansuza,,1,43,85,128
25967,mrcriminy,,1,1,1,2
25968,ccamp,,1,4,6,10
25969,Eratosthenes,,1,25,45,70
25970,testermctest,,1,2,1,3
25971,rob411,,1,3,1,4
25972,ShiftSurfer,,1,73,116,189
25973,obeseeurotrash,,1,13,14,27
25974,pjdoland,,1,14,15,29
25975,metaman,,1,5,8,13
25976,opus13i,,1,5,8,13
25977,gmcg,,1,275,368,643
25978,bloodqc,,1,30,43,73
25979,alexjc,,1,12,13,25
25980,johsgrd,,1,1,1,2
25981,knifebucket,,1,81,230,311
25982,theprince,,1,8,14,22
25983,dhertz666,,1,1,2,3
25984,kral2,,1,27,23,50
25985,pazz,,1,1,4,5
25986,JacobHey,,1,286,18,304
25987,paraedolia,,1,347,488,835
25988,karl_hungus,,1,7,9,16
25989,dontyoutellme,,1,1,1,2
25990,quetzalwing,,1,116,158,274
25991,gematt,,1,56,73,129
25992,modawg,,1,5,8,13
25993,monsieurk,,1,1,1,2
25994,iordi,,1,7,9,16
25995,jonp,,1,41,2,43
25996,blipblop123,,1,4,1,5
25997,individualathome,,1,69,22,91
25998,zzbigalzz,,1,4,18,22
25999,smhinsey,,1,61,101,162
26000,bennig,,1,428,505,933
26001,SquirrelOnFire,,1,308,166,474
26002,0wnagetime,,1,76,131,207
26003,davidevosti,,1,1,2,3
26004,stocksy,,1,130,167,297
26005,akshayr,,1,60,45,105
26006,mccain2016,,1,1,1,2
26007,Kavika,,1,36,75,111
26008,DevilPliers,,1,9,20,29
26009,dazzlindonna,,1,2,5,7
26010,sensi313,,1,1,1,2
26011,chicklets,,1,2,1,3
26012,adam-nude,,1,5,9,14
26013,TheChicEcologist,,1,3,3,6
26014,nrbartman,,1,923,872,1795
26015,God-the-Almighty,,1,3,4,7
26016,brojangles,,1,5,5,10
26017,samandiriel,,1,2,2,4
26018,trickmil,,1,1,2,3
26019,rlleung,,1,3,3,6
26020,pkuriakose,,1,6,7,13
26021,Zefend,,1,3,3,6
26022,puppyman10,,1,6,10,16
26023,NothingbutRage,,1,5,1,6
26024,meatbites,,1,3,6,9
26025,woodlandsfonz,,1,58,5,63
26026,zedlander,,1,11,10,21
26027,zephyrfalcon,,1,6,5,11
26028,kopkaas2000,,1,44,54,98
26029,Patriciefan,,1,62,25,87
26030,s0ckpuppet,,1,111,212,323
26031,chal88,,1,1,3,4
26032,cfis,,1,2,1,3
26033,mckatze,,1,27,22,49
26034,bluerat,,1,3,4,7
26035,rabidgoldfish,,1,221,419,640
26036,raycosm,,1,4,4,8
26037,zornfett,,1,1,1,2
26038,MachFour,,1,1,3,4
26039,GayMeansHappy,,1,1,2,3
26040,jmunsin,,1,2,1,3
26041,FirstDivision,,1,1,7,8
26042,uc0qremp,,1,43,84,127
26043,Prodon,,1,9,4,13
26044,NENEUNMSM,,1,1,2,3
26045,WigginLSU,,1,5,15,20
26046,luckyvanessa,,1,10,24,34
26047,olbeefy,,1,9,8,17
26048,Huuuuuuuge_Asshole,,1,58,84,142
26049,spiralbinder,,1,2,8,10
26050,yappery,,1,5,1,6
26051,bingaman,,1,43,60,103
26052,chris_71767,,1,1,1,2
26053,Gully_Foyle,,1,12,9,21
26054,Albatron,,1,18,24,42
26055,MrDobalina,,1,168,5,173
26056,bigt,,1,84,52,136
26057,greatblackowl,,1,4,7,11
26058,Hortong,,1,37,69,106
26059,awergfawe,,1,84,84,168
26060,Ma8e,,1,98,161,259
26061,broadbeacher,,1,7,3,10
26062,plasmaflux,,1,4,6,10
26063,me_spiek,,1,1,2,3
26064,jdlshore,,1,8,9,17
26065,grumpy3039,,1,41,3,44
26066,burtonboarder,,1,6,3,9
26067,toastednut,,1,1,1,2
26068,cuppajoe,,1,142,291,433
26069,mrabear,,1,1,1,2
26070,SLG52,,1,2,2,4
26071,gsadamb,,1,30,27,57
26072,sezzme,,1,6,1,7
26073,vafada,,1,66,61,127
26074,sadz79,,1,25,21,46
26075,heffa,,1,39,37,76
26076,Captain-Offtopic,,1,7,2,9
26077,Ls3,,1,1,1,2
26078,VulturE,,1,280,180,460
26079,FooBarWidget,,1,52,59,111
26080,tyler_durden,,1,230,187,417
26081,MightyCicero,,1,2,5,7
26082,thecentaur,,1,85,68,153
26083,Autoeroticrat,,1,7,17,24
26084,nocturbulous,,1,39,10,49
26085,mzzarh,,1,1,2,3
26086,zipperhead,,1,8,6,14
26087,freekill,,1,190,87,277
26088,rocketslot,,1,44,2,46
26089,ajg,,1,5,9,14
26090,herbcharles,,1,256,1,257
26091,torrent1337,,1,111,136,247
26092,mads91,,1,20,29,49
26093,JamesChase,,1,1,2,3
26094,justinreeck,,1,12,43,55
26095,tvmute,,1,58,116,174
26096,usamom,,1,1,4,5
26097,ComicSansMS,,1,3,2,5
26098,ddevil63,,1,203,347,550
26099,lhaas,,1,1,3,4
26100,genica,,1,2,1,3
26101,eluberoff,,1,2,1,3
26102,arrix,,1,1,1,2
26103,Demaroth,,1,7,16,23
26104,cualcrees,,1,280,89,369
26105,liber8US,,1,713,1441,2154
26106,djmeds,,1,3,4,7
26107,wolfbrand,,1,4,3,7
26108,eranshor,,1,1,1,2
26109,mmilenko,,1,5,8,13
26110,sifiblog,,1,8,2,10
26111,jimbecile,,1,785,201,986
26112,Timmih,,1,20,3,23
26113,sararose244,,1,2,1,3
26114,strktwo,,1,5,5,10
26115,didi5679,,1,5,10,15
26116,boola19,,1,83,95,178
26117,mizaya,,1,171,277,448
26118,Jesus0fNazareth,,1,1,1,2
26119,meowfaceman,,1,23,43,66
26120,lankakitten,,1,17,32,49
26121,Ironphp,,1,41,4,45
26122,hrumphgrumble,,1,117,170,287
26123,kiwijim,,1,39,13,52
26124,madelino,,1,7,3,10
26125,Misery90,,1,1,1,2
26126,caex,,1,3,13,16
26127,saddor,,1,1,1,2
26128,Talky,,1,3,5,8
26129,jenniemic,,1,8,19,27
26130,schwa23,,1,1,1,2
26131,Adieu1,,1,2,1,3
26132,alpine01,,1,7,5,12
26133,dmix,,1,25,33,58
26134,DogBotherer,,1,364,617,981
26135,notsoonenough,,1,1,3,4
26136,qazujm,,1,11,9,20
26137,oyok2112,,1,103,143,246
26138,carpespasm,,1,390,686,1076
26139,jtablerd,,1,124,51,175
26140,benjo8,,1,11,12,23
26141,verisimilitude,,1,21,38,59
26142,discord,,1,52,63,115
26143,loerneas,,1,9,13,22
26144,cyklopps,,1,21,14,35
26145,tekgnosis,,1,30,75,105
26146,isejfosffdsfs,,1,5,5,10
26147,BlahblahName,,1,37,42,79
26148,steveo23349,,1,55,55,110
26149,drewr,,1,43,11,54
26150,belovely,,1,13,52,65
26151,fab13n,,1,39,53,92
26152,polakmark,,1,3,5,8
26153,denzuko,,1,3,7,10
26154,CUBICcube,,1,6,1,7
26155,TNCLR,,1,7,19,26
26156,jbw31415,,1,44,4,48
26157,YellowTruck,,1,2,1,3
26158,thaahg,,1,1,2,3
26159,dextroz,,1,123,209,332
26160,patrix,,1,1,3,4
26161,mice_power,,1,7,4,11
26162,kobayashi,,1,24,40,64
26163,zeekiller,,1,30,3,33
26164,yaruki_zero,,1,64,93,157
26165,iamagainststupid,,1,1,5,6
26166,campaignmrozek,,1,6,1,7
26167,lemkenski,,1,6,6,12
26168,thisisnotmyname,,1,21,10,31
26169,WolfgangAmadeus,,1,1,1,2
26170,McHoff,,1,112,131,243
26171,minutemantm,,1,71,157,228
26172,baros,,1,4,5,9
26173,gemineyes,,1,1,2,3
26174,mkrfctr,,1,778,1171,1949
26175,peter411,,1,11,21,32
26176,canonymous,,1,31,56,87
26177,zvikico,,1,5,1,6
26178,scarletrouble,,1,2,1,3
26179,mdiokwe,,1,14,1,15
26180,koomapotilas,,1,4,4,8
26181,javes,,1,1,1,2
26182,factotvm,,1,3,2,5
26183,charlatan,,1,2963,662,3625
26184,afghanwhiggle,,1,5,2,7
26185,an0el,,1,8,6,14
26186,depa,,1,3,2,5
26187,zac79,,1,295,411,706
26188,shimitsm,,1,112,3,115
26189,ericksoa,,1,2,2,4
26190,timmothhead,,1,1,3,4
26191,familynight,,1,1,1,2
26192,speachless,,1,1,2,3
26193,ramijames,,1,363,319,682
26194,stoops,,1,2,3,5
26195,sveinhal,,1,42,39,81
26196,Kommy,,1,8,15,23
26197,zergatheart,,1,5,4,9
26198,debng,,1,69,4,73
26199,Sitamama,,1,17,59,76
26200,kylethegreat,,1,3,6,9
26201,nannerla,,1,5,6,11
26202,xMetalDetectorx,,1,2,14,16
26203,jamoes,,1,51,61,112
26204,chu,,1,208,244,452
26205,dirtyp,,1,739,12,751
26206,cudegra,,1,3,8,11
26207,Rlittle66,,1,5,34,39
26208,s7uckinreality,,1,42,41,83
26209,Foo7,,1,189,170,359
26210,Smeed,,1,2,8,10
26211,Strayphoenix6,,1,81,4,85
26212,paramage,,1,2,1,3
26213,dezmodium,,1,318,431,749
26214,toshok,,1,3,9,12
26215,smoots,,1,4,3,7
26216,Vulpyne,,1,4,9,13
26217,rotinski,,1,5,4,9
26218,nm00ph,,1,59,146,205
26219,5wen,,1,4,2,6
26220,brainflow,,1,61,29,90
26221,steveg,,1,23,27,50
26222,dstcruz,,1,4,5,9
26223,wyyyrm,,1,5,7,12
26224,churchdog,,1,169,54,223
26225,atduskgreg,,1,3,1,4
26226,eskimomatt,,1,2,7,9
26227,crystallyn,,1,1,1,2
26228,snwbrdr464,,1,1,1,2
26229,habitus,,1,7,11,18
26230,xoomani,,1,16,3,19
26231,ab9003,,1,2,2,4
26232,ghiuryy,,1,33,12,45
26233,nenoload,,1,4,4,8
26234,macroman,,1,2,1,3
26235,lmclapp68,,1,20,38,58
26236,otrov77,,1,393,22,415
26237,superjerk,,1,158,256,414
26238,rehevkor5,,1,4,3,7
26239,darlyn,,1,275,527,802
26240,jamieoli,,1,4,3,7
26241,racarr,,1,27,7,34
26242,WhyNotToday,,1,10,13,23
26243,striker69,,1,23,14,37
26244,Danthekilla,,1,6,4,10
26245,greenskin,,1,29,31,60
26246,bentronic,,1,11,29,40
26247,avalenci,,1,48,20,68
26248,bikko,,1,8,15,23
26249,nighttrain,,1,2,2,4
26250,earthman19,,1,88,102,190
26251,anemptygun,,1,4,17,21
26252,xGreatRomances0x,,1,12,1,13
26253,magiclava,,1,6,11,17
26254,anonnymouse,,1,6,5,11
26255,younggrammy,,1,1,2,3
26256,hoopmastaflex,,1,5,14,19
26257,ragehot,,1,11,2,13
26258,garyg1322424,,1,4,7,11
26259,symphony,,1,6,4,10
26260,Thelema,,1,1,2,3
26261,jessbo,,1,1,3,4
26262,ReneeAshley,,1,1,1,2
26263,RegMcF,,1,1,1,2
26264,Baphomet,,1,16,39,55
26265,KenC411,,1,15,12,27
26266,janeylicious,,1,16,33,49
26267,da4,,1,2,2,4
26268,porphyria,,1,1,4,5
26269,currentlocation,,1,2,5,7
26270,pchristensen,,1,20,13,33
26271,Prospagnosia,,1,3,3,6
26272,daveeff,,1,1,1,2
26273,jaldrich,,1,4,5,9
26274,cinemafest,,1,46,13,59
26275,noclips,,1,2,2,4
26276,bejitto101,,1,25,14,39
26277,bobcat_08,,1,1,3,4
26278,knylok,,1,1511,2486,3997
26279,gardnert2,,1,1,1,2
26280,jeffvangrumpy,,1,6,4,10
26281,anon_john,,1,2,1,3
26282,ffej,,1,30,44,74
26283,Fenrisulfr,,1,4,4,8
26284,mallusyr,,1,1,3,4
26285,loki969,,1,14,9,23
26286,No-Shit-Sherlock,,1,1,1,2
26287,esilverberg,,1,7,1,8
26288,CorvusPDX,,1,5,15,20
26289,Mr_Splashy_Pants,,1,23,31,54
26290,Nimbus2000,,1,57,102,159
26291,xor,,1,2,2,4
26292,powerjg,,1,6,6,12
26293,8string,,1,18,20,38
26294,petercasier,,1,149,2,151
26295,Caeremonia,,1,22,26,48
26296,UncleOxidant,,1,933,1103,2036
26297,letharus,,1,57,92,149
26298,chzplz,,1,70,81,151
26299,dreddor,,1,10,12,22
26300,vancouve,,1,33,14,47
26301,MTCicero,,1,42,15,57
26302,codyc,,1,83,45,128
26303,DRUGSISRUNBYTHEGOVT,,1,2,1,3
26304,livefood,,1,1,1,2
26305,gatsby137,,1,171,168,339
26306,jcmoscon,,1,1,1,2
26307,tuple,,1,89,84,173
26308,Jredrum,,1,962,124,1086
26309,jacekplacek,,1,214,416,630
26310,viborg,,1,5,6,11
26311,Elizabelle,,1,1,1,2
26312,ajd17case,,1,56,16,72
26313,paultantk,,1,4,1,5
26314,robotnick,,1,82,10,92
26315,planteo,,1,13,1,14
26316,imarobot,,1,17,32,49
26317,cerpntaxt,,1,40,15,55
26318,advancednano,,1,2,5,7
26319,pandaro,,1,5,21,26
26320,chrisarndt,,1,13,18,31
26321,demosthenes247,,1,2,2,4
26322,jo-cisco,,1,2,4,6
26323,diligentdogs,,1,192,64,256
26324,subtleanddangerous,,1,14,34,48
26325,jadedfox,,1,1,2,3
26326,attractivetb,,1,635,108,743
26327,dfsw,,1,2,10,12
26328,sixdoublefive321,,1,10,21,31
26329,angledluffa2,,1,9,5,14
26330,bozho,,1,3,1,4
26331,wheezl,,1,32,44,76
26332,uf9878,,1,2,1,3
26333,simonjp,,1,183,207,390
26334,madRomanian,,1,91,30,121
26335,wanax,,1,25,1,26
26336,randrews,,1,28,38,66
26337,cmdln_,,1,1,1,2
26338,dailite,,1,3,5,8
26339,2oonhed,,1,135,421,556
26340,indrax,,1,3,11,14
26341,bigfatphony,,1,23,18,41
26342,traffle,,1,7,10,17
26343,joeyjoejoe,,1,33,1,34
26344,i0n,,1,3,8,11
26345,Squidmore,,1,1,2,3
26346,ghztew,,1,2,1,3
26347,johnnyk,,1,34,54,88
26348,nicereddit,,1,20,1,21
26349,full_throttle,,1,1,1,2
26350,Erudecorp,,1,637,1387,2024
26351,Mollow,,1,1,2,3
26352,drusam,,1,12,17,29
26353,acrodizer,,1,1,2,3
26354,sil3nce,,1,1,1,2
26355,niwinski,,1,1,1,2
26356,dayvan,,1,155,59,214
26357,stereomind,,1,2,2,4
26358,Railboy,,1,4,4,8
26359,zabaduba,,1,23,21,44
26360,corbs,,1,9,13,22
26361,Omarosa,,1,5,3,8
26362,NotMarkus,,1,584,580,1164
26363,MrBobBarker,,1,2,4,6
26364,doneddat,,1,1,6,7
26365,crfergus,,1,1,3,4
26366,The1337,,1,83,2,85
26367,5rgb79,,1,17,40,57
26368,chriseidhof,,1,6,5,11
26369,thehumungus,,1,173,175,348
26370,Qingy,,1,35,41,76
26371,outsyder,,1,1,4,5
26372,RgbyTgr24,,1,71,60,131
26373,poliscimajor,,1,4,1,5
26374,xuoG_1988,,1,51,39,90
26375,fyl9000,,1,7,4,11
26376,Korian,,1,13,29,42
26377,9brandon,,1,137,2,139
26378,zirconium,,1,24,13,37
26379,Mathiasdm,,1,11,11,22
26380,terato,,1,174,167,341
26381,mutz,,1,1,5,6
26382,mythealias,,1,2,2,4
26383,tobeyswain,,1,2,1,3
26384,Zebby,,1,309,213,522
26385,tri_wine,,1,1,9,10
26386,bowermr,,1,244,9,253
26387,TITS-or-GTFO,,1,1,1,2
26388,Shantaram,,1,2,1,3
26389,JewishPropaganda,,1,651,456,1107
26390,albar129,,1,24,16,40
26391,moocat,,1,9,5,14
26392,yellowhelly,,1,2,2,4
26393,biotech9,,1,144,76,220
26394,NobleCommerce,,1,40,30,70
26395,beebers,,1,2,2,4
26396,shapechanger,,1,28,11,39
26397,farre,,1,3,1,4
26398,SleepingSheeple,,1,302,139,441
26399,patroclus,,1,2,1,3
26400,pb_zeppelin,,1,33,53,86
26401,ivorylineslead30,,1,3,9,12
26402,kank84,,1,70,83,153
26403,crei0,,1,1,2,3
26404,SourcesPlease,,1,10,4,14
26405,digitaldevil,,1,1,2,3
26406,Frazzydee,,1,88,97,185
26407,stmiller,,1,54,72,126
26408,alex_gregor,,1,1,1,2
26409,jaemccall,,1,18,20,38
26410,ba33eg,,1,14,2,16
26411,flukes2,,1,9,15,24
26412,hojomonkey,,1,14,16,30
26413,degustisnuffleupagus,,1,39,54,93
26414,charliedouglas,,1,4,5,9
26415,spacelincoln,,1,297,347,644
26416,Ttaxchristine,,1,4,4,8
26417,DiscordantJellyfish,,1,75,95,170
26418,lukaskaiser,,1,1,4,5
26419,soyabstemio,,1,307,623,930
26420,briandunning,,1,6,5,11
26421,JackAzzz,,1,38,113,151
26422,Mastrmind,,1,1321,449,1770
26423,brooks19,,1,1,1,2
26424,xamdam,,1,66,114,180
26425,calbear81,,1,84,70,154
26426,punkypine,,1,40,28,68
26427,HeirToPendragon,,1,864,1341,2205
26428,tabigail,,1,1,5,6
26429,Mitchacho,,1,74,87,161
26430,mo0nrider,,1,11,6,17
26431,klapaucius,,1,6,10,16
26432,freehat704,,1,35,2,37
26433,tclbuzz,,1,20,57,77
26434,mizuhana,,1,3,7,10
26435,SomewhatDisturbed,,1,76,147,223
26436,brewtalized,,1,1,1,2
26437,TooCloseToCall,,1,1,5,6
26438,mpstevens_uk,,1,2,5,7
26439,silence7,,1,400,297,697
26440,maggiesguy,,1,2,2,4
26441,jeffbarr,,1,1,1,2
26442,lyontamer,,1,72,163,235
26443,webomatica,,1,3,10,13
26444,tommia,,1,3,4,7
26445,e-socrates,,1,126,200,326
26446,ux-guy,,1,2,4,6
26447,newpatriots,,1,269,486,755
26448,whatthedeuce,,1,36,77,113
26449,geoCorpse,,1,17,14,31
26450,so_very_wrong,,1,1,1,2
26451,meox,,1,3,1,4
26452,SyphilisBoy,,1,17,43,60
26453,Halcyone1024,,1,1,2,3
26454,LibertyKnight,,1,2,4,6
26455,rock217,,1,56,74,130
26456,PossumTucker,,1,386,446,832
26457,hugsandnugs,,1,1,4,5
26458,fiam,,1,17,22,39
26459,theycallmemorty,,1,475,404,879
26460,cyah,,1,1,1,2
26461,Stripper,,1,1,3,4
26462,Die-Bold,,1,124,76,200
26463,bleachedanus,,1,279,100,379
26464,Vorgus,,1,4,1,5
26465,Canyon1951,,1,1,1,2
26466,macj321,,1,1,1,2
26467,sgarissta,,1,1,3,4
26468,CraigUma,,1,92,113,205
26469,peabody,,1,11,12,23
26470,execute85,,1,388,409,797
26471,jsb123,,1,5,6,11
26472,Luis_R,,1,1,6,7
26473,greeneggsnam,,1,53,59,112
26474,Dolphinwolf,,1,12,4,16
26475,ATLG,,1,2,3,5
26476,BobFromAccounting,,1,8,10,18
26477,qwerty42,,1,181,291,472
26478,oxigen,,1,1,2,3
26479,xsql,,1,7,3,10
26480,RFKresearcher,,1,1,3,4
26481,RantyDave,,1,60,94,154
26482,mohammy,,1,18,2,20
26483,onmach,,1,102,104,206
26484,Magjua,,1,2,6,8
26485,dejavont,,1,5,11,16
26486,ThesisAnti,,1,4,1,5
26487,FatAlbert,,1,68,111,179
26488,lordxenu74,,1,1,1,2
26489,PLanPLan,,1,33,56,89
26490,Scorpion1011,,1,51,77,128
26491,solinent,,1,51,106,157
26492,sigurmyrkur,,1,2,1,3
26493,hocktwoie,,1,8,3,11
26494,zraelian,,1,63,125,188
26495,IhateEverything,,1,26,33,59
26496,durzagott,,1,21,17,38
26497,Bukz68,,1,205,230,435
26498,duncan80,,1,42,57,99
26499,scatgreen2,,1,844,180,1024
26500,MissingNo,,1,1,1,2
26501,tbak,,1,1,2,3
26502,bumped,,1,405,723,1128
26503,Scrutable,,1,6,2,8
26504,ApontePR,,1,6,1,7
26505,vovcheg,,1,2,1,3
26506,xDeToXx,,1,1,1,2
26507,yhodda,,1,4,4,8
26508,skooty,,1,12,14,26
26509,Spaceomega,,1,21,6,27
26510,rb545331,,1,2,2,4
26511,avengingturnip,,1,2,2,4
26512,Jonex,,1,2,2,4
26513,teuobk,,1,49,43,92
26514,tlankow,,1,5,3,8
26515,1point21Gigawatts,,1,5,11,16
26516,toadst00l,,1,7,8,15
26517,abhinay99,,1,3,5,8
26518,vikadin,,1,15,10,25
26519,KarateRobot,,1,24,31,55
26520,timbrell,,1,1,2,3
26521,highspeedbee,,1,64,7,71
26522,fr00ty,,1,1,1,2
26523,ltorvalds,,1,4,1,5
26524,AJLobo,,1,5,16,21
26525,kuda,,1,2,3,5
26526,vindos,,1,11,1,12
26527,euroamerican,,1,110,11,121
26528,driftersgold,,1,3,5,8
26529,DrEvil,,1,19,36,55
26530,Johnny_5_alive,,1,48,22,70
26531,psrobert,,1,4,1,5
26532,scoobiashi,,1,4,2,6
26533,yellowcakewalk,,1,1,2,3
26534,ko773,,1,2,7,9
26535,nyclass,,1,4,6,10
26536,343409890,,1,1,1,2
26537,BXRWXR,,1,1,4,5
26538,themanchild,,1,32,50,82
26539,aarontaylor5000,,1,173,86,259
26540,joethebob,,1,49,70,119
26541,ReadilyApparentBoy,,1,5,14,19
26542,don221955,,1,1,1,2
26543,lookagain,,1,41,55,96
26544,jcurtis65,,1,6,18,24
26545,jaymunger,,1,1,3,4
26546,longbow7,,1,89,156,245
26547,shoutwire2007,,1,63,68,131
26548,Coalesce,,1,50,82,132
26549,Kaashar,,1,20,7,27
26550,schudder,,1,102,75,177
26551,mudslag,,1,265,161,426
26552,grammarian,,1,9,7,16
26553,matthasaproblem,,1,17,14,31
26554,monicel,,1,2,1,3
26555,rhmcisafaggot,,1,5,4,9
26556,krizo,,1,509,621,1130
26557,jacksonhewitt,,1,2,2,4
26558,dudley14144,,1,2,14,16
26559,sleazyb,,1,138,2,140
26560,efxeditor,,1,1,2,3
26561,poub,,1,1,1,2
26562,task,,1,2,3,5
26563,vodkat,,1,28,45,73
26564,misphit,,1,2,2,4
26565,TheRonMan,,1,20,22,42
26566,coodie,,1,1,2,3
26567,chip33550336,,1,270,560,830
26568,Stormwatch36,,1,12,39,51
26569,gernwood,,1,3,3,6
26570,embee,,1,8,3,11
26571,winstonsmith,,1,85,15,100
26572,silverman66,,1,1,1,2
26573,otto_s,,1,12,25,37
26574,lkozma,,1,57,9,66
26575,justinlillich,,1,3,19,22
26576,hiegel,,1,20,2,22
26577,nitran,,1,29,40,69
26578,gnufrra,,1,7,12,19
26579,prider,,1,439,403,842
26580,ben321,,1,6,4,10
26581,clytle374,,1,408,671,1079
26582,doubleginntonic,,1,486,487,973
26583,jungans,,1,2,3,5
26584,zombiefresh,,1,7,14,21
26585,rosshettel,,1,61,80,141
26586,ltriant,,1,81,34,115
26587,DanielLee50,,1,16,41,57
26588,steveissuperman,,1,40,32,72
26589,refugeewc,,1,4,4,8
26590,awetawef,,1,36,10,46
26591,mivsek,,1,93,4,97
26592,rlmowry,,1,31,1,32
26593,syristi,,1,2,3,5
26594,BAKEDpotatoe,,1,3,6,9
26595,jeanlucpikachu,,1,510,370,880
26596,paganmonkeyboy,,1,152,184,336
26597,patio11,,1,16,11,27
26598,mevodig,,1,1,2,3
26599,TheAnomaly,,1,2,5,7
26600,jdale27,,1,11,7,18
26601,zerokey,,1,111,173,284
26602,mikemorley,,1,7,13,20
26603,alandunne,,1,9,8,17
26604,mastema_ro,,1,25,49,74
26605,I_own_what_you_think,,1,12,8,20
26606,monjorob,,1,12,13,25
26607,thatsapaddlin,,1,4,5,9
26608,pastrytroll,,1,1,1,2
26609,doublejay1999,,1,159,266,425
26610,314159265358979,,1,3,4,7
26611,cryptic,,1,71,74,145
26612,missye,,1,92,3,95
26613,abstractnonsense,,1,1,2,3
26614,billjohns2,,1,105,5,110
26615,Kphaup,,1,18,11,29
26616,nimita,,1,1,2,3
26617,organic,,1,274,395,669
26618,bbcoburn,,1,10,8,18
26619,r0b0_m4tt,,1,4,2,6
26620,liamQ,,1,32,23,55
26621,Tw0Bit,,1,1,3,4
26622,Skorrogan,,1,3,1,4
26623,fingers,,1,1676,3118,4794
26624,Solomatrix,,1,2,2,4
26625,sigil,,1,1,2,3
26626,MamGu,,1,4,1,5
26627,Kitsunemisao,,1,1,8,9
26628,waynemr,,1,45,13,58
26629,stressinsh,,1,2,4,6
26630,Moseste,,1,2,2,4
26631,Cubedesigner2,,1,5,4,9
26632,solidworksalkan,,1,194,2,196
26633,chemrat,,1,1,7,8
26634,ringkichard,,1,5,2,7
26635,mcescherwhat,,1,3,8,11
26636,nonguy,,1,1,1,2
26637,eighteyes,,1,10,6,16
26638,hermes369,,1,21,41,62
26639,hamhed,,1,4,9,13
26640,ftzine,,1,8,11,19
26641,poopshootjohnson,,1,1,1,2
26642,michaeljsouth,,1,13,7,20
26643,mikeplugh,,1,3,3,6
26644,Ritchie_13,,1,1,2,3
26645,lefty33,,1,2,4,6
26646,unitas,,1,72,77,149
26647,vemrion,,1,606,395,1001
26648,Dr_Egon_Spengler,,1,2,5,7
26649,jellofiend84,,1,31,19,50
26650,23450982304958,,1,1,2,3
26651,peterpincus,,1,247,63,310
26652,edwardnh,,1,8,3,11
26653,manBEARpigBEARman,,1,19,16,35
26654,awaazbandh,,1,94,89,183
26655,Greta_B,,1,1,1,2
26656,thundersnow,,1,4,6,10
26657,abfa00,,1,1,6,7
26658,AchtungAchtung,,1,1,2,3
26659,onions,,1,3,4,7
26660,Paulaner,,1,126,296,422
26661,johndavis730,,1,25,12,37
26662,ssunder,,1,2,5,7
26663,mcarlint,,1,23,48,71
26664,stumps,,1,1,3,4
26665,theozoph,,1,48,92,140
26666,dieselmachine,,1,109,172,281
26667,voip,,1,125,125,250
26668,freakonthefiddle,,1,14,26,40
26669,vdoma,,1,21,5,26
26670,almost,,1,11,20,31
26671,rwallen,,1,8,4,12
26672,polyrhythmic,,1,144,264,408
26673,timbofield,,1,17,15,32
26674,touchthesky,,1,26,85,111
26675,darrint,,1,21,9,30
26676,hohs20,,1,11,1,12
26677,shadow_cloak,,1,2,1,3
26678,JenniferMX,,1,22,31,53
26679,Tekkoist,,1,4,1,5
26680,uniplexer,,1,31,24,55
26681,skillzphd,,1,16,11,27
26682,kekko,,1,287,142,429
26683,batsheba,,1,1,7,8
26684,thetheroo,,1,10,11,21
26685,mat05e,,1,12,14,26
26686,windsmith,,1,4,1,5
26687,proee,,1,19,20,39
26688,nailz1000,,1,263,392,655
26689,jennywine,,1,1,1,2
26690,alextryie,,1,36,6,42
26691,b00ks,,1,234,334,568
26692,dodga,,1,2,1,3
26693,fakeaccount12345,,1,24,6,30
26694,Apotheosis,,1,14,17,31
26695,w1r3r4t,,1,15,14,29
26696,mangalamraj,,1,3,1,4
26697,caolo,,1,5,8,13
26698,ddeano,,1,2,1,3
26699,touchpadonbackon,,1,15,15,30
26700,retard_applejuice,,1,5,4,9
26701,timperry42,,1,5,5,10
26702,manbitesdog,,1,4,18,22
26703,conradparker,,1,20,1,21
26704,thephilwhite,,1,51,32,83
26705,arsenix,,1,1,1,2
26706,blerg,,1,5,4,9
26707,beatnixxx,,1,3,1,4
26708,beer_stein,,1,20,10,30
26709,edman007,,1,4,5,9
26710,theclaw,,1,81,106,187
26711,yafsho,,1,8,14,22
26712,BurritoFrenzy,,1,13,26,39
26713,bonerobo,,1,37,66,103
26714,salzstangen,,1,2,3,5
26715,deadbob,,1,2,4,6
26716,frankparker,,1,6,9,15
26717,vep,,1,13,28,41
26718,JokeRuiner,,1,1,2,3
26719,JordanZakarin,,1,1,1,2
26720,tacitblue,,1,8,4,12
26721,littlerobothead,,1,2,5,7
26722,asenz,,1,26,75,101
26723,MrCrud,,1,7,4,11
26724,Mathematics411,,1,1,3,4
26725,masticate,,1,6,1,7
26726,bigcynic,,1,1036,841,1877
26727,insect_song,,1,110,128,238
26728,anndrewd,,1,1,1,2
26729,Xptql,,1,13,9,22
26730,donkeymon,,1,3,8,11
26731,lbt,,1,1,3,4
26732,asciilifeform,,1,842,238,1080
26733,odddrums,,1,28,8,36
26734,Steveb08,,1,6,11,17
26735,socialbanner,,1,92,5,97
26736,mavelikara,,1,20,21,41
26737,andy4443,,1,78,85,163
26738,sommer,,1,1,5,6
26739,onlinehero,,1,45,9,54
26740,f-_-_-_-_r,,1,2,6,8
26741,Originate,,1,1092,780,1872
26742,issem,,1,8,10,18
26743,Nois3,,1,19,21,40
26744,GkDragon,,1,2,14,16
26745,timmaxw,,1,144,189,333
26746,buccia,,1,135,33,168
26747,bogg,,1,1,3,4
26748,tomrees,,1,10,1,11
26749,madratz,,1,31,103,134
26750,nolander,,1,7,20,27
26751,faloose,,1,3,3,6
26752,buzzer,,1,12,5,17
26753,Rhysaff,,1,25,33,58
26754,LeCollectif,,1,60,95,155
26755,drewbic,,1,340,155,495
26756,jackruby43,,1,1,1,2
26757,_red,,1,297,344,641
26758,jaymunee80,,1,2,1,3
26759,kRabbit,,1,26,6,32
26760,krod4,,1,83,147,230
26761,slickrick327,,1,8,6,14
26762,lowspeed,,1,72,117,189
26763,Ronik,,1,2,2,4
26764,frorocker,,1,1,1,2
26765,uint32,,1,20,45,65
26766,stonecold,,1,76,23,99
26767,fijidaddy,,1,1,5,6
26768,VonTurbo,,1,2,1,3
26769,jasonlushable,,1,2,1,3
26770,dirtychic,,1,5,3,8
26771,wasthedavecollins,,1,13,4,17
26772,jamessun,,1,5,2,7
26773,jmusselwhite,,1,3,1,4
26774,lovelythr,,1,10,2,12
26775,mr_luc,,1,86,122,208
26776,HarDeFuckingHar,,1,2,2,4
26777,kumpera,,1,2,2,4
26778,indigotree,,1,9,24,33
26779,yoojin,,1,1,4,5
26780,hottoddy,,1,1,5,6
26781,alpha486,,1,5,3,8
26782,sumdeus,,1,26,22,48
26783,davidryal,,1,1,8,9
26784,random12345,,1,19,23,42
26785,Anthaneezy,,1,5,7,12
26786,Brndn,,1,32,47,79
26787,jjacobs2,,1,1,1,2
26788,traemccombs,,1,2,5,7
26789,tehgeekmeister,,1,33,5,38
26790,priapusmaximus,,1,7,8,15
26791,smadley,,1,3,13,16
26792,Lambboy,,1,88,74,162
26793,monogoose,,1,1,1,2
26794,motherrussia,,1,2,2,4
26795,peteybear,,1,1,1,2
26796,inoshiro,,1,3,3,6
26797,kzhi,,1,1,4,5
26798,sunbright2,,1,4,4,8
26799,jimithng33,,1,2,3,5
26800,thewileyone,,1,48,113,161
26801,mycivicsi2006,,1,139,191,330
26802,mdaniel,,1,5,13,18
26803,piranha,,1,123,197,320
26804,myaltalt,,1,4,3,7
26805,timmertc,,1,4,4,8
26806,lordofthejungle,,1,4,2,6
26807,brad08,,1,5,23,28
26808,Estha,,1,12,3,15
26809,Jesus_Faction,,1,8,9,17
26810,cbraga,,1,33,39,72
26811,azngunsmoke,,1,7,8,15
26812,samurai123,,1,1,1,2
26813,kernelhappy,,1,286,448,734
26814,jsjkim,,1,47,3,50
26815,sci901,,1,12,20,32
26816,Sodaware,,1,4,1,5
26817,kirby12,,1,3,5,8
26818,rgaginol,,1,94,128,222
26819,bchociej,,1,1,5,6
26820,wenzelr2,,1,1,1,2
26821,dcr42,,1,4,6,10
26822,dcooper8,,1,2,1,3
26823,rzn1987,,1,38,3,41
26824,laughtears,,1,2,7,9
26825,mikebrowne,,1,4,5,9
26826,nickeldimedime,,1,1,1,2
26827,IAmUrMum,,1,1,2,3
26828,bellamix,,1,6,2,8
26829,eigenvector,,1,4,7,11
26830,koosisking,,1,1,4,5
26831,Agrippa,,1,8,4,12
26832,Seeders,,1,77,155,232
26833,itan,,1,5,1,6
26834,SharewareFun,,1,2,1,3
26835,Zyrkon,,1,1,1,2
26836,shrednivashtar,,1,46,38,84
26837,buffinator,,1,25,16,41
26838,mascot,,1,1,1,2
26839,repercussion,,1,57,19,76
26840,rongenre,,1,24,24,48
26841,dubalom,,1,4,5,9
26842,tmp1,,1,2,2,4
26843,anaxerzia,,1,88,93,181
26844,keeish,,1,1,1,2
26845,Sollus2,,1,2,2,4
26846,Severious,,1,4,1,5
26847,kenmo,,1,7,8,15
26848,bakosdelowang,,1,53,96,149
26849,SpinDoctor,,1,1,1,2
26850,tinghao76,,1,1,1,2
26851,angularvision,,1,1,2,3
26852,serenadingfool,,1,1,4,5
26853,kopikat,,1,2,2,4
26854,dewey2100,,1,2,1,3
26855,Fauxbama,,1,1,1,2
26856,gimmickaccountrating,,1,1,4,5
26857,quakank,,1,238,268,506
26858,askjigga,,1,23,23,46
26859,s7r1k3r,,1,4,6,10
26860,Erobern,,1,36,49,85
26861,cptmarginal,,1,2,4,6
26862,felixgolden,,1,1,3,4
26863,chadmyers,,1,3,2,5
26864,PartySlug,,1,32,15,47
26865,Stagnantdwarves,,1,8,28,36
26866,foca,,1,14,22,36
26867,boredidiot,,1,76,86,162
26868,esteroth12,,1,1,1,2
26869,thephotoman,,1,282,474,756
26870,soco,,1,2,1,3
26871,determined1,,1,2,5,7
26872,could_be_paranoia,,1,3,2,5
26873,digitalmemory,,1,1,9,10
26874,Kevin-Roses-Left-Nut,,1,422,402,824
26875,Skitzie,,1,37,53,90
26876,toastedzergling,,1,50,72,122
26877,goanalog,,1,40,2,42
26878,tricksterspirit,,1,1,5,6
26879,rubyaeyes,,1,16,45,61
26880,elf631,,1,2,4,6
26881,Emelius,,1,1,1,2
26882,HeywoodJablowme,,1,28,50,78
26883,joinordie,,1,2,4,6
26884,GregHouse,,1,2,1,3
26885,bbbrain,,1,1,4,5
26886,jamminpotato,,1,1,1,2
26887,ninjamurf,,1,5,6,11
26888,daeron,,1,2,2,4
26889,Jalford,,1,43,7,50
26890,angeltari,,1,5,22,27
26891,extinct,,1,1,1,2
26892,thisismyanonymousnic,,1,2,3,5
26893,chuckwho,,2,1,1,2
26894,mosesconspiracy,,1,174,322,496
26895,ajay,,1,1,2,3
26896,tgdvw,,1,1,2,3
26897,acmercer,,1,3,3,6
26898,235rtgsgdsfg,,1,2,1,3
26899,mistermick,,1,147,203,350
26900,PENIX,,1,61,85,146
26901,Uresu,,1,5,4,9
26902,unwittingaccomplice,,1,4,4,8
26903,epicrule34,,1,64,124,188
26904,keeperofkeys,,1,21,43,64
26905,dpa62,,1,5,5,10
26906,superpredditor,,1,3,4,7
26907,hiq_boy,,1,2,1,3
26908,jessegberg,,1,21,23,44
26909,Ancho,,1,3,2,5
26910,hex4def6,,1,2,2,4
26911,flashpimp,,1,10,3,13
26912,dairem,,1,40,13,53
26913,wwosik,,1,1,2,3
26914,joeskunk,,1,9,22,31
26915,abas,,1,5,8,13
26916,Lukassus,,1,1,3,4
26917,Icanhazreddit,,1,411,541,952
26918,ErikMuskrat,,1,1,4,5
26919,jacktheripper,,1,56,45,101
26920,koksiboks,,1,2,2,4
26921,elmuchoprez,,1,180,90,270
26922,Tryke,,1,56,59,115
26923,Greenpointer,,1,13,3,16
26924,Itkovan,,1,41,84,125
26925,viagrakamagra,,1,2,8,10
26926,dg10050,,1,73,132,205
26927,nobody1234,,1,36,53,89
26928,zaggynl,,1,12,17,29
26929,d_b,,1,6,12,18
26930,jqueryit,,1,1,1,2
26931,bushel,,1,75,96,171
26932,bgcialis,,1,3,2,5
26933,Slick424,,1,46,71,117
26934,mcornett94,,1,3,6,9
26935,ErinER,,1,1,1,2
26936,Mashulace,,1,89,143,232
26937,pandering,,1,10,1,11
26938,luvthenet,,1,26,2,28
26939,bostonsoxfan,,1,3,7,10
26940,balkotn,,1,14,8,22
26941,Rusty99Arabian,,1,7,7,14
26942,mbruns,,1,2,1,3
26943,ehabkost,,1,4,7,11
26944,BigMikeYork,,1,61,52,113
26945,sotonohito,,1,301,286,587
26946,draustus,,1,4,4,8
26947,mercid,,1,16,10,26
26948,muffdyvr,,1,7,20,27
26949,exactamentos,,1,2,10,12
26950,InsincereDave,,1,104,10,114
26951,usdysk,,1,2,3,5
26952,Snazzy42,,1,21,15,36
26953,namlas,,1,65,33,98
26954,diamondjim,,1,47,100,147
26955,jdeneut,,1,1,1,2
26956,GeneralTsosChicken,,1,23,44,67
26957,doidydoidy,,1,85,198,283
26958,jcopling,,1,1,2,3
26959,onlineinspirations,,1,1,1,2
26960,CavMan,,1,32,36,68
26961,vreyes84,,1,18,9,27
26962,mdorn,,1,2,1,3
26963,grandpa,,1,51,38,89
26964,Bep,,1,5,5,10
26965,LxRogue,,1,45,51,96
26966,zhiliang,,1,3,11,14
26967,gabeiscoding,,1,16,16,32
26968,RickAHyatt,,1,2,3,5
26969,New_Hampshire,,1,14,16,30
26970,arthurni65,,1,1,4,5
26971,callingallcops,,1,6,1,7
26972,cezary,,1,2,1,3
26973,cojoco,,1,371,378,749
26974,JuiceBox,,1,1,5,6
26975,je255j,,1,954,1158,2112
26976,musicscoutjustin,,1,3,2,5
26977,WarPigs,,1,6,12,18
26978,lvtrance,,1,1,2,3
26979,codazzo,,1,16,12,28
26980,jcdreads,,1,1,1,2
26981,atnnn,,1,9,2,11
26982,ribald_jester,,1,69,112,181
26983,thereddust,,1,19,22,41
26984,blamecheney,,1,44,42,86
26985,jimgordon,,1,1,1,2
26986,bhrgunatha,,1,94,159,253
26987,sychadelicamania,,1,7,5,12
26988,smoofra,,1,100,148,248
26989,MJDiAmore,,1,4,6,10
26990,lavozatidebida,,1,5,11,16
26991,turkmenistan,,1,1,1,2
26992,kutya,,1,129,128,257
26993,Cxan,,1,17,28,45
26994,mycall,,1,860,726,1586
26995,DeadlyBrad42,,1,2,6,8
26996,jazzillion,,1,6,10,16
26997,TheKnightsWhoSayNi,,1,862,94,956
26998,TheUberDork,,1,190,384,574
26999,dr_qwertz,,1,86,149,235
27000,geekagent,,1,1,4,5
27001,moofive,,1,2,6,8
27002,desp,,1,54,74,128
27003,746f6d,,1,11,17,28
27004,charlestheoaf,,1,129,216,345
27005,SPna15,,1,2,4,6
27006,milki_,,1,6,4,10
27007,187lennon,,1,55,60,115
27008,jango_broughty,,1,1,1,2
27009,spoonito,,1,25,7,32
27010,xian24,,1,1,3,4
27011,rjonesx,,1,1624,364,1988
27012,Spudders,,1,548,778,1326
27013,human_giant,,1,71,91,162
27014,estone,,1,18,34,52
27015,hornetjockey,,1,12,19,31
27016,efbee,,1,4,9,13
27017,Stick,,1,148,311,459
27018,tienshiao,,1,9,13,22
27019,elint,,1,4,13,17
27020,greasyspoon,,1,1,2,3
27021,nickw,,1,14,7,21
27022,HillarysEyeSockets,,1,1,1,2
27023,gosh,,1,4,5,9
27024,lightether,,1,103,174,277
27025,ty8l8er,,1,95,24,119
27026,BigRedDSP,,1,3,2,5
27027,roug,,1,4,6,10
27028,Kim_Jong_Il,,1,23,42,65
27029,madrigael,,1,3,2,5
27030,sewellcm,,1,19,25,44
27031,slavus,,1,50,5,55
27032,chad206548,,1,1,2,3
27033,nanofiggis,,1,95,60,155
27034,gthing,,1,6,7,13
27035,moneeskyblue,,3,1,2,3
27036,desrever,,1,3,2,5
27037,ambyrhodes,,1,6,4,10
27038,bobjane,,1,11,9,20
27039,aflury,,1,1,1,2
27040,jimblackler,,1,1,2,3
27041,kk_090,,1,22,22,44
27042,thorndike,,1,37,42,79
27043,Tomstateler111,,1,58,3,61
27044,shirov,,1,2,3,5
27045,unrealredditaccount,,1,1,1,2
27046,ohwhytheresnoopenid,,1,2,1,3
27047,tagger22,,1,1,2,3
27048,heydude008,,1,1,4,5
27049,glen_scott,,1,8,3,11
27050,kvncortez,,1,4,15,19
27051,redditorin2006,,1,1,1,2
27052,mike-switch,,1,9,2,11
27053,JohnKerry,,1,2,2,4
27054,jngrow,,1,1,1,2
27055,alexsott,,1,2,2,4
27056,jasonmanley,,1,11,6,17
27057,bmusic,,1,2,2,4
27058,ApostrophePosse,,1,944,345,1289
27059,sayswhat,,1,1,1,2
27060,Marijuana_Enthusiast,,1,124,180,304
27061,dr_vertigo2,,1,17,29,46
27062,squizzled,,1,8,2,10
27063,reddiquettePolice,,1,43,82,125
27064,cnull,,1,69,59,128
27065,crowds,,1,71,3,74
27066,JCOrion,,1,15,24,39
27067,losethos,,1,71,19,90
27068,threetoed,,1,3,3,6
27069,msweeney,,1,1,1,2
27070,Bagel,,1,1122,1542,2664
27071,JonAtkinson,,1,5,5,10
27072,jmghollywood,,1,1,6,7
27073,theanarcrist,,1,144,15,159
27074,ethylhexyl,,1,8,8,16
27075,criminyjicket,,1,1,1,2
27076,aceinthehole,,1,58,177,235
27077,PurpleSfinx,,1,30,63,93
27078,sungod23,,1,2,3,5
27079,halfjew,,1,2,2,4
27080,chrisryland,,1,1,1,2
27081,tomtt,,1,49,11,60
27082,lip,,1,27,31,58
27083,russdot,,1,45,49,94
27084,MihaiC,,1,25,50,75
27085,dagit,,1,6,4,10
27086,leladax,,1,80,186,266
27087,dugdig,,1,8,7,15
27088,ThickGreenPuke,,1,388,439,827
27089,gusbustafunk,,1,106,134,240
27090,Droviin,,1,16,37,53
27091,jayesanctus,,1,7,17,24
27092,abc2020,,1,1,1,2
27093,burnninator,,1,2,2,4
27094,drdcuddy,,1,2,1,3
27095,zmonk2,,1,41,85,126
27096,erranttv,,1,116,12,128
27097,simplybrenty,,1,12,1,13
27098,unlearned,,1,2,2,4
27099,nicksauce,,1,114,112,226
27100,Shaelen,,1,1,1,2
27101,lllaaauuurrraaa,,1,15,32,47
27102,irenamak,,1,1,1,2
27103,shoneys,,1,66,104,170
27104,CockeyedPete,,1,21,27,48
27105,spammishking,,1,11,10,21
27106,tehgreek,,1,97,219,316
27107,jellobot,,1,1,2,3
27108,supermeerkat,,1,80,126,206
27109,jkennedy27,,1,69,1,70
27110,textfiles,,1,1,6,7
27111,markbres,,1,1,1,2
27112,bobb100,,1,9,1,10
27113,snot_rocket,,1,3,3,6
27114,GooZshooZ,,1,219,344,563
27115,thomas2431,,1,2,1,3
27116,jugabee,,1,2,1,3
27117,majorneo,,1,340,368,708
27118,ranma,,1,209,282,491
27119,lyon,,1,5,18,23
27120,kevlarcupid,,1,221,237,458
27121,911was_a_outside_job,,1,3,10,13
27122,CheBuzz,,1,1,1,2
27123,dcrall,,1,1,1,2
27124,thomas533,,1,23,13,36
27125,23_98,,1,1,1,2
27126,eatgrass,,1,7,3,10
27127,hetero_genius,,1,4,12,16
27128,belasco99,,1,1,1,2
27129,misohonie,,1,13,11,24
27130,joesapo,,1,2,5,7
27131,JazzJayZee,,1,64,4,68
27132,wallywoot,,1,1,2,3
27133,wingie,,1,16,37,53
27134,milomilo,,1,17,31,48
27135,DjFeltTip,,1,1,1,2
27136,lrm242,,1,9,2,11
27137,yelnatz,,1,3,3,6
27138,jchimney,,1,6,8,14
27139,leebones,,1,1,2,3
27140,NoiseBOX,,1,6,9,15
27141,Muziking,,1,5,2,7
27142,obrienj,,1,4,1,5
27143,nickfil,,1,22,14,36
27144,zeekstah,,1,17,16,33
27145,michaeljruscito,,1,1,4,5
27146,innocentbystander,,1,1758,2314,4072
27147,gojibot,,1,3,9,12
27148,kokok,,1,22,46,68
27149,bizquisite,,1,17,41,58
27150,schtarb,,1,24,30,54
27151,aalmiray,,1,1,1,2
27152,The_FBI,,1,6,14,20
27153,givas,,1,2,3,5
27154,Sophisticatedd,,1,4,4,8
27155,verrius,,1,6,7,13
27156,premiumdude,,1,3,3,6
27157,carsonbiz,,1,2318,108,2426
27158,squigs,,1,631,892,1523
27159,ine8181,,1,544,613,1157
27160,robosatan,,1,282,414,696
27161,gruehunter,,1,3,4,7
27162,pdewacht,,1,15,25,40
27163,BG5954729,,1,1,1,2
27164,ExpatSarah,,1,7,3,10
27165,saskboy,,1,2,4,6
27166,yogthos,,1,4,5,9
27167,MrDanger,,1,1161,1307,2468
27168,GoPolitics,,1,1,1,2
27169,nathanclay,,1,3,7,10
27170,joshyelon,,1,8,8,16
27171,JKillaII,,1,8,14,22
27172,duuude,,1,2,2,4
27173,fnot,,1,3,12,15
27174,Wilkerson,,1,1,1,2
27175,bauhous,,1,1,1,2
27176,blcline,,1,2,3,5
27177,CasualT,,1,2,14,16
27178,lamestuff,,1,57,1,58
27179,frankster,,1,21,38,59
27180,lilmiss2,,1,47,18,65
27181,mkuehn,,1,1,2,3
27182,gadamer,,1,3,1,4
27183,leper99,,1,1,1,2
27184,mdanuser,,1,8,1,9
27185,TheSOB88,,1,460,760,1220
27186,mvcornelius,,1,23,50,73
27187,pistolntulip,,1,122,5,127
27188,RainmadeMan,,1,641,542,1183
27189,brosephius,,1,265,389,654
27190,BingMcGhandi,,1,20,4,24
27191,argonlightray1,,1,2,1,3
27192,wtf_ever,,1,95,109,204
27193,mme_deviance,,1,20,27,47
27194,dylan7,,1,11,21,32
27195,cowsgonemadd3,,1,13,4,17
27196,floodedcodeboy,,1,7,10,17
27197,arichi,,1,86,153,239
27198,Magma42,,1,50,29,79
27199,0boy,,1,1232,34,1266
27200,tempreddit,,1,486,435,921
27201,longwalker,,1,1,1,2
27202,user69,,1,1,3,4
27203,pwner,,1,1,2,3
27204,noodles12,,1,3,5,8
27205,kip50,,1,7,13,20
27206,Ranugad,,1,7,10,17
27207,Daishiman,,1,20,18,38
27208,VC2217,,1,2,1,3
27209,ThreeT,,1,5,9,14
27210,Hodan,,1,11,10,21
27211,rarrrrrr,,1,10,4,14
27212,rems,,1,223,551,774
27213,grassyknolluk,,1,113,26,139
27214,zaach,,1,12,8,20
27215,tahawus,,1,5,7,12
27216,DropTableUsers,,1,131,56,187
27217,valadil,,1,33,53,86
27218,thudbang,,1,5,5,10
27219,callmecharlie,,1,4,10,14
27220,amiramir,,1,3,1,4
27221,speciousfool,,1,445,55,500
27222,mattOmynameO,,1,31,41,72
27223,deeceeo,,1,27,15,42
27224,abcxyz1234,,1,6,8,14
27225,alchemeron,,1,428,625,1053
27226,SmellyRaghead,,1,1,6,7
27227,Telluride12,,1,74,121,195
27228,amylynne321,,1,9,1,10
27229,hermanlo,,1,66,105,171
27230,GNUGeist,,1,1,2,3
27231,coz23,,1,1,1,2
27232,noobprodigy,,1,219,237,456
27233,stonyandcher,,1,1,1,2
27234,ddade,,1,1,1,2
27235,c0da,,1,66,89,155
27236,ach3030,,1,3,4,7
27237,dadRabbit,,1,79,15,94
27238,mrbill,,1,7,12,19
27239,d0nkeh,,1,1,3,4
27240,TomK,,1,7,3,10
27241,geoscopic,,1,4,7,11
27242,soakratikmethod,,1,3,1,4
27243,sunboy798,,1,1,5,6
27244,IMONMETH,,1,2,1,3
27245,dissdigg,,1,8,23,31
27246,rwg,,1,14,13,27
27247,aythun,,1,57,83,140
27248,long_story_teller,,1,3,1,4
27249,spoids,,1,93,90,183
27250,el_donovano,,1,3,9,12
27251,Whatsthatsound,,1,3,1,4
27252,resolva,,1,124,4,128
27253,NickG,,1,22,32,54
27254,frostyknees,,1,5,22,27
27255,notathrowawayaccount,,1,9,22,31
27256,a_trotskyite,,1,17,46,63
27257,Mustapha_Monds,,1,9,16,25
27258,pivotal,,1,91,123,214
27259,pipian,,1,3,1,4
27260,Sanguine,,1,33,62,95
27261,lolinyerface,,1,155,319,474
27262,gk8679,,1,7,8,15
27263,myplacedk,,1,11,14,25
27264,kfine,,1,10,4,14
27265,strax,,1,47,49,96
27266,deong,,1,160,183,343
27267,luigis_girlfriend,,1,17,13,30
27268,tanside,,1,9,15,24
27269,poohpoohpandah,,1,10,9,19
27270,KarateKid,,1,9,8,17
27271,Wwoody123,,1,4,2,6
27272,spotter,,1,23,61,84
27273,netburnr,,1,1,5,6
27274,pzn,,1,1,1,2
27275,phoenixfireball,,1,35,3,38
27276,toru,,1,33,37,70
27277,boredgeorge,,1,6,5,11
27278,sirgerg2,,1,1,10,11
27279,TheNational22,,1,3,3,6
27280,supremepbsk,,1,5,8,13
27281,bobrocks,,1,13,12,25
27282,ortsed,,1,3,4,7
27283,nnunley,,1,17,14,31
27284,ilikebikes,,1,16,14,30
27285,gamblekat,,1,44,69,113
27286,vokrus,,1,9,14,23
27287,dangph,,1,174,219,393
27288,efree58,,1,5,10,15
27289,Aluhut,,1,31,71,102
27290,charlesgoodall,,1,1,8,9
27291,mikefiction,,1,54,61,115
27292,dcormann,,1,8,4,12
27293,tom94115,,1,1,1,2
27294,inanytime,,1,27,26,53
27295,silentbobsc,,1,339,392,731
27296,ianbanks,,1,1,2,3
27297,userd,,1,43,80,123
27298,Bensch,,1,1033,1712,2745
27299,wallish,,1,305,544,849
27300,WarResistor,,1,8,7,15
27301,jennynyc,,1,1,5,6
27302,yanomamoman,,1,8,6,14
27303,JWarder,,1,7,6,13
27304,travisg,,1,1,1,2
27305,int3,,1,1,1,2
27306,SKROOB,,1,1,2,3
27307,rthomas6,,1,459,571,1030
27308,voxorg5,,1,2,2,4
27309,spiceweasel,,1,87,75,162
27310,shamelessPRhack,,1,188,92,280
27311,sudoko,,1,1,1,2
27312,devinedj,,1,166,104,270
27313,har3,,1,10,9,19
27314,KrisJordan,,1,16,4,20
27315,visarga,,1,439,430,869
27316,raglandpark,,1,57,109,166
27317,kerray,,1,8,16,24
27318,bhunterr,,1,2,3,5
27319,scarlin,,1,2,3,5
27320,LeeJunFan,,1,171,241,412
27321,daddyrief,,1,1,2,3
27322,joecarst,,1,15,30,45
27323,orthros,,1,4,6,10
27324,tallwookie,,1,3,14,17
27325,suedad,,1,12,18,30
27326,Kimura,,1,2122,15,2137
27327,lejoq,,1,14,34,48
27328,tashi-d,,1,5,10,15
27329,iggit,,1,4,2,6
27330,ajadoniz,,1,6,6,12
27331,Shoegaze99,,1,321,317,638
27332,fuckinhell,,1,34,82,116
27333,Prosit,,1,1,5,6
27334,element112,,1,6,5,11
27335,decklap,,1,36,46,82
27336,zoltron2,,1,2,1,3
27337,brettgian,,1,1,2,3
27338,traianus,,1,1,1,2
27339,pera001,,1,4,17,21
27340,FBernadotte,,1,6,6,12
27341,flxstr,,1,1,1,2
27342,TheOpossum,,1,147,211,358
27343,LameRedditCommenter,,1,1,1,2
27344,fattybob,,1,1,8,9
27345,merdely,,1,4,8,12
27346,quinnsa,,1,105,93,198
27347,axonblue,,1,230,202,432
27348,beastlycarnivore,,1,14,13,27
27349,ZACK_DE_LA_ROCHA,,1,19,41,60
27350,lowtone94,,1,228,29,257
27351,exgrafix,,1,1,1,2
27352,dafook,,1,10,5,15
27353,jimbo00000,,1,3,7,10
27354,icancheckyourhead,,1,2,2,4
27355,dudutch,,1,5,9,14
27356,hlvoorhees,,1,5,2,7
27357,Atomsk3,,1,11,13,24
27358,toban,,1,2,2,4
27359,eyeheartyou,,1,199,3,202
27360,toanoma,,1,3,1,4
27361,Sarah_Silverman,,1,9,9,18
27362,robinhoode,,1,6,10,16
27363,throwaway1,,1,1,1,2
27364,bahmak2003,,1,1,3,4
27365,jackastro,,1,6,2,8
27366,jumpstart,,1,1,1,2
27367,HoratioMcMoney1,,1,29,7,36
27368,demige10,,1,1,1,2
27369,spainexpat,,1,2,1,3
27370,iklnob,,1,4,2,6
27371,uberrandom,,1,5,3,8
27372,hailstone,,1,42,54,96
27373,lobofanina,,1,9,20,29
27374,shanemx,,1,3,8,11
27375,RandomOddNumbers,,1,2,1,3
27376,shaze,,1,186,235,421
27377,holysun,,1,1,1,2
27378,zackks,,1,267,529,796
27379,phobs,,1,113,175,288
27380,rizoh,,1,227,31,258
27381,Tekfrog,,1,8,6,14
27382,heston,,1,1,2,3
27383,HonestGuy,,1,6,5,11
27384,canuck-farmer,,1,4,6,10
27385,FuZ3,,1,15,18,33
27386,frikativ54,,1,14,10,24
27387,unknown_lamer,,1,63,130,193
27388,lickmydesktopmonit0r,,1,1,1,2
27389,andjjru,,1,11,28,39
27390,seavan,,1,1,1,2
27391,lanaer,,1,102,179,281
27392,gclaramunt,,1,27,53,80
27393,uzzaruby,,1,11,2,13
27394,leandroc76,,1,34,92,126
27395,AndrewStephens,,1,16,11,27
27396,starlifter71,,1,5,4,9
27397,RadiantBlueLight,,1,84,22,106
27398,JPathis,,1,6,8,14
27399,halobender,,1,30,45,75
27400,Null_State,,1,103,31,134
27401,degustihydrofoil,,1,1,1,2
27402,xitdedragon,,1,41,64,105
27403,cinemascope,,1,1,2,3
27404,smalltalk,,1,3,1,4
27405,bamanation,,1,5,7,12
27406,Fangsinmybeard,,1,19,41,60
27407,bruster,,1,1,2,3
27408,superscooter,,1,1,2,3
27409,rickk,,1,84,116,200
27410,darkchild82,,1,786,36,822
27411,ladyshelly,,1,39,2,41
27412,jericho,,1,120,209,329
27413,Gills131,,1,1,2,3
27414,placeholder,,1,199,118,317
27415,Viamin,,1,3,2,5
27416,fnog,,1,2,2,4
27417,smokkeyy,,1,1,3,4
27418,fala2000,,1,1,2,3
27419,bascule,,1,118,39,157
27420,cosmofraek,,1,29,94,123
27421,batkin,,1,2,4,6
27422,golansm,,1,21,1,22
27423,spicypiss,,1,14,12,26
27424,funkstick,,1,37,5,42
27425,right_to_arm_bears,,1,99,153,252
27426,mjayb,,1,5,10,15
27427,AssignMeARole,,1,8,8,16
27428,lickmydesktopmonitor,,1,3,1,4
27429,doctorgonzo,,1,424,100,524
27430,cport1,,1,8,1,9
27431,usr211211212,,1,18,38,56
27432,rsavage,,1,19,36,55
27433,jbb3rd,,1,6,4,10
27434,drfishy520,,1,4,3,7
27435,ssalmine,,1,4,4,8
27436,alidin,,1,1,5,6
27437,Ulyss3s,,1,45,4,49
27438,paulie1313,,1,1,6,7
27439,isunixthekey,,1,3,2,5
27440,ccmarsig,,1,1,2,3
27441,jnet,,1,1,2,3
27442,jayz28,,1,1,3,4
27443,chuck001,,1,46,14,60
27444,RayNbow,,1,28,35,63
27445,tevslin,,1,2,2,4
27446,shr1n1,,1,11,12,23
27447,unsubscribe,,1,21,41,62
27448,r12sxiqau,,1,1,1,2
27449,archaeopteryx,,1,42,21,63
27450,SteveRawx,,1,110,66,176
27451,okidokegirl,,1,14,23,37
27452,ToxicSox,,1,1,2,3
27453,raghurao,,1,1,1,2
27454,KevMike,,1,58,93,151
27455,narph,,1,3,5,8
27456,gravityboard,,1,6,12,18
27457,greut,,1,200,26,226
27458,mtbhucker,,1,6,18,24
27459,cabcaraway,,1,3,3,6
27460,BigKahunaBurger,,1,62,86,148
27461,novocaine21,,1,6,12,18
27462,anewaccount,,1,52,31,83
27463,timmenzies,,1,1,1,2
27464,rob_b,,1,1,1,2
27465,laprice,,1,187,127,314
27466,jooj1313,,1,2,1,3
27467,jables,,1,1,3,4
27468,delirial00,,1,2,5,7
27469,JigoroKano,,1,8,11,19
27470,SVKinAZ,,1,2,1,3
27471,jsghetto,,1,1,1,2
27472,Derge,,1,20,29,49
27473,Larry_Fishburn,,1,1,7,8
27474,TheLoneHoot,,1,121,199,320
27475,pokemans,,1,5,1,6
27476,meunierd,,1,3,4,7
27477,Randy_Marsh,,1,2,1,3
27478,pahanaama,,1,1,6,7
27479,loginname,,1,2,10,12
27480,jlowry,,1,86,45,131
27481,Blargh12345,,1,1,1,2
27482,lanzkron,,1,55,15,70
27483,sango0711,,1,37,104,141
27484,triggersix,,1,36,51,87
27485,MyCn18,,1,19,24,43
27486,aslan_ia,,1,1,2,3
27487,Facelessjoe,,1,149,112,261
27488,paulquinn00,,1,39,43,82
27489,No0n3,,1,25,29,54
27490,EmperorPalpatine,,1,2,1,3
27491,jbogli,,1,1,2,3
27492,voracity,,1,59,100,159
27493,matsalleh,,1,12,4,16
27494,TH322,,1,32,17,49
27495,redog,,1,424,739,1163
27496,Booie,,1,4,14,18
27497,greenmeatmonster,,1,2,2,4
27498,BusStation16,,1,11,18,29
27499,kitomo,,1,2,1,3
27500,isaacs,,1,7,17,24
27501,EthanPDX,,1,4,13,17
27502,Scientitian,,1,10,20,30
27503,malefactor1,,1,4,2,6
27504,shinobikins,,1,2,3,5
27505,danny_,,1,184,176,360
27506,geoserv,,1,1,1,2
27507,OtherOne,,1,71,8,79
27508,Tonnynocks,,1,2,3,5
27509,zeroooooooooooo,,1,69,75,144
27510,mope,,1,1,2,3
27511,Aixelsyd720,,1,3,7,10
27512,synt4x,,1,4,11,15
27513,mrfletcher,,1,1,1,2
27514,shinya666,,1,91,29,120
27515,singnyc,,1,5,2,7
27516,sixsidepentagon,,1,1,1,2
27517,MajorObvious,,1,1,2,3
27518,nirjhari,,1,2,4,6
27519,bonniemuffin,,1,8,14,22
27520,Homestar,,1,14,21,35
27521,stoneyb,,1,1,1,2
27522,nelag,,1,6,3,9
27523,micahglasser,,1,6,4,10
27524,321,,1,1,2,3
27525,lightedgiraffe,,1,15,14,29
27526,cryptlib,,1,2,1,3
27527,dude111,,1,1,2,3
27528,darkswarm,,1,40,11,51
27529,conal,,1,14,13,27
27530,zach,,1,55,43,98
27531,Ruckus,,1,26,32,58
27532,adamtsai,,1,21,28,49
27533,sofiseymor,,1,82,117,199
27534,Cobalt-Spike,,1,7,14,21
27535,kharriss,,1,1,1,2
27536,tackle,,1,149,201,350
27537,superman9,,1,1,1,2
27538,EvilGeniusCartier,,1,3,10,13
27539,NMSpaz,,1,13,14,27
27540,blankspaceseattle,,1,3,3,6
27541,aladi,,1,3,1,4
27542,HiddenTalents99,,1,9,1,10
27543,naughty,,1,21,47,68
27544,5to10,,1,2,1,3
27545,redditking,,1,312,33,345
27546,shoeninja,,1,35,31,66
27547,rightchoiceamerica,,1,2,5,7
27548,3rdFunkyBot,,1,144,55,199
27549,vaibhavsagar,,1,28,15,43
27550,newagenda,,1,1,1,2
27551,Gdupandout,,1,2,2,4
27552,timjay,,1,4,3,7
27553,deitrich_reitrich,,1,14,7,21
27554,khafra,,1,615,1082,1697
27555,DavidHausen,,1,48,92,140
27556,Jasper1984,,1,134,264,398
27557,christierney,,1,3,5,8
27558,Rhiannon,,1,680,19,699
27559,I_LOVE_ANAL_SEX,,1,37,31,68
27560,Tarn,,1,2,4,6
27561,simple_solution,,1,1,1,2
27562,Li17,,1,17,26,43
27563,nosuperstitions,,1,1,1,2
27564,gpowell,,1,17,3,20
27565,TruthSerum44,,1,35,40,75
27566,elsagacious,,1,220,295,515
27567,G325C9,,1,16,17,33
27568,scientologyrulez,,1,1,1,2
27569,lilacsandlolita0513,,1,1,1,2
27570,ondal,,1,68,82,150
27571,mov,,1,1,2,3
27572,will_itblend,,1,352,595,947
27573,OldeBill,,1,1,5,6
27574,yoink15,,1,21,20,41
27575,potatochipthief13,,1,7,4,11
27576,nipps85,,1,268,257,525
27577,treefrog55,,1,1,4,5
27578,phoneguy,,1,12,1,13
27579,col-pepper,,1,1,1,2
27580,ToastAndJam,,1,18,27,45
27581,Gaylord_Focker,,1,1,1,2
27582,blinkkk,,1,1,4,5
27583,tomek77,,1,51,80,131
27584,Palin2012,,1,10,8,18
27585,silentp,,1,7,7,14
27586,brokenburrito,,1,1,1,2
27587,hashbangperl,,1,26,27,53
27588,jacobiconstant,,1,13,19,32
27589,fatterangrywiccan,,1,22,58,80
27590,namsu971,,1,38,5,43
27591,i_am_the_best,,1,1,1,2
27592,locqlemur,,1,9,12,21
27593,denisedwitmer,,1,2,1,3
27594,MrSurly,,1,73,140,213
27595,projectshave,,1,186,186,372
27596,WaterboardWetbackLOL,,1,27,49,76
27597,Observant_Servant,,1,13,25,38
27598,fluffle,,1,16,24,40
27599,adma1,,1,64,72,136
27600,sogroig,,1,19,16,35
27601,burnblue,,1,259,433,692
27602,nick31,,1,11,4,15
27603,carny666,,1,351,241,592
27604,bcompton,,1,10,11,21
27605,puffypants123,,1,423,274,697
27606,hkstar,,1,2,1,3
27607,purefx,,1,7,19,26
27608,desultorypawn,,1,48,54,102
27609,the_trout,,1,179,193,372
27610,polnikes,,1,2,8,10
27611,maxm,,1,15,15,30
27612,yougene,,1,12,11,23
27613,skraemate,,1,3,2,5
27614,myth1n,,1,27,12,39
27615,Minim4c,,1,14,19,33
27616,mcsethanon,,1,31,49,80
27617,trjordan,,1,47,59,106
27618,chopp3r,,1,1,1,2
27619,newacct,,1,15,5,20
27620,jfb3,,1,3,3,6
27621,sprash,,1,35,44,79
27622,dadvocate,,1,4,10,14
27623,ScottMaximus23,,1,5,8,13
27624,moogs,,1,261,329,590
27625,shables2222,,1,7,25,32
27626,phathippo,,1,4,1,5
27627,Brian975,,1,8,16,24
27628,kilowatt,,1,102,87,189
27629,vicgolgo13,,1,2,2,4
27630,GrantShoe,,1,3,2,5
27631,user_1,,1,1,1,2
27632,Herge,,1,5,3,8
27633,cinta5,,1,13,1,14
27634,melindia,,1,31,1,32
27635,carving_a_giant,,1,2,2,4
27636,steelio,,1,123,185,308
27637,troymg,,1,2,5,7
27638,ataricult,,1,19,30,49
27639,dancerobots,,1,5,8,13
27640,o2pb,,1,22,26,48
27641,cconger,,1,1,8,9
27642,pornleak,,1,11,1,12
27643,gliscameria,,1,334,315,649
27644,jpclex,,1,3,8,11
27645,letthemswim,,1,6,7,13
27646,keito,,1,83,138,221
27647,rabidw,,1,38,49,87
27648,fredinbed,,1,1,4,5
27649,godofpumpkins,,1,4,3,7
27650,jbindel,,1,18,35,53
27651,macousin,,1,1,5,6
27652,vinblackham,,1,116,29,145
27653,alakra,,1,2,4,6
27654,liarliarpantsonfire,,1,10,10,20
27655,spindoc,,1,1,1,2
27656,marshray,,1,19,25,44
27657,morn,,1,2,1,3
27658,ziquapix,,1,5,3,8
27659,dreamlandburns,,1,2,2,4
27660,Spankypoo,,1,14,19,33
27661,climbinkid,,1,2,9,11
27662,mkultra123,,1,4,12,16
27663,gtani7,,1,17,14,31
27664,adutzu,,1,13,3,16
27665,thekingoflapland,,1,51,51,102
27666,okeefe,,1,37,70,107
27667,delliott64,,1,6,1,7
27668,black44166,,1,1,1,2
27669,bravetoaster,,1,18,2,20
27670,petersenman21,,1,7,3,10
27671,prpldrgnfly,,1,1,2,3
27672,totalspaceship,,1,1,1,2
27673,SUNY_Boy,,1,1,1,2
27674,lAmInLoveWithJesus,,1,4,2,6
27675,employeeno5,,1,230,262,492
27676,wfarr,,1,23,57,80
27677,GenevaConventionsFTW,,1,1,1,2
27678,godLESS1,,1,29,47,76
27679,TheCanadian,,1,3,4,7
27680,hidiloper,,1,3,2,5
27681,suexian,,1,324,662,986
27682,cloverT,,1,5,4,9
27683,wmv248,,1,2,1,3
27684,mike23bz,,1,4,3,7
27685,jkr,,1,1,2,3
27686,MyrddinE,,1,333,525,858
27687,codeodor,,1,285,254,539
27688,suprthug8d,,1,6,1,7
27689,tryx,,1,505,392,897
27690,FearlessDreams,,1,7,1,8
27691,ondrah,,1,15,17,32
27692,Apple_dev,,1,1,1,2
27693,morehush,,1,2,9,11
27694,eadinad,,1,108,55,163
27695,rapist,,1,104,95,199
27696,Larakin,,1,2,6,8
27697,WhoRadley,,1,1,1,2
27698,drunk2much,,1,1,2,3
27699,Cherry5oda,,1,2,3,5
27700,angryostrich,,1,225,218,443
27701,jennaon,,1,4,5,9
27702,errantKnave,,1,30,52,82
27703,politicssuck1,,1,2,3,5
27704,ckasper,,1,5,5,10
27705,Willop23,,1,1,2,3
27706,adambeta,,1,15,13,28
27707,anmar,,1,7,10,17
27708,redleif,,1,1,1,2
27709,venificusd,,1,15,12,27
27710,Kaws,,1,12,20,32
27711,Sonicus,,1,1,2,3
27712,Foone,,1,194,228,422
27713,adenium,,1,1,2,3
27714,klancaster1957,,1,12,16,28
27715,kanuk876,,1,374,461,835
27716,6f6,,1,61,28,89
27717,BBK2008,,1,13,24,37
27718,drJamesKamm,,1,2,1,3
27719,ganelo,,1,1,1,2
27720,alexfarran,,1,114,38,152
27721,dmwit,,1,163,217,380
27722,RobotLordofTokyo,,1,28,75,103
27723,teKniepo,,1,2,1,3
27724,amade,,1,11,12,23
27725,blogmeister,,1,17,4,21
27726,jdweeks,,1,2,1,3
27727,undauntedspirit,,1,17,21,38
27728,jmkogut,,1,52,67,119
27729,thesqlguy,,1,155,67,222
27730,kaoblues,,1,5,1,6
27731,mrlawlsome,,1,30,59,89
27732,jschau2,,1,87,1,88
27733,MorganQuinn,,1,12,34,46
27734,redditboy23,,1,2,1,3
27735,thenationalgadfly,,1,7,1,8
27736,glaucon,,1,2,2,4
27737,syobosyobo,,1,17,6,23
27738,rhialto,,1,2,1,3
27739,locster,,1,24,43,67
27740,vstas,,1,21,17,38
27741,Purpledrank,,1,44,114,158
27742,grimboy,,1,154,290,444
27743,huybee,,1,62,1,63
27744,EmoticonMan,,1,1,5,6
27745,raoul,,1,2,1,3
27746,Ginseng,,1,1,1,2
27747,onezerozeroone,,1,133,139,272
27748,ryth,,1,6,3,9
27749,skatanic,,1,13,23,36
27750,jodythebad,,1,128,120,248
27751,SovereignZ,,1,69,55,124
27752,doctapeppa,,1,91,122,213
27753,momeb,,1,6,12,18
27754,akvj1n,,1,8,7,15
27755,robahu,,1,18,18,36
27756,gulp35,,1,25,23,48
27757,MisterBill,,1,8,11,19
27758,zeroelixis,,1,21,34,55
27759,esc125,,1,10,9,19
27760,mot_choker,,1,1,1,2
27761,daedstars,,1,7,4,11
27762,procrasturbate,,1,3,4,7
27763,amichai,,1,1,2,3
27764,TheManWithNoName,,1,128,88,216
27765,fourthie,,1,89,51,140
27766,gmnotyet,,1,7,9,16
27767,emperor_of_fun,,1,77,81,158
27768,PeterBraden,,1,8,1,9
27769,contentmanager,,1,1,4,5
27770,epyon9283,,1,2,2,4
27771,Cebus,,1,80,39,119
27772,Cowbellz,,1,4,3,7
27773,apower,,1,7,17,24
27774,scornedpatriot,,1,22,27,49
27775,slypheed,,1,1,1,2
27776,Prosody,,1,35,40,75
27777,bwarbiany,,1,62,5,67
27778,easedowntheroad,,1,4,7,11
27779,dimitrynewyork,,1,2,2,4
27780,Johnny_Guitar,,1,38,57,95
27781,pat965,,1,62,134,196
27782,pbh101,,1,2,5,7
27783,Elmira_Green_Gulch,,1,17,2,19
27784,Fishyfishy44,,1,1,2,3
27785,alextraynor,,1,2,1,3
27786,DisConform,,1,307,53,360
27787,CygnusXII,,1,2,4,6
27788,ass2mouth,,1,11,18,29
27789,pogothemonkey81,,1,261,24,285
27790,andrewmp,,1,27,23,50
27791,jeffthestripper,,1,2,1,3
27792,sleepingsquirrel,,1,41,44,85
27793,larsivi,,1,4,7,11
27794,waterclock,,1,13,3,16
27795,georgeb48,,1,5,6,11
27796,andrepl,,1,1,2,3
27797,andy_boyd,,1,40,75,115
27798,romcabrera,,1,132,132,264
27799,keupo,,1,3,6,9
27800,Tyler32,,1,3,2,5
27801,chopper77,,1,4,7,11
27802,ramblertwin,,1,7,7,14
27803,imnotanitwit,,1,1,1,2
27804,bakergo,,1,6,7,13
27805,fakenathan,,1,4,9,13
27806,archipodius,,1,1,1,2
27807,japherwocky,,1,3,5,8
27808,PreservedKillick,,1,17,16,33
27809,upnorth1967,,1,18,36,54
27810,quakerorts,,1,573,231,804
27811,ranscot,,1,271,141,412
27812,kickasspodcast,,1,7,8,15
27813,btl,,1,827,994,1821
27814,hermzz,,1,116,92,208
27815,icefox,,1,201,118,319
27816,expedient,,1,2,6,8
27817,retlawmacpro,,1,19,32,51
27818,alrokerjr,,1,1,1,2
27819,snowchaser,,1,2,9,11
27820,wvit1001,,1,2,3,5
27821,Jesusish,,1,423,63,486
27822,alexes,,1,2,2,4
27823,mattsta,,1,7,2,9
27824,por,,1,54,17,71
27825,cometparty,,1,402,436,838
27826,fieldglass,,1,4,2,6
27827,00seven,,1,2,3,5
27828,bababeechums,,1,34,4,38
27829,allpurposecleaning,,1,27,4,31
27830,sdbest,,1,20,2,22
27831,UnknownVariable,,1,58,80,138
27832,zck,,1,183,204,387
27833,_sic,,1,139,190,329
27834,amykate,,1,1,4,5
27835,OrionBlastar,,1,16,10,26
27836,Cloukyo,,1,66,91,157
27837,LAmarODom420,,1,4,8,12
27838,Kardon,,1,4,4,8
27839,drcode,,1,54,22,76
27840,vanimal,,1,6,13,19
27841,surfincolorado,,1,9,7,16
27842,quentinnuk,,1,326,58,384
27843,bobf,,1,2,1,3
27844,ModelConsumer,,1,14,17,31
27845,JordanGreenberg,,1,7,13,20
27846,kunalshah83,,1,1,1,2
27847,pbr,,1,13,31,44
27848,informer100,,1,2,1,3
27849,greedz,,1,24,58,82
27850,fabreeze,,1,2,3,5
27851,nakedpeewee,,1,48,19,67
27852,nevries,,1,7,3,10
27853,fangolo,,1,1061,483,1544
27854,InfernalTempestX,,1,2,1,3
27855,jasondragon,,1,147,119,266
27856,FISHBWOY09,,1,44,99,143
27857,IVIAuric,,1,148,116,264
27858,DaTruth,,1,3,3,6
27859,harrison_the_skater,,1,4,7,11
27860,vyoma999,,1,4,12,16
27861,nestletollhouse,,1,2,3,5
27862,splato,,1,5,1,6
27863,jimmymets,,1,202,24,226
27864,Katsuichi,,1,16,18,34
27865,uprightnetizen,,1,1,1,2
27866,ProfaneDrunk,,1,4,1,5
27867,joefiro,,1,8,8,16
27868,mr_dbr,,1,438,495,933
27869,trehug,,1,1,2,3
27870,g_sus,,1,48,27,75
27871,lifelonglearning,,1,37,44,81
27872,nyamatongwe,,1,2,2,4
27873,BFinuc,,1,50,77,127
27874,myconetyeti,,1,1,1,2
27875,coreyp319,,1,15,36,51
27876,rilo,,1,99,91,190
27877,earthheart,,1,47,67,114
27878,ToughNoogies,,1,108,82,190
27879,jockc,,1,40,55,95
27880,gorvis,,1,2,1,3
27881,xniphobe,,1,53,26,79
27882,jaydoggy,,1,3,5,8
27883,spoondoodle2,,1,4,3,7
27884,polgara04,,1,24,67,91
27885,apsudraconis,,1,4,7,11
27886,payoff,,1,184,274,458
27887,warpzero,,1,11,14,25
27888,bekele2617,,1,45,42,87
27889,krazymelvin,,1,1,3,4
27890,bobolux,,1,8,29,37
27891,Freidenker,,1,1,1,2
27892,junk2006,,1,12,21,33
27893,hal22,,1,53,24,77
27894,callmemrshades,,1,2,6,8
27895,collegesophomore,,1,2,1,3
27896,Knute5,,1,55,106,161
27897,joecam,,1,15,52,67
27898,pmf,,1,89,89,178
27899,Bozodog,,1,2,9,11
27900,acpawlek,,1,137,283,420
27901,pandacity,,1,1,2,3
27902,gimpslayer,,1,1,1,2
27903,prosanity,,1,2,2,4
27904,cdenyikayedu,,1,6,16,22
27905,markfl12,,1,1,1,2
27906,luvthymullet,,1,2,5,7
27907,onehundredmonkeys,,1,15,15,30
27908,CherryInHove,,1,195,188,383
27909,biglook,,1,3,5,8
27910,dirvanDambilo,,1,99,135,234
27911,OneUpper,,1,14,17,31
27912,randomman420,,1,10,14,24
27913,Justinsaccount,,1,79,144,223
27914,fh_,,1,6,5,11
27915,rsanheim,,1,9,5,14
27916,jamin_brook,,1,482,271,753
27917,irregardless,,1,265,225,490
27918,Kushali,,1,2,4,6
27919,seudonymus,,1,8,6,14
27920,finite,,1,83,90,173
27921,willson,,1,16,31,47
27922,cd411,,1,4,2,6
27923,ppot667,,1,5,6,11
27924,rockicon82,,1,313,332,645
27925,sedo1800,,1,29,58,87
27926,Elfman72,,1,2,2,4
27927,ubitendo,,1,249,318,567
27928,xlamplighter,,1,295,413,708
27929,Serious-Cat,,1,2,1,3
27930,Jessica_Henderson,,1,468,345,813
27931,jemjabella,,1,2,8,10
27932,snv3000,,1,4,3,7
27933,userunderscorename,,1,30,38,68
27934,Apfel,,1,1,2,3
27935,13ren,,1,761,1118,1879
27936,arkmtech,,1,2,2,4
27937,splynncryth,,1,2,3,5
27938,tribat,,1,1,3,4
27939,jtmarlin,,1,62,2,64
27940,silverfoxx08,,1,27,40,67
27941,Scheschy,,1,3,4,7
27942,ubito,,1,1,2,3
27943,Bex4Jesus,,1,27,2,29
27944,I_pity_the_fool,,1,41,68,109
27945,rep_movsd,,1,15,6,21
27946,fkn_eh,,1,2,3,5
27947,Hagoroo,,1,2,2,4
27948,HoneyMustardIcing,,1,1,1,2
27949,djwm,,1,9,15,24
27950,Lycoris,,1,16,46,62
27951,pwnies,,1,3,2,5
27952,calantus,,1,379,648,1027
27953,auiris,,1,1,3,4
27954,fritzair,,1,5,11,16
27955,discdigger,,1,5,5,10
27956,g2boojum,,1,1,1,2
27957,RyanGWU82,,1,81,40,121
27958,arkpog,,1,6,5,11
27959,mads-80,,1,30,54,84
27960,khell,,1,7,1,8
27961,jennybold,,1,20,25,45
27962,idiocrat,,1,3,2,5
27963,Suicide_Guy,,1,179,133,312
27964,miketwo1s,,1,22,30,52
27965,l034me,,1,13,13,26
27966,timekillerjay,,1,5,2,7
27967,querulous,,1,16,19,35
27968,trollnick,,1,2,1,3
27969,chegeordievara,,1,63,88,151
27970,critteriste,,1,12,1,13
27971,Lloyd_Christmas,,1,1,1,2
27972,nobodyspecial,,1,216,188,404
27973,kinesis,,1,1,1,2
27974,Esoteria,,1,64,68,132
27975,TheChaosKitty,,1,12,1,13
27976,killerstorm,,1,441,688,1129
27977,coadmunki,,1,1,1,2
27978,mustardgas,,1,2,2,4
27979,Wangus,,1,2,4,6
27980,niccha,,1,324,18,342
27981,cdward,,1,9,14,23
27982,TheQuoteBot,,1,1,9,10
27983,redbike,,1,4,10,14
27984,yorgle,,1,3,14,17
27985,OGLothar,,1,51,57,108
27986,EricArthurBlair,,1,20,29,49
27987,chembro84,,1,1,3,4
27988,stanmartin1952,,1,43,14,57
27989,ttys0,,1,2,4,6
27990,AnotherLameHaiku,,1,12,17,29
27991,aphrodite1,,1,21,38,59
27992,hoaznod,,1,9,3,12
27993,svenjolly,,1,8,5,13
27994,fubuki,,1,47,105,152
27995,ladycrappo,,1,272,184,456
27996,MachinShin2006,,1,260,455,715
27997,dysenteryduke,,1,10,1,11
27998,antillus,,1,1,6,7
27999,martin87654,,1,2,1,3
28000,snotrokit,,1,207,293,500
28001,prof_booty,,1,3,2,5
28002,Cole_Avenue,,1,2,5,7
28003,DaveTheLightingGuy,,1,10,8,18
28004,Badenkin,,1,2,1,3
28005,weeble,,1,1,1,2
28006,iusig,,1,2,6,8
28007,drogian,,1,1,1,2
28008,oditogre,,1,627,856,1483
28009,thylacine222,,1,1,1,2
28010,An_Anteater,,1,1,4,5
28011,lefty100,,1,3,1,4
28012,Guinnessin,,1,10,15,25
28013,dossy,,1,4,1,5
28014,matthooks,,1,5,8,13
28015,jimrooney,,1,16,27,43
28016,fradiavolo,,1,1,2,3
28017,GhostOfRussert,,1,12,9,21
28018,klinegl,,1,3,1,4
28019,francpaul,,1,2,1,3
28020,RedditSuxFuckingAss,,1,1,2,3
28021,EmmDock,,1,2,3,5
28022,paaki,,1,9,12,21
28023,redditards,,1,1,2,3
28024,JohnSmith2008,,1,20,20,40
28025,ivette81,,1,20,27,47
28026,Jrix,,1,8,10,18
28027,patrickinminneapolis,,1,2,2,4
28028,kiddcode,,1,1,2,3
28029,ness0216,,1,23,33,56
28030,whackamole64,,1,1,3,4
28031,Gro-Tsen,,1,23,12,35
28032,headspace,,1,3,6,9
28033,replicacobra,,1,2,6,8
28034,JesusWuta40oz,,1,4,9,13
28035,dwcharn,,1,1,1,2
28036,oddst,,1,139,19,158
28037,user1024,,1,3,1,4
28038,madeofcheese,,1,3,5,8
28039,andrewjs42,,1,3,5,8
28040,Ninjaattack,,1,7,5,12
28041,littleboylost,,1,3,5,8
28042,Denki,,1,3,2,5
28043,gucker,,1,10,4,14
28044,papadoc,,1,1,1,2
28045,cmiller173,,1,112,168,280
28046,spyderiii,,1,40,10,50
28047,Latch,,1,22,54,76
28048,Oswyt3hMihtig,,1,45,50,95
28049,fhauge,,1,6,8,14
28050,sanotaan,,1,7,18,25
28051,tweetums,,1,1,1,2
28052,sutcivni,,1,12,12,24
28053,redditeer,,1,62,93,155
28054,Pendleton1990,,1,3,4,7
28055,ovreucpac,,1,14,16,30
28056,Sherm,,1,115,176,291
28057,portalcakes,,1,2,4,6
28058,justryde,,1,12,37,49
28059,lyrnx,,1,1,1,2
28060,oregoncon,,1,1,3,4
28061,geik,,1,13,13,26
28062,whiterabbitmuse,,1,1,2,3
28063,amabaie,,1,1,1,2
28064,thefieryking,,1,1,1,2
28065,Yabbaba,,1,10,23,33
28066,lachristy,,1,6,1,7
28067,Stinkis,,1,1,2,3
28068,dragonfly_blue,,1,7,5,12
28069,ian-t,,1,5,3,8
28070,jinkies,,1,4,6,10
28071,daversf,,1,14,6,20
28072,HiluxCrux,,1,49,114,163
28073,qwerty123321,,1,35,33,68
28074,visceralflux,,1,1,2,3
28075,arrowaytech,,1,2,5,7
28076,manflesh,,1,5,5,10
28077,RD-Arcadia,,1,4,2,6
28078,azenhi,,1,18,31,49
28079,DonnieMarco,,1,6,9,15
28080,bechus,,1,66,69,135
28081,NAntill,,1,24,8,32
28082,jedsen,,1,8,13,21
28083,jambajews,,1,30,42,72
28084,key95,,1,147,74,221
28085,Stancisco,,1,2,3,5
28086,bgfinkel,,1,15,45,60
28087,logic,,1,4,9,13
28088,theprizefight,,1,7,2,9
28089,gjl321,,1,5,1,6
28090,nicwilliams,,1,1,3,4
28091,Gluverty,,1,40,91,131
28092,Dave222222,,1,22,31,53
28093,opek,,1,3,10,13
28094,minxer,,1,2,4,6
28095,Pharaonic,,1,219,257,476
28096,tedbowman,,1,15,7,22
28097,eggplantoffire,,1,8,24,32
28098,pecet,,1,19,7,26
28099,Jambi,,1,47,49,96
28100,bndr,,1,1,1,2
28101,mdfmk05,,1,63,23,86
28102,gaunilo,,1,40,2,42
28103,Jacob_dp,,1,84,16,100
28104,justarandomguy,,1,1,1,2
28105,jliendo,,1,16,5,21
28106,billbakeracmorg,,1,1,2,3
28107,andersbergh,,1,11,17,28
28108,blackraven36,,1,1,1,2
28109,rottendolls,,1,42,4,46
28110,kristine25,,1,36,18,54
28111,mcroydon,,1,1,1,2
28112,dangerdoug,,1,15,17,32
28113,trakus,,1,2,1,3
28114,bking,,1,8,1,9
28115,TheAutophobe,,1,18,34,52
28116,tprzepiorka,,1,1,1,2
28117,Atomics,,1,879,1102,1981
28118,Azi,,1,3,6,9
28119,materialist,,1,181,226,407
28120,onan,,1,64,78,142
28121,drunksquirrel,,1,1,2,3
28122,ballaa,,1,7,5,12
28123,livingcasper,,1,2,11,13
28124,mrpeabody208,,1,1,8,9
28125,CowboyDan,,1,336,95,431
28126,KCBassCadet,,1,35,36,71
28127,monkmellon,,1,16,25,41
28128,perb123,,1,452,306,758
28129,pauljonas,,1,1,1,2
28130,TutsiPop,,1,2,1,3
28131,antisocialiting,,1,1,6,7
28132,enocenip,,1,85,56,141
28133,calumr,,1,60,25,85
28134,baltman,,1,1,1,2
28135,AngryClarinettist,,1,2,3,5
28136,postalrat,,1,30,37,67
28137,thau,,1,16,3,19
28138,wjg10,,1,139,98,237
28139,leehp83,,1,6,6,12
28140,chickenlittle,,1,3,7,10
28141,cedargrove,,1,455,479,934
28142,avid_reader1986,,1,4,5,9
28143,__hage,,1,1,2,3
28144,DestroyedGenius,,1,1,1,2
28145,joshross,,1,5,13,18
28146,ohxten,,1,580,213,793
28147,jetmark,,1,146,296,442
28148,A_Human_Being,,1,86,73,159
28149,rubbermaid,,1,106,125,231
28150,dutchlad,,1,21,12,33
28151,UntakenUsername,,1,548,1214,1762
28152,jungle_jim,,1,17,26,43
28153,skeez,,1,51,29,80
28154,azron,,1,1505,837,2342
28155,lubricious,,1,132,294,426
28156,angie13,,1,24,5,29
28157,AnnFurthermore,,1,14,31,45
28158,ConsciousPilot,,1,31,19,50
28159,somethingup,,1,9,15,24
28160,eiketsujinketsu,,1,1,1,2
28161,sofa,,1,10,32,42
28162,cappie2000,,1,2,1,3
28163,raj200,,1,102,2,104
28164,bkey23,,1,5,10,15
28165,nocreativityx,,1,17,27,44
28166,arniegrape,,1,2,4,6
28167,tom_at_biketempe,,1,1,2,3
28168,natch,,1,280,371,651
28169,BillyJeansBaby,,1,11,7,18
28170,Infinity_Wasted,,1,266,524,790
28171,iesvs,,1,14,56,70
28172,trot-trot,,1,79,17,96
28173,RandomChu,,1,1,1,2
28174,Torq,,1,2,2,4
28175,burritovision,,1,8,7,15
28176,crego20,,1,9,14,23
28177,richiejp,,1,27,55,82
28178,limabean4,,1,4,2,6
28179,senzen,,1,2,21,23
28180,bart2019,,1,363,644,1007
28181,raindoggie,,1,3,5,8
28182,TwoSweet,,1,17,20,37
28183,JustinKSU,,1,1,1,2
28184,cassius_,,1,13,16,29
28185,jaguar_paw,,1,8,9,17
28186,erwanl,,1,38,42,80
28187,groapacuprosti,,1,5,3,8
28188,jonahan,,1,52,46,98
28189,J2011R,,1,12,7,19
28190,occidental_inkling,,1,52,129,181
28191,fiercelyfriendly,,1,381,601,982
28192,PartyInMyTummy,,1,24,40,64
28193,gte910h,,1,93,143,236
28194,Jacqueline_Hyde,,1,8,11,19
28195,billcube,,1,12,17,29
28196,sighbourbon,,1,347,561,908
28197,Pynchon,,1,4,7,11
28198,patrickcollison,,1,7,5,12
28199,mollylolly88,,1,4,6,10
28200,murphy99,,1,2,1,3
28201,ReanLu,,1,2,6,8
28202,maslachak,,1,2,2,4
28203,deus_pater,,1,2,7,9
28204,MeridianJP,,1,157,229,386
28205,samrobroy,,1,3,1,4
28206,drtyfrnk,,1,170,295,465
28207,SarcasticGuy,,1,83,135,218
28208,qax951,,1,6,3,9
28209,millymilltown,,1,2,7,9
28210,jstills,,1,1316,341,1657
28211,KeyserSosa,,1,99,19,118
28212,xed122333,,1,4,8,12
28213,Lord_Hex,,1,7,13,20
28214,jessebogan,,1,1,1,2
28215,ocicat,,1,86,42,128
28216,kisschicken,,1,21,30,51
28217,redalastor,,1,156,200,356
28218,Harelin,,1,10,12,22
28219,armrest,,1,1,5,6
28220,Nicholie,,1,138,174,312
28221,Dinglefarmer,,1,310,240,550
28222,velocityhead,,1,4,9,13
28223,ryanx435,,1,204,61,265
28224,metaGlass,,1,3,2,5
28225,Sidewinder77,,1,406,10,416
28226,worldking,,1,3,2,5
28227,beardjam,,1,2,2,4
28228,Sheffield_Police,,1,1,1,2
28229,TheTempest,,1,3,1,4
28230,LongTimeFirstTime,,1,40,33,73
28231,Gnascher,,1,21,33,54
28232,judgeschmales,,1,7,5,12
28233,JowSithm,,1,1,1,2
28234,d0odx,,1,19,3,22
28235,Dragon256,,1,71,4,75
28236,jms11235,,1,3,4,7
28237,Digital_Omnivore,,1,6,17,23
28238,mrmaxpowers,,1,2,2,4
28239,deepcleansingguffaw,,1,71,148,219
28240,colmcnamara,,1,4,17,21
28241,ngangishetti,,1,6,17,23
28242,dock2,,1,5,7,12
28243,arnonrgo,,1,2,1,3
28244,sdeken,,1,3,6,9
28245,therustytracks,,1,14,21,35
28246,Xenius,,1,2,4,6
28247,dcormier,,1,31,50,81
28248,ak472u,,1,2,6,8
28249,babaganoosh,,1,19,25,44
28250,grumble_au,,1,24,21,45
28251,brstilson,,1,233,196,429
28252,oldchicolocal,,1,4,1,5
28253,slygreyfox,,1,12,4,16
28254,seven,,1,14,17,31
28255,xendmaker,,1,1,1,2
28256,americanhellyeah,,1,606,538,1144
28257,PhuQ,,1,67,163,230
28258,Morghus,,1,53,89,142
28259,Aiue,,1,5,1,6
28260,lmntal,,1,2,6,8
28261,nofrak,,1,112,300,412
28262,Lunchbox753,,1,1,1,2
28263,sdhjkjhgfdxfgh,,1,1,1,2
28264,videothink,,1,19,23,42
28265,strongox,,1,16,4,20
28266,morthul,,1,1,1,2
28267,uses,,1,185,112,297
28268,kragnax,,1,169,203,372
28269,desertpuke,,1,7,44,51
28270,cumhur,,1,15,13,28
28271,therealtrypto,,1,22,20,42
28272,rox_midge,,1,34,73,107
28273,rzzazzr,,1,22,34,56
28274,Blacks_Are_Retarded,,1,11,12,23
28275,ogleme,,1,250,125,375
28276,dr_mtarver,,1,1,1,2
28277,surfmadpig,,1,39,77,116
28278,kadath32,,1,7,16,23
28279,candyman420,,1,11,15,26
28280,scodav,,1,2,3,5
28281,heldhelm,,1,7,3,10
28282,citation_nazi,,1,2,1,3
28283,siniavine,,1,3,1,4
28284,klax89,,1,45,62,107
28285,chokolad,,1,6,6,12
28286,bigrocco,,1,1,2,3
28287,d0ubleplus,,1,2,2,4
28288,capnjack,,1,10,15,25
28289,ajaycb,,1,5,2,7
28290,juu4,,1,8,19,27
28291,drksolrsing,,1,1,1,2
28292,frank_dux,,1,2,17,19
28293,Dr_Wooosh,,1,1,1,2
28294,acamus,,1,3,9,12
28295,rout39574,,1,2,2,4
28296,phreakz0r,,1,3,1,4
28297,spooonage,,1,3,2,5
28298,epic9x,,1,7,5,12
28299,Zorak,,1,261,257,518
28300,nwalker,,1,2,2,4
28301,noteed,,1,9,8,17
28302,three1oh,,1,1,1,2
28303,worthlesscomment,,1,1,8,9
28304,reddit-man_98_points,,1,6,2,8
28305,suatb,,1,3,12,15
28306,MustacheMan,,1,1,1,2
28307,neverenoughgimmicks,,1,2,3,5
28308,memebot33,,1,8,26,34
28309,HoppyMcScragg,,1,66,117,183
28310,Gairloch,,1,15,23,38
28311,jasno,,1,6,2,8
28312,Khaledk,,1,73,14,87
28313,eibat,,1,2,3,5
28314,cchooper,,1,97,106,203
28315,nicasso,,1,1,2,3
28316,panek,,1,100,81,181
28317,MattyDub,,1,13,10,23
28318,bquinlan,,1,1,1,2
28319,bobobobob,,1,18,18,36
28320,twelvehands,,1,18,3,21
28321,CiXeL,,1,289,345,634
28322,sard,,1,32,31,63
28323,grokcode,,1,15,4,19
28324,Wolydarg,,1,2,3,5
28325,vegittoss15,,1,1,1,2
28326,gislan,,1,1,1,2
28327,dr_fear,,1,14,14,28
28328,Sheber,,1,13,19,32
28329,robotshoelaces,,1,2,14,16
28330,drobilla,,1,22,45,67
28331,J-Less,,1,6,1,7
28332,plontz,,1,4,2,6
28333,robhall,,1,1,1,2
28334,dan360man,,1,534,167,701
28335,xela321,,1,16,19,35
28336,charcourt,,1,3,7,10
28337,LetsGo,,1,4,3,7
28338,proteusguy,,1,57,61,118
28339,AverageCypress,,1,2,8,10
28340,mslaven,,1,4,8,12
28341,maxcarter,,1,36,25,61
28342,jimmyjohns,,1,1,1,2
28343,MrSkov,,1,2,2,4
28344,IAmMe1,,1,8,7,15
28345,lkcl,,1,2,1,3
28346,C_Robinson,,1,7,13,20
28347,edufish,,1,1,2,3
28348,hermana,,1,171,290,461
28349,StinkyZergling,,1,2,7,9
28350,Picsman,,1,11,2,13
28351,Burnsx3,,1,8,25,33
28352,toastspork,,1,555,954,1509
28353,Syngekhoomei,,1,5,2,7
28354,Jorsh,,1,17,9,26
28355,manilagurrl75,,1,25,10,35
28356,Korvar,,1,3,6,9
28357,vej,,1,32,19,51
28358,shaneo83,,1,1,2,3
28359,plankton_gobler,,1,1,4,5
28360,posborne,,1,8,18,26
28361,kicue,,1,2,1,3
28362,large_sandwich,,1,1,1,2
28363,Onsia,,1,4,9,13
28364,FreeManOnTheLand,,1,6,17,23
28365,animatus,,1,8,1,9
28366,Shawm,,1,13,13,26
28367,faster,,1,1,2,3
28368,dysk,,1,66,95,161
28369,dmahbubanijr,,1,2,3,5
28370,sketerpot,,1,321,607,928
28371,bolshov,,1,1,1,2
28372,gerritvb,,1,45,80,125
28373,mrplow,,1,1,4,5
28374,jeff419,,1,66,38,104
28375,gosee,,1,1,1,2
28376,stallmer,,1,23,26,49
28377,LilifyFey,,1,7,13,20
28378,zanwar000,,1,1,6,7
28379,AngryOfMiddlesex,,1,1,1,2
28380,ChocChinder,,1,28,36,64
28381,randiddy,,1,1,1,2
28382,Toucan,,1,1,1,2
28383,robbie,,1,7,5,12
28384,vanstorm,,1,92,259,351
28385,shakenbacon1564,,1,1,2,3
28386,largarfaaa,,1,29,51,80
28387,demlog,,1,2,1,3
28388,jvictor118,,1,3,2,5
28389,TMM,,1,209,58,267
28390,serudla,,1,153,46,199
28391,Joshua_,,1,6,4,10
28392,GnatDog,,1,1,1,2
28393,xof711,,1,1,1,2
28394,peggelegge,,1,3,1,4
28395,markus_b,,1,2,4,6
28396,figurefaster,,1,4,13,17
28397,moyos7,,1,2,1,3
28398,robel,,1,6,7,13
28399,ratedsar,,1,82,143,225
28400,schleg,,1,12,11,23
28401,messup,,1,4,5,9
28402,heavysteve,,1,128,131,259
28403,MileStretch,,1,2,2,4
28404,trii,,1,12,9,21
28405,Csaurus,,1,2,5,7
28406,mackman,,1,2,3,5
28407,bottleneck,,1,4,2,6
28408,youranidiot,,1,19,17,36
28409,ricehead,,1,22,56,78
28410,toosheds,,1,174,51,225
28411,cachrnthry79,,1,90,48,138
28412,upperlittleappletree,,1,19,27,46
28413,viglen,,1,495,828,1323
28414,israphel,,1,1,1,2
28415,drench,,1,17,30,47
28416,nicolele12,,1,10,3,13
28417,chhintz,,1,22,40,62
28418,infekt,,1,143,151,294
28419,drhowarddrfine,,1,3,1,4
28420,kiafaldorius,,1,14,14,28
28421,anon00,,1,5,2,7
28422,20CMC,,1,4,3,7
28423,danry25,,1,1,2,3
28424,chuliomartinez,,1,5,6,11
28425,Honeymaid,,1,18,22,40
28426,wild_eep,,1,12,16,28
28427,mrbogle,,1,43,45,88
28428,cagsmith,,1,2,2,4
28429,guisar,,1,221,381,602
28430,rabuf,,1,2,1,3
28431,mbentley,,1,4,3,7
28432,AaronRowe,,1,472,28,500
28433,kiderdav,,1,4,2,6
28434,ClownSuitCowboy,,1,1,2,3
28435,crudbeans,,1,5,2,7
28436,EmptyPockets,,1,1,4,5
28437,rob90,,1,85,1,86
28438,hardyboy,,1,2,1,3
28439,showbizkid,,1,2,13,15
28440,eevo,,1,2,3,5
28441,dedalus12,,1,16,26,42
28442,daslife,,1,8,1,9
28443,cogitofire,,1,242,331,573
28444,peppapig,,1,222,2,224
28445,ModernRonin,,1,343,622,965
28446,davidjayhawk,,1,17,4,21
28447,covah,,1,2,2,4
28448,StampCollect0r,,1,13,13,26
28449,monadyne,,1,19,18,37
28450,mjolnir18,,1,1,1,2
28451,JUNK0,,1,13,25,38
28452,jesster84,,1,14,31,45
28453,shelbygt33,,1,13,25,38
28454,majinski,,1,3,10,13
28455,Zafner,,1,208,172,380
28456,dbavaria,,1,21,37,58
28457,amacarth,,1,45,7,52
28458,au5lander,,1,143,230,373
28459,Vindicator,,1,9,9,18
28460,eloisius,,1,89,46,135
28461,Double_D,,1,2,1,3
28462,jgranby,,1,1,1,2
28463,bmiljko,,1,11,2,13
28464,RainmansGirl,,1,1,2,3
28465,yourmomis1337,,1,16,11,27
28466,cal_01,,1,261,228,489
28467,gigaquack,,1,782,992,1774
28468,Adam_AD,,1,2,10,12
28469,strike2867,,1,302,463,765
28470,myhandleonreddit,,1,303,603,906
28471,Karzyn,,1,208,299,507
28472,slacks,,1,16,23,39
28473,stone11,,1,415,495,910
28474,denshi,,1,2,4,6
28475,Daemonlee,,1,2,11,13
28476,strat31,,1,263,93,356
28477,timothycutter,,1,1,1,2
28478,lazyslackerblog,,1,7,2,9
28479,Master_Rux,,1,104,138,242
28480,eanoper,,1,56,117,173
28481,joke-explainer,,1,69,38,107
28482,petdance,,1,378,435,813
28483,IAO131,,1,5,10,15
28484,the_nuclear_lobby,,1,2,4,6
28485,azadaisy,,1,4,2,6
28486,nut854,,1,5,6,11
28487,everymn,,1,111,206,317
28488,Dyyne,,1,61,18,79
28489,EternalNite,,1,6,1,7
28490,ruertar,,1,29,13,42
28491,escape_goat,,1,748,643,1391
28492,chadkeck,,1,1,2,3
28493,Flame0001,,1,141,140,281
28494,dwhee,,1,1,5,6
28495,Reddit-Politician,,1,28,1,29
28496,Yarrbles,,1,152,148,300
28497,Bodie1550,,1,32,81,113
28498,drummer9,,1,9,4,13
28499,spoilmenow,,1,1,1,2
28500,kimpira,,1,5,12,17
28501,bernakeisthedevil,,1,3,2,5
28502,StickUpKid,,1,1,1,2
28503,grandmotherfucker,,1,15,21,36
28504,mulciber,,1,2,1,3
28505,OJisGUILTY07,,1,1,2,3
28506,cinder,,1,1,1,2
28507,boozinf,,1,29,53,82
28508,DrBartosz,,1,15,15,30
28509,shadm81,,1,25,10,35
28510,VoodooIdol,,1,666,1178,1844
28511,Grinder_,,1,51,27,78
28512,meeemo,,1,3,5,8
28513,dalittribal,,1,18,47,65
28514,ricket,,1,24,32,56
28515,blorbx,,1,1,1,2
28516,iman2413,,1,2,1,3
28517,MaxCorbetti,,1,28,8,36
28518,numb3rb0y,,1,243,264,507
28519,vapor64,,1,2,1,3
28520,henryprecheur,,1,66,9,75
28521,referee,,1,17,42,59
28522,djsdotcom,,1,128,198,326
28523,lucidilullo,,1,1,1,2
28524,leftenant_wright,,1,2,3,5
28525,baringforge,,1,2,1,3
28526,throwaway1340,,1,2,3,5
28527,videowordflesh,,1,39,51,90
28528,fraudwasteabuse,,1,8,15,23
28529,hnautiyal,,1,90,140,230
28530,cornholio,,1,51,40,91
28531,paxdavid,,1,204,205,409
28532,KesshoRyu,,1,2,1,3
28533,oggelbe2007,,1,36,46,82
28534,pdizz,,1,292,295,587
28535,cvp,,1,11,11,22
28536,OolisKraprin,,1,42,33,75
28537,endtime,,1,398,436,834
28538,AndyOB,,1,7,8,15
28539,phill0,,1,668,444,1112
28540,brovril,,1,3,4,7
28541,raped_gummy_bear,,1,11,15,26
28542,perfectfire,,1,23,39,62
28543,alkaiser142,,1,13,21,34
28544,GutenSlob,,1,1,1,2
28545,seanstickle,,1,6,5,11
28546,asshammer,,1,31,33,64
28547,PhysicsMajor,,1,2,1,3
28548,grokalator,,1,2,4,6
28549,joerick,,1,24,21,45
28550,mattmason,,1,139,18,157
28551,BradC,,1,2,12,14
28552,mumrah,,1,25,33,58
28553,vplatt,,1,312,505,817
28554,voxel,,1,173,176,349
28555,Tetranitrate,,1,2,4,6
28556,ludw,,1,11,9,20
28557,MrsDePoint,,1,20,26,46
28558,Flashhater,,1,6,15,21
28559,Newspapertaxy,,1,1,4,5
28560,lusserreal,,1,1,4,5
28561,railroadmike,,1,6,5,11
28562,patzors,,1,11,10,21
28563,KelbornCmd,,1,7,27,34
28564,kidintheshadows,,1,15,51,66
28565,volvospeed,,1,4,1,5
28566,greenblatt,,1,1,1,2
28567,benjy,,1,13,13,26
28568,Fritter,,1,2,1,3
28569,nunyadambizness,,1,1,14,15
28570,keen75,,1,793,4,797
28571,Illuminarch,,1,7,11,18
28572,ibn4n,,1,2,2,4
28573,keath,,1,7,13,20
28574,chrajohn,,1,76,160,236
28575,paul3720,,1,8,17,25
28576,contextclouds,,1,27,46,73
28577,whigs,,1,12,17,29
28578,ecotraz,,1,1,1,2
28579,honestbleeps,,1,193,200,393
28580,montyalfred,,1,4,13,17
28581,prozacjack,,1,134,235,369
28582,shilkytouch,,1,6,19,25
28583,offcentric,,1,12,7,19
28584,vnast,,1,8,9,17
28585,Mr_Morley,,1,5,13,18
28586,aguyiusedtoknow,,1,4,5,9
28587,wii247,,1,13,7,20
28588,L_diablo,,1,2,1,3
28589,bolhuijo,,1,10,15,25
28590,davidsickmiller,,1,9,15,24
28591,crwper,,1,68,72,140
28592,jomamma2,,1,103,49,152
28593,itsokmom,,1,1,1,2
28594,cvk,,1,1464,424,1888
28595,mycroft61,,1,1,11,12
28596,bhan07,,1,3,2,5
28597,ZooMan,,1,41,13,54
28598,thorie79,,1,4,1,5
28599,StateRadioFan,,1,2,1,3
28600,grandon,,1,593,921,1514
28601,rpowers,,1,98,208,306
28602,bcaff05,,1,1,1,2
28603,labbrat,,1,82,53,135
28604,Arainach,,1,23,12,35
28605,irongeek,,1,1,1,2
28606,silenceofnight,,1,53,38,91
28607,OMG_Ponies,,1,62,72,134
28608,veggieburrito,,1,3,2,5
28609,arithmetic,,1,8,6,14
28610,ropiku,,1,121,26,147
28611,wookiecontrol,,1,3,7,10
28612,wampwamp,,1,3,10,13
28613,megamichan,,1,8,11,19
28614,willhaney,,1,2,7,9
28615,PaperLess,,1,1302,40,1342
28616,Negitivefrags,,1,1,1,2
28617,devinypin,,1,3,5,8
28618,2kymonk,,1,2,1,3
28619,cybercobra,,1,15,14,29
28620,shinratdr,,1,156,253,409
28621,modyoudown,,1,15,1,16
28622,smartbear,,1,12,1,13
28623,bubbleboyz,,1,2,1,3
28624,steveeso,,1,10,18,28
28625,jc_denton,,1,35,8,43
28626,colin8651,,1,24,27,51
28627,devinjay,,1,57,71,128
28628,kordos,,1,42,65,107
28629,RonPaul2012,,1,83,155,238
28630,ignitingtides,,1,1,2,3
28631,theaceoffire,,1,117,131,248
28632,khyberkitsune,,1,61,32,93
28633,IEatBabies,,1,384,685,1069
28634,nutjob,,1,13,6,19
28635,Nienor,,1,6,3,9
28636,toonces,,1,622,554,1176
28637,whathell,,1,6,7,13
28638,ChuckChuck321,,1,2,1,3
28639,omegaman1984,,1,35,22,57
28640,thewiglaf,,1,25,30,55
28641,calebros,,1,107,142,249
28642,cyclic,,1,74,41,115
28643,zeroOne1,,1,1,1,2
28644,oddbob,,1,5,1,6
28645,Diice2,,1,5,9,14
28646,captainslog,,1,7,5,12
28647,SomewhereInTime,,1,2,3,5
28648,roxyrockwell,,1,2,5,7
28649,randomgoogler,,1,1,2,3
28650,karmatjie,,1,4,4,8
28651,g0zer,,1,27,30,57
28652,Crackheadbob,,1,13,28,41
28653,notlearninglatin,,1,5,11,16
28654,haveacigaro,,1,7,9,16
28655,Snafu7,,1,3,13,16
28656,Taciturn,,1,38,46,84
28657,tbartels,,1,1,1,2
28658,rhonersutin,,1,1,1,2
28659,Fergi,,1,21,10,31
28660,shakbhaji,,1,2,4,6
28661,HotSlag,,1,5,10,15
28662,kotten,,1,24,42,66
28663,senojetan08,,1,1,1,2
28664,bedfellow,,1,1,1,2
28665,damebavaralie,,1,2,2,4
28666,charlie222,,1,2,2,4
28667,Pilot7,,1,137,95,232
28668,epsilondelta,,1,11,10,21
28669,Brackhar,,1,3,2,5
28670,joe12321,,1,13,23,36
28671,senfo,,1,1,2,3
28672,GaryX,,1,124,101,225
28673,ninjamike,,1,9,8,17
28674,blueside,,1,13,3,16
28675,jjjjjjb,,1,1,1,2
28676,raasclaat1,,1,1,1,2
28677,treevu,,1,138,59,197
28678,registerundo,,1,2,1,3
28679,MrFunions,,1,36,42,78
28680,Johnny_5,,1,1,6,7
28681,Shafi,,1,3,1,4
28682,inomniaparatus,,1,7,15,22
28683,dougmataconis,,1,1425,278,1703
28684,bringswisdom,,1,25,56,81
28685,zugnush,,1,2,2,4
28686,runxctry,,1,17,19,36
28687,smullaney,,1,22,13,35
28688,spasmdaze,,1,15,1,16
28689,jon_smith_1980,,1,1,2,3
28690,Baseline,,1,87,110,197
28691,bobx11,,1,4,4,8
28692,percypersimmon,,1,25,30,55
28693,mjm1374,,1,33,25,58
28694,beefcake1234,,1,1,1,2
28695,Chrysophrase,,1,134,197,331
28696,blawa,,1,4,10,14
28697,unfocused1,,1,8,8,16
28698,Chirp08,,1,595,858,1453
28699,hutchbunny,,1,23,46,69
28700,TokyoXtreme,,1,9,33,42
28701,bassbin,,1,94,113,207
28702,hourigan,,1,293,2,295
28703,jamiepitts,,1,5,10,15
28704,Freedelivery,,1,25,53,78
28705,BobJobs,,1,36,1,37
28706,dpinh,,1,4,2,6
28707,evtedeschi3,,1,97,33,130
28708,thevza,,1,6,4,10
28709,nurd,,1,1,1,2
28710,TrueTom,,1,74,73,147
28711,mothraStewart,,1,32,33,65
28712,dhain,,1,1,1,2
28713,julirocks,,1,173,139,312
28714,zzcm,,1,9,12,21
28715,dirtysherman,,1,1,1,2
28716,den_of_thieves,,1,1,2,3
28717,taul,,1,7,11,18
28718,tamar,,1,156,9,165
28719,andreyseven,,1,4,11,15
28720,cmessner,,1,2,1,3
28721,zeppelinfromled,,1,253,352,605
28722,youlikethat,,1,16,5,21
28723,rbrt,,1,4,1,5
28724,bensig,,1,2,1,3
28725,tashbarg,,1,80,107,187
28726,AvatarOfErebus,,1,20,33,53
28727,captainpuma,,1,1,4,5
28728,daveb5,,1,1,1,2
28729,carioca76,,1,1,2,3
28730,jining,,1,4,5,9
28731,bradediger,,1,34,64,98
28732,chauss7,,1,160,113,273
28733,RyanSeacrest,,1,40,44,84
28734,Transistor,,1,1,1,2
28735,criis,,1,22,40,62
28736,weeksie,,1,52,59,111
28737,PuppetBoy,,1,10,24,34
28738,vexxor,,1,21,16,37
28739,earlycj5,,1,1,2,3
28740,samuel1411,,1,16,26,42
28741,vilator,,1,8,14,22
28742,aikiai,,1,20,26,46
28743,fretbuzz,,1,99,63,162
28744,demizer,,1,77,98,175
28745,christophe971,,1,1,1,2
28746,iriscoler,,1,78,17,95
28747,toddlb,,1,3,5,8
28748,mcccain,,1,3,1,4
28749,tbmcmullen,,1,13,9,22
28750,tskegel,,1,10,10,20
28751,DrDichotomous,,1,42,90,132
28752,tepas,,1,14,16,30
28753,stsaby,,1,30,29,59
28754,gtc55,,1,10,2,12
28755,cake3412,,1,7,9,16
28756,ioni3000,,1,17,6,23
28757,rkag,,1,38,83,121
28758,Gorgomon,,1,99,23,122
28759,johnw188,,1,91,66,157
28760,Naga,,1,97,114,211
28761,adam75,,1,7,1,8
28762,ramibotros,,1,3,14,17
28763,zz101,,1,21,20,41
28764,ani625,,1,528,114,642
28765,Procrastinator,,1,2,3,5
28766,drplump,,1,3,15,18
28767,mr-datter,,1,2,1,3
28768,ilikeyou,,1,16,16,32
28769,moxiepuff,,1,188,282,470
28770,theDook,,1,1,1,2
28771,LazloHollifeld,,1,13,18,31
28772,SuperSnooper,,1,3,4,7
28773,ws1984,,1,6,3,9
28774,thall,,1,1,7,8
28775,Korova,,1,1,2,3
28776,rbblum,,1,1,4,5
28777,General_Solipsist,,1,128,239,367
28778,bodyheatstarempire,,1,4,3,7
28779,Naedlus,,1,1,4,5
28780,Digeratus,,1,173,193,366
28781,iolokus,,1,5,3,8
28782,Ciserus,,1,678,767,1445
28783,mirach,,1,1,2,3
28784,crikey321,,1,25,4,29
28785,IckPooYuck,,1,1,1,2
28786,mattchambers,,1,1,2,3
28787,jeffehobbs,,1,438,184,622
28788,geekner,,1,78,124,202
28789,sun_tzu,,1,10,16,26
28790,glebd,,1,12,22,34
28791,Chknbone,,1,80,137,217
28792,mtraven,,1,13,17,30
28793,ElectricMoose,,1,19,46,65
28794,DrDystopia,,1,134,268,402
28795,unpossible,,1,6,10,16
28796,rannic,,1,1,1,2
28797,Open_Your_Eyes,,1,169,51,220
28798,tehmatticus,,1,59,75,134
28799,loveline,,1,32,18,50
28800,tulrich,,1,58,57,115
28801,blackmothsuperainbow,,1,1,2,3
28802,ChipotleSalad,,1,4,9,13
28803,Sr_Moreno,,1,161,121,282
28804,Speckles,,1,2,1,3
28805,askalyuk,,1,3,2,5
28806,logicpill,,1,5,13,18
28807,nmcnulty,,1,1,1,2
28808,smooshie,,1,562,9,571
28809,tasharanee,,1,4,9,13
28810,gaso,,1,223,346,569
28811,upside_down,,1,3,2,5
28812,picklefeather,,1,87,4,91
28813,nimm,,1,5,4,9
28814,Gh057h4k,,1,70,40,110
28815,domston,,1,29,20,49
28816,draught,,1,7,5,12
28817,Bossman1086,,1,139,213,352
28818,tdf27,,1,33,20,53
28819,dakboy,,1,357,533,890
28820,rcar,,1,7,10,17
28821,animesh1977,,1,5,3,8
28822,LiviaLive,,1,3,4,7
28823,yourthreecents,,1,184,2,186
28824,noodhoog,,1,12,31,43
28825,essjay2009,,1,45,44,89
28826,clambucket,,1,15,11,26
28827,polarbz,,1,43,74,117
28828,OSUbuckeye,,1,11,18,29
28829,ryanlowe,,1,3,4,7
28830,voteup,,1,2,12,14
28831,welldoitliveFUCKIT,,1,4,2,6
28832,Lone_Wolf,,1,35,57,92
28833,gau_veldt,,1,17,59,76
28834,Wiggin,,1,2,1,3
28835,joshuamckenty,,1,5,5,10
28836,Spytap,,1,7,13,20
28837,alergictomorning,,1,1,1,2
28838,jeremiahrogers,,1,1,3,4
28839,OlympicPirate,,1,1381,1847,3228
28840,craybur,,1,31,68,99
28841,losslessignal,,1,3,4,7
28842,duncanwilde,,1,11,11,22
28843,shen,,1,70,92,162
28844,bagammon,,1,4,6,10
28845,fleetmouse,,1,11,21,32
28846,MaryjaneBrewington,,1,9,44,53
28847,Todes,,1,28,27,55
28848,wengem,,1,1,2,3
28849,zachsandberg,,1,1,1,2
28850,simianrusselli,,1,2,1,3
28851,babaganushka,,1,2,5,7
28852,zergl1ng,,1,62,25,87
28853,hanz,,1,2,4,6
28854,frummidge,,1,23,51,74
28855,watermillvillage,,1,10,21,31
28856,ExplodingBob,,1,242,341,583
28857,gbypass654,,1,2,1,3
28858,JSiobhan,,1,3,6,9
28859,pinxox,,1,187,198,385
28860,elezeta,,1,116,172,288
28861,Greyholme,,1,1,1,2
28862,Doane,,1,368,3,371
28863,BusinessDelivery,,1,2,4,6
28864,headcrabcake,,1,2,3,5
28865,saleop,,1,14,15,29
28866,CalvinR,,1,102,122,224
28867,zaius,,1,2,1,3
28868,jsantos17,,1,62,105,167
28869,markncream,,1,26,19,45
28870,viciousglue,,1,2,6,8
28871,3dimka,,1,61,95,156
28872,Cunstitutionalist,,1,45,90,135
28873,ambulatorybird,,1,1,1,2
28874,jfredett,,1,345,615,960
28875,frayed_knot,,1,2,1,3
28876,mrdelayer,,1,16,2,18
28877,maalyex,,1,2,1,3
28878,osmosisgenius,,1,31,50,81
28879,thinksalot,,1,2,6,8
28880,thecoollamer,,1,59,5,64
28881,KimRae,,1,1,1,2
28882,Mrgalikanookis,,1,1,4,5
28883,erikw,,1,27,54,81
28884,giorgioagamben,,1,10,5,15
28885,Anemonerr,,1,54,5,59
28886,atlacatl,,1,451,740,1191
28887,Miser,,1,7,13,20
28888,redjeb,,1,26,26,52
28889,bigmajor,,1,7,2,9
28890,seamusm,,1,39,2,41
28891,beeff,,1,2,1,3
28892,nicolaslloyd,,1,183,349,532
28893,weegee,,1,1009,1089,2098
28894,aleon010,,1,1,1,2
28895,kukon,,1,462,15,477
28896,cyrano741,,1,3,9,12
28897,mareek,,1,5,2,7
28898,tanstaafl90,,1,152,294,446
28899,defyapathy,,1,1,1,2
28900,mlpnko,,1,5,1,6
28901,zestytaco,,1,1,1,2
28902,neoice,,1,222,332,554
28903,torgeze,,1,3,1,4
28904,Khuldan,,1,26,2,28
28905,shad0w_walker,,1,10,22,32
28906,jespern,,1,52,56,108
28907,EndymionAwake,,1,280,412,692
28908,anodes,,1,310,433,743
28909,krapfi,,1,1,1,2
28910,Wakuko,,1,92,124,216
28911,theothemonkey,,1,2,1,3
28912,aju2,,1,17,12,29
28913,Tanuki0,,1,8,9,17
28914,j4m3z,,1,6,1,7
28915,willfull,,1,5,17,22
28916,dillbilly,,1,21,38,59
28917,ILoveBlowjobs,,1,1,1,2
28918,wormwood_pearl,,1,171,44,215
28919,bofh,,1,71,142,213
28920,mdsvanc,,1,1,1,2
28921,wejorg,,1,3,4,7
28922,Raptor563,,1,121,72,193
28923,Gforce20,,1,6,12,18
28924,jjohnston,,1,11,11,22
28925,hoss-style,,1,491,7,498
28926,changy82,,1,1,1,2
28927,jrichmond,,1,1,1,2
28928,antena,,1,7,13,20
28929,markusmark,,1,17,35,52
28930,pawntokingspawn,,1,4,10,14
28931,Parrot57,,1,1,2,3
28932,tgbyhn,,1,308,2,310
28933,acsync,,1,3,3,6
28934,ksnap,,1,8,13,21
28935,SlvrEagle23,,1,244,239,483
28936,acidfire,,1,9,25,34
28937,jlongster,,1,68,24,92
28938,xxtreem,,1,1,1,2
28939,amurriken,,1,2,2,4
28940,DNME,,1,22,24,46
28941,szetlan,,1,1,1,2
28942,Renshai,,1,1,2,3
28943,mao_neko,,1,213,366,579
28944,elasticsoul,,1,997,1556,2553
28945,dontknowhwattodo,,1,1,1,2
28946,destraynor,,1,2,2,4
28947,mzappitello,,1,1,3,4
28948,partyjess,,1,216,12,228
28949,GoldbachsConjecture,,1,2,1,3
28950,itsgoodya,,1,1,3,4
28951,TopicA1,,1,178,70,248
28952,mwgore,,1,2,2,4
28953,bellboy,,1,66,111,177
28954,redder4322,,1,8,16,24
28955,divbyzero,,1,42,43,85
28956,coob,,1,336,377,713
28957,Maeglom,,1,116,218,334
28958,youropinionisnotfact,,1,1,1,2
28959,greenknight,,1,113,256,369
28960,NekoKaneko,,1,2,3,5
28961,LeonGrey,,1,24,6,30
28962,inversionofhope,,1,22,14,36
28963,frnzy,,1,2,8,10
28964,mangodrunk,,1,528,804,1332
28965,SaidTheShotgun,,1,1,2,3
28966,ustgblerkvusrd,,1,70,96,166
28967,itaborai83,,1,2,3,5
28968,norwegianwood,,1,50,29,79
28969,Pseudoscience,,1,2,2,4
28970,kunalgoel,,1,8,8,16
28971,libertybangor,,1,2,2,4
28972,skinniouschinnious,,1,51,40,91
28973,rhnigl,,1,21,27,48
28974,Pirat,,1,2,5,7
28975,z0gf7,,1,5,2,7
28976,PriestofSyrinx,,1,8,14,22
28977,SitPoMk,,1,1,1,2
28978,roydog11,,1,1,1,2
28979,gfish3000,,1,1,3,4
28980,Overreacting_Old_Man,,1,3,4,7
28981,jwilke,,1,6,4,10
28982,Katarungan,,1,4,10,14
28983,malthusian,,1,11,17,28
28984,2p1s,,1,2,1,3
28985,achiebaba,,1,13,32,45
28986,osfn8,,1,9,72,81
28987,mediaspree,,1,1,1,2
28988,Laodicea,,1,88,7,95
28989,134KS,,1,11,13,24
28990,DiscoWolf,,1,144,220,364
28991,00j,,1,2,2,4
28992,evilwombat,,1,281,467,748
28993,jtune,,1,1,1,2
28994,bgiltner,,1,2,2,4
28995,drif,,1,3,1,4
28996,you_ve,,1,6,12,18
28997,tweiler,,1,1,3,4
28998,gnrfan,,1,10,1,11
28999,dieselcreek2,,1,4,6,10
29000,snair,,1,340,708,1048
29001,greekgeek,,1,1,1,2
29002,jpnkevin,,1,46,19,65
29003,dorkasaurus,,1,1,6,7
29004,glenndo,,1,30,44,74
29005,citizen_j,,1,15,3,18
29006,Thespus,,1,7,12,19
29007,Ebirah,,1,58,88,146
29008,Theisos,,1,1,1,2
29009,judgej2,,1,1538,2743,4281
29010,vansciver,,1,5,5,10
29011,pazoo,,1,1,3,4
29012,tetsuto,,1,1,2,3
29013,zonkzor,,1,88,103,191
29014,zikks,,1,19,33,52
29015,misterme,,1,14,28,42
29016,waz67,,1,6,4,10
29017,starseed42,,1,28,46,74
29018,Daniel_Plainview,,1,16,17,33
29019,donnyg16,,1,6,4,10
29020,Still_Hillary,,1,1,1,2
29021,aricene,,1,7,12,19
29022,spoony,,1,8,12,20
29023,Forgery,,1,4,2,6
29024,IustinusM,,1,4,9,13
29025,smanek,,1,76,12,88
29026,spaceghost0r,,1,35,24,59
29027,tubes,,1,3,3,6
29028,scootertronic,,1,4,3,7
29029,sms4share,,1,1,1,2
29030,jmelesky,,1,189,174,363
29031,cowboytronic,,1,42,74,116
29032,q-bit,,1,3,4,7
29033,DeathWish808,,1,103,22,125
29034,campbellm,,1,31,15,46
29035,dubled,,1,35,27,62
29036,onmytoes,,1,65,11,76
29037,simonhsu,,1,6,6,12
29038,ebendread,,1,8,20,28
29039,Aaronontheweb,,1,9,15,24
29040,sd897,,1,1,1,2
29041,ShawnGupta,,1,208,202,410
29042,jrnewton,,1,8,22,30
29043,SnavenShake,,1,2,5,7
29044,jarwiz1,,1,6,5,11
29045,mythicalbyrd,,1,15,31,46
29046,Astroturfer,,1,2,6,8
29047,siffinleex,,1,2,4,6
29048,gregd,,1,324,68,392
29049,archibaldcox,,1,1,1,2
29050,idiotwithastick,,1,49,45,94
29051,bleedingdark,,1,2,9,11
29052,stealtheair,,1,10,8,18
29053,redbenn,,1,24,55,79
29054,schwindelkonto,,1,2,9,11
29055,rughmanchoo,,1,4,5,9
29056,freeloadr,,1,3,2,5
29057,IHaG0Fw,,1,54,53,107
29058,keptblue,,1,133,127,260
29059,m242,,1,5,3,8
29060,dsch1,,1,10,22,32
29061,lilylauren,,1,66,3,69
29062,fridesntrom,,1,30,44,74
29063,quintios,,1,1,3,4
29064,sirgallium,,1,9,16,25
29065,c7272,,1,42,4,46
29066,mochaboy,,1,6,15,21
29067,pong,,1,1,1,2
29068,ypostelnik,,1,22,1,23
29069,rperk,,1,1,3,4
29070,Captain-Ambivalent,,1,1,2,3
29071,jubalicious,,1,2,3,5
29072,jpgetout,,1,86,50,136
29073,zygy,,1,2,10,12
29074,Silvent,,1,2,2,4
29075,subcultured,,1,4,2,6
29076,gluino,,1,104,117,221
29077,hard2kill,,1,73,12,85
29078,msakas,,1,259,606,865
29079,dominosci,,1,7,10,17
29080,calliopejones,,1,12,5,17
29081,MrUnhappy,,1,12,15,27
29082,Kalimotxo,,1,66,100,166
29083,0in0out,,1,2,1,3
29084,benjidog,,1,1,1,2
29085,mik0r,,1,10,25,35
29086,WreckRoom,,1,12,12,24
29087,BayState,,1,7,5,12
29088,Spunt,,1,4,8,12
29089,wrestle4228,,1,14,36,50
29090,mattymomostl,,1,275,171,446
29091,mudkiller,,1,1,9,10
29092,bigboomer223,,1,335,116,451
29093,FreeThingLostMyWay,,1,41,64,105
29094,dutchmcnubb,,1,3,10,13
29095,redchuck,,1,8,9,17
29096,posthole,,1,13,19,32
29097,Crontab,,1,6,8,14
29098,MegaKN,,1,77,90,167
29099,smackson,,1,99,133,232
29100,mickeymongoose,,1,2,2,4
29101,javajunkie,,1,2,5,7
29102,MotTheBarber,,1,1,4,5
29103,obama2012,,1,5,9,14
29104,eawesome3,,1,35,37,72
29105,nagrom,,1,7,10,17
29106,AdamPan,,1,30,67,97
29107,sameoldmike,,1,9,8,17
29108,LewP,,1,9,8,17
29109,charlesm,,1,4,1,5
29110,timmy6591,,1,125,172,297
29111,johnflynn50,,1,8,6,14
29112,slice,,1,2,8,10
29113,sonyturbo,,1,3,2,5
29114,sknob,,1,2,1,3
29115,huipot24,,1,2,3,5
29116,repster,,1,62,103,165
29117,poplin,,1,4,2,6
29118,Rapidog,,1,1,4,5
29119,HottenTotten,,1,6,2,8
29120,dherve,,1,16,6,22
29121,damncommies27,,1,8,1,9
29122,homerdash,,1,11,17,28
29123,stevanl,,1,4,7,11
29124,alfador,,1,9,11,20
29125,Stupidfish,,1,13,16,29
29126,rbuschur,,1,5,5,10
29127,JeffMo,,1,112,161,273
29128,djninjastar,,1,7,10,17
29129,CecilDL,,1,2,7,9
29130,Specul8,,1,6,7,13
29131,yar18,,1,3,7,10
29132,JoJoMan18,,1,7,10,17
29133,aldhelm,,1,420,477,897
29134,enterthepizza,,1,4,9,13
29135,Gigabyte,,1,5,6,11
29136,Flipp100,,1,2,1,3
29137,TheUsher,,1,62,108,170
29138,liubsgilasdubg,,1,1,1,2
29139,hugolp,,1,35,34,69
29140,fuck_obama,,1,2,5,7
29141,makubex,,1,154,200,354
29142,bunnyfart,,1,34,62,96
29143,PC_LOAD_LETTER,,1,2,2,4
29144,insertamusingmoniker,,1,61,49,110
29145,Parmanoir,,1,3,4,7
29146,voodoochi1d,,1,2,9,11
29147,youcaughtafish,,1,2,5,7
29148,jus10case,,1,1,1,2
29149,nachof,,1,79,102,181
29150,cuil_theoretician,,1,1,1,2
29151,lastmovement,,1,71,3,74
29152,mbreese,,1,18,18,36
29153,redditor55,,1,1,1,2
29154,Crath,,1,14,23,37
29155,melonhedd,,1,24,26,50
29156,tr0y,,1,1,2,3
29157,fr1j0l3,,1,40,27,67
29158,33a,,1,19,13,32
29159,jbonura,,1,2,1,3
29160,chakl,,1,5,3,8
29161,redditHQ,,1,4,5,9
29162,majikmixx,,1,2,3,5
29163,kandicole,,1,1,1,2
29164,adnan278,,1,4,1,5
29165,redberyl,,1,2,2,4
29166,pinkhamster,,1,1,3,4
29167,ascus4,,1,150,282,432
29168,mcnicholl,,1,22,7,29
29169,mredd,,1,52,89,141
29170,esker,,1,1,3,4
29171,obehag,,1,4,9,13
29172,ollie77,,1,4,6,10
29173,Hookstra,,1,87,59,146
29174,sabaidee,,1,107,115,222
29175,bunkmonkee,,1,17,5,22
29176,gregglind,,1,6,8,14
29177,lol_at_haskell,,1,2,1,3
29178,Merendino,,1,8,7,15
29179,wrybabydave,,1,2,3,5
29180,immure,,1,7,10,17
29181,flow207,,1,18,15,33
29182,315was_an_inside_job,,1,455,721,1176
29183,droden,,1,42,101,143
29184,JackBower,,1,1,4,5
29185,cynosargos,,1,1,3,4
29186,tharris7,,1,22,31,53
29187,rmarson,,1,2,1,3
29188,ulissescosta,,1,7,2,9
29189,mkaplan,,1,15,18,33
29190,nknezek,,1,14,15,29
29191,pantaloon,,1,33,46,79
29192,deltawk,,1,1,3,4
29193,arctyr,,1,4,9,13
29194,cottonbuds,,1,9,2,11
29195,spinn,,1,24,68,92
29196,spectorjay,,1,15,41,56
29197,jollynix,,1,2,15,17
29198,eddhillman,,1,24,55,79
29199,whatthehellbro,,1,1,1,2
29200,seanconwell,,1,58,76,134
29201,thegreatgazoo,,1,315,361,676
29202,djwohls,,1,12,19,31
29203,Professor-Subtle,,1,1,1,2
29204,jonopei,,1,1,3,4
29205,jmcstar,,1,9,17,26
29206,DiamondBack,,1,258,471,729
29207,pitapa,,1,115,2,117
29208,hardoncollider,,1,2,4,6
29209,dtuur,,1,2,1,3
29210,tendeuchen,,1,1,5,6
29211,Amythystnights,,1,4,2,6
29212,modulus,,1,80,127,207
29213,Mikle,,1,161,218,379
29214,dufflove,,1,11,15,26
29215,FreedomForever,,1,16,24,40
29216,kissmychrome,,1,1,2,3
29217,Undertoad,,1,50,59,109
29218,seandxi,,1,1,3,4
29219,senright,,1,1,2,3
29220,rcunningham,,1,1,2,3
29221,flyingpostman,,1,11,9,20
29222,gsiener,,1,8,12,20
29223,thepipirate,,1,149,211,360
29224,corellia40,,1,5,3,8
29225,tunedradio,,1,36,4,40
29226,thejesse,,1,4,6,10
29227,spooniep,,1,1,2,3
29228,brettfromtibet,,1,14,11,25
29229,Mark0Pon,,1,2,4,6
29230,nnagflar,,1,18,17,35
29231,teraflop,,1,112,145,257
29232,uncannyvalley,,1,15,27,42
29233,francoMJ,,1,1,19,20
29234,Saxe-Coburg-Gotha,,1,4,24,28
29235,thebeef,,1,40,53,93
29236,rtaito,,1,1,1,2
29237,koskos,,1,27,33,60
29238,El_Colombo10,,1,1,4,5
29239,eggnet,,1,21,31,52
29240,mpn,,1,1,1,2
29241,fludgesickles,,1,9,7,16
29242,Spire,,1,5,2,7
29243,taromsn,,1,1,3,4
29244,gbot,,1,3,2,5
29245,Johnny_Cash,,1,440,623,1063
29246,botbooty,,1,4,2,6
29247,putney,,1,280,162,442
29248,trb122387,,1,1,3,4
29249,quaker1729,,1,57,131,188
29250,polveroj,,1,6,14,20
29251,jjsb64,,1,1,2,3
29252,cvinson86,,1,1,3,4
29253,soonago,,1,1,1,2
29254,ashok,,1,54,37,91
29255,doubleviking,,1,1,5,6
29256,daver,,1,46,25,71
29257,miles_dad,,1,45,55,100
29258,Kleenex1,,1,76,12,88
29259,azazello3,,1,8,4,12
29260,rza,,1,8,4,12
29261,RacistConspiracy,,1,3,1,4
29262,chlamydia,,1,1,1,2
29263,kahoonas,,1,18,28,46
29264,phire,,1,152,203,355
29265,FrothyKillsKittens,,1,23,38,61
29266,ambiversive,,1,161,122,283
29267,jackdot1,,1,2,2,4
29268,lolcatraptorjesus,,1,2,5,7
29269,stiltzor,,1,3,3,6
29270,charlesgrrr,,1,556,455,1011
29271,ActualArticle,,1,7,9,16
29272,Higgs,,1,10,4,14
29273,cocorobot,,1,131,205,336
29274,samurai725,,1,28,54,82
29275,armadalol,,1,4,5,9
29276,bertacus,,1,12,16,28
29277,postlogic,,1,1,2,3
29278,nickadams,,1,15,22,37
29279,soeric,,1,15,11,26
29280,kevin28282,,1,1,4,5
29281,kundera1,,1,7,1,8
29282,simsea,,1,41,58,99
29283,gbouchard,,1,3,8,11
29284,nixcamic,,1,105,176,281
29285,penisbird,,1,6,11,17
29286,Blergh,,1,1,1,2
29287,Midness,,1,6,8,14
29288,BrianRCampbell,,1,11,15,26
29289,podperson,,1,292,337,629
29290,opengovt,,1,2,2,4
29291,Nadia4077,,1,1,1,2
29292,inerte,,1,14,18,32
29293,Reorax,,1,2,7,9
29294,lisper,,1,132,24,156
29295,RovertP,,1,1,1,2
29296,blackhat,,1,15,3,18
29297,ghpoobah,,1,21,25,46
29298,terryducks,,1,1,1,2
29299,whatnowbitch,,1,1,3,4
29300,Agent00funk,,1,11,13,24
29301,americagreedgreed,,1,1,1,2
29302,kharmel,,1,34,28,62
29303,somanybutts,,1,59,112,171
29304,scrubber,,1,2,1,3
29305,arjuan,,1,2,9,11
29306,beefmagnet,,1,7,8,15
29307,celticraven,,1,1,2,3
29308,WhoreChurch,,1,270,338,608
29309,Manuzhai,,1,298,104,402
29310,rbobby,,1,178,272,450
29311,hhhseses,,1,1,1,2
29312,demented_pants,,1,102,76,178
29313,supafupa,,1,1,8,9
29314,ebrunar,,1,2,2,4
29315,aek82,,1,2,9,11
29316,tamrix,,1,15,23,38
29317,bzavadil,,1,2,2,4
29318,cstuart,,1,1,1,2
29319,tgeliot,,1,33,56,89
29320,upnation,,1,18,7,25
29321,pedrobelo,,1,52,24,76
29322,LeRenard,,1,87,210,297
29323,jasonreid,,1,3,4,7
29324,LookWhosHere,,1,27,5,32
29325,JRepin,,1,224,20,244
29326,Urdna,,1,5,7,12
29327,ProphetV,,1,1,1,2
29328,synspark,,1,2,4,6
29329,inkkungfu,,1,4,1,5
29330,rline928,,1,4,4,8
29331,sitq,,1,7,7,14
29332,yellowdwarf,,1,122,2,124
29333,localhost80,,1,2,2,4
29334,Korollary,,1,32,73,105
29335,remiprev,,1,1,1,2
29336,russpinke,,1,4,1,5
29337,fukifino,,1,13,28,41
29338,rivethaus,,1,2,2,4
29339,feizouhema,,0,1,1,2
29340,trocar,,1,107,118,225
29341,damselinadress,,1,3,1,4
29342,skuunk,,1,10,22,32
29343,JOA23,,1,21,33,54
29344,vcyhju7yt,,1,3,1,4
29345,yahaya,,1,168,121,289
29346,enivid,,1,32,1,33
29347,HalCion,,1,292,473,765
29348,qualiaqueen,,1,10,2,12
29349,rvsdrvs,,1,1,3,4
29350,figa,,1,11,11,22
29351,Odog,,1,3,5,8
29352,the-ace,,1,2,4,6
29353,tripartisan,,1,159,26,185
29354,blrbytes,,1,1,3,4
29355,peroyo,,1,217,124,341
29356,robinhd,,1,51,25,76
29357,AlGoretex,,1,4,7,11
29358,grigorescu,,1,43,22,65
29359,nalf38,,1,117,218,335
29360,kiwi90fsu,,1,4,6,10
29361,jondue,,1,6,10,16
29362,TheFeds,,1,1,1,2
29363,radicade,,1,4,3,7
29364,drakino,,1,1,1,2
29365,gjx86,,1,12,9,21
29366,commongiga,,1,160,60,220
29367,naysayer123,,1,11,17,28
29368,flarkenhoffy,,1,11,29,40
29369,poptarts,,1,2,4,6
29370,Thwart,,1,185,579,764
29371,nightchrome,,1,16,21,37
29372,McBushLies,,1,85,67,152
29373,shoy,,1,7,6,13
29374,robic,,1,1,6,7
29375,MechaBlue,,1,104,155,259
29376,Starks,,1,9,14,23
29377,bobbane,,1,43,64,107
29378,wroth,,1,3,6,9
29379,hellomudda,,1,17,26,43
29380,dev-urandom,,1,13,6,19
29381,jimmyr,,1,4,1,5
29382,AerialAdvertising,,1,2,1,3
29383,homar,,1,3,5,8
29384,tatinthehat,,1,6,13,19
29385,ZippyDan,,1,40,50,90
29386,jugimaster,,1,1,1,2
29387,cowpowered,,1,20,14,34
29388,Deacon,,1,1069,2138,3207
29389,htsoulja66,,1,5,9,14
29390,rumrokh,,1,324,161,485
29391,redditer004,,1,2,3,5
29392,lungdart,,1,30,33,63
29393,kortneypayge,,1,1,1,2
29394,eightbithero,,1,4,6,10
29395,oldy,,1,7,5,12
29396,dfgsdja,,1,3,1,4
29397,RJHinton,,1,52,34,86
29398,vulgar,,1,8,4,12
29399,steved3298,,1,3,2,5
29400,noodler,,1,26,38,64
29401,homeathouse2,,1,1,1,2
29402,emindead,,1,2,2,4
29403,MC_Shortbus,,1,12,14,26
29404,tanasinn,,1,4,5,9
29405,whatsreal,,1,3,5,8
29406,crashwhack,,1,4,3,7
29407,optimizeprime,,1,34,23,57
29408,jimfitz,,1,4,1,5
29409,Toggan,,1,3,4,7
29410,jamesmnz,,1,3,7,10
29411,AthlonRob,,1,62,74,136
29412,Creative_User_Name,,1,3,1,4
29413,genida,,1,116,136,252
29414,fios,,1,4,1,5
29415,ricemilk,,1,10,11,21
29416,Uncial,,1,102,163,265
29417,gabort,,1,107,9,116
29418,billycreate,,1,28,33,61
29419,remcoder,,1,3,1,4
29420,megalodon77,,1,1,6,7
29421,loonatic,,1,5,8,13
29422,rumdiary,,1,2,2,4
29423,sweetholymosiah,,1,4,10,14
29424,Mormolyke,,1,9,9,18
29425,remko,,1,9,6,15
29426,bole33mo,,1,1,1,2
29427,ADHD,,1,6,8,14
29428,Ozymandi,,1,88,86,174
29429,nopal,,1,18,5,23
29430,victorcrowns,,1,5,2,7
29431,vava,,1,208,592,800
29432,socksuka,,1,3,1,4
29433,ftothe3,,1,75,61,136
29434,dijxtra,,1,20,9,29
29435,Ksilebo,,1,30,79,109
29436,2343984098,,1,2,5,7
29437,ndt,,1,2,1,3
29438,obamaobama,,1,21,12,33
29439,BIllyHatesYou,,1,1,3,4
29440,poostew,,1,5,3,8
29441,crumbelievable,,1,6,10,16
29442,n1ik,,1,2,3,5
29443,wreckshop,,1,1,2,3
29444,lubjob12,,1,2,8,10
29445,DuncanCV,,1,80,26,106
29446,apok,,1,41,9,50
29447,oliverdaniel,,1,51,7,58
29448,xankriz,,1,29,26,55
29449,CancerLancer,,1,4,1,5
29450,jasonr11,,1,9,4,13
29451,cr0n1c,,1,12,3,15
29452,MsHappyDance,,1,1,1,2
29453,sonyasav,,1,1,2,3
29454,shylockfox,,1,1,1,2
29455,WritersCoin,,1,8,12,20
29456,JackyPaper320,,1,2,3,5
29457,alger82,,1,40,9,49
29458,elemenohpee,,1,251,286,537
29459,stephenactually,,1,7,6,13
29460,DrBone,,1,34,29,63
29461,fkyrnf,,1,4,8,12
29462,dhhlovely,,1,6,2,8
29463,nullpointer0x00,,1,1,3,4
29464,tylerbgood,,1,13,15,28
29465,caribbeing,,1,2,6,8
29466,redshirt67,,1,4,5,9
29467,hotani,,1,1,6,7
29468,MarkZspot,,1,23,46,69
29469,pacifist16,,1,6,2,8
29470,chiguy,,1,25,27,52
29471,funkybjorn,,1,65,9,74
29472,kymar911,,1,2,1,3
29473,themightymouse,,1,12,2,14
29474,bang_wanger,,1,5,11,16
29475,thatsthelawinbritain,,1,1,1,2
29476,DrunkMc,,1,4,5,9
29477,FryDuck,,1,14,19,33
29478,Gentle_Pirate,,1,8,8,16
29479,greenwizard,,1,158,335,493
29480,Theoneisis,,1,4,17,21
29481,kd5bjo,,1,3,1,4
29482,MSWsHusband,,1,2,6,8
29483,g123,,1,61,56,117
29484,lovingkindness,,1,1,4,5
29485,roflburger,,1,138,119,257
29486,imfm,,1,4,7,11
29487,fenris23,,1,2,3,5
29488,Arth-Vader,,1,1,1,2
29489,spedmyster,,1,32,38,70
29490,Scooby0,,1,25,46,71
29491,jhrace2,,1,14,12,26
29492,novous,,1,19,30,49
29493,RockinRoel,,1,330,561,891
29494,MetalPig,,1,2,3,5
29495,lempo,,1,3,7,10
29496,jimmiejaz,,1,119,102,221
29497,JamesM_,,1,2,1,3
29498,statictype,,1,264,318,582
29499,twodayslate,,1,190,173,363
29500,yaniikk78,,1,1,1,2
29501,02021345,,1,5,6,11
29502,backinblack,,1,3,4,7
29503,degustiwagoneer,,1,63,62,125
29504,Tim2thaTom,,1,1,1,2
29505,corybantic,,1,1,8,9
29506,philldiamond,,1,2,1,3
29507,kronholm,,1,25,30,55
29508,blalpha,,1,7,8,15
29509,u2knapp,,1,9,11,20
29510,znsh18,,1,2,3,5
29511,nrmehta,,1,1,1,2
29512,jart,,1,4,4,8
29513,gr4kk3r,,1,5,9,14
29514,krispykrackers,,1,972,859,1831
29515,Max4000,,1,3,4,7
29516,wrathael,,1,2,4,6
29517,rzza,,1,42,25,67
29518,edgarvm,,1,2,6,8
29519,SelahSoItGoes,,1,78,111,189
29520,MrDallreen,,1,5,3,8
29521,syntheticpubes,,1,56,2,58
29522,DeadBent,,1,33,54,87
29523,woowoooo,,1,4,14,18
29524,ilan,,1,9,6,15
29525,taniaderveaux,,1,154,3,157
29526,chromakode,,1,349,260,609
29527,nostrademons,,1,375,473,848
29528,sybersonic,,1,92,40,132
29529,ryansmeets,,1,5,1,6
29530,jweebo,,1,31,46,77
29531,toddmanqa,,1,1,1,2
29532,kellegous,,1,14,1,15
29533,Nexus_Zero,,1,5,4,9
29534,Ohfscott,,1,1,2,3
29535,rmtatum,,1,6,2,8
29536,esdraelon,,1,11,8,19
29537,scarheel,,1,24,41,65
29538,pyramix,,1,3,4,7
29539,cibyr,,1,54,26,80
29540,sterne,,1,29,34,63
29541,jcal,,1,15,24,39
29542,WanderingStars,,1,11,30,41
29543,pja,,1,5,8,13
29544,NoRealHat,,1,8,28,36
29545,SexyItaliaBella,,1,4,1,5
29546,DarkGoosey,,1,121,137,258
29547,stalematedizzy,,1,7,3,10
29548,thehustler,,1,9,31,40
29549,FRABAR,,1,7,13,20
29550,mdasenn,,1,59,24,83
29551,iluvlucyie,,1,1,2,3
29552,holst,,1,1,2,3
29553,dingbatman,,1,3,1,4
29554,justindossey,,1,5,6,11
29555,GreyWalker,,1,20,34,54
29556,willans,,1,1,2,3
29557,wombatsneedlove,,1,2,3,5
29558,meeb,,1,46,73,119
29559,theragu40,,1,3,1,4
29560,dbauchary,,1,3,1,4
29561,linkserf,,1,36,3,39
29562,osiris7,,1,27,39,66
29563,DrOOpieS,,1,18,46,64
29564,dink_,,1,84,17,101
29565,esotericguy,,1,378,283,661
29566,dotseeohdotzedaye,,1,2,6,8
29567,hayabusarider,,1,3,4,7
29568,Xzibit,,1,13,27,40
29569,arowan,,1,466,358,824
29570,doctornick,,1,190,22,212
29571,spdowling,,1,3,2,5
29572,Pinky88,,1,1,2,3
29573,pacbat,,1,2,2,4
29574,TBob,,1,54,86,140
29575,tow2a,,1,1,1,2
29576,andreah,,1,1,1,2
29577,hellz_yeah,,1,15,20,35
29578,GullyF,,1,1,1,2
29579,jk1150,,1,252,324,576
29580,aut0maticdan,,1,1,2,3
29581,monobot2,,1,81,84,165
29582,leolaith,,1,2,1,3
29583,mutable_beast,,1,4,8,12
29584,elcapitanp,,1,4,4,8
29585,richcoder,,1,18,9,27
29586,Futile,,1,1,1,2
29587,dpk,,1,1,1,2
29588,pseudomind,,1,3,5,8
29589,Yanaran,,1,8,6,14
29590,rubarb,,1,2,2,4
29591,ztorgo,,1,7,2,9
29592,snowbbdd,,1,4,3,7
29593,simplezeal,,1,1,1,2
29594,buffyoda,,1,1,3,4
29595,robtotheb,,1,1,1,2
29596,marike,,1,49,61,110
29597,Rolo,,1,18,3,21
29598,jertheripper,,1,1,1,2
29599,weedwhacker,,1,3,16,19
29600,grant0,,1,102,109,211
29601,lamby,,1,43,63,106
29602,apodo,,1,5,5,10
29603,pelirrojo,,1,433,494,927
29604,dancingholly,,1,2,4,6
29605,thunder_rob,,1,602,393,995
29606,alulim,,1,14,28,42
29607,pamiamb,,1,6,4,10
29608,pessimist,,1,4,5,9
29609,thinkpol,,1,3,1,4
29610,ZMANKER,,1,1,1,2
29611,tissle,,1,73,102,175
29612,kindling,,1,21,8,29
29613,EliezerYudkowsky,,1,1,2,3
29614,vbhtngr,,1,8,1,9
29615,jtanniru,,1,1,1,2
29616,laserman92027,,1,2,2,4
29617,gorrepati,,1,11,19,30
29618,sauce71,,1,1,3,4
29619,andre2003s,,1,2,3,5
29620,yabadaba,,1,1,1,2
29621,werdan,,1,5,12,17
29622,wyvern1,,1,2,2,4
29623,contre,,1,3,6,9
29624,rocksmom,,1,28,14,42
29625,JasonHears,,1,153,197,350
29626,smithfield,,1,1,2,3
29627,BoonTobias,,1,82,115,197
29628,felzix,,1,1,3,4
29629,hwillis,,1,16,43,59
29630,spaniardslikelisp,,1,1,2,3
29631,5aculu5,,1,9,16,25
29632,swordsaintzero,,1,36,36,72
29633,Nimish,,1,105,145,250
29634,Vladekk,,1,52,64,116
29635,plix,,1,4,2,6
29636,GayJewishNazi,,1,2,1,3
29637,phlux,,1,64,86,150
29638,carlio,,1,372,86,458
29639,thebandit,,1,1,1,2
29640,pinginfan1,,1,7,21,28
29641,INIT_6,,1,23,26,49
29642,the_confused,,1,138,58,196
29643,biokinetic,,1,21,42,63
29644,justice4all,,1,32,3,35
29645,terazx,,1,9,1,10
29646,mountain19,,1,22,10,32
29647,aardvark1,,1,23,42,65
29648,angliss,,1,32,12,44
29649,gong,,1,2,4,6
29650,logical,,1,131,80,211
29651,squirrelthetic,,1,2,5,7
29652,organised,,1,1,1,2
29653,junk8755,,1,362,261,623
29654,tntnews,,1,78,96,174
29655,AmieN,,1,35,5,40
29656,kngfling,,1,1,1,2
29657,notreallyuser,,1,1,3,4
29658,jamesj,,1,106,104,210
29659,sincewednesday,,1,59,62,121
29660,johnsibly,,1,1,1,2
29661,SamyK,,1,83,46,129
29662,bday_on_august_27,,1,10,1,11
29663,stinkystank,,1,1,1,2
29664,brownkidd,,1,18,2,20
29665,c0ldfusi0n,,1,167,255,422
29666,DODECAHEDRON,,1,1,5,6
29667,goingstuckey,,1,14,3,17
29668,snra786,,1,6,2,8
29669,thernkworks,,1,2,1,3
29670,minigamer1896,,1,34,57,91
29671,helleborus,,1,294,509,803
29672,Erikk,,1,5,3,8
29673,Pillow_Talk,,1,36,71,107
29674,tiredofthis,,1,2,1,3
29675,atientp,,1,1,1,2
29676,PizzaKiller,,1,3,1,4
29677,a_labelle,,1,12,3,15
29678,linuxcod3r,,1,1,1,2
29679,ZaaK433,,1,501,977,1478
29680,zombietwat,,1,1,2,3
29681,bigot,,1,6,3,9
29682,courbabe,,1,5,5,10
29683,2percentright,,1,50,77,127
29684,sh0tzy,,1,2,1,3
29685,jomofo,,1,50,17,67
29686,Captainfidget,,1,118,101,219
29687,Mahmoud_Ahmadinejad,,1,1,7,8
29688,Weebs,,1,15,5,20
29689,nkription,,1,1,4,5
29690,doddi,,1,8,12,20
29691,interg12,,1,825,48,873
29692,laughingboy0,,1,7,5,12
29693,dennern,,1,1,2,3
29694,anatoly,,1,29,39,68
29695,SirRobS,,1,2,1,3
29696,Lykus42,,1,2,7,9
29697,ojiisan,,1,31,35,66
29698,garyes19,,1,8,4,12
29699,arikb,,1,6,15,21
29700,adamld,,1,123,216,339
29701,I_E_Leibowitz,,1,1,1,2
29702,peterb518,,1,2,3,5
29703,Uzah,,1,5,2,7
29704,Klorox,,1,52,91,143
29705,joseacolor,,3,6,8,14
29706,oku,,1,105,103,208
29707,elmer_the_arse,,1,44,114,158
29708,ph8,,1,1,1,2
29709,grampybone,,1,50,82,132
29710,lardo,,1,6,1,7
29711,ragatiki504,,1,1,1,2
29712,Rofl_Waffler,,1,90,188,278
29713,thrax1fy,,1,9,19,28
29714,dooooood,,1,4,9,13
29715,sparhawk1985,,1,6,3,9
29716,Dead1nside,,1,8,20,28
29717,StormCraft,,1,38,6,44
29718,cvolz,,1,41,5,46
29719,followup,,1,24,2,26
29720,Wunderbar,,1,53,119,172
29721,psycko,,1,71,83,154
29722,picmium,,1,257,2,259
29723,playmusic,,1,6,1,7
29724,ansdofuno,,1,18,5,23
29725,plawplew,,1,2,2,4
29726,dreamslaughter,,1,29,16,45
29727,Anal-Limpet,,1,1,1,2
29728,nathanielb,,1,4,5,9
29729,dungar,,1,36,36,72
29730,Moj0,,1,8,14,22
29731,159734682,,1,19,35,54
29732,armhead,,1,54,49,103
29733,getemboys,,1,4,3,7
29734,Alexiares,,1,3,1,4
29735,OlderIgor,,1,20,38,58
29736,davidbgonzalez,,1,2,1,3
29737,s_reed,,1,21,36,57
29738,libertyy,,1,20,8,28
29739,doug11235,,1,21,4,25
29740,thrillhouse,,1,37,30,67
29741,spikedLemur,,1,28,26,54
29742,constellation,,1,8,18,26
29743,toefur,,1,13,16,29
29744,lazylion_ca,,1,33,38,71
29745,NekkedRingworm,,1,2,3,5
29746,quodestveritas,,1,29,18,47
29747,killercanary,,1,4,3,7
29748,Ablerank,,1,14,35,49
29749,gator2112,,1,72,2,74
29750,americanender,,1,2,2,4
29751,recoton007,,1,1,1,2
29752,sanswork,,1,6,10,16
29753,geogaddii,,1,5,9,14
29754,vrangnarr,,1,50,37,87
29755,dfaraci,,1,70,146,216
29756,edderly,,1,3,5,8
29757,vikramhaer,,1,2,3,5
29758,gehenom,,1,117,139,256
29759,haywired,,1,4,10,14
29760,Watanabex,,1,1,2,3
29761,santas_boyfriend,,1,1,2,3
29762,Anarkos,,1,5,26,31
29763,jackattax,,1,1,1,2
29764,So_Cash,,1,5,1,6
29765,YellowSnot,,1,3,9,12
29766,dirkachbar,,1,31,54,85
29767,moonman,,1,489,804,1293
29768,aylarose4,,1,3,5,8
29769,Phallicular,,1,5,6,11
29770,akifbayram,,1,49,41,90
29771,redditbannedmetwice,,1,12,18,30
29772,noworld,,1,2,1,3
29773,just_sayin,,1,3,1,4
29774,dbbob,,1,184,11,195
29775,blufr0g,,1,1214,1126,2340
29776,ididntREADIT,,1,4,2,6
29777,GeorgeForemanGrillz,,1,6,34,40
29778,ninjamongoose,,1,15,34,49
29779,Estoye,,1,22,27,49
29780,karlb103,,1,2,3,5
29781,elvisliveson,,1,495,636,1131
29782,justanother_R0boT,,1,84,84,168
29783,chriscooley,,1,2,1,3
29784,gizmothe1,,1,568,23,591
29785,addsense,,1,20,28,48
29786,Grammer,,1,1,1,2
29787,CygnusX1,,1,23,24,47
29788,piratebroadcast,,1,19,17,36
29789,danprager,,1,3,4,7
29790,mnemonicsloth,,1,1,1,2
29791,blay,,1,1,2,3
29792,gasull,,1,43,70,113
29793,ThePoopsmith,,1,14,9,23
29794,burty89,,1,5,7,12
29795,thetripp,,1,23,24,47
29796,goondocks,,1,115,65,180
29797,nickellis14,,1,2,3,5
29798,ehares,,1,1,2,3
29799,Siksay,,1,3,7,10
29800,shit,,1,228,277,505
29801,TBMonkey,,1,90,151,241
29802,Svenstaro,,1,81,149,230
29803,owen007,,1,21,2,23
29804,drysquid,,1,38,51,89
29805,MAXZOOM,,1,6,14,20
29806,doublejrecords,,1,4,6,10
29807,ampegg,,1,1,2,3
29808,liza,,1,13,7,20
29809,PrawnSolo,,1,91,74,165
29810,isny,,1,4,8,12
29811,mattalexx,,1,1,8,9
29812,Copy_Cat,,1,1,1,2
29813,bosco,,1,40,19,59
29814,whitlock,,1,6,9,15
29815,ohblair,,1,14,17,31
29816,tullypimp,,1,234,316,550
29817,hirak99,,1,1,7,8
29818,coc_ar,,1,47,25,72
29819,Rhadoo1980,,1,24,12,36
29820,silverlight,,1,105,35,140
29821,Anzat,,1,36,55,91
29822,Tobiaswk,,1,33,62,95
29823,jacobmiller,,1,463,249,712
29824,ABentSpoon,,1,23,30,53
29825,cman_04,,1,54,47,101
29826,level255,,1,1,1,2
29827,Ingenium13,,1,73,8,81
29828,TomorrowPlusX,,1,155,130,285
29829,statbit,,1,1,2,3
29830,ephebobear,,1,1,1,2
29831,saisniorp,,1,3,4,7
29832,diamondjo,,1,31,29,60
29833,GaryOak,,1,1,2,3
29834,lordbee,,1,66,2,68
29835,revo86,,1,2,2,4
29836,finerrecliner,,1,293,132,425
29837,CarsonCity314,,1,21,45,66
29838,zooky,,1,4,15,19
29839,lethain,,1,10,5,15
29840,nor-and-or-not,,1,1,3,4
29841,katzmo,,1,1,4,5
29842,slavojzizek,,1,1,1,2
29843,neilgorman,,1,1,1,2
29844,no_dice,,1,67,49,116
29845,SCVirus,,1,83,114,197
29846,bishopbrady,,1,2,1,3
29847,westmini,,1,3,4,7
29848,jswedler,,1,2,1,3
29849,Glassius,,1,3,4,7
29850,steveuk50,,1,50,79,129
29851,mtnkodiak,,1,123,136,259
29852,Howie509,,1,57,100,157
29853,personator,,1,6,3,9
29854,subzerogts,,1,426,541,967
29855,dreish,,1,18,43,61
29856,burdalane,,1,160,320,480
29857,thefedexpope1,,1,11,2,13
29858,HillaryRodhamClinton,,1,1,2,3
29859,keanu_reeves,,1,41,60,101
29860,Doingitwrong,,1,16,18,34
29861,piersicuta,,1,1,1,2
29862,MohamedO,,1,3,5,8
29863,fictionclemens,,1,27,27,54
29864,youcaughtthegay,,1,4,13,17
29865,senecavirus,,1,9,16,25
29866,MrJolly,,1,10,1,11
29867,Arve,,1,2439,498,2937
29868,fastdruid,,1,1,1,2
29869,Arcueid01,,1,52,97,149
29870,gtrmike,,1,55,25,80
29871,indeyets,,1,32,7,39
29872,haberman,,1,3,2,5
29873,WhyOhWhyOhWhy,,1,24,34,58
29874,Untruth,,1,2,5,7
29875,dead_ed,,1,426,989,1415
29876,socialskills,,1,1,1,2
29877,ibanex22,,1,55,6,61
29878,burgermind,,1,64,104,168
29879,abcboy,,1,17,2,19
29880,blindmonk,,1,41,55,96
29881,pznn,,1,1,6,7
29882,steamynachos,,1,131,248,379
29883,jeremymcanally,,1,40,54,94
29884,thatfuckingjerk,,1,2,3,5
29885,almodozo,,1,32,25,57
29886,rask,,1,27,24,51
29887,siovene,,1,47,28,75
29888,Invader_Zim,,1,3,3,6
29889,Ionis,,1,3,3,6
29890,bernypark,,1,1,4,5
29891,wanderingcynic,,1,3,7,10
29892,plasticbuddha,,1,1,2,3
29893,baconn,,1,336,400,736
29894,derekco,,1,68,14,82
29895,crazyfinx,,1,4,3,7
29896,technonotice,,1,8,3,11
29897,yoink,,1,8,7,15
29898,GregTBunny,,1,26,6,32
29899,blue58,,1,1,1,2
29900,obamaman99,,1,1,1,2
29901,Afaflix,,1,35,38,73
29902,somerandommember,,1,12,20,32
29903,McReasonable,,1,5,3,8
29904,quag,,1,9,8,17
29905,soldier4568,,1,1,1,2
29906,NoParents,,1,3,1,4
29907,b21ft,,1,2,3,5
29908,Dexter77,,1,72,69,141
29909,costin,,1,8,4,12
29910,locu,,1,1,6,7
29911,Alpx5,,1,1,1,2
29912,metalchick70,,1,4,1,5
29913,bluecup,,1,10,10,20
29914,KishCom,,1,247,171,418
29915,phoenixshard,,1,2,2,4
29916,BradHAWK,,1,4,4,8
29917,static,,1,10,16,26
29918,dibbler2,,1,57,77,134
29919,denmoff,,1,1,1,2
29920,tqh20178,,1,1,1,2
29921,MIkeR1988,,1,1,4,5
29922,howpeegoo,,1,3,5,8
29923,db2,,1,950,1512,2462
29924,Throwmeabone,,1,43,107,150
29925,jkkramer,,1,12,11,23
29926,msx,,1,1,2,3
29927,FRONTIER_PHARMACIST,,1,2,1,3
29928,diamond,,1,1096,1307,2403
29929,unkb,,1,24,3,27
29930,Eivo,,1,3,1,4
29931,robertglenn,,1,9,9,18
29932,brcleeroy,,1,5,8,13
29933,bethlehem18,,1,29,34,63
29934,RobWW,,1,93,184,277
29935,wallyf11,,1,2,1,3
29936,fillmore,,1,3,1,4
29937,Capitain_Oblivion,,1,17,25,42
29938,WSPCambridge,,1,2,1,3
29939,punny,,1,5,3,8
29940,freemarketmyass,,1,8,1,9
29941,madoublet,,1,10,21,31
29942,SaddleShoe,,1,7,17,24
29943,timepad,,1,2,5,7
29944,necromancer1976,,1,326,11,337
29945,kublakhan1816,,1,220,323,543
29946,aktufe,,1,147,221,368
29947,greeny789,,1,1,3,4
29948,trifecta,,1,628,101,729
29949,SgtCedar,,1,6,3,9
29950,dano85,,1,3,3,6
29951,Trevj,,1,45,61,106
29952,MarcoVincenzo,,1,11,35,46
29953,pedanticdave,,1,3,5,8
29954,zpweeks,,1,1,1,2
29955,psyyduck,,1,1,7,8
29956,sunnyjim,,1,7,28,35
29957,nugan,,1,2,4,6
29958,hootnanny,,1,22,39,61
29959,someuser,,1,1,2,3
29960,jonathanownbey,,1,4,5,9
29961,doremon313,,1,18,39,57
29962,smika,,1,258,192,450
29963,h2gofast,,1,45,124,169
29964,lordgibby0,,1,5,8,13
29965,D2dodder,,1,41,93,134
29966,ScienceSpeakingHere,,1,7,1,8
29967,mafihotz,,1,14,1,15
29968,MarcelleLeahy,,1,4,3,7
29969,redditron,,1,44,45,89
29970,chksixx,,1,1,1,2
29971,fuzzyl0g1c,,1,1,2,3
29972,deviantz,,1,1,1,2
29973,kevxross,,1,1,4,5
29974,woman_on_reddit_omg,,1,2,1,3
29975,arnoldo101,,1,1,1,2
29976,CSharpSauce,,1,40,54,94
29977,SpellNazi,,1,2,2,4
29978,alanpost,,1,18,46,64
29979,player2,,1,133,172,305
29980,mburke6,,1,3,3,6
29981,danth,,1,73,53,126
29982,pjprd,,1,3,3,6
29983,nordo,,1,143,230,373
29984,thant,,1,6,8,14
29985,kidcannuck,,1,1,1,2
29986,pauld,,1,1,1,2
29987,timmox,,1,1,1,2
29988,random-wharfedale,,1,1,6,7
29989,drboyd,,1,14,15,29
29990,malune,,1,2,3,5
29991,dist,,1,1,2,3
29992,cosmokramer,,1,15,1,16
29993,corewarrior,,1,3,1,4
29994,nikils,,1,32,2,34
29995,bryanalves,,1,7,15,22
29996,bishopcheck,,1,9,14,23
29997,conciliatory,,1,74,22,96
29998,turtletail,,1,12,18,30
29999,322,,1,44,3,47
30000,iamnoah,,1,118,159,277
30001,picfan,,1,1,2,3
30002,tico86,,1,40,56,96
30003,thasiet,,1,26,56,82
30004,TooSloJoe,,1,7,12,19
30005,buttz,,1,3,8,11
30006,psilva,,1,5,5,10
30007,klook,,1,1,3,4
30008,Stevey,,1,14,21,35
30009,joshchapstick,,1,2,1,3
30010,Luminaire,,1,1,1,2
30011,Humphrey0,,1,8,4,12
30012,hasiangurl,,1,1,1,2
30013,Reno1,,1,3,7,10
30014,ajaw,,1,53,2,55
30015,WillardMittRomney,,1,2,4,6
30016,StormTheGates,,1,45,21,66
30017,Cole2026,,1,36,47,83
30018,lukeredpath,,1,17,30,47
30019,shitkicker,,1,77,44,121
30020,jawalking,,1,2,2,4
30021,WaterBottle22,,1,1,1,2
30022,ando-xxx,,1,1,1,2
30023,Koniferous,,1,65,94,159
30024,hsenag,,1,14,21,35
30025,pgoetz,,1,17,21,38
30026,ccasey,,1,42,30,72
30027,ajushi,,1,1,2,3
30028,JimRoepcke,,1,1,1,2
30029,chuong1981,,1,1,1,2
30030,ladykaty24,,1,1,1,2
30031,FraterNS,,1,1,2,3
30032,matt88,,1,6,15,21
30033,intuition25,,1,41,63,104
30034,voice_of_civility,,1,1,1,2
30035,masterbaexunn,,1,57,127,184
30036,tkeeley,,1,117,18,135
30037,tinderstix,,1,4,2,6
30038,Borris,,1,1,1,2
30039,uksaunders,,1,9,7,16
30040,Barnesy8,,1,18,9,27
30041,harma,,1,5,7,12
30042,grandpawiggly,,1,106,54,160
30043,yatpay,,1,27,12,39
30044,bazta,,1,5,4,9
30045,possiblyj,,1,1,1,2
30046,stanthebat,,1,44,44,88
30047,c_a_turner,,1,116,54,170
30048,danielsoneg,,1,37,61,98
30049,cpualani,,1,2,1,3
30050,master_rahl,,1,21,19,40
30051,bward76,,1,2,2,4
30052,adelime,,1,1,3,4
30053,sendmoreparamedics,,1,6,1,7
30054,phreakymonkey,,1,382,412,794
30055,the13thzen,,1,12,10,22
30056,Bjoolz,,1,3,1,4
30057,Internets,,1,1,2,3
30058,joka86,,1,301,28,329
30059,zakalwe30,,1,36,99,135
30060,zip99,,1,2,4,6
30061,madmax_br5,,1,913,748,1661
30062,kriegsdrachen,,1,44,71,115
30063,skawaii,,1,2,3,5
30064,Nanobe,,1,6,4,10
30065,ncesare,,1,7,1,8
30066,crgreddit,,1,1,2,3
30067,reverz,,1,17,11,28
30068,jakewolf,,1,2,5,7
30069,Roughy,,1,38,84,122
30070,jchrome,,1,2,4,6
30071,gnotredditor,,1,3,7,10
30072,breadtk,,1,2,9,11
30073,hi123123,,1,1,2,3
30074,dgrant,,1,161,126,287
30075,potatomato,,1,2,1,3
30076,guanxi,,1,6,22,28
30077,yumology,,1,76,74,150
30078,curtistheory,,1,7,1,8
30079,WalterSear,,1,130,142,272
30080,seadaddy,,1,4,2,6
30081,itsdeuce,,1,50,88,138
30082,jondissed,,1,30,41,71
30083,phaedrusalt,,1,2,9,11
30084,tourettedog,,1,8,12,20
30085,loki16,,1,2,5,7
30086,faithnomore,,1,1,1,2
30087,Sobe,,1,44,13,57
30088,sinsyder,,1,59,155,214
30089,addius,,1,34,49,83
30090,bombtrack,,1,26,17,43
30091,Teegro,,1,1,1,2
30092,Scutterbotch,,1,6,3,9
30093,tjarko,,1,18,15,33
30094,hakonlo,,1,35,60,95
30095,QueenZ,,1,20,21,41
30096,queuetue,,1,27,40,67
30097,sombrero66,,1,52,1,53
30098,Zaborix,,1,19,21,40
30099,RipTatermen,,1,3,6,9
30100,freedomISslavery,,1,1,2,3
30101,vokiel,,1,1,1,2
30102,DerelictMan,,1,11,14,25
30103,ecommando,,1,5,6,11
30104,xkageryux,,1,25,55,80
30105,spencerlucas,,1,3,3,6
30106,macmcteague,,1,1,2,3
30107,smart_ass,,1,384,527,911
30108,mikedemarais,,1,1,1,2
30109,pgiani,,1,5,1,6
30110,mikko1111,,1,2,1,3
30111,LoompaOompa,,1,59,75,134
30112,antipathy,,1,9,4,13
30113,U747,,1,30,8,38
30114,blowmage,,1,3,4,7
30115,evolrewsna,,1,2,5,7
30116,defect,,1,1,2,3
30117,systemsengineer,,1,11,42,53
30118,PessimistParty4Life,,1,4,6,10
30119,Tringle,,1,6,4,10
30120,introitus,,1,218,261,479
30121,monoglot,,1,346,304,650
30122,PTPolitics,,1,226,12,238
30123,madthomas,,1,3,2,5
30124,narupo,,1,2,2,4
30125,bwoj,,1,10,26,36
30126,krasn0yarsk,,1,33,39,72
30127,pilotbread,,1,92,132,224
30128,thepeopleseason,,1,1,4,5
30129,Hambone,,1,93,111,204
30130,myth1218,,1,1,1,2
30131,whiskeymango,,1,2,1,3
30132,Ranger_Rick,,1,2,2,4
30133,FLUSHGORDEN,,1,1,1,2
30134,neithernet,,1,72,167,239
30135,Xuyen,,1,4,7,11
30136,dumbass2008,,1,2,3,5
30137,Poplicola,,1,2,2,4
30138,LuckyBdx4,,1,228,505,733
30139,bvlietst,,1,1,5,6
30140,jacktasia,,1,6,7,13
30141,notme93,,1,24,13,37
30142,Grey-Fox,,1,2,2,4
30143,homanh,,1,27,33,60
30144,Surferess,,1,15,4,19
30145,Rotlaus,,1,2,3,5
30146,feelix,,1,57,19,76
30147,pointer2void,,1,428,531,959
30148,bigly,,1,1,1,2
30149,torode,,1,1,2,3
30150,tehmarty,,1,9,11,20
30151,rachet06,,1,8,16,24
30152,abenzenering,,1,2,4,6
30153,dwf,,1,16,23,39
30154,sharpquote,,1,3,4,7
30155,Tesaaa,,1,12,15,27
30156,fearthesheep,,1,4,1,5
30157,zeroone,,1,25,7,32
30158,badfish301,,1,238,178,416
30159,Ridiculer,,1,3,1,4
30160,crushhawk,,1,1,1,2
30161,robplace30,,1,4,7,11
30162,gin7,,1,4,6,10
30163,ieopruwiofu,,1,4,3,7
30164,zebraface,,1,1,2,3
30165,Ofenza,,1,33,30,63
30166,AmishHobo,,1,9,2,11
30167,giantpandachair,,1,26,23,49
30168,cobblehillmartin,,1,8,14,22
30169,9us,,1,75,104,179
30170,ColinStewart,,1,21,3,24
30171,eastlib,,1,18,26,44
30172,ilovemccain,,1,1,1,2
30173,blabla3,,1,6,5,11
30174,fantasma,,1,1,2,3
30175,fdasfew,,1,7,8,15
30176,NeoconDouchebags13,,1,4,10,14
30177,dicesgary,,1,17,7,24
30178,iamyourevilid,,1,2,9,11
30179,pnumb,,1,1,1,2
30180,ChoobaChabba,,1,57,42,99
30181,mrblowhart,,1,5,5,10
30182,Slick135,,1,2,3,5
30183,attackofthetim,,1,3,4,7
30184,serume,,1,39,56,95
30185,TurtleEater,,1,265,184,449
30186,krazykorean,,1,312,15,327
30187,J05H,,1,1,1,2
30188,unintuitive,,1,15,15,30
30189,stirringthepot,,1,1,3,4
30190,fivre,,1,354,482,836
30191,Zorb750,,1,19,26,45
30192,FountainsOfDave,,1,142,116,258
30193,serine,,1,16,38,54
30194,poxy1,,1,9,13,22
30195,Takalth,,1,101,69,170
30196,oniony,,1,193,198,391
30197,magnumix,,1,18,6,24
30198,edmdusty,,1,319,288,607
30199,bluecloud,,1,29,2,31
30200,eatmyshorts,,1,23,34,57
30201,wleahcim,,1,46,35,81
30202,rossovino,,1,2,1,3
30203,krisscofield,,1,6,17,23
30204,martinbishop,,1,392,260,652
30205,crankyliberal,,1,10,4,14
30206,seelen,,1,4,3,7
30207,MaxQ,,1,6,8,14
30208,dsaint,,1,5,5,10
30209,tabbser,,1,3,1,4
30210,Rubin0,,1,94,58,152
30211,itsnothdr,,1,9,2,11
30212,jaunssi,,1,5,2,7
30213,MIlanKundera,,1,1,1,2
30214,benio1804,,1,28,7,35
30215,asb,,1,55,21,76
30216,a-gorilla,,1,29,54,83
30217,mikenick42,,1,181,294,475
30218,AbeEstrada,,1,9,19,28
30219,GautierGiuliani,,1,31,79,110
30220,timeywimey,,1,149,353,502
30221,DrRoboto,,1,1,1,2
30222,DaemonXI,,1,496,325,821
30223,tehjamez,,1,82,192,274
30224,idiotboxbox,,1,1,1,2
30225,taliswolf,,1,24,42,66
30226,audaxxx,,1,1,2,3
30227,astubbs,,1,2,3,5
30228,metricton,,1,19,31,50
30229,jhherren,,1,12,7,19
30230,wajones67,,1,3,2,5
30231,pcx99,,1,121,83,204
30232,mrphillc,,1,40,43,83
30233,BoomptyMcBloog,,1,721,817,1538
30234,commentsaredeleted,,1,1,1,2
30235,Buzzby,,1,5,13,18
30236,memefilter,,1,112,236,348
30237,sea_bass,,1,1,3,4
30238,HollywoodHoes,,1,23,7,30
30239,mcnada54,,1,1,1,2
30240,abc2015,,1,5,7,12
30241,belred,,1,1,2,3
30242,ImaPC_andaNoob,,1,2,1,3
30243,Dundun,,1,23,27,50
30244,mechanon05,,1,8,2,10
30245,milohoss,,1,80,42,122
30246,trabuco007,,1,10,9,19
30247,arman0,,1,28,3,31
30248,mramm,,1,2,5,7
30249,thechitowncubs,,1,23,22,45
30250,futureruins,,1,21,64,85
30251,joetheredditor,,1,6,9,15
30252,aanand,,1,42,17,59
30253,SupaFurry,,1,152,90,242
30254,kevin70,,1,52,96,148
30255,bizplan2,,1,1,1,2
30256,pomo_homo,,1,2,3,5
30257,erisson,,1,24,21,45
30258,workreddit,,1,2,6,8
30259,oneironaut,,1,9,8,17
30260,jaxomlotus,,1,126,30,156
30261,Ethril,,1,2,2,4
30262,sriramalka,,1,25,66,91
30263,TheSecondCommandment,,1,3,7,10
30264,lemnich,,1,4,3,7
30265,carrot57,,1,3,2,5
30266,wenyude,,0,1,3,4
30267,dataset,,1,22,35,57
30268,hooba,,1,1,2,3
30269,gzur,,1,13,32,45
30270,zenon,,1,24,8,32
30271,A-hole,,1,1,1,2
30272,knavillus,,1,23,19,42
30273,opsn,,1,1,2,3
30274,protocol0,,1,5,5,10
30275,S7evyn,,1,487,684,1171
30276,anonymous_troll,,1,6,5,11
30277,quizzical,,1,1,3,4
30278,learn2punctuate,,1,9,13,22
30279,genericshell,,1,52,60,112
30280,rgoslins,,1,25,8,33
30281,HeadfirstForHalos,,1,17,16,33
30282,WiZZLa,,1,32,52,84
30283,appleflaxen,,1,3,2,5
30284,Turandot,,1,6,7,13
30285,showmesomescars,,1,10,26,36
30286,mikecalios,,1,43,3,46
30287,DarthVona,,1,1,1,2
30288,jlenes,,1,18,2,20
30289,rincebrain,,1,1,1,2
30290,franimal61,,1,12,30,42
30291,michaels0620,,1,2,2,4
30292,wieczo,,1,1,4,5
30293,emmster,,1,423,619,1042
30294,DrunkPudge,,1,1,1,2
30295,flamingeyebrows,,1,358,581,939
30296,Akirasan,,1,2,1,3
30297,captain_stubbs,,1,51,61,112
30298,tfp,,1,46,41,87
30299,phjr,,1,18,28,46
30300,ke1y,,1,4,3,7
30301,rs98101,,1,15,5,20
30302,idarling,,1,56,48,104
30303,ifeatu,,1,1,1,2
30304,elurin,,1,20,9,29
30305,chameche,,1,18,39,57
30306,demonic,,1,18,8,26
30307,Psyqlone,,1,23,35,58
30308,mudah,,1,43,4,47
30309,Gravy,,1,239,17,256
30310,J_gault,,1,2,2,4
30311,Sapho,,1,1,2,3
30312,killtherebel,,1,85,25,110
30313,jamesmarshall,,1,17,12,29
30314,Thraxamer,,1,5,6,11
30315,telecaster,,1,747,726,1473
30316,schwarzwald,,1,182,131,313
30317,ruthfull,,1,13,18,31
30318,thingnumber2,,1,132,160,292
30319,bassist789,,1,44,39,83
30320,LaurieCheers,,1,440,605,1045
30321,shutyourmemehole,,1,3,1,4
30322,pickyourking,,1,1,12,13
30323,neilbarnwell,,1,1,1,2
30324,nikhil,,1,11,3,14
30325,skbrne,,1,17,30,47
30326,rboyce,,1,50,68,118
30327,Knossus,,1,4,16,20
30328,synthespian,,1,334,141,475
30329,iamchenny,,1,1,1,2
30330,sondatch,,1,201,7,208
30331,rgautier,,1,7,15,22
30332,adamx,,1,2,2,4
30333,pnsm,,1,3,4,7
30334,bradwheeler,,1,61,24,85
30335,diginux,,1,3,8,11
30336,jeff303,,1,150,279,429
30337,davidarnow,,1,1,1,2
30338,snyderjw,,1,71,106,177
30339,Ron_Paula,,1,1,1,2
30340,WhatMatters,,1,1,3,4
30341,worseneil,,1,4,4,8
30342,slackbp,,1,1,2,3
30343,mujahideenryder,,1,255,96,351
30344,jun2san,,1,196,211,407
30345,Ksero,,1,19,26,45
30346,sheepthief,,1,182,23,205
30347,spinerret,,1,14,12,26
30348,jinks,,1,29,8,37
30349,neito,,1,796,54,850
30350,dokholidae,,1,3,5,8
30351,exile29,,1,8,11,19
30352,taw,,1,334,323,657
30353,pc486,,1,28,25,53
30354,xyzzypoof,,1,41,40,81
30355,blackdeath88012,,1,43,94,137
30356,Lystrodom,,1,361,545,906
30357,Shadow6363,,1,14,6,20
30358,virtual_void,,1,12,20,32
30359,tmsagain,,1,6,10,16
30360,earthgirl1983,,1,1,3,4
30361,briandon,,1,3,2,5
30362,elZaphod,,1,1,5,6
30363,ck0,,1,1,1,2
30364,thuffner,,1,2,1,3
30365,rrihnafmgm,,1,2,2,4
30366,zero01101,,1,62,73,135
30367,PastorDisaster,,1,3,2,5
30368,geekmom2,,1,76,66,142
30369,can_has,,1,21,51,72
30370,ssn,,1,25,12,37
30371,vimau,,1,9,11,20
30372,nanooker,,1,3,2,5
30373,mondokoosh737,,1,16,28,44
30374,jibegod,,1,59,43,102
30375,zebra10,,1,121,55,176
30376,brendhan,,1,27,44,71
30377,tamu,,1,1,1,2
30378,Vovchick2004,,1,5,3,8
30379,MenosElOso,,1,3,11,14
30380,aspenbordr,,1,13,5,18
30381,mallardtheduck,,1,113,119,232
30382,k3871,,1,8,11,19
30383,tombonneau,,1,32,57,89
30384,fingstupider,,1,1,2,3
30385,devon223,,1,6,8,14
30386,Morbot,,1,44,147,191
30387,anthony_barker,,1,9,12,21
30388,jerk1off,,1,1,6,7
30389,Hershon,,1,32,3,35
30390,Heyooooh,,1,7,12,19
30391,hankols,,1,2,1,3
30392,dvorak,,1,108,162,270
30393,redditer033,,1,1,1,2
30394,Headzzot,,1,3,4,7
30395,mpinkeyes,,1,282,2,284
30396,MrUlterior,,1,28,44,72
30397,briagreen,,3,1,1,2
30398,nhinman,,1,1,2,3
30399,fagmotard,,1,5,15,20
30400,jlogelin,,1,14,4,18
30401,tromik,,1,3,10,13
30402,pasat,,1,19,1,20
30403,phouck,,1,26,47,73
30404,p0tent1al,,1,90,161,251
30405,mjw2025,,1,145,198,343
30406,MocToc,,1,1,1,2
30407,alangcarter,,1,11,26,37
30408,topnotch,,1,64,30,94
30409,xzZzZzZzx,,1,14,24,38
30410,datskosdatsko,,1,9,11,20
30411,iizsmart,,1,36,51,87
30412,skilless,,1,48,13,61
30413,badger99,,1,2,5,7
30414,SiPhuYoda,,1,1,1,2
30415,heathen_chemistry,,1,1,1,2
30416,Rufus_2,,1,1,1,2
30417,deadelephant,,1,115,206,321
30418,independentwatcher,,1,19,8,27
30419,chrystofier,,1,29,23,52
30420,MrWoIf,,1,3,15,18
30421,hveiti,,1,9,41,50
30422,JJFO,,1,278,357,635
30423,courttimesinfiniti,,1,88,186,274
30424,malfunctionality,,1,2,2,4
30425,rubikfreak,,1,5,14,19
30426,houligansz,,1,1,2,3
30427,radavasquez,,1,3,5,8
30428,ffualo,,1,1038,616,1654
30429,grusbf5,,1,3,1,4
30430,yonyonjohn,,1,18,21,39
30431,waku2waku,,1,5,4,9
30432,mcash,,1,1,1,2
30433,MyPants,,1,6,12,18
30434,sundance1028,,1,77,35,112
30435,stanleypane,,1,61,52,113
30436,hagbard_celine,,1,28,66,94
30437,intrigued11,,1,1,5,6
30438,mtyoung,,1,2,9,11
30439,mlesniak,,1,1,5,6
30440,senornono,,1,2,6,8
30441,JWF,,1,98,1,99
30442,rnixon,,1,44,10,54
30443,worthless_poster,,1,210,56,266
30444,BlackSunshine,,1,19,30,49
30445,dundas,,1,1,1,2
30446,er_er,,1,23,20,43
30447,seacrop,,1,1,1,2
30448,redditcodephp,,1,1,3,4
30449,njr,,1,56,118,174
30450,meson537,,1,29,32,61
30451,apeman,,1,78,27,105
30452,reuivcuiqowe,,1,2,1,3
30453,NOTstupid,,1,10,19,29
30454,neofuturism,,1,1,4,5
30455,sh0rty,,1,57,23,80
30456,c0d3thug,,1,15,20,35
30457,whatintheworldisthat,,1,30,31,61
30458,sidolin,,1,5,5,10
30459,markonen,,1,2,2,4
30460,ebs,,1,3,3,6
30461,piderman,,1,8,10,18
30462,KorayA,,1,15,23,38
30463,chrisgemignani,,1,2,2,4
30464,thebushdoctrine,,1,4,3,7
30465,discreet2ndaccount,,1,1,2,3
30466,Resum,,1,4,4,8
30467,stupendousman,,1,264,469,733
30468,zsoltika,,1,51,11,62
30469,japolo,,1,5,8,13
30470,riiik,,1,3,6,9
30471,languin,,1,20,19,39
30472,Artcfox,,1,1,1,2
30473,OneEyedJack,,1,10,77,87
30474,thejewishgun,,1,2,5,7
30475,slagpelosi,,1,52,136,188
30476,viclopez,,1,336,53,389
30477,xApple,,1,1,1,2
30478,Yawb,,1,1,1,2
30479,ksidbg,,1,1,1,2
30480,cunnilinguslover,,1,2,7,9
30481,burpit,,1,1,5,6
30482,kochier,,1,117,106,223
30483,Spiffjiggins,,1,59,155,214
30484,haywire,,1,982,1682,2664
30485,oracle2b,,1,2,6,8
30486,uf98787,,1,1,1,2
30487,chimchim123,,1,5,5,10
30488,blakeh,,1,27,27,54
30489,tacodog,,1,15,21,36
30490,DouchesWild,,1,13,25,38
30491,BLIPYOU,,1,1,1,2
30492,rgh,,1,6,20,26
30493,isuckcock,,1,8,15,23
30494,acyclic,,1,46,25,71
30495,NINJAF1,,1,1,1,2
30496,signal9,,1,2,4,6
30497,BoardWalker,,1,43,39,82
30498,zima,,1,23,8,31
30499,infinity,,1,20,37,57
30500,punkinpi,,1,83,135,218
30501,BastiX,,1,29,34,63
30502,eh13,,1,1,1,2
30503,bemmu,,1,1428,310,1738
30504,JokeExplainer,,1,6,1,7
30505,MrDuncan,,1,2,8,10
30506,adlittle,,1,8,25,33
30507,Aqua_lung,,1,70,76,146
30508,cy88,,1,4,1,5
30509,xMadxScientistx,,1,478,841,1319
30510,codekitchen,,1,22,26,48
30511,chrono13,,1,75,95,170
30512,Orange_Crush,,1,5,4,9
30513,kingmonkey,,1,100,6,106
30514,stubray,,1,1,2,3
30515,rasteri,,1,2,4,6
30516,MaxK,,1,14,20,34
30517,luker,,1,4,2,6
30518,armadillo,,1,16,1,17
30519,TorleyX,,1,187,125,312
30520,Cecil077,,1,9,13,22
30521,tieze,,1,2,6,8
30522,virgule,,1,124,273,397
30523,KMKSouthie2001,,1,62,23,85
30524,sirencio,,1,1,1,2
30525,desitexan,,1,285,47,332
30526,talkincat,,1,75,85,160
30527,life_is_beautiful,,1,1,3,4
30528,JonnyQabbala,,1,30,32,62
30529,aqhb11,,1,7,4,11
30530,tef,,1,58,56,114
30531,Marivs,,1,26,40,66
30532,Jaqen,,1,118,165,283
30533,yipyapyipyap,,1,1,1,2
30534,3498349848,,1,1,1,2
30535,Captain0bvious,,1,13,7,20
30536,moose262,,1,2,8,10
30537,RandySammy,,1,3,11,14
30538,angocman,,1,35,4,39
30539,Kirsten,,1,45,61,106
30540,Inigo__Montoya,,1,2,1,3
30541,YogiBerra,,1,1,1,2
30542,bayjubla,,1,7,3,10
30543,cia_plant,,1,87,78,165
30544,ningwut5000,,1,19,37,56
30545,Oogly1,,1,14,6,20
30546,garethm,,1,10,7,17
30547,johndhackensacker,,1,131,43,174
30548,TRBenji,,1,2,4,6
30549,roopp,,1,3,1,4
30550,defrost,,1,58,87,145
30551,Reactivist,,1,28,25,53
30552,mijalis,,1,2,1,3
30553,poppawinst,,1,5,6,11
30554,caldwell04,,1,7,13,20
30555,clade,,1,2,5,7
30556,mordain,,1,3,4,7
30557,isolde,,1,34,53,87
30558,gaffe,,1,8,14,22
30559,Debbie-Downer,,1,1,1,2
30560,eMigo,,1,271,419,690
30561,photo_nazzi,,1,3,1,4
30562,diegoami,,1,4,18,22
30563,Twiek,,1,129,14,143
30564,miql,,1,2,1,3
30565,INTERNET_COP,,1,1,2,3
30566,Aries9,,1,22,52,74
30567,zeroDNT,,1,13,12,25
30568,qazima,,1,32,20,52
30569,that_fun_guy,,1,8,4,12
30570,superluminal23,,1,26,2,28
30571,betab34r,,1,1,1,2
30572,ga16lucino,,1,4,8,12
30573,geekmaster01,,1,1,1,2
30574,vikingshipper,,1,3,6,9
30575,omargard,,1,180,419,599
30576,juliusctw,,1,1,1,2
30577,TheOfficeNewb,,1,44,3,47
30578,appypolly,,1,21,15,36
30579,dylan420,,1,5,16,21
30580,zimbabwe,,1,39,58,97
30581,starfire,,1,2,1,3
30582,limpinandpimpin,,1,1,2,3
30583,senlei23,,1,10,27,37
30584,northstand,,1,304,36,340
30585,flaminggarlic,,1,21,45,66
30586,ragman_43,,1,1,1,2
30587,KemperBoyd,,1,4,11,15
30588,aphroditerules,,1,1,1,2
30589,cnk,,1,144,209,353
30590,nahlol,,1,1,4,5
30591,MineDevin,,1,1,4,5
30592,sweddit,,1,287,379,666
30593,foobark,,1,3,7,10
30594,heyhellohi,,1,2,3,5
30595,sebnukem,,1,79,180,259
30596,artaak,,1,1,1,2
30597,Tranejam,,1,4,11,15
30598,NameTry2468,,1,221,58,279
30599,08orbust,,1,51,30,81
30600,eatcrayons,,1,34,22,56
30601,tensix,,1,6,6,12
30602,Kalyrn,,1,20,37,57
30603,ChevChelios,,1,603,26,629
30604,layinginwait,,1,8,9,17
30605,skopp,,1,22,41,63
30606,wolf3973,,1,11,22,33
30607,wordy,,1,3,4,7
30608,altoloco,,1,2,6,8
30609,barneytoe,,1,17,20,37
30610,Ipipholypse,,1,25,5,30
30611,rolfv,,1,232,302,534
30612,Fitzhume,,1,91,9,100
30613,unknowingjoy,,1,5,3,8
30614,deanwinters,,1,1,2,3
30615,Riddle-,,1,1,1,2
30616,strange-moo,,1,10,7,17
30617,AEA2,,1,21,54,75
30618,geekamongus,,1,21,20,41
30619,notalent,,1,6,12,18
30620,anonymoussuperman,,1,189,289,478
30621,prattmic,,1,8,4,12
30622,m0th,,1,11,7,18
30623,pkimmich,,1,1,1,2
30624,technoguyrob,,1,100,98,198
30625,dsprox,,1,9,2,11
30626,andysmith25,,1,10,6,16
30627,thadjudkins,,1,17,20,37
30628,janelsee,,1,4,5,9
30629,quasiquarck,,1,10,14,24
30630,waltm005,,1,1,7,8
30631,mizmoxie,,1,2,1,3
30632,warpspasm,,1,5,2,7
30633,bobbymac,,1,314,13,327
30634,gltexas,,1,2,1,3
30635,sallyknows,,1,4,1,5
30636,omoplata,,1,10,9,19
30637,dashOw,,1,1,2,3
30638,Ephewall,,1,103,144,247
30639,Jhonie_Fklits,,1,19,22,41
30640,shrike3000,,1,2,5,7
30641,driveways,,1,1,5,6
30642,tizona,,1,1,1,2
30643,thejungleman,,1,12,24,36
30644,lokai_,,1,6,4,10
30645,syoutsey,,1,4,2,6
30646,solarbeat,,1,15,24,39
30647,altgenetics,,1,2,2,4
30648,supercool,,1,2,1,3
30649,pahncrd,,1,85,112,197
30650,ibrahim73,,1,4,4,8
30651,khlavguy,,1,64,60,124
30652,smaerdnekorb,,1,23,17,40
30653,homesick,,1,9,65,74
30654,Misunderstandingator,,1,1,11,12
30655,leticiagirl69,,1,6,5,11
30656,PocketCultures,,1,12,4,16
30657,notsleepy,,1,7,2,9
30658,skeena1,,1,109,241,350
30659,llamaesque,,1,6,7,13
30660,neongod,,1,1,3,4
30661,ireddit2,,1,5,3,8
30662,thisisj3w,,1,7,12,19
30663,thinkerx,,1,276,9,285
30664,mikeylopez,,1,27,22,49
30665,sketec,,1,128,159,287
30666,AIHound,,1,24,25,49
30667,flexible,,1,17,5,22
30668,bordergroves,,1,8,12,20
30669,trademark912,,1,25,44,69
30670,bmdubpk,,1,4,9,13
30671,gomexz,,1,4,7,11
30672,kandams0415,,1,1,1,2
30673,unreason03,,1,6,2,8
30674,LindsS,,1,2,1,3
30675,Brantin,,1,163,46,209
30676,NecoRadio,,1,8,12,20
30677,wgosel,,1,18,10,28
30678,timjpriebe,,1,17,17,34
30679,jpatten,,1,25,21,46
30680,al343806,,1,38,101,139
30681,todahawk,,1,148,71,219
30682,Nelstone,,1,23,12,35
30683,drewlott,,1,1,1,2
30684,Ziggurattt,,1,34,103,137
30685,svendavids,,1,8,3,11
30686,DismissMystics,,1,18,23,41
30687,TheAtomicMoose,,1,25,48,73
30688,Piotr1,,1,1,1,2
30689,little_evil,,1,133,284,417
30690,honestbender,,1,1,1,2
30691,mediaman2,,1,7,10,17
30692,BBMainsequence,,1,1,3,4
30693,sugaredpeaches,,1,2,1,3
30694,michael_palin,,1,223,179,402
30695,osamabladen,,1,3,5,8
30696,seetwist,,1,40,80,120
30697,back-in-black,,1,105,127,232
30698,westsan,,1,157,423,580
30699,Rostin,,1,6,8,14
30700,BeardWand,,1,21,36,57
30701,ryanmonroe,,1,1,2,3
30702,RedditParodiesItself,,1,7,8,15
30703,harwell,,1,6,4,10
30704,tweez,,1,11,1,12
30705,wagerlabs,,1,6,11,17
30706,youngpilgrim,,1,2,1,3
30707,handsomemilo,,1,1,3,4
30708,pubs,,1,1,1,2
30709,gnurag,,1,1,7,8
30710,hyto,,1,1,1,2
30711,shanemitchell,,1,1,4,5
30712,SecurityFirst,,1,2,1,3
30713,monstercack,,1,97,187,284
30714,z3rb,,1,412,571,983
30715,Oryx,,1,1214,1399,2613
30716,BlackPocket,,1,21,49,70
30717,distantstar,,1,1,2,3
30718,gadfly1000,,1,6,19,25
30719,democracy101,,1,2790,73,2863
30720,Toma-,,1,93,81,174
30721,joeyda3rd,,1,1,2,3
30722,SuperHappyFunGuy,,1,1,3,4
30723,coconut_pete,,1,6,4,10
30724,mikemike,,1,8,10,18
30725,cybersphere9,,1,2,3,5
30726,Kalimari,,1,227,441,668
30727,gdamjan,,1,2,1,3
30728,propool,,1,147,258,405
30729,HairSupply,,1,6,7,13
30730,hax0r,,1,262,373,635
30731,troelskn,,1,116,197,313
30732,infinity777,,1,55,14,69
30733,ajh1138,,1,6,5,11
30734,StopJohnMcNasty,,1,97,101,198
30735,compubomb,,1,57,55,112
30736,EndOfTheWorldWeKnow,,1,4,1,5
30737,aristideau,,1,72,83,155
30738,madio85,,1,17,38,55
30739,oddjob60,,1,9,8,17
30740,yelocorado,,1,20,34,54
30741,qgyh2,,1,8360,1186,9546
30742,Smiley,,1,36,48,84
30743,croup,,1,78,169,247
30744,UK-sHaDoW,,1,32,33,65
30745,LinkGCN4,,1,38,51,89
30746,brightyellowsign,,1,3,2,5
30747,tr87,,1,2,1,3
30748,jphudy,,1,6,5,11
30749,sad_bug_killer,,1,178,130,308
30750,oaaao,,1,3,7,10
30751,allspinzone,,1,200,5,205
30752,alta_dena,,1,1,2,3
30753,KCasier,,1,1,2,3
30754,Ty51,,1,9,3,12
30755,Germaphobe,,1,2,1,3
30756,flowsome,,1,1,1,2
30757,greenhat,,1,4,2,6
30758,Corey24,,1,38,66,104
30759,bhumphreys,,1,55,26,81
30760,Nhoji,,1,7,15,22
30761,howL_,,1,41,28,69
30762,omninull,,1,27,45,72
30763,waxwing,,1,83,128,211
30764,The_Mudslinger,,1,3,6,9
30765,Geminize,,1,10,23,33
30766,JustJoekingEX,,1,265,685,950
30767,emordino,,1,26,65,91
30768,nitish0991,,1,2,4,6
30769,Will_T,,1,1,3,4
30770,vaterite,,1,1,1,2
30771,researchbuff,,1,10,2,12
30772,wthomas,,1,1,1,2
30773,hardtalkfk,,1,546,20,566
30774,M44Ist,,1,2,2,4
30775,U_n_I_verse,,1,2,6,8
30776,Morningstar,,1,3,4,7
30777,starman68916,,1,1,4,5
30778,monkey166,,1,2,2,4
30779,monkeydemon,,1,7,21,28
30780,helpyhelperton,,1,4,1,5
30781,smallchanger,,1,122,175,297
30782,artee,,1,17,12,29
30783,rocky_m,,1,1,1,2
30784,slimdizzy,,1,27,102,129
30785,alleagra,,1,517,358,875
30786,ryanabrams,,1,3,4,7
30787,raccou,,1,67,171,238
30788,joebwhite,,1,13,23,36
30789,lsumnler,,1,8,2,10
30790,staticjester,,1,12,32,44
30791,scook0,,1,12,23,35
30792,-___-,,1,47,66,113
30793,carmexjoe,,1,2,3,5
30794,Trindle,,1,1,2,3
30795,SirTrollALot,,1,33,34,67
30796,enochrisen,,1,5,1,6
30797,disfunct,,1,26,43,69
30798,jephthai,,1,3,6,9
30799,MyaloMark,,1,361,637,998
30800,overdosis,,1,3,6,9
30801,iav,,1,15,12,27
30802,Cannabrain,,1,57,73,130
30803,FreeToaster,,1,5,5,10
30804,grimlok,,1,1,3,4
30805,kevinglowacz,,1,9,7,16
30806,gwerstiuk,,1,4,9,13
30807,reggieray,,1,30,51,81
30808,holeeray,,1,135,239,374
30809,kiml4n,,1,1,1,2
30810,chuckieballs,,1,24,30,54
30811,hardrain,,1,13,4,17
30812,kungfulkoder,,1,1,1,2
30813,mike24,,1,2,1,3
30814,brotherbear,,1,35,43,78
30815,einexile,,1,298,542,840
30816,scottmacpherson,,1,2,2,4
30817,casiodrone,,1,2,1,3
30818,aznpwnzor,,1,4,11,15
30819,3littlebears,,1,2,4,6
30820,LudiDabar,,1,1,1,2
30821,doofus2,,1,1,5,6
30822,that_dusty_guy,,1,197,51,248
30823,bradshawz,,1,87,99,186
30824,jesus4u,,1,346,313,659
30825,marklewis87,,1,2,1,3
30826,hennagaijinjapan,,1,126,189,315
30827,americanoddjobs,,1,13,5,18
30828,obamavoter2,,1,3,1,4
30829,sharique9800,,1,38,3,41
30830,ducksa,,1,12,21,33
30831,Jyxtrant,,1,11,13,24
30832,centx,,1,9,10,19
30833,apathy,,1,474,751,1225
30834,monitron,,1,3,3,6
30835,flashboy,,1,2,1,3
30836,fentunfont,,1,163,398,561
30837,javabrewer,,1,4,7,11
30838,teflonbob,,1,43,49,92
30839,obsidianih,,1,155,272,427
30840,bytelord,,1,24,18,42
30841,farra,,1,156,153,309
30842,mdf7g,,1,3,3,6
30843,jal3473,,1,30,43,73
30844,K-W,,1,6,6,12
30845,RedSoxFan,,1,63,27,90
30846,jicksta,,1,1,3,4
30847,afroman,,1,6,13,19
30848,tartle,,1,20,26,46
30849,steveit_is,,1,14,17,31
30850,dareonion,,1,2,4,6
30851,suckitsteve,,1,2,2,4
30852,antiv,,1,1,2,3
30853,jorydotcom,,1,2,9,11
30854,GerFitz,,1,2,1,3
30855,Araya213,,1,24,64,88
30856,mbarlow310,,1,2,1,3
30857,vbsmith6x7,,1,24,37,61
30858,friendlyfoop,,1,2,3,5
30859,ShesGotSauce,,1,22,26,48
30860,jinzo,,1,15,13,28
30861,meldroc,,1,108,34,142
30862,rex84,,1,4,8,12
30863,rsk01,,1,26,8,34
30864,masterflex,,1,3,3,6
30865,burtonmkz,,1,952,1117,2069
30866,silverwater,,1,29,46,75
30867,nikbackm,,1,6,12,18
30868,sakkio,,1,7,8,15
30869,tanhauser,,1,46,64,110
30870,darthgarlic,,1,6,3,9
30871,crl826,,1,6,11,17
30872,testiculan,,1,9,22,31
30873,aornald22,,1,1,1,2
30874,igcatastrophe,,1,1,1,2
30875,dzan,,1,14,27,41
30876,livingtogether,,1,5,8,13
30877,JohnMayer,,1,4,2,6
30878,cosmo7,,1,191,224,415
30879,marklad2020,,1,75,15,90
30880,ashley059,,1,1,1,2
30881,Terex,,1,149,203,352
30882,speedeep,,1,4,2,6
30883,zerogravity,,1,102,345,447
30884,starthirteen,,1,80,123,203
30885,chrisbosh,,1,14,2,16
30886,zandercruise,,1,9,25,34
30887,collintmiller_,,1,1,2,3
30888,FoxSynergy,,1,6,33,39
30889,mr_robert,,1,1,7,8
30890,chetanbhawani,,1,1,2,3
30891,vibaka,,1,2,1,3
30892,snedig,,1,10,18,28
30893,shimei,,1,54,54,108
30894,corranhorn85,,1,9,6,15
30895,AlexPeccator,,1,8,1,9
30896,Dearon,,1,5,13,18
30897,lickedcat,,1,3,4,7
30898,cubey,,1,36,37,73
30899,Fork82,,1,57,73,130
30900,djnrrd,,1,1,3,4
30901,jwszoid,,1,194,23,217
30902,jsinjasonjsin,,1,4,2,6
30903,NerdWeasel,,1,1,1,2
30904,joincamp,,1,9,13,22
30905,xrenditionx,,1,122,20,142
30906,02J,,1,96,169,265
30907,Thimble,,1,546,713,1259
30908,mattxb,,1,241,363,604
30909,jammie1974,,1,2,5,7
30910,manu,,1,20,22,42
30911,Flupkear,,1,1,1,2
30912,trimtab,,1,6,28,34
30913,intehnet,,1,1,1,2
30914,BruceCampbell123,,1,41,62,103
30915,brict,,1,7,5,12
30916,fyl8999,,1,7,5,12
30917,hancocklg,,1,36,4,40
30918,anyb0dyme,,1,1,1,2
30919,denverlarry,,1,2,1,3
30920,stopourdrugwarblog,,1,3,4,7
30921,forbes2008,,1,3,7,10
30922,infinite,,1,1042,1530,2572
30923,rancid_squirts,,1,185,283,468
30924,rcmark,,1,1,15,16
30925,callsorputs,,1,198,32,230
30926,mach7,,1,54,21,75
30927,GonnaRideIt,,1,5,1,6
30928,osfameron,,1,2,5,7
30929,Wheelwright,,1,48,43,91
30930,Simulacron3,,1,16,18,34
30931,diabloenfuego,,1,2,2,4
30932,the_anti_christ,,1,5,8,13
30933,reppit,,1,84,166,250
30934,PhillyNetminder,,1,39,22,61
30935,ffn,,1,95,110,205
30936,ac_dispatcher,,1,1,1,2
30937,Demonmonger,,1,180,69,249
30938,Nutricidal,,1,172,179,351
30939,requestedRerun,,1,1,7,8
30940,Hangly,,1,41,108,149
30941,farmerje,,1,78,30,108
30942,sirscooter,,1,9,19,28
30943,lord_jesus_christ,,1,5,7,12
30944,chaos,,1,20,44,64
30945,omgwtfuspolitics,,1,149,64,213
30946,uncle_jesse,,1,1,1,2
30947,shamrick79,,1,3,2,5
30948,laxdef10,,1,1,1,2
30949,festus,,1,3,1,4
30950,mpdefeo,,1,1,1,2
30951,anonymous11235,,1,23,28,51
30952,mibi,,1,20,44,64
30953,mambo78,,1,1,1,2
30954,wohho,,1,78,110,188
30955,stbill79,,1,15,12,27
30956,getty,,1,3,3,6
30957,lrrr,,1,3,3,6
30958,pimaniac,,1,17,12,29
30959,betamike,,1,6,2,8
30960,tdk2fe,,1,379,585,964
30961,Chromo,,1,1,3,4
30962,mtrommer,,1,13,12,25
30963,maccdrizzle,,1,7,2,9
30964,nobama71,,1,1,1,2
30965,azimuth,,1,13,19,32
30966,troothsayer,,1,2,4,6
30967,scalz1,,1,1,5,6
30968,R-R-R-R-R-R-RONPAUL,,1,34,56,90
30969,bimalr,,1,16,1,17
30970,daemonwolf,,1,1,4,5
30971,doodlesmalone,,1,23,22,45
30972,bitt3n,,1,111,142,253
30973,FlipNasty,,1,10,13,23
30974,jimweirich,,1,1,1,2
30975,aseclear,,1,14,27,41
30976,DavidSJ,,1,347,89,436
30977,prashmohan,,1,3,5,8
30978,wintermute,,1,19,12,31
30979,qgyh1,,1,1,2,3
30980,Tairy_Greene,,1,6,7,13
30981,toddec,,1,1,1,2
30982,ronpaulFTMFW,,1,28,39,67
30983,zakharov,,1,6,2,8
30984,scottpanton,,1,1,1,2
30985,tangentboy,,1,353,534,887
30986,JohnUSeed,,1,67,7,74
30987,shuri,,1,1,2,3
30988,uuiioopp,,1,3,1,4
30989,mrminty,,1,142,273,415
30990,calp,,1,106,161,267
30991,AmericanPatriot,,1,63,19,82
30992,amazoncon,,1,15,20,35
30993,harpoonz,,1,56,51,107
30994,pugface,,1,2,2,4
30995,lovecraftiansock1,,1,2,1,3
30996,chaconne,,1,160,237,397
30997,naive,,1,1,1,2
30998,Gwarek2,,1,46,116,162
30999,chant,,1,3,4,7
31000,stringer4,,1,43,47,90
31001,geekunit,,1,6,1,7
31002,BioGeek,,1,978,66,1044
31003,PainfullyObvious,,1,27,4,31
31004,daveafx,,1,10,14,24
31005,cayennext,,1,3,4,7
31006,pigalien1,,1,9,16,25
31007,icaruswings0,,1,7,14,21
31008,salsas,,1,1,5,6
31009,Grahar64,,1,31,43,74
31010,tikkun,,1,46,86,132
31011,Fixthemedia,,1,3,4,7
31012,miskulecka,,1,4,3,7
31013,baabaah,,1,2,1,3
31014,ThreeWordAl,,1,2,12,14
31015,rizaus,,1,1,5,6
31016,Norseman2,,1,17,20,37
31017,guy123,,1,95,102,197
31018,sublimation,,1,9,10,19
31019,ashkendo,,1,29,13,42
31020,puzza007,,1,10,17,27
31021,madriutt,,1,12,26,38
31022,eras,,1,29,42,71
31023,Hiccup,,1,22,23,45
31024,hvee7,,1,17,8,25
31025,Chanotc,,1,61,100,161
31026,JennSierra,,1,55,1,56
31027,gotfoo,,1,4,6,10
31028,dieselstation,,1,6,11,17
31029,dieselray9999,,1,50,114,164
31030,FalleenFan,,1,6,5,11
31031,jojotdfb,,1,130,206,336
31032,Sh3ut,,1,9,2,11
31033,nfck,,1,8,1,9
31034,econous,,1,90,135,225
31035,david927,,1,7,11,18
31036,DanWallace,,1,1,3,4
31037,woohalladoobop,,1,32,37,69
31038,unix_mind,,1,1,5,6
31039,oobewan,,1,1,2,3
31040,abhoffman,,1,7,6,13
31041,Rodman930,,1,301,288,589
31042,dunkelzahn,,1,3,7,10
31043,happydahg,,1,105,119,224
31044,phaed,,1,62,120,182
31045,blacklouis,,1,7,12,19
31046,justush,,1,4,4,8
31047,John_Idol,,1,26,5,31
31048,natgeo,,1,13,1,14
31049,manatlan,,1,3,3,6
31050,billygoat2000,,1,2,2,4
31051,kazakdogofspace,,1,13,21,34
31052,rlxtr,,1,1,1,2
31053,megadump,,1,3,3,6
31054,I_Love_Dr,,1,3,1,4
31055,SickFinga,,1,150,61,211
31056,dotlizard,,1,3,2,5
31057,versusgorilla,,1,1,2,3
31058,babyjesus31,,1,4,25,29
31059,Einstine1984,,1,1,1,2
31060,uzimonkey,,1,33,50,83
31061,java999,,1,80,164,244
31062,scooby1680,,1,2,10,12
31063,monocle,,1,12,20,32
31064,sudonim87,,1,12,12,24
31065,flinchy,,1,5,5,10
31066,evildrdan,,1,7,15,22
31067,Straus,,1,6,12,18
31068,cleborp,,1,3,2,5
31069,bwargh,,1,28,10,38
31070,boot13,,1,4,3,7
31071,wrathofrath,,1,18,28,46
31072,afaf90,,1,2,2,4
31073,makked,,1,12,13,25
31074,Huvet,,1,2,2,4
31075,ytfcman,,1,1,1,2
31076,Trailing_Offf,,1,1,2,3
31077,ventonegro,,1,67,35,102
31078,bradynliam,,1,2,1,3
31079,BeornS,,1,4,1,5
31080,emagdnim2100,,1,46,40,86
31081,MirrorGirl,,1,1,2,3
31082,enterneo,,1,2,3,5
31083,sgndave,,1,70,80,150
31084,dariusmonsef,,1,29,7,36
31085,bilyl,,1,39,29,68
31086,Kijjii,,1,5,1,6
31087,focus,,1,8,29,37
31088,vazelos,,1,9,1,10
31089,beethovensghost,,1,5,3,8
31090,nmbfdbskf,,1,5,4,9
31091,schmeebis,,1,2,6,8
31092,ankmorp,,1,1,1,2
31093,Tasach,,1,24,21,45
31094,EmileRedant,,1,7,9,16
31095,baatezu,,1,4,2,6
31096,BigBigBigWhoop,,1,1,3,4
31097,bdefore,,1,15,20,35
31098,xeromem,,1,1,1,2
31099,naturboy20,,1,54,30,84
31100,AlphaTeam,,1,2,3,5
31101,applecore,,1,1,2,3
31102,midtable_obscurity,,1,10,25,35
31103,pmh160,,1,119,107,226
31104,hajk,,1,239,568,807
31105,brumoeller,,1,1,1,2
31106,venturanima,,1,54,77,131
31107,jackcrow69,,1,8,16,24
31108,Xet,,1,332,392,724
31109,tsteele999,,1,3,1,4
31110,raplvr,,1,3,2,5
31111,mopel,,1,1,1,2
31112,Iamspecial,,1,1,1,2
31113,stimcaps,,1,61,55,116
31114,EddieStarr,,1,7,1,8
31115,haroldhupmobile,,1,5,5,10
31116,sgblinky,,1,2,11,13
31117,railsjedi,,1,20,6,26
31118,bobpaul,,1,1544,2349,3893
31119,OMGiGotdownmoddedLOL,,1,4,4,8
31120,rhonva,,1,9,10,19
31121,jackson58,,1,3,1,4
31122,potatolicious,,1,120,110,230
31123,kast,,1,7,3,10
31124,rubynho,,1,3,6,9
31125,Celsis,,1,69,26,95
31126,brheath,,1,54,43,97
31127,pawnticket,,1,13,23,36
31128,JuCee,,1,129,188,317
31129,Judy-Lee,,1,29,54,83
31130,gordon_c,,1,7,4,11
31131,srmjjg,,1,725,188,913
31132,frankba11,,1,1,3,4
31133,f3l1x,,1,3,4,7
31134,austinfrank,,1,10,17,27
31135,twinwing,,1,5,4,9
31136,recursion,,1,19,14,33
31137,petra234,,1,3,5,8
31138,component,,1,3,2,5
31139,infininme,,1,4,4,8
31140,Maexotic,,1,1,1,2
31141,lintrone,,1,9,8,17
31142,mackprime,,1,798,1290,2088
31143,twwilliams,,1,19,10,29
31144,Folkvangr,,1,19,4,23
31145,emaa,,1,1,1,2
31146,CrunchyRoll,,1,3,3,6
31147,oofoe,,1,18,22,40
31148,pseudonym_again,,1,2,3,5
31149,igkunow,,1,76,4,80
31150,normmccray,,1,2,1,3
31151,black3ug,,1,1,2,3
31152,joaoma,,1,2,2,4
31153,Vomitron,,1,20,10,30
31154,yousername,,1,5,1,6
31155,daldraeic,,1,3,3,6
31156,nolebotic,,1,8,1,9
31157,silence8086,,1,4,7,11
31158,cynopt,,1,3,10,13
31159,pestcontrols,,1,101,118,219
31160,supersi,,1,25,27,52
31161,mikko22222,,1,3,2,5
31162,rdosser,,1,6,12,18
31163,jeb,,1,32,34,66
31164,cbfreder,,1,53,58,111
31165,FreeBSoD,,1,1,1,2
31166,vgi19,,1,1,1,2
31167,0N1KUDAK1,,1,2,2,4
31168,iamadeathgod,,1,1,6,7
31169,notor,,1,237,181,418
31170,chriswitts,,1,2,2,4
31171,lrhamelin,,1,2,3,5
31172,SuperMechaDan,,1,1,6,7
31173,Cosmonaut86,,1,81,3,84
31174,black_belt_jones,,1,40,124,164
31175,boysha,,1,4,2,6
31176,battlintim,,1,7,1,8
31177,lballs,,1,24,27,51
31178,thedripp,,1,6,1,7
31179,Britney_Spears,,1,9,9,18
31180,smpx,,1,468,597,1065
31181,BoingWhacker,,1,18,37,55
31182,Drifter,,1,18,5,23
31183,JimmyL,,1,82,8,90
31184,robfixmycomputer,,1,5,1,6
31185,drwatson,,1,231,316,547
31186,dieselfrog,,1,109,92,201
31187,maximinus,,1,12,1,13
31188,BiGGMike,,1,1,1,2
31189,pierreman,,1,1,1,2
31190,imissthe80s,,1,1,4,5
31191,hxa7241,,1,18,24,42
31192,ex_veritate_sum,,1,24,31,55
31193,degen,,1,1,2,3
31194,mirvnillith,,1,7,4,11
31195,mystifiedglobe,,1,73,91,164
31196,bungalow,,1,47,51,98
31197,vikophageine,,1,6,1,7
31198,georwale,,1,76,9,85
31199,futuredead,,1,70,10,80
31200,walt65,,1,5,9,14
31201,madman1969,,1,127,294,421
31202,HLHLHL,,1,18,19,37
31203,king_of_blades,,1,2,8,10
31204,jhoge,,1,7,5,12
31205,fiona_,,1,2,4,6
31206,Submitted2State,,1,66,86,152
31207,ieatpants,,1,6,15,21
31208,chiprut,,1,2,4,6
31209,nubela,,1,31,35,66
31210,ShellfishGene,,1,16,18,34
31211,DivideByZero,,1,3,4,7
31212,sjbarker,,1,1,7,8
31213,yipgoo,,1,1,1,2
31214,kbott9000,,1,1,1,2
31215,bunnyland7552,,1,7,23,30
31216,RainMaker420,,1,57,27,84
31217,drj11,,1,1,1,2
31218,mikegagnon,,1,1,1,2
31219,maggs01,,1,13,2,15
31220,blkadder,,1,1,2,3
31221,hamcake,,1,3,4,7
31222,viva101,,1,1,2,3
31223,eioua,,1,35,11,46
31224,slider1985,,1,1,1,2
31225,porman,,1,1,3,4
31226,colonSTABBER,,1,6,7,13
31227,x_entrik,,1,1,2,3
31228,PeteAndRepeat,,1,3,3,6
31229,andresthor,,1,7,8,15
31230,Ranger-phx,,1,13,1,14
31231,madinaz,,1,1,1,2
31232,cops_are_great,,1,1,1,2
31233,Xert,,1,254,494,748
31234,nicholaiman,,1,5,1,6
31235,ttlfantastic,,1,669,65,734
31236,200ernesto,,1,47,14,61
31237,uykucu,,1,6,14,20
31238,hollowhills,,1,5,8,13
31239,iliveinoaklawn,,1,1,1,2
31240,ayb,,1,138,102,240
31241,wodemoneke,,1,4,6,10
31242,nekoloco,,1,25,56,81
31243,gws923,,1,3,10,13
31244,theclapp,,1,54,74,128
31245,sequentious,,1,3,2,5
31246,wokiko,,1,223,324,547
31247,joe24pack,,1,478,708,1186
31248,kap2903,,1,1,1,2
31249,humptydumtonme,,1,42,73,115
31250,fake_brasilian,,1,2,15,17
31251,humpi,,1,9,19,28
31252,himom,,1,2,4,6
31253,Taratis,,1,18,14,32
31254,IAmAngry,,1,6,5,11
31255,john75half,,1,6,1,7
31256,jimothie,,1,1,5,6
31257,perpetualstroll,,1,47,11,58
31258,meiforeverfree,,1,4,30,34
31259,Legionofmarduk,,1,2,4,6
31260,artesios,,1,206,264,470
31261,cloeequips,,1,7,25,32
31262,talboito,,1,16,16,32
31263,newseamus,,1,2,6,8
31264,toyman70,,1,2,2,4
31265,Peatey,,1,3,7,10
31266,PunchingBag,,1,31,44,75
31267,mesohungry,,1,177,232,409
31268,Xelopheris,,1,47,41,88
31269,Cenoern,,1,5,4,9
31270,alparsla,,1,98,74,172
31271,redditjimmy,,1,3,2,5
31272,DontBeStupid,,1,7,10,17
31273,Unturned1,,1,23,57,80
31274,sleepydude,,1,30,3,33
31275,anotherhydrahead,,1,42,39,81
31276,FLCLFan,,1,16,16,32
31277,cwillu,,1,19,62,81
31278,48klocs,,1,168,137,305
31279,millions,,1,2,2,4
31280,CannedMango,,1,705,913,1618
31281,neekburm,,1,1,2,3
31282,alxalx,,1,45,74,119
31283,reappear,,1,3,3,6
31284,meramera,,1,118,129,247
31285,cupcupcup,,1,50,7,57
31286,dim_mak,,1,2,1,3
31287,heymister,,1,148,154,302
31288,pcfx,,1,4,7,11
31289,DaylenDOA,,1,3,5,8
31290,snthaoeu,,1,10,18,28
31291,whatteaux,,1,2,1,3
31292,rofltosh,,1,7,8,15
31293,srot3,,1,1,1,2
31294,monxcracy,,1,107,129,236
31295,DerSpeicherplatz,,1,1,1,2
31296,cirisme,,1,1,1,2
31297,TwoToke,,1,946,1248,2194
31298,rainbowface,,1,1,1,2
31299,Sparklepuff,,1,2,5,7
31300,BPolitic,,1,9,17,26
31301,darkon,,1,128,170,298
31302,Looniee,,1,68,9,77
31303,FaithInMe,,1,6,1,7
31304,Bombheart,,1,15,20,35
31305,jaiwithani,,1,288,130,418
31306,witty,,1,1,1,2
31307,oh_shaw,,1,9,8,17
31308,foobar83,,1,2,2,4
31309,Gort,,1,5,7,12
31310,niceyoungman,,1,49,61,110
31311,aliengoods1,,1,135,130,265
31312,kawpp,,1,2,3,5
31313,blue1,,1,6,9,15
31314,Porkfish,,1,1,2,3
31315,squareoak,,1,14,2,16
31316,alfredosauce,,1,2,1,3
31317,Risiko,,1,141,228,369
31318,foulpudding,,1,7,2,9
31319,jujuguy,,1,61,192,253
31320,Rowsdower,,1,4,4,8
31321,icculus20,,1,1,1,2
31322,Brittlg06,,1,1,1,2
31323,Caleb666,,1,29,28,57
31324,zhico,,1,3,6,9
31325,jesuslol,,1,80,108,188
31326,gilead89,,1,5,5,10
31327,phrozenwind,,1,2,2,4
31328,Smockie,,1,3,6,9
31329,PuppyHat,,1,264,360,624
31330,tcycle,,1,5,4,9
31331,Cannabis-American,,1,1,1,2
31332,joseph11h,,1,10,5,15
31333,googleferrari4ever,,1,1,3,4
31334,exhibitionthree,,1,264,158,422
31335,jammmet,,1,8,9,17
31336,trukin,,1,1,1,2
31337,mungmung,,1,13,15,28
31338,Sonizel,,1,1,1,2
31339,trilorez,,1,6,5,11
31340,Slikkster,,1,1,1,2
31341,AtheniaStarr,,1,2,2,4
31342,jeffquipp,,1,361,41,402
31343,shawnmsimpson,,1,3,2,5
31344,hellotherepine,,1,1,2,3
31345,Lord_Illidan,,1,183,325,508
31346,luanda,,1,2,2,4
31347,UserAccount,,1,5,22,27
31348,jubilusv,,1,1,2,3
31349,skifreaknyc,,1,61,13,74
31350,JaniceJane,,1,1,1,2
31351,vnnzo,,1,2,1,3
31352,MegaRouge,,1,7,7,14
31353,boba,,1,16,16,32
31354,mojority,,1,32,1,33
31355,saxomophone,,1,3,5,8
31356,larrisonw,,1,19,1,20
31357,loklocke,,1,4,4,8
31358,interiot,,1,73,102,175
31359,grantdent,,1,13,8,21
31360,bronny14,,1,1,1,2
31361,fre3k,,1,3,5,8
31362,Bamrz,,1,4,16,20
31363,freethis,,1,8,12,20
31364,writersteve,,1,28,5,33
31365,brg500,,1,2,2,4
31366,dws,,1,23,37,60
31367,borga,,1,15,37,52
31368,metabaron,,1,16,26,42
31369,kmcx8,,1,1,2,3
31370,BlueBeard,,1,1630,1734,3364
31371,chibiele,,1,2,2,4
31372,drez24,,1,17,16,33
31373,jcairns16,,1,18,3,21
31374,aceregen,,1,6,12,18
31375,psi-,,1,135,160,295
31376,polyGone,,1,95,205,300
31377,may05,,1,34,51,85
31378,Thrip,,1,127,164,291
31379,harajukukei,,1,73,125,198
31380,strfryed,,1,7,3,10
31381,strawmann,,1,17,12,29
31382,duphregne,,1,1,1,2
31383,Doppelganger,,1,4,14,18
31384,egeverything,,1,11,19,30
31385,lexande,,1,2,4,6
31386,farox,,1,80,167,247
31387,oriontechno,,1,2,2,4
31388,begemot,,1,108,133,241
31389,presthatcher,,1,12,4,16
31390,honeybadger,,1,4,2,6
31391,pkej,,1,2,3,5
31392,janhammer,,1,10,21,31
31393,skaufman,,1,1,1,2
31394,chelleeliz,,1,2,1,3
31395,midnitcafe,,1,2,8,10
31396,NotSoHotPink,,1,152,183,335
31397,sp198003,,1,1,1,2
31398,johnnycanada,,1,1,1,2
31399,palmerjp,,1,2,2,4
31400,mooinakan,,1,10,14,24
31401,tehowe,,1,12,1,13
31402,i_c_dumbsheeple,,1,1,1,2
31403,sskatygirl,,1,8,13,21
31404,gislik,,1,1,1,2
31405,squidfartz,,1,23,15,38
31406,khammack,,1,76,126,202
31407,kimberst,,1,3,5,8
31408,ishmetot,,1,8,17,25
31409,DKKat,,1,89,129,218
31410,nasorenga,,1,74,137,211
31411,kerouac_,,1,5,14,19
31412,gk3coloursred,,1,7,21,28
31413,SuedeRS100,,1,67,84,151
31414,polarix,,1,27,74,101
31415,SlideGuitar,,1,9,6,15
31416,uriDium,,1,16,35,51
31417,kengrandlund,,1,31,2,33
31418,pikonu,,1,13,13,26
31419,arnorhs,,1,8,5,13
31420,Biogeek22,,1,1,1,2
31421,williampbarnes,,1,2,5,7
31422,rejs7,,1,8,15,23
31423,aquavit,,1,11,12,23
31424,javiercero1,,1,1,4,5
31425,sfhippie,,1,1,1,2
31426,howshotweb,,1,1,2,3
31427,Ramone1234,,1,20,25,45
31428,no_kahn,,1,2,1,3
31429,YourNameHere,,1,31,53,84
31430,megatron12,,1,1,1,2
31431,zbranigan,,1,1,1,2
31432,nexus6,,1,1,1,2
31433,RhyminS,,1,9,13,22
31434,rickligg,,1,5,2,7
31435,Sampo,,1,6,6,12
31436,Tulle,,1,1,2,3
31437,carotids,,1,58,33,91
31438,Sneakas,,1,2,8,10
31439,zarmao,,1,23,16,39
31440,AlwaysAwake,,1,42,5,47
31441,matthank,,1,421,940,1361
31442,heyjohn07,,1,1,1,2
31443,lambosv21,,1,6,6,12
31444,synthoid,,1,77,82,159
31445,mike744,,1,1,2,3
31446,entropyfails,,1,158,115,273
31447,Devilish,,1,61,67,128
31448,PRONEUELE,,1,59,93,152
31449,Salim101,,1,1,1,2
31450,Sarahsahara,,1,4,10,14
31451,halobob98,,1,50,77,127
31452,cboshuizen,,1,4,5,9
31453,sayhar,,1,21,9,30
31454,strazys,,1,50,15,65
31455,bjanas,,1,3,1,4
31456,marioletto,,1,1,2,3
31457,Winoria,,1,286,319,605
31458,yanikd,,1,1,5,6
31459,Arcoril,,1,4,7,11
31460,raruler,,1,5,8,13
31461,aiz,,1,2,1,3
31462,uncoveror,,1,15,21,36
31463,Downtown,,1,45,47,92
31464,kmm3,,1,95,13,108
31465,pear22,,1,1,1,2
31466,TerreC,,1,1,1,2
31467,Jackm7,,1,191,125,316
31468,Jadedknight,,1,35,13,48
31469,Manalore,,1,2,6,8
31470,kcafka,,1,17,21,38
31471,weaselword,,1,52,56,108
31472,bbqbot,,1,2,5,7
31473,sarafiq,,1,3,1,4
31474,mouseh,,1,2,7,9
31475,jorge,,1,7,6,13
31476,25121642,,1,5,6,11
31477,ate4m,,1,10,8,18
31478,ryodoan,,1,11,9,20
31479,Carioca,,1,124,145,269
31480,andymad,,1,165,30,195
31481,torgski,,1,1,1,2
31482,CountFerdinandVonZep,,1,9,20,29
31483,rdermody,,1,5,8,13
31484,gregtron,,1,28,33,61
31485,nobrakes,,1,7,5,12
31486,claymeyers,,1,9,1,10
31487,TheKRF,,1,30,1,31
31488,viniciusfs,,1,5,4,9
31489,useful_idiot,,1,6,9,15
31490,frogmander,,1,84,103,187
31491,wonderdolkje,,1,13,17,30
31492,tedprodromou,,1,4,1,5
31493,crdoconnor,,1,36,41,77
31494,aideity,,1,6,12,18
31495,Avinio,,1,79,6,85
31496,yakovsmirnoff,,1,5,20,25
31497,oppositionradio,,1,4,2,6
31498,Sqwirl,,1,404,485,889
31499,chipsambos,,1,3,1,4
31500,Schoens,,1,17,12,29
31501,Jeffrey903,,1,2,1,3
31502,drewcee,,1,8,2,10
31503,hobocop,,1,36,62,98
31504,fitstretching,,1,1,3,4
31505,scobot,,1,1,2,3
31506,Erox1234,,1,96,45,141
31507,MR_LAFRALDO,,1,98,122,220
31508,Lirael,,1,2,4,6
31509,hoelzro,,1,32,37,69
31510,hookabooka,,1,5,2,7
31511,DDDdean,,1,1,1,2
31512,darksabrelord,,1,49,94,143
31513,brandong,,1,32,27,59
31514,georgehotelling,,1,4,5,9
31515,PoliticalMari,,1,1,1,2
31516,undimensionalman,,1,24,17,41
31517,illforgetitshortly,,1,1,2,3
31518,toolshed,,1,18,29,47
31519,cattnack,,1,54,78,132
31520,thunderdan7000,,1,1,7,8
31521,cheezel,,1,42,61,103
31522,shepherd81,,1,4,5,9
31523,OldGrandet,,1,6,10,16
31524,kilooneniner,,1,3,3,6
31525,david-icke,,1,1,1,2
31526,Skuld,,1,194,403,597
31527,yurbud,,1,110,12,122
31528,dkrazfoo,,1,16,3,19
31529,snz333,,1,1,2,3
31530,patrick_,,1,2,4,6
31531,niloc132,,1,6,6,12
31532,tenebrousx,,1,46,56,102
31533,snookerboy,,1,2,3,5
31534,zimmdj,,1,2,1,3
31535,protoopus,,1,347,761,1108
31536,royagole,,1,82,1,83
31537,FAILBOAT,,1,1,1,2
31538,gurki,,1,7,8,15
31539,thrind,,1,5,8,13
31540,netzdamon,,1,91,186,277
31541,hal2000,,1,6,10,16
31542,the_bob,,1,265,478,743
31543,piotrm,,1,2,3,5
31544,rujith,,1,24,31,55
31545,Zat,,1,5,7,12
31546,TheCityOfZing,,1,2,1,3
31547,abethebrewer,,1,55,97,152
31548,wtfmf,,1,13,10,23
31549,twist_420,,1,12,14,26
31550,SteefHarsley,,1,4,4,8
31551,dehm,,1,1,1,2
31552,diggoryvenn,,1,3,2,5
31553,jdiamond,,1,1,2,3
31554,jaybee,,1,158,164,322
31555,pulse_dial,,1,7,5,12
31556,rheimbuch,,1,6,7,13
31557,thallium205,,1,4,2,6
31558,jefurii,,1,5,1,6
31559,MikeyMadness,,1,23,35,58
31560,Edalgo,,1,127,280,407
31561,Bakie,,1,105,20,125
31562,crake,,1,111,148,259
31563,SDPBMX,,1,2,2,4
31564,T-MACK,,1,10,25,35
31565,blackbellamy,,1,4,5,9
31566,jvongator,,1,88,15,103
31567,bugnuker,,1,2,1,3
31568,ogijun,,1,34,15,49
31569,skypnd,,1,4,11,15
31570,the_bees_knees,,1,4,8,12
31571,timcoleman,,1,2,1,3
31572,junky24,,1,11,9,20
31573,wcarss,,1,1,2,3
31574,alexanderkjerulf,,1,94,15,109
31575,horizon_effect,,1,18,10,28
31576,woodeee,,1,3,1,4
31577,kemitchell,,1,38,93,131
31578,zitterbewegung,,1,147,119,266
31579,mike2386,,1,4,7,11
31580,hashedmac,,1,25,4,29
31581,thefixer90723,,1,3,3,6
31582,valermos,,1,4,2,6
31583,louizatakk,,1,11,19,30
31584,Reify,,1,8,13,21
31585,Odenized,,1,13,18,31
31586,werpon,,1,2,3,5
31587,djimmy,,1,10,14,24
31588,mykdavies,,1,42,36,78
31589,itshurleytime,,1,5,13,18
31590,mcrezin,,1,3,10,13
31591,tidderllor,,1,2,1,3
31592,mundungous,,1,631,270,901
31593,geoff422,,1,552,787,1339
31594,gilbertgrape,,1,248,122,370
31595,jimbopouliot,,1,1,2,3
31596,Verroq,,1,131,203,334
31597,BigBob1216,,1,7,7,14
31598,BleakFuture,,1,1,1,2
31599,lfbayer,,1,1,2,3
31600,alchemist,,1,1,2,3
31601,jade_22,,1,4,3,7
31602,BattleHall,,1,3,2,5
31603,c27penn,,1,12,16,28
31604,ITolerateLosAngeles,,1,1,1,2
31605,chinacatridr,,1,16,1,17
31606,jomohke,,1,1,4,5
31607,daw_ards,,1,2,2,4
31608,snakeysnakes,,1,3,3,6
31609,derivation,,1,11,6,17
31610,koolsitez,,1,59,47,106
31611,disquietus,,1,1,4,5
31612,YellowBlueGreen,,1,4,6,10
31613,kalithieu,,1,3,1,4
31614,jamougha,,1,22,30,52
31615,wang-banger,,1,2698,449,3147
31616,justrudd,,1,1,2,3
31617,dotrob,,1,318,534,852
31618,DownX,,1,6,13,19
31619,leonh,,1,88,93,181
31620,futpoo,,1,1,1,2
31621,ggk1,,1,121,318,439
31622,hopson2462,,1,2,4,6
31623,hjst,,1,22,33,55
31624,lux1955,,1,1,4,5
31625,bowlofudon,,1,15,10,25
31626,Dan_Farina,,1,74,126,200
31627,johanlbotha,,1,1,1,2
31628,Spankmeister,,1,1,3,4
31629,abrs,,1,8,8,16
31630,semanticdesigner,,1,3,3,6
31631,coolweb,,1,103,1,104
31632,DUG1138,,1,23,19,42
31633,wolf550e,,1,16,21,37
31634,sledcat,,1,2,11,13
31635,bahumbug1,,1,26,31,57
31636,ottilie,,1,19,14,33
31637,ocdude,,1,187,243,430
31638,Errenden,,1,7,12,19
31639,paulreiners,,1,5,6,11
31640,EvanRWT,,1,6,10,16
31641,badpauly,,1,7,19,26
31642,noeljohnhoward,,1,35,48,83
31643,jmpeters,,1,77,15,92
31644,jack2damx,,1,10,11,21
31645,booshack,,1,4,8,12
31646,ksiz,,1,2,3,5
31647,rber,,1,2,3,5
31648,lordspesh,,1,9,15,24
31649,stas,,1,27,4,31
31650,drdwi,,1,3,1,4
31651,Mainsley,,1,1,3,4
31652,Faja22,,1,1,1,2
31653,kylevonblum,,1,1,2,3
31654,husla3x,,1,38,1,39
31655,randyest,,1,46,84,130
31656,zigbar06,,1,2,1,3
31657,duaneduane,,1,1,1,2
31658,reir,,1,2,3,5
31659,capiCrimm,,1,122,155,277
31660,mystery-meme,,1,5,6,11
31661,Badekar,,1,34,70,104
31662,eliatic,,1,109,288,397
31663,Xhippie,,1,21,57,78
31664,newnetmp3,,1,128,143,271
31665,pbwill95,,1,6,4,10
31666,just4fun,,1,16,1,17
31667,JodoYodo,,1,9,16,25
31668,aemadrid,,1,24,5,29
31669,northzilla,,1,33,102,135
31670,bannana,,1,56,124,180
31671,skepchick,,1,1,2,3
31672,ximprezax,,1,4,4,8
31673,areallylongusername,,1,2,3,5
31674,beaner25,,1,3,2,5
31675,OldSpice,,1,1,1,2
31676,Niten,,1,297,333,630
31677,IAmimperfectlyCalm,,1,6,3,9
31678,Admiral_Winfield,,1,1,1,2
31679,RockStories,,1,11,24,35
31680,chak,,1,3,5,8
31681,shiva777,,1,12,15,27
31682,csixty4,,1,88,155,243
31683,mrhinsliy,,1,1,1,2
31684,jillsy,,1,59,56,115
31685,rainywrath,,1,6,10,16
31686,airshowfan,,1,26,2,28
31687,alternon,,1,1,1,2
31688,crunkworks,,1,4,3,7
31689,jrdn,,1,6,5,11
31690,Alexace31190,,1,93,121,214
31691,Mother_fucker,,1,3,1,4
31692,roskopp,,1,1,2,3
31693,obmud,,1,8,5,13
31694,rhouse,,1,47,87,134
31695,zwigby,,1,1,2,3
31696,ElfWord,,1,5,5,10
31697,minderbinder,,1,16,2,18
31698,cordsie,,1,12,3,15
31699,badge,,1,1,5,6
31700,Joe_Smlter,,1,24,20,44
31701,peg_leg,,1,250,557,807
31702,mems,,1,4,2,6
31703,shadowfox,,1,88,152,240
31704,wal9000,,1,118,187,305
31705,ArtieZiff,,1,2,1,3
31706,gavinpanella,,1,7,4,11
31707,slaptijack,,1,63,8,71
31708,cats-is-hungreh,,1,8,7,15
31709,zomgsauce,,1,9,15,24
31710,ksforpedro,,1,29,1,30
31711,Ranma-kun,,1,20,18,38
31712,samg,,1,201,288,489
31713,tribs,,1,9,5,14
31714,tommym,,1,25,15,40
31715,jayekub,,1,1,1,2
31716,phxboy,,1,464,14,478
31717,ironpony,,1,247,480,727
31718,ASupertramp,,1,14,22,36
31719,newacctlol,,1,4,3,7
31720,fathead,,1,6,4,10
31721,AnneHalibut,,1,7,8,15
31722,jonra,,1,334,72,406
31723,heyiquit,,1,55,60,115
31724,vietnamesesandwich,,1,1,1,2
31725,theangleshavegone,,1,3,7,10
31726,mathewjm,,1,61,22,83
31727,Saamfou,,1,1,1,2
31728,theknifeman,,1,4,4,8
31729,ST2K,,1,523,875,1398
31730,minibadger,,1,8,6,14
31731,chimerical_brio,,1,17,4,21
31732,dryguy,,1,98,5,103
31733,mkjones,,1,281,123,404
31734,opabinia,,1,29,37,66
31735,brothers,,1,2,3,5
31736,askjoe,,1,24,18,42
31737,KirillM,,1,16,25,41
31738,talo1019,,0,1,1,2
31739,emoticon,,1,550,7,557
31740,trendykendy,,1,28,5,33
31741,dickinson,,1,1,2,3
31742,spek,,1,28,62,90
31743,moistastic,,1,97,21,118
31744,gracecommunityfellow,,1,2,1,3
31745,angryletter,,1,4,1,5
31746,brutalunicorn,,1,2,3,5
31747,mattrussell,,1,1,2,3
31748,atlasx,,1,1,1,2
31749,uwflatlander,,1,2,1,3
31750,nofreelunch,,1,1,1,2
31751,shumizzle,,1,5,4,9
31752,m4dc4p,,1,43,22,65
31753,Canadian_Infidel,,1,390,753,1143
31754,rivenwolf,,1,1,4,5
31755,mmgreenmms,,1,2,2,4
31756,40_lb,,1,4,9,13
31757,supertoned,,1,46,75,121
31758,Grim_Chook,,1,3,3,6
31759,bronyaur1,,1,1,8,9
31760,dadrik,,1,1,1,2
31761,nsfw808,,1,2,2,4
31762,vineire7,,1,1,1,2
31763,wiegraff13,,1,1,1,2
31764,mitchwells,,1,28,25,53
31765,cyks,,1,149,227,376
31766,dotnetrock101,,1,66,109,175
31767,knobwrangler,,1,18,45,63
31768,cdickerson,,1,1,1,2
31769,superisaac,,1,1,2,3
31770,tenfttall,,1,3,16,19
31771,ubernostrum,,1,368,439,807
31772,sonja77,,1,1,1,2
31773,chalfont_alarm,,1,3,8,11
31774,klutometis,,1,2,7,9
31775,ironlenin,,1,32,48,80
31776,swerdna,,1,58,89,147
31777,ratatask,,1,1,9,10
31778,shimbob,,1,1,1,2
31779,butwait,,1,129,176,305
31780,normchow,,1,142,13,155
31781,acangiano,,1,708,297,1005
31782,Cultist,,1,59,12,71
31783,clone00,,1,17,23,40
31784,ThorYourGod,,1,16,43,59
31785,hellofriends2,,1,5,3,8
31786,bioskope,,1,513,621,1134
31787,esun,,1,10,11,21
31788,wethefallen,,1,5,2,7
31789,cb22,,1,67,71,138
31790,mainman3322,,1,5,3,8
31791,redditsucksball5,,1,5,1,6
31792,blubloblu,,1,57,71,128
31793,cap10,,1,3,4,7
31794,KillsItBad,,1,4,7,11
31795,amanda2007,,1,279,50,329
31796,charlie230,,1,31,19,50
31797,broalex,,1,4,7,11
31798,cccmikey,,1,7,21,28
31799,nabsy,,1,1,2,3
31800,ironfighter2008,,1,1,3,4
31801,kman001,,1,47,60,107
31802,Dionadah,,1,14,19,33
31803,Zerokool5string,,1,4,1,5
31804,shivernz,,1,12,19,31
31805,toastr,,1,1,2,3
31806,JohnnyNemonic,,1,2,2,4
31807,jarjarbinks,,1,5,5,10
31808,carbon28,,1,12,10,22
31809,djshaw,,1,2,3,5
31810,all2hectic,,1,2,7,9
31811,freethinkers,,1,8,9,17
31812,kdjakq,,1,1,2,3
31813,caesar_honeybee,,1,3,15,18
31814,scottiesan,,1,18,23,41
31815,dodisman,,1,211,477,688
31816,Voor,,1,54,73,127
31817,rit,,1,23,34,57
31818,orad,,1,6,7,13
31819,jiarb,,1,10,11,21
31820,grauenwolf,,1,1774,1571,3345
31821,HofmannsDelysid,,1,7,10,17
31822,daltonlp,,1,65,11,76
31823,spazmaster,,1,2,4,6
31824,hellfeuer,,1,5,7,12
31825,daftdad,,1,30,44,74
31826,stebbiv,,1,33,67,100
31827,jnoempire,,1,16,7,23
31828,scrat,,1,6,6,12
31829,nickcald,,1,3,4,7
31830,dotc0m,,1,2,3,5
31831,TheMemoman,,1,281,413,694
31832,matasar,,1,2,1,3
31833,oldFonzie,,1,4,2,6
31834,mclovinsuperpower,,1,6,68,74
31835,blackflag77,,1,111,231,342
31836,yog,,1,1,1,2
31837,bidou,,1,130,59,189
31838,edguy,,1,143,214,357
31839,mcantelon,,1,892,805,1697
31840,vawn,,1,2,1,3
31841,mookieXL,,1,14,27,41
31842,disastrophe,,1,31,37,68
31843,talex5,,1,2,4,6
31844,SFWopinions,,1,6,14,20
31845,mpollan,,1,7,1,8
31846,Brady1984,,1,18,37,55
31847,JohnnyCanuck,,1,124,211,335
31848,pookybum,,1,4,5,9
31849,ionspin,,1,13,11,24
31850,meatydelight,,1,31,30,61
31851,n9e9o9,,1,5,17,22
31852,JamesJanega,,1,18,5,23
31853,oaklandcory,,1,1,2,3
31854,kiwi1986,,1,60,10,70
31855,wowlolcat,,1,78,93,171
31856,sanat,,1,15,9,24
31857,shortboarder,,1,1,9,10
31858,coolpoints,,1,3,4,7
31859,icexe,,1,17,33,50
31860,KPrime,,1,1,1,2
31861,wh0wants2know,,1,11,4,15
31862,derekbox,,1,2,6,8
31863,rocapotamus,,1,6,4,10
31864,outcastspice,,1,10,12,22
31865,patrickdennis25,,1,2,2,4
31866,seeldee,,1,19,19,38
31867,stpauley45,,1,26,51,77
31868,todd_s4,,1,1,1,2
31869,migelius,,1,61,96,157
31870,kuraikaze,,1,126,207,333
31871,MatiG,,1,35,51,86
31872,jasurbek,,1,3,2,5
31873,panders,,1,5,23,28
31874,Fauster,,1,1256,999,2255
31875,atoothforatooth,,1,4,3,7
31876,santu,,1,2,2,4
31877,Dickwad,,1,12,22,34
31878,adamsplugins,,1,1,1,2
31879,SentientU,,1,97,168,265
31880,twitternut,,1,1,1,2
31881,rik7,,1,4,2,6
31882,taxi81887,,1,2,2,4
31883,adriano,,1,1,1,2
31884,svuori,,1,10,16,26
31885,what_a_nice_castle,,1,2,4,6
31886,NotPortlyNJ,,1,41,55,96
31887,illiteratebeef,,1,21,32,53
31888,mieczyslaw,,1,8,9,17
31889,fismo,,1,2,4,6
31890,sunsunsun,,1,81,203,284
31891,colusito,,1,11,5,16
31892,cephyn,,1,3,4,7
31893,katcol26,,1,5,1,6
31894,chexzie,,1,5,5,10
31895,joekro,,1,6,14,20
31896,lightthenations,,1,2,1,3
31897,franz_dawonk,,1,1,1,2
31898,ablock,,1,1,1,2
31899,boriskin,,1,25,29,54
31900,nerp,,1,8,11,19
31901,nherd,,1,4,3,7
31902,Whipsnake,,1,4,1,5
31903,jlongstreet,,1,4,3,7
31904,nemodomi,,1,9,15,24
31905,jwaters,,1,9,13,22
31906,KaptainKraken,,1,19,45,64
31907,idreamincode,,1,71,49,120
31908,reddista,,1,1,1,2
31909,DaTroof,,1,4,3,7
31910,carlfish,,1,16,27,43
31911,kjfarley,,1,22,9,31
31912,F3AR,,1,140,33,173
31913,Ariox,,1,2,2,4
31914,jedipunk,,1,4,4,8
31915,uteunawaytoy,,1,7,5,12
31916,xipetotec,,1,149,184,333
31917,WackyWorld,,1,6,5,11
31918,Bobgnote,,1,2,1,3
31919,lucidreamstate,,1,34,4,38
31920,why,,1,3,2,5
31921,Matthew_atNAL,,1,1,1,2
31922,holaworld,,1,1,1,2
31923,4569294,,1,1,1,2
31924,DrEnigma,,1,1,2,3
31925,zyx,,1,13,10,23
31926,shan564,,1,68,19,87
31927,cstor,,1,1,1,2
31928,lolza,,1,44,6,50
31929,gott_ist_tott,,1,1,1,2
31930,db4n,,1,186,307,493
31931,dreale,,1,78,222,300
31932,lebishop,,1,6,4,10
31933,Netsufr2k7,,1,8,19,27
31934,aensues,,1,33,42,75
31935,vaclev,,1,2,3,5
31936,blenderhead,,1,5,8,13
31937,meu,,1,1,4,5
31938,AdRook,,1,10,12,22
31939,thesheqq,,1,10,23,33
31940,ajensen,,1,31,11,42
31941,prioryofsion,,1,9,15,24
31942,sonof101,,1,2,1,3
31943,nrgianni,,1,20,36,56
31944,trogo,,1,32,72,104
31945,Rantosune,,1,1,1,2
31946,tophat02,,1,105,119,224
31947,tmetzger,,1,16,10,26
31948,SweetSauce,,1,4,2,6
31949,sr4free,,1,6,8,14
31950,P_ro,,1,3,6,9
31951,metalbox69,,1,52,68,120
31952,stopgo,,1,102,26,128
31953,deadcat,,1,132,156,288
31954,mrdctaylor,,1,11,2,13
31955,YouFunnyToo,,1,1,1,2
31956,courtowndave,,1,3,1,4
31957,JimmyCrackedCorn,,1,35,7,42
31958,valarmorghulis,,1,9,17,26
31959,norrsson,,1,163,9,172
31960,senex,,1,5,3,8
31961,stoool,,1,34,67,101
31962,JustAZombie,,1,35,26,61
31963,jsmith77555,,1,4,5,9
31964,bionicseraph,,1,98,123,221
31965,taxandspend,,1,9,8,17
31966,happyday,,1,20,27,47
31967,mccoey01,,1,5,4,9
31968,james39,,1,15,43,58
31969,MobileDigit,,1,11,11,22
31970,apotre,,1,31,59,90
31971,sgrace575,,1,100,172,272
31972,bplus,,1,13,15,28
31973,LouFisFucktarded,,1,15,12,27
31974,e2tango,,1,46,56,102
31975,seattlevisitor,,1,1,1,2
31976,citizenwhite,,1,31,16,47
31977,thedaniel,,1,32,55,87
31978,devslashnull,,1,16,18,34
31979,rwinston,,1,96,38,134
31980,monkeyslikebananas,,1,110,87,197
31981,peaceyp,,1,51,55,106
31982,federal_employee,,1,38,42,80
31983,ktr73,,1,19,6,25
31984,vitaltrade,,1,3,2,5
31985,baffle,,1,2,5,7
31986,nedrUoD,,1,6,3,9
31987,freefrombroke,,1,1,2,3
31988,daveloper,,1,56,65,121
31989,phdsharkey,,1,2,5,7
31990,Ultravod,,1,137,30,167
31991,_sheeple_,,1,2,4,6
31992,blamedesign,,1,1,2,3
31993,fryguy,,1,1,1,2
31994,RadioFreeJimmy,,1,2,1,3
31995,NotQuite,,1,5,1,6
31996,I_LIKE_PIE,,1,1,1,2
31997,mistereff,,1,1,1,2
31998,nathananderson,,1,35,19,54
31999,matzero99,,1,1,2,3
32000,chesterjosiah,,1,56,18,74
32001,boynton,,1,6,1,7
32002,jdrake3r,,1,1,4,5
32003,Shrubber,,1,65,101,166
32004,nillio89,,1,7,1,8
32005,fietspad,,1,2,5,7
32006,FLX,,1,27,29,56
32007,ZisforZebras,,1,4,5,9
32008,biggu_makku,,1,8,17,25
32009,egotripping,,1,27,47,74
32010,number5,,1,38,8,46
32011,xxxalio,,1,6,9,15
32012,indi,,1,19,10,29
32013,ilkkah,,1,21,5,26
32014,ResN8,,1,1,2,3
32015,Blckman,,1,3,5,8
32016,Sackboy1980,,1,1,1,2
32017,bluegrama,,1,1,4,5
32018,soonerpet,,1,22,17,39
32019,xael,,1,41,87,128
32020,SNIa,,1,2,1,3
32021,myredditaccnt,,1,4,4,8
32022,coder21,,1,63,39,102
32023,dll,,1,18,27,45
32024,chrj,,1,86,34,120
32025,harbinjer,,1,8,20,28
32026,ecogeek,,1,34,8,42
32027,estherschindler,,1,87,8,95
32028,magikaru,,1,94,85,179
32029,indierockclimber,,1,17,25,42
32030,rr82,,1,1,3,4
32031,panda129,,1,7,8,15
32032,PvtGoon,,1,6,6,12
32033,theanti9,,1,54,7,61
32034,wankware_police,,1,7,6,13
32035,DuBBle,,1,43,33,76
32036,peregrine,,1,229,239,468
32037,vikingbuddhist,,1,2,2,4
32038,Lordcain9,,1,2,1,3
32039,runako,,1,2,3,5
32040,xac00fm,,1,14,14,28
32041,richardfarley,,1,2,1,3
32042,bahuma,,1,4,4,8
32043,banzai3,,1,1,1,2
32044,majorbta,,1,1,2,3
32045,grules,,1,70,6,76
32046,wroteit,,1,20,33,53
32047,schtog,,1,6,10,16
32048,athurston,,1,34,38,72
32049,DarthMaul,,1,1,1,2
32050,huw1000,,1,4,5,9
32051,cowboysstar,,1,36,3,39
32052,digg_suxx_bigg,,1,253,326,579
32053,amazingwealth1,,1,1,1,2
32054,leonardscarlow,,1,45,28,73
32055,epe,,1,7,6,13
32056,SurlyJason,,1,15,14,29
32057,superconnected,,1,1,2,3
32058,Synx,,1,22,19,41
32059,h3jh0g,,1,22,2,24
32060,nastysuicide,,1,30,36,66
32061,tephe,,1,1,2,3
32062,millermj,,1,1,5,6
32063,thefuture,,1,1,3,4
32064,jwkolberg,,1,44,61,105
32065,liquilife,,1,113,57,170
32066,conspirisi,,1,1,2,3
32067,coffeegeek,,1,6,3,9
32068,BobSaget,,1,1,1,2
32069,wfwfe123,,1,2,3,5
32070,jrmorrill,,1,2,7,9
32071,basementcat,,1,74,127,201
32072,dalore,,1,37,55,92
32073,d07c0m,,1,580,795,1375
32074,nonprofitpirate,,1,2,6,8
32075,a1k0n,,1,192,243,435
32076,bart9h,,1,58,129,187
32077,georgelazenby,,1,236,336,572
32078,chiphead2332,,1,26,33,59
32079,rharmelink,,1,4,3,7
32080,johnnyAnon,,1,1,1,2
32081,nadslkvvn,,1,7,3,10
32082,alexybeetle,,1,1,1,2
32083,Leonidas_from_XIV,,1,265,393,658
32084,Orsenfelt,,1,1,1,2
32085,oblommer,,1,12,9,21
32086,mrstinton,,1,14,10,24
32087,jadtrue,,1,1,1,2
32088,Jesus_,,1,4,3,7
32089,volkadav,,1,5,2,7
32090,dancing_bagel,,1,74,98,172
32091,tenmillion,,1,1,2,3
32092,Kesslerjfox,,1,68,146,214
32093,randomexpert,,1,24,27,51
32094,nsfworker,,1,2,3,5
32095,PhotonJohn,,1,15,16,31
32096,DrywallThief,,1,1,1,2
32097,Steak_Efreet,,1,7,10,17
32098,ralf_,,1,94,125,219
32099,s717ch3s,,1,129,76,205
32100,elrizzy,,1,1,1,2
32101,donnie_dark0,,1,42,78,120
32102,shmorsh,,1,1,1,2
32103,averyv,,1,377,627,1004
32104,glebaron,,1,1,1,2
32105,Shlight,,1,83,32,115
32106,zipdog,,1,169,230,399
32107,dnh,,1,4,4,8
32108,MiiCH3LL3_N3ON,,3,1,1,2
32109,nessaneko,,1,17,29,46
32110,xgjkp,,1,2,1,3
32111,JabberBody,,1,4,1,5
32112,jba,,1,95,60,155
32113,BeowulfShaeffer,,1,16,29,45
32114,dcristoloveanu,,1,1,2,3
32115,thetreeoflibertyorg,,1,2,3,5
32116,hseldon,,1,4,6,10
32117,stewartallyn,,1,18,18,36
32118,Smithwick,,1,5,2,7
32119,cwmonkey,,1,132,254,386
32120,BeZany,,1,26,31,57
32121,cymen,,1,12,31,43
32122,anonami,,1,8,5,13
32123,fujimitsu,,1,1208,1699,2907
32124,vtail,,1,3,2,5
32125,Bjango,,1,2,4,6
32126,ITP404,,1,2,1,3
32127,davelong,,1,2,2,4
32128,wicbldw,,1,11,9,20
32129,dlukegordon,,1,2,2,4
32130,sanchitosonria,,1,616,214,830
32131,webist,,1,38,79,117
32132,romanovsky,,1,1,1,2
32133,GLeD,,1,19,24,43
32134,chrisrico,,1,43,44,87
32135,DocXango,,1,14,25,39
32136,jroes,,1,19,10,29
32137,Gajolo,,1,1,3,4
32138,Estaris1,,1,2,6,8
32139,roconnor,,1,241,278,519
32140,someguyinkali,,1,37,44,81
32141,nomdeweb,,1,1478,105,1583
32142,dmisda,,1,5,4,9
32143,Humboldt,,1,1,2,3
32144,wycats,,1,1,3,4
32145,kyle_kennedy7,,1,4,2,6
32146,L8sho,,1,16,33,49
32147,pkredditor,,1,2,5,7
32148,rgdfilms,,1,2,1,3
32149,Terras,,1,4,12,16
32150,bbqribs,,1,664,1009,1673
32151,medeshago,,1,3,8,11
32152,nacorom,,1,11,8,19
32153,GingerBoyIV,,1,1,1,2
32154,bluetshirt,,1,70,116,186
32155,StandardBearer,,1,3,10,13
32156,pfalabella,,1,1,2,3
32157,americanjackass,,1,5,3,8
32158,TimFinnegan,,1,8,17,25
32159,bitados65,,1,2,2,4
32160,krg6O9,,1,27,50,77
32161,polysics,,1,3,19,22
32162,RedditAHole,,1,5,1,6
32163,obamalie,,1,3,3,6
32164,Cris987,,1,14,15,29
32165,InanePenguin,,1,3,3,6
32166,paxsifal,,1,8,11,19
32167,GodJesusHolyspirit,,1,10,23,33
32168,jumberboy,,1,2,3,5
32169,cynicalmoose,,1,1,5,6
32170,TinyTim08,,1,3,1,4
32171,fiction916,,1,13,4,17
32172,bat-mite,,1,6,6,12
32173,twinkle720,,1,1,3,4
32174,moogle516,,1,2039,2233,4272
32175,llou,,1,1,3,4
32176,alittlerebel,,1,4,6,10
32177,letdinosaursdie,,1,1,1,2
32178,chorny,,1,3,13,16
32179,Baaz,,1,2,5,7
32180,ravindraS,,1,15,23,38
32181,UrzaJR,,1,1,5,6
32182,bdki,,1,3,11,14
32183,dzkalman,,1,39,20,59
32184,ReddiThor,,1,5,6,11
32185,lockart,,1,1,2,3
32186,razzmataz,,1,48,109,157
32187,aph,,1,1,1,2
32188,bigboehmboy,,1,141,134,275
32189,AndrewBlevins,,1,3,2,5
32190,chris462,,1,11,53,64
32191,hereticjoe,,1,9,17,26
32192,malapropist,,1,57,48,105
32193,dzappone,,1,11,16,27
32194,buthead,,1,14,21,35
32195,celestec,,1,54,16,70
32196,Singletoned,,1,42,4,46
32197,akston,,1,59,24,83
32198,regulator1,,1,10,11,21
32199,horneraa,,1,14,16,30
32200,feeman_4_life,,1,3,5,8
32201,SenorCarbone,,1,1,2,3
32202,kryptor,,1,1,2,3
32203,nofxet,,1,4,2,6
32204,joshtradomus,,1,1,3,4
32205,ninjadave,,1,3,1,4
32206,cippirimerlo,,1,2,5,7
32207,ThomasMueller,,1,3,1,4
32208,BlendNewYork,,1,4,2,6
32209,cwcheang,,1,1,1,2
32210,mlusher,,1,6,3,9
32211,lanevo,,1,2,1,3
32212,5am,,1,19,37,56
32213,AHFX,,1,11,11,22
32214,commonslip,,1,618,596,1214
32215,runevault,,1,6,8,14
32216,LKM,,1,33,31,64
32217,unsee,,1,125,177,302
32218,vurx,,1,13,13,26
32219,itburnzwineyep,,1,1,1,2
32220,tonic,,1,14,8,22
32221,vedema,,1,2,5,7
32222,maido,,1,51,2,53
32223,almkglor,,1,208,354,562
32224,trock,,1,75,103,178
32225,dhaffner,,1,5,9,14
32226,savvu,,1,102,144,246
32227,laconicfunk,,1,231,41,272
32228,doomcomplex,,1,515,378,893
32229,lotek0000,,1,4,4,8
32230,bitecode,,1,14,18,32
32231,pwb,,1,34,1,35
32232,blackbullet4749,,1,2,1,3
32233,rastrillo,,1,3,2,5
32234,guinnessstout,,1,113,160,273
32235,sdpope,,1,42,40,82
32236,ReverendResidrew,,1,2,1,3
32237,metaldogman,,1,248,94,342
32238,t86d,,1,1,1,2
32239,zapcon,,1,4,5,9
32240,blondin,,1,219,347,566
32241,SINGLE_ENTENDRE,,1,5,6,11
32242,disambiguate,,1,10,3,13
32243,Damario,,1,1,1,2
32244,AcEBAthunTeR,,1,1,1,2
32245,ro4ers,,1,150,138,288
32246,basque_linguist,,1,3,1,4
32247,triskaid,,1,91,239,330
32248,tjclassic82,,1,4,18,22
32249,urigzu,,1,187,210,397
32250,nukalarbalm,,1,5,21,26
32251,rooskyranger,,1,6,9,15
32252,divia83,,1,2,8,10
32253,urbinsissy,,1,3,1,4
32254,SeguroKC,,1,56,74,130
32255,wzzrd,,1,2,1,3
32256,byouk,,1,3,3,6
32257,insertusernamehere,,1,5,4,9
32258,cleverfoo,,1,12,7,19
32259,sonne611,,1,61,4,65
32260,eaFriendly,,1,18,25,43
32261,icantstanditanymore,,1,1,1,2
32262,friedgoop,,1,3,4,7
32263,wodehouse,,1,15,5,20
32264,admiralmatt,,1,6,18,24
32265,underscore,,1,1,2,3
32266,daenerys,,1,1,3,4
32267,antisthenex,,1,126,131,257
32268,rickyshaw,,1,422,13,435
32269,Haaretz,,1,2,1,3
32270,echo_chamber,,1,134,120,254
32271,republiwho,,1,1,1,2
32272,popic,,1,2,1,3
32273,sshenanigans,,1,26,13,39
32274,katsumio,,1,1,1,2
32275,Sid_209,,1,17,19,36
32276,mridlen,,1,53,19,72
32277,vannion,,1,1,2,3
32278,traitor_qgyh2,,1,2,1,3
32279,sizah,,1,23,2,25
32280,usrbinladen,,1,2,1,3
32281,wreckit,,1,2,1,3
32282,rbarfoot,,1,378,523,901
32283,zloog,,1,16,21,37
32284,FAIL_INSPECTOR,,1,2,2,4
32285,Tetraca,,1,180,387,567
32286,WilliamJLepetomane,,1,1,2,3
32287,ninjaknowell,,1,23,6,29
32288,RadioZonde,,1,2,6,8
32289,gu13,,1,18,31,49
32290,hole-in-the-wall,,1,1,8,9
32291,nascent,,1,103,186,289
32292,haydepops,,1,72,3,75
32293,reportage,,1,18,5,23
32294,tristanp,,1,1,1,2
32295,adityaw,,1,16,12,28
32296,web3,,1,7,3,10
32297,XzeroX,,1,179,116,295
32298,king_kenyon,,1,4,8,12
32299,seidaku,,1,37,1,38
32300,kgen,,1,21,26,47
32301,elabogado,,1,3,7,10
32302,j0ey,,1,3,1,4
32303,lostlogic,,1,63,52,115
32304,the_observer,,1,35,20,55
32305,vizzeroth,,1,2,3,5
32306,Narcotic,,1,27,43,70
32307,Zaii,,1,1,9,10
32308,jsoul,,1,1,2,3
32309,joaq,,1,2,1,3
32310,MarkTraceur,,1,200,267,467
32311,Wires,,1,8,9,17
32312,Soccer-Bot,,1,4,11,15
32313,Parsolamew,,1,7,9,16
32314,tnevlos,,1,1,1,2
32315,penguinfeather,,1,31,12,43
32316,seventythree,,1,4,13,17
32317,psycosulu,,1,1,1,2
32318,jwallenfeldt,,1,1,9,10
32319,Buelldozer,,1,33,33,66
32320,aadcock,,1,16,23,39
32321,st3v3,,1,3,1,4
32322,stygyan,,1,101,138,239
32323,Pyronaut,,1,1,1,2
32324,DRMacIver,,1,446,329,775
32325,mirthcontrol,,1,6,12,18
32326,zakqwy,,1,11,3,14
32327,st1710,,1,29,20,49
32328,runner166,,1,1,2,3
32329,Chris2048,,1,38,60,98
32330,MGDIBTYGD,,1,5,8,13
32331,edward,,1,48,2,50
32332,londawg,,1,5,3,8
32333,somestranger26,,1,10,23,33
32334,kadjar,,1,3,3,6
32335,yoyo,,1,1,1,2
32336,queensnake,,1,74,98,172
32337,sfultong,,1,392,539,931
32338,chumpy4747,,1,3,1,4
32339,atronic92,,1,4,10,14
32340,accidentallywut,,1,22,27,49
32341,shellybell,,1,2,1,3
32342,nutsack,,1,25,31,56
32343,guyonphone,,1,33,45,78
32344,JoeShlabotnick,,1,1,1,2
32345,mragreeable,,1,18,10,28
32346,cs123,,1,5,6,11
32347,internetstreetnoledg,,1,2,2,4
32348,kkania,,1,2,4,6
32349,xsoapboxherox,,1,110,164,274
32350,dri3s,,1,101,42,143
32351,daood,,1,6,6,12
32352,borf003,,1,3,1,4
32353,xyroclast,,1,169,328,497
32354,HarveyBirdman,,1,1,1,2
32355,mlandis,,1,1,5,6
32356,jimdesu,,1,24,55,79
32357,kazino,,1,1,11,12
32358,ignatus,,1,6,5,11
32359,glugglug,,1,7,16,23
32360,youre_an_idiot,,1,2,1,3
32361,maradeath,,1,5,2,7
32362,pcaisse,,1,3,7,10
32363,prospitrage,,1,1,1,2
32364,JeremyPridemore,,1,3,1,4
32365,flyingpotato,,1,11,9,20
32366,perenzo,,1,2,3,5
32367,Auger,,1,18,18,36
32368,PiZZaBAGEL432,,1,5,6,11
32369,tomkzinti,,1,3,4,7
32370,TylerR,,1,6,2,8
32371,chloecatkins,,1,8,2,10
32372,promarket,,1,1,2,3
32373,palalab,,1,199,465,664
32374,animalcrackers,,1,21,24,45
32375,samwichz,,1,6,8,14
32376,doctorgnx,,1,1,3,4
32377,jasen,,1,4,3,7
32378,MissClara,,1,3,1,4
32379,proudbuy,,1,2,1,3
32380,teetante,,1,284,68,352
32381,mazerrackham,,1,4,6,10
32382,dgnw,,1,3,3,6
32383,taskmistress,,1,1,2,3
32384,winsmith,,1,12,34,46
32385,GraceKungFu,,1,1,1,2
32386,huguley,,1,6,3,9
32387,xposijenx,,1,2,4,6
32388,gaggedbythealien,,1,310,487,797
32389,rattboi,,1,4,2,6
32390,furbius,,1,18,2,20
32391,raditha,,1,1,1,2
32392,tokyo,,1,34,80,114
32393,fewfw,,1,58,97,155
32394,oddlyattractive,,1,20,41,61
32395,Noxious,,1,1,2,3
32396,tptmonkey,,1,1,1,2
32397,Sly_R,,1,17,17,34
32398,russbo50,,1,1,1,2
32399,rictic,,1,98,43,141
32400,RightBrainLeftBrain,,1,4,4,8
32401,nospmis_remoh,,1,3,2,5
32402,jonnyathan,,1,10,19,29
32403,jalanb,,1,8,10,18
32404,plehu,,1,166,76,242
32405,KOM,,1,353,530,883
32406,team_ira,,1,11,6,17
32407,charlesesl,,1,208,340,548
32408,Freop,,1,1,1,2
32409,iff2in,,1,2,1,3
32410,rgov,,1,1,1,2
32411,shadymilkman,,1,1,1,2
32412,kathano,,1,19,27,46
32413,imprinter,,1,1,3,4
32414,slevin,,1,9,2,11
32415,Superschill,,1,46,50,96
32416,PopeJohnPaulII,,1,1,1,2
32417,naven,,1,21,48,69
32418,gigglescale,,1,1,5,6
32419,ayn_rand_worshipper,,1,423,167,590
32420,kzn,,1,2,2,4
32421,Fantomapple,,1,4,6,10
32422,shmoyko,,1,2,7,9
32423,PrettyWilbur,,1,15,79,94
32424,yleviel,,1,14,2,16
32425,gorkon,,1,8,13,21
32426,tuki,,1,70,95,165
32427,africabound,,1,1,2,3
32428,dsmgirl,,1,1,1,2
32429,dznqbit,,1,34,73,107
32430,tommytwotats,,1,116,62,178
32431,fuglybear,,1,18,22,40
32432,octophobic,,1,97,243,340
32433,Siegy,,1,19,26,45
32434,SPConsulting,,1,2,9,11
32435,upstream,,1,56,55,111
32436,ecmendenhall,,1,40,1,41
32437,howest,,1,1,1,2
32438,isanmateo,,1,6,3,9
32439,diein2fires,,1,2,1,3
32440,gabriele,,1,2,1,3
32441,gordond,,1,8,11,19
32442,lickmygiggle,,1,6,4,10
32443,bulgakovish,,1,11,15,26
32444,Your_Sister,,1,1,1,2
32445,OctopusMan,,1,48,28,76
32446,ZuG,,1,36,42,78
32447,harry8227,,1,53,104,157
32448,TigerCityTrails,,1,1,1,2
32449,epsd101,,1,159,55,214
32450,tapster,,1,1,10,11
32451,y0k0,,1,6,5,11
32452,hughperson,,1,23,16,39
32453,justtiffer,,1,13,1,14
32454,MosX,,1,12,13,25
32455,dbell,,1,5,6,11
32456,MDoubleM,,1,1,4,5
32457,genefarmer,,1,2,1,3
32458,trashrockx,,1,3,2,5
32459,mazarax,,1,2,2,4
32460,xjvz,,1,85,153,238
32461,molestake,,1,436,154,590
32462,rulebook,,1,3,1,4
32463,log1cstudios,,1,6,10,16
32464,runningscared,,1,98,80,178
32465,blogger75,,1,28,2,30
32466,vthacker03,,1,66,15,81
32467,j1o1h1n,,1,3,14,17
32468,chickenbandit,,1,1,3,4
32469,Agent-Smith,,1,1,1,2
32470,pbegley,,1,3,2,5
32471,FalseAnimal,,1,2,1,3
32472,writerchick,,1,4,4,8
32473,QuantumNeedledick,,1,1,1,2
32474,agaley,,1,2,4,6
32475,burtleboo,,1,14,31,45
32476,ABTechie,,1,13,7,20
32477,__god__,,1,1,3,4
32478,seanalltogether,,1,304,221,525
32479,u2boy_nl,,1,36,19,55
32480,emilbjorklund,,1,3,3,6
32481,cheese_puff42,,1,35,61,96
32482,MrPolite,,1,5,7,12
32483,kataztrophy,,1,1,2,3
32484,pivo,,1,16,42,58
32485,quackmeister,,1,342,359,701
32486,Iamfrontosa,,1,1,7,8
32487,rscubes,,1,7,1,8
32488,kanetrain,,1,21,30,51
32489,zube__,,1,4,7,11
32490,kharlowe,,1,4,19,23
32491,spif,,1,1988,396,2384
32492,Shadowrose,,1,80,133,213
32493,Prysorra,,1,1978,1755,3733
32494,gmtruckclub,,1,2,2,4
32495,Emergencist,,1,2,2,4
32496,vincentk,,1,21,31,52
32497,giant_robot,,1,1,3,4
32498,seldon3,,1,1,1,2
32499,molsi01,,1,3,2,5
32500,greyflcn,,1,16,32,48
32501,duncanf,,1,15,9,24
32502,dum_spiro_spero,,1,13,17,30
32503,faswich,,1,8,18,26
32504,frobischer,,1,127,161,288
32505,shockdoctrined,,1,2,8,10
32506,McDeath,,1,7,9,16
32507,marcinwk,,1,18,32,50
32508,uniques,,1,7,5,12
32509,bamfb2,,1,5,9,14
32510,hunterkll,,1,15,9,24
32511,ChaoticLlama,,1,89,8,97
32512,jackrobinson1,,1,4,3,7
32513,themanlog,,1,6,1,7
32514,Sanyo3456,,1,12,20,32
32515,421,,1,1,1,2
32516,takakoshimizu,,1,56,68,124
32517,timschon,,1,23,20,43
32518,skoh,,1,59,26,85
32519,norcon,,1,5,4,9
32520,LCnSac,,1,1,1,2
32521,joeblow80,,1,3,2,5
32522,dstopping,,1,81,4,85
32523,Joke_Police,,1,113,192,305
32524,dbug,,1,1,5,6
32525,niels,,1,10,6,16
32526,Ruiner,,1,26,24,50
32527,rac1,,1,1,3,4
32528,elx9c0,,1,5,4,9
32529,CForsythe,,1,1,2,3
32530,headtale,,1,6,3,9
32531,holyfool26,,1,130,193,323
32532,erangi,,1,4,2,6
32533,blitzbaby,,1,5,7,12
32534,CaptnHector,,1,57,59,116
32535,aseriesofenemas,,1,4,1,5
32536,artpop,,1,6,10,16
32537,Fiendish_Jam,,1,22,24,46
32538,Macdaddy357,,1,33,46,79
32539,sonikk,,1,10,20,30
32540,stealmywealth2009,,1,3,2,5
32541,Chancellor740,,1,29,49,78
32542,obanite,,1,28,33,61
32543,kino101,,1,122,238,360
32544,UpmodMeOrDie,,1,6,5,11
32545,adamnmcc,,1,3,5,8
32546,taleofconstantsorrow,,1,1,1,2
32547,bluesky36912,,1,61,21,82
32548,chomski,,1,3,13,16
32549,GunnerMcGrath,,1,1263,883,2146
32550,monstrosabatier,,1,5,6,11
32551,brc,,1,9,22,31
32552,grub,,1,2,3,5
32553,sipofsoma,,1,11,20,31
32554,AmyNewman,,1,18,1,19
32555,yoshevchoshev,,1,1,1,2
32556,drizzt001,,1,6,8,14
32557,malanalars,,1,285,112,397
32558,TODizzle91,,1,138,114,252
32559,mrjah,,1,28,28,56
32560,buildmonkey,,1,319,482,801
32561,AdamSelene138,,1,1,2,3
32562,scsp85,,1,9,19,28
32563,Sangermaine,,1,597,799,1396
32564,nupetfish,,1,2,1,3
32565,ragipy,,1,76,109,185
32566,ccolec,,1,40,54,94
32567,Independent,,1,375,228,603
32568,ruffimonster,,1,77,14,91
32569,berserkur,,1,14,41,55
32570,ananthmv,,1,27,2,29
32571,freedomfritos,,1,1,4,5
32572,Hastin,,1,22,45,67
32573,ngai,,1,1,3,4
32574,benwad,,1,2,1,3
32575,Jameswa,,1,6,3,9
32576,BoredHottie,,1,123,207,330
32577,javimahai,,1,50,54,104
32578,xanderhud,,1,2,3,5
32579,MFLUDER,,1,24,7,31
32580,brooksbp,,1,29,15,44
32581,Brandon_Sachse,,1,1,1,2
32582,justanotherone,,1,1,4,5
32583,bardioc,,1,4,6,10
32584,mrsantonio,,1,13,30,43
32585,culbeda,,1,406,432,838
32586,bmeckel,,1,60,62,122
32587,lejuscara,,1,11,12,23
32588,bgraves20,,1,183,45,228
32589,damonpoole,,1,32,22,54
32590,ReelDeel,,1,27,19,46
32591,garamond10pt,,1,72,52,124
32592,news_addict,,1,16,18,34
32593,Liebre,,1,37,29,66
32594,wewa,,1,176,167,343
32595,JokerTrain,,1,15,22,37
32596,didumos,,1,1,2,3
32597,TripMaster_Monkey,,1,578,500,1078
32598,24sparky,,1,129,206,335
32599,mbchoe,,1,2,1,3
32600,ukcz,,1,359,277,636
32601,miahfost,,1,3,4,7
32602,nyteryder79,,1,58,133,191
32603,sharth,,1,29,55,84
32604,jlo7719,,1,59,4,63
32605,snaut,,1,21,44,65
32606,mathesonmd,,1,1,1,2
32607,dr_pyser,,1,73,8,81
32608,akmark,,1,11,16,27
32609,OhioDude,,1,109,154,263
32610,maep,,1,4,4,8
32611,ma7moudshadi,,1,17,3,20
32612,saobi,,1,127,18,145
32613,JayBrezny,,1,53,4,57
32614,thecosmicfool,,1,18,24,42
32615,johnd24,,1,146,1,147
32616,thehayworth,,1,3,11,14
32617,garamon,,1,14,25,39
32618,LegalSlave,,1,1,3,4
32619,FatBelly,,1,1,2,3
32620,copurate,,1,1,1,2
32621,SquidLord,,1,1,1,2
32622,carinda,,1,9,21,30
32623,uzerzer,,1,63,109,172
32624,Snoron,,1,662,867,1529
32625,lotllotl,,1,1,1,2
32626,bijantehrani,,1,1,3,4
32627,greatsites,,1,2,1,3
32628,zemsta,,1,169,120,289
32629,emacdona,,1,19,7,26
32630,jakesonaplane,,1,48,21,69
32631,awaken,,1,123,6,129
32632,mybrainisfull,,1,9,13,22
32633,monkeylectric,,1,1,1,2
32634,firebird84,,1,50,55,105
32635,guyal,,1,1,3,4
32636,dijkstra,,1,6,6,12
32637,tharxide,,1,5,8,13
32638,justnoise,,1,5,9,14
32639,cornflakepirate,,1,1,2,3
32640,Pufflekun,,1,75,93,168
32641,hmmmmmmmmmmm,,1,1,1,2
32642,jasperx,,1,109,29,138
32643,juiceboxrock,,1,248,222,470
32644,Cooptwentysix,,1,1,2,3
32645,druski,,1,1,3,4
32646,XanderCage,,1,17,12,29
32647,internetbadass,,1,4,10,14
32648,smartsingh,,1,48,39,87
32649,Ollietheweatherman,,1,1,1,2
32650,jordankasteler,,1,642,30,672
32651,stunkcrunk,,1,2,1,3
32652,dhinchak,,1,14,13,27
32653,fatshady,,1,8,11,19
32654,jewz911thinkaboutit,,1,2,3,5
32655,JoelB,,1,73,106,179
32656,JSTARR356,,1,15,13,28
32657,hjkl_,,1,1,1,2
32658,jgumpert,,1,17,3,20
32659,baller,,1,2,3,5
32660,howhard1309,,1,2,1,3
32661,Chrisstines,,1,2,1,3
32662,kirkyak,,1,15,13,28
32663,linux_traveler,,1,7,7,14
32664,eliot999,,1,6,6,12
32665,happyphilter,,1,24,10,34
32666,burningion,,1,5,2,7
32667,reddituser000,,1,1,1,2
32668,Schlichten,,1,359,111,470
32669,NutrientCyclist,,1,1,1,2
32670,dgodon,,1,33,15,48
32671,biteableniles,,1,20,28,48
32672,Kwilco,,1,9,11,20
32673,ohyouknow,,1,3,4,7
32674,mcflyfly,,1,6,9,15
32675,I922sParkCir,,1,39,61,100
32676,fireorgan,,1,69,138,207
32677,theropolitans,,1,2,1,3
32678,reed311,,1,298,277,575
32679,andyisaramblinman,,1,2,1,3
32680,underanalt,,1,31,37,68
32681,Roxja-it,,1,6,7,13
32682,switch72,,1,78,84,162
32683,d3dkat,,1,1,1,2
32684,alfonsoeromero,,1,1,1,2
32685,CellBlock,,1,35,31,66
32686,CYG,,1,1,1,2
32687,niles,,1,21,31,52
32688,sunroom,,1,32,24,56
32689,greentangent,,1,147,358,505
32690,tobidotman,,1,1,1,2
32691,anargeek77,,1,2,3,5
32692,green777,,1,1,1,2
32693,i_am_my_father,,1,85,202,287
32694,narkee,,1,179,112,291
32695,thedarkman,,1,2,5,7
32696,nova1989,,1,1,1,2
32697,brandondos,,1,40,70,110
32698,terrel,,1,5,2,7
32699,shawnl2,,1,2,4,6
32700,God_The_Almighty,,1,50,47,97
32701,flydog2,,1,251,223,474
32702,howdyduty,,1,1,2,3
32703,bluestater,,1,2,4,6
32704,topcat31,,1,39,4,43
32705,mentalfruit,,1,86,38,124
32706,AngelFury,,1,5,1,6
32707,mscaprikell,,1,1,2,3
32708,McNutty,,1,7,7,14
32709,snarfman,,1,1849,61,1910
32710,jwshapir,,1,4,3,7
32711,supaphly42,,1,409,782,1191
32712,cfire,,1,6,1,7
32713,IBFreddy,,1,10,15,25
32714,recluce,,1,14,6,20
32715,racsismisbadmkay,,1,1,2,3
32716,dokijic,,1,19,30,49
32717,kitsune,,1,138,57,195
32718,dacrinton,,1,2,1,3
32719,steven_p,,1,11,5,16
32720,jrockway,,1,536,741,1277
32721,cyclops79,,1,29,12,41
32722,uhwhat,,1,1,2,3
32723,vaquero,,1,2,10,12
32724,kaska1,,1,2,1,3
32725,producerism,,1,8,28,36
32726,ttread,,1,20,10,30
32727,feralmonkey,,1,14,13,27
32728,perjorativejinx,,1,55,56,111
32729,mikeshine,,1,17,19,36
32730,SadyeBabi,,1,33,4,37
32731,pkeane,,1,7,2,9
32732,Badtz,,1,8,11,19
32733,gorzak,,1,1,2,3
32734,propanbutan,,1,3,7,10
32735,vanliao,,0,2,1,3
32736,killeole,,1,1,1,2
32737,tejas3d,,1,1,1,2
32738,ColdSnickersBar,,1,547,716,1263
32739,SashaNein,,1,1,2,3
32740,Abuchner,,1,18,4,22
32741,pabs,,1,52,52,104
32742,bystandereffect,,1,2,3,5
32743,grudolf,,1,2,4,6
32744,BeeBole,,1,25,12,37
32745,tangoholic,,1,3,4,7
32746,unitvector,,1,7,5,12
32747,pano200,,1,1,3,4
32748,mrchak,,1,127,184,311
32749,Toxygene,,1,34,32,66
32750,ltdraper,,1,3,6,9
32751,slithymonster,,1,29,43,72
32752,NeoWhig,,1,83,81,164
32753,the-outlier,,1,28,36,64
32754,worldtraveller,,1,193,21,214
32755,pchalich,,1,15,11,26
32756,medicalsteve,,1,2,4,6
32757,bjschnei,,1,103,2,105
32758,kindageek,,1,7,2,9
32759,melissaf,,1,4,1,5
32760,c53x12,,1,331,395,726
32761,dodeja,,1,1,1,2
32762,Firehunter,,1,11,16,27
32763,malcontent,,1,2135,3102,5237
32764,Matt08642,,1,80,12,92
32765,sankyo,,1,1,2,3
32766,robinw,,1,15,1,16
32767,Cookie-Monster,,1,1,1,2
32768,StupidCrocs,,1,1,4,5
32769,gormly,,1,18,15,33
32770,clippedtoofar,,1,11,9,20
32771,Neuro420,,1,250,433,683
32772,2GuysAaron,,1,1,1,2
32773,doctor_x,,1,10,10,20
32774,tienm23,,1,2,2,4
32775,PuP5,,1,310,507,817
32776,shawnaroo,,1,2,2,4
32777,morimoto,,1,3,9,12
32778,blkguyattheprty,,1,55,36,91
32779,oshout,,1,118,106,224
32780,Insom,,1,2,2,4
32781,dourk,,1,2,16,18
32782,ScottAlexander,,1,13,9,22
32783,leexine,,1,46,16,62
32784,another_one,,1,1,1,2
32785,dadadada,,1,274,137,411
32786,SamReidHughes,,1,26,38,64
32787,aroras,,1,6,4,10
32788,snissn,,1,86,125,211
32789,ChimpWithACar,,1,68,92,160
32790,echostorm,,1,19,9,28
32791,137,,1,24,12,36
32792,ToasterCoaster,,1,16,15,31
32793,jluebbert,,1,1,1,2
32794,Teaboy,,1,148,127,275
32795,binkabinka,,1,28,9,37
32796,hugeness,,1,4,4,8
32797,michael003,,1,46,1,47
32798,NearlyHuman,,1,49,14,63
32799,buckethead--,,1,18,24,42
32800,dave007,,1,3,2,5
32801,slashninja,,1,2,1,3
32802,d42,,1,910,840,1750
32803,mmiikk,,1,21,72,93
32804,jrhass,,1,3,3,6
32805,iDrifter,,1,1,5,6
32806,Canadian_Imperialist,,1,16,9,25
32807,pintsize317,,1,1,3,4
32808,mattraibert,,1,22,3,25
32809,GlryX,,1,6,10,16
32810,BillMTracer,,1,1,1,2
32811,yehauma,,1,1250,2225,3475
32812,SantiagoRamon,,1,381,426,807
32813,smgilroy,,1,1,1,2
32814,jlks,,1,347,555,902
32815,elihusmails,,1,7,1,8
32816,wrldcmnt,,1,1,1,2
32817,lovelinuxlove,,1,2,4,6
32818,autonomousgerm,,1,6,12,18
32819,dra_cula,,1,22,39,61
32820,Capps83,,1,1,1,2
32821,Kesko,,1,491,15,506
32822,washcapsfan37,,1,432,575,1007
32823,ArcticTurtle,,1,48,6,54
32824,NewsCrew,,1,1,1,2
32825,artman,,1,1090,1714,2804
32826,spooky47,,1,101,13,114
32827,milesphenn,,1,8,21,29
32828,711was_a_retail_job,,1,217,354,571
32829,qlight,,1,12,24,36
32830,pyderi,,1,2,1,3
32831,DodgeStRegis,,1,24,49,73
32832,audioeric,,1,36,28,64
32833,somersault,,1,4,4,8
32834,erickt,,1,1,3,4
32835,gasface,,1,53,42,95
32836,DR_SBAITSO,,1,2,1,3
32837,nescafe,,1,4,1,5
32838,guitardemon,,1,51,10,61
32839,lazyfriction,,1,4,3,7
32840,simpat1zq,,1,2,1,3
32841,hschenker,,1,41,34,75
32842,smovorg,,1,3,4,7
32843,clea,,1,253,195,448
32844,djreedps,,1,5,4,9
32845,jdavis301,,1,278,219,497
32846,yodacallmesome,,1,1,3,4
32847,miamistu,,1,4,8,12
32848,MrRadar,,1,88,28,116
32849,Xophmeister,,1,309,333,642
32850,illleaveafterthis,,1,2,5,7
32851,tsondie21,,1,160,140,300
32852,verticallyintegrated,,1,1,1,2
32853,snaxion,,1,58,145,203
32854,LinuxFTW,,1,36,82,118
32855,playful,,1,15,13,28
32856,puetzk,,1,18,38,56
32857,akirksey,,1,11,10,21
32858,Kavok,,1,56,85,141
32859,jhi,,1,2,5,7
32860,Stripper-Cookie-Girl,,1,1,3,4
32861,espergreen,,1,4,7,11
32862,runningskull,,1,35,6,41
32863,Catch-22,,1,126,68,194
32864,treerex,,1,31,68,99
32865,thetable,,1,2,1,3
32866,karmakillernz,,1,9,17,26
32867,falyst,,1,1,2,3
32868,quitNow,,1,14,2,16
32869,gecko,,1,87,71,158
32870,phunc,,1,4,13,17
32871,glorax,,1,2,6,8
32872,carlito99,,1,1,3,4
32873,luisnarvaez582,,1,1,2,3
32874,tooslow,,1,56,21,77
32875,arthur_d,,1,5,11,16
32876,piratetyler,,1,6,6,12
32877,digg_sucks,,1,2,5,7
32878,jmurphy,,1,3,2,5
32879,benalene,,1,99,15,114
32880,TearsOfRage,,1,645,1094,1739
32881,OvidPerl,,1,123,67,190
32882,wesumd,,1,70,55,125
32883,swag,,1,2,15,17
32884,viller,,1,50,86,136
32885,moonglow,,1,30,48,78
32886,code6226,,1,10,3,13
32887,dcinsea,,1,2,7,9
32888,alisdair,,1,1,1,2
32889,gerg6111,,1,298,636,934
32890,jocamero,,1,3,6,9
32891,megamega2,,1,1,1,2
32892,spam_bogey,,1,1,1,2
32893,shy_bc,,1,6,11,17
32894,MrUniverse,,1,162,32,194
32895,eiclectis,,1,1,3,4
32896,h2so4hurts,,1,145,5,150
32897,iysdjp2rk0,,1,1,1,2
32898,Gregorus,,1,5,2,7
32899,thatAnonymousGuy,,1,2,3,5
32900,bloodniece,,1,64,102,166
32901,dfan,,1,98,47,145
32902,dirtbiker,,1,1,6,7
32903,danniboi33,,1,64,43,107
32904,rjminniear,,1,3,2,5
32905,WRYYYZARD,,1,10,14,24
32906,macseminal,,1,62,2,64
32907,andylepp,,1,18,44,62
32908,clarkster,,1,15,18,33
32909,jessman1982,,1,1,1,2
32910,Glitch29,,1,95,118,213
32911,redsky989,,1,3,2,5
32912,paal349,,1,14,29,43
32913,NorthernView,,1,27,37,64
32914,r275delta,,1,1,2,3
32915,k1114,,1,3,9,12
32916,JimmyGarcia,,1,15,21,36
32917,davidconnell,,1,14,5,19
32918,Stiophan,,1,14,24,38
32919,indigoparadox,,1,23,31,54
32920,hendler,,1,5,7,12
32921,Jay_kay_au,,1,18,29,47
32922,gracefulfailure,,1,21,9,30
32923,sqjtaipei,,1,58,82,140
32924,dankeezer,,1,67,67,134
32925,okayUK,,1,54,7,61
32926,ApostropheNazi,,1,1,7,8
32927,enigma66marktwo,,1,336,570,906
32928,razend,,1,1,3,4
32929,iggyviola,,1,375,62,437
32930,Anonymous7777,,1,126,88,214
32931,kavedaa,,1,17,22,39
32932,straightalk,,1,1,1,2
32933,madcoweater,,1,22,27,49
32934,markthis,,1,5,3,8
32935,b0xii,,1,3,2,5
32936,ajmoir,,1,12,15,27
32937,fringzxk,,1,6,15,21
32938,mactep86,,1,123,8,131
32939,onepostpseudonym,,1,5,1,6
32940,RockHardplace,,1,1,1,2
32941,dskerman,,1,27,15,42
32942,slartibartfas,,1,11,19,30
32943,parsim,,1,15,13,28
32944,IAmInLoveWithJesus,,1,1494,532,2026
32945,kmonk,,1,210,284,494
32946,iamverycanadian,,1,80,66,146
32947,lackingin,,1,1,1,2
32948,deadringer76,,1,3,2,5
32949,kmakmfa,,1,13,28,41
32950,mailinator1138,,1,252,172,424
32951,densitywave,,1,4,4,8
32952,oblique_parallax,,1,1,1,2
32953,korran,,1,6,7,13
32954,adamrgolf,,1,125,178,303
32955,mccord,,1,31,36,67
32956,SubvertMSM,,1,20,20,40
32957,kill_the_xtians,,1,1,1,2
32958,FlyingFoetus,,1,4,3,7
32959,swedegeek,,1,26,10,36
32960,silentlaw,,1,23,20,43
32961,drunkenfud,,1,32,2,34
32962,chrisfranklin,,1,2,2,4
32963,jayssite,,1,393,491,884
32964,edditr,,1,17,21,38
32965,mll,,1,9,5,14
32966,Juppylolo,,1,1,4,5
32967,SuperDanny,,1,1,9,10
32968,conesieur,,1,1,1,2
32969,Smithore,,1,5,9,14
32970,DiatomaceousEarth,,1,1,6,7
32971,sambowman,,1,9,5,14
32972,robofetus,,1,22,11,33
32973,RCHD,,1,3,6,9
32974,4_STAR_GENERAL,,1,1,1,2
32975,stalyn,,1,5,3,8
32976,2Ricky,,1,1,4,5
32977,bradhannah,,1,3,2,5
32978,slhandler,,1,1,5,6
32979,turkourjurbs,,1,1197,1534,2731
32980,WWFStern,,1,5,4,9
32981,zsouthboy,,1,47,74,121
32982,pirate742,,1,1,1,2
32983,spam99,,1,134,140,274
32984,Hookhand,,1,34,77,111
32985,indrid5000,,1,7,6,13
32986,PPatBoyd,,1,31,28,59
32987,kkhunziker,,1,33,43,76
32988,wesamel,,1,9,6,15
32989,gadimus,,1,11,14,25
32990,kytsune,,1,5,16,21
32991,vittles,,1,1,2,3
32992,bsdboy,,1,81,127,208
32993,banksnld,,1,5,12,17
32994,khanthe,,1,36,5,41
32995,antslater,,1,1,2,3
32996,sunbeam60,,1,24,20,44
32997,Perkstoph,,1,8,2,10
32998,scenerio,,1,3,3,6
32999,ellemnopee,,1,64,73,137
33000,macandcheese,,1,13,19,32
33001,PanTardovski,,1,2,3,5
33002,dwvvz,,1,3,10,13
33003,bmswa,,1,7,7,14
33004,prestonberryworth,,1,8,12,20
33005,bigbada,,1,2,1,3
33006,coolmartin160,,1,63,1,64
33007,cheez-it,,1,155,157,312
33008,itsmeee,,1,79,148,227
33009,TheElitistCoup,,1,2,5,7
33010,Poromenos,,1,2440,3211,5651
33011,msbehaviour,,1,4,11,15
33012,atomic_fireball,,1,16,12,28
33013,ScottBartell,,1,6,12,18
33014,claybodie,,1,566,9,575
33015,BoiledToothpaste,,1,6,8,14
33016,amga10,,1,9,7,16
33017,corrhea,,1,5,9,14
33018,karcass,,1,140,154,294
33019,fineadc,,1,1,1,2
33020,Aggronaut,,1,3,6,9
33021,REdd06,,1,68,107,175
33022,pointNumberOne,,1,2,6,8
33023,evanbd,,1,1,1,2
33024,ultraturd,,1,2,2,4
33025,dimpki,,1,7,2,9
33026,KindlyRequests,,1,12,21,33
33027,wurly,,1,6,5,11
33028,infohawk,,1,1,1,2
33029,zekel,,1,62,11,73
33030,zelpop,,1,300,17,317
33031,antronx,,1,4,4,8
33032,paul_bunyan,,1,1,1,2
33033,apethedog,,1,12,22,34
33034,distortedHistory,,1,463,534,997
33035,daveross121,,1,1,3,4
33036,Reliant,,1,410,653,1063
33037,highlandery,,1,1,2,3
33038,marklubi,,1,28,22,50
33039,Captain_Oblivious,,1,1,4,5
33040,ezmobius,,1,10,9,19
33041,callturk245,,1,1,3,4
33042,ferriswheel,,1,102,46,148
33043,DudeAsInCool,,1,713,1301,2014
33044,bigbango,,1,1,1,2
33045,violetknickers,,1,10,18,28
33046,fit4130,,1,81,106,187
33047,Browner,,1,6,1,7
33048,anibus,,1,28,2,30
33049,mikm,,1,210,372,582
33050,Steven87,,1,5,7,12
33051,BeetleB,,1,360,441,801
33052,prodiglow,,1,209,24,233
33053,abnormalbrain,,1,35,59,94
33054,jasonscheirer,,1,1,8,9
33055,whespe,,1,6,8,14
33056,sule21,,1,143,198,341
33057,devilsenigma,,1,188,56,244
33058,akatherder,,1,611,568,1179
33059,rex420,,1,8,2,10
33060,biess06,,1,4,1,5
33061,utcursch,,1,36,36,72
33062,ckopack,,1,2,2,4
33063,DustinEchoes,,1,1,1,2
33064,Miyamoto_Musashi,,1,1,2,3
33065,p0lt,,1,3,2,5
33066,carraway,,1,7,9,16
33067,Anisty,,1,1,3,4
33068,digdug2020,,1,6,4,10
33069,StiveGonzales,,1,1,3,4
33070,lynchie,,1,1,2,3
33071,greginnj,,1,1056,1601,2657
33072,hokie86,,1,3,2,5
33073,budtske,,1,5,4,9
33074,SlippersIsClean,,1,3,1,4
33075,drunkVoodoo,,1,2,7,9
33076,jonshinn,,1,2,1,3
33077,morselsrule,,1,60,44,104
33078,timidlikerivers,,1,7,8,15
33079,heden,,1,1,1,2
33080,jordo3284,,1,5,10,15
33081,bmiguy,,1,1,1,2
33082,Froztwolf,,1,17,4,21
33083,accvrat,,1,6,13,19
33084,catalytica,,1,18,38,56
33085,nobomican,,1,1,1,2
33086,RanaFuerte,,1,16,24,40
33087,renegade,,1,193,181,374
33088,larphenflorp,,1,2,2,4
33089,reasonable_dude,,1,1,2,3
33090,yirra,,1,2,1,3
33091,ShinyCobra,,1,7,8,15
33092,z0zqx1,,1,5,10,15
33093,sindisil,,1,79,55,134
33094,sapato,,1,6,6,12
33095,x4294967295,,1,4,1,5
33096,oldno7brand,,1,141,206,347
33097,hillgod,,1,168,273,441
33098,alteralias,,1,1,1,2
33099,dankluz,,1,1,1,2
33100,stuff_sux,,1,7,3,10
33101,-snarf-,,1,1,2,3
33102,psy966,,1,1,3,4
33103,xftwitch,,1,19,5,24
33104,SurferDude,,1,22,21,43
33105,SirNuke,,1,6,14,20
33106,tendrils,,1,51,111,162
33107,christ_,,1,21,25,46
33108,NintendoGal,,1,8,9,17
33109,brush,,1,11,3,14
33110,WNxNukeem,,1,2,4,6
33111,weffy,,1,1,3,4
33112,yishan,,1,131,134,265
33113,firetruck1,,1,18,18,36
33114,ashwinb,,1,1,2,3
33115,AlanYx,,1,232,175,407
33116,blookins,,1,18,1,19
33117,KPM1,,1,1,1,2
33118,semianonymous,,1,2,3,5
33119,Felicia_Svilling,,1,132,246,378
33120,pomyao,,1,5,1,6
33121,DAE,,1,4,2,6
33122,magixx,,1,28,28,56
33123,Sir_Isaac_Lime,,1,16,11,27
33124,retardo,,1,649,322,971
33125,FakenameMcAlias,,1,59,76,135
33126,cautionhot,,1,8,1,9
33127,merid85,,1,2,2,4
33128,janl,,1,18,6,24
33129,passwordispassword2,,1,2,2,4
33130,lex99,,1,257,231,488
33131,bmpwe,,1,2,1,3
33132,Misio,,1,206,305,511
33133,moshaker,,1,3,2,5
33134,mute_requiem,,1,121,238,359
33135,franksvalli,,1,14,9,23
33136,avsa,,1,1,1,2
33137,zankoubs,,1,14,17,31
33138,LOOSEvsLOSE,,1,1,4,5
33139,martybo,,1,1,1,2
33140,swharper,,1,2,1,3
33141,eric22vhs,,1,8,12,20
33142,Nolari,,1,2,1,3
33143,ldrager,,1,15,37,52
33144,jonscorpio22,,1,1,2,3
33145,tarobaap,,1,6,2,8
33146,digitalmob,,1,21,31,52
33147,wordsNtricks,,1,67,5,72
33148,clevernick,,1,5,8,13
33149,rtomayko,,1,17,15,32
33150,marktully,,1,98,123,221
33151,pasttraveller,,1,1,1,2
33152,thade,,1,3,3,6
33153,dopewars22a,,1,1,1,2
33154,Chambone,,1,7,7,14
33155,bs2k,,1,2,2,4
33156,mwcred,,1,1,1,2
33157,jordanlund,,1,2418,2481,4899
33158,Mr_A,,1,401,422,823
33159,garrettl,,1,1,2,3
33160,evilknee,,1,12,6,18
33161,zangorn,,1,24,21,45
33162,Zylo,,1,24,14,38
33163,bmatul,,1,10,17,27
33164,dasschwein,,1,1,2,3
33165,gulik,,1,3,12,15
33166,whymewhyme,,1,1,1,2
33167,Stelman,,1,19,3,22
33168,somacore,,1,27,21,48
33169,IamCitiznInsane,,1,1,5,6
33170,10gic,,1,1,2,3
33171,TempusFugitive,,1,1,5,6
33172,ike368,,1,50,68,118
33173,futuramaboy,,1,48,79,127
33174,seattleite99,,1,4,5,9
33175,barapa,,1,36,34,70
33176,RufusJSquirrel,,1,63,18,81
33177,brohan,,1,1,1,2
33178,Zweben,,1,414,455,869
33179,TheNewAndy,,1,56,78,134
33180,marr,,1,4,10,14
33181,9bpm9,,1,68,74,142
33182,kidfury,,1,50,106,156
33183,sandusky_hohoho,,1,29,9,38
33184,rainboy,,1,3,5,8
33185,FloyDejesus,,1,31,36,67
33186,johnarras,,1,2,1,3
33187,novas0x2a,,1,5,1,6
33188,Rubric,,1,2,1,3
33189,deadcell,,1,5,3,8
33190,jollyllama,,1,62,65,127
33191,reddicted,,1,1,1,2
33192,tarsier,,1,1,2,3
33193,adjohnson916,,1,2,8,10
33194,raptorl3,,1,1,2,3
33195,alchemist23,,1,22,25,47
33196,jozzas,,1,378,444,822
33197,rickf71,,1,68,69,137
33198,Sweetgum,,1,107,192,299
33199,Swans_Flight,,1,2,2,4
33200,deadi,,1,5,8,13
33201,theefaulted,,1,1,1,2
33202,joper90,,1,21,27,48
33203,stopwastingyourtime,,1,1,1,2
33204,opie_why,,1,1,1,2
33205,immortalilych,,1,36,49,85
33206,Cheddarwurst,,1,2,2,4
33207,Portman,,1,1,1,2
33208,bigital,,1,21,10,31
33209,mianwaheed,,1,4,1,5
33210,jtor2020,,1,2,3,5
33211,mr_malarky,,1,81,34,115
33212,Danchan,,1,1,5,6
33213,systay,,1,38,18,56
33214,iowaxproud,,1,3,7,10
33215,desbaratto,,1,11,36,47
33216,notsotragichero,,1,2,3,5
33217,libtec7,,1,2,2,4
33218,killbrad,,1,34,59,93
33219,dr_speck,,1,50,89,139
33220,rhino666,,1,36,40,76
33221,DarkStars2882,,1,2,6,8
33222,karenlovestosmile,,1,20,6,26
33223,crazyass13,,1,1,1,2
33224,markturner,,1,7,1,8
33225,shotmaker,,1,1,3,4
33226,Bobachu,,1,1,2,3
33227,kuhawk5,,1,596,914,1510
33228,iicare,,1,6,6,12
33229,SidVacuous,,1,11,5,16
33230,rumblinggryphon,,1,14,19,33
33231,ElGaucho56,,1,707,395,1102
33232,apathist,,1,1,2,3
33233,wrat,,1,5,14,19
33234,old_snake,,1,64,129,193
33235,stayingdeadfornow,,1,6,5,11
33236,Jpool,,1,13,28,41
33237,prosper_spurius,,1,1,1,2
33238,phloggy,,1,3,3,6
33239,neopariah,,1,13,28,41
33240,mentol,,1,247,149,396
33241,OprahsVaJayJay,,1,3,2,5
33242,fxer,,1,59,109,168
33243,doatdays,,1,6,9,15
33244,fyl60000,,1,5,7,12
33245,bellmounte,,1,1,4,5
33246,flmz,,1,3,9,12
33247,bocephus1125,,1,7,1,8
33248,cnirrad,,1,3,7,10
33249,GodEater,,1,4,3,7
33250,oggusfoo,,1,10,29,39
33251,tch,,1,1159,337,1496
33252,Smokalotapotamus,,1,274,252,526
33253,jordanblock,,1,28,26,54
33254,zanthraxnl,,1,14,11,25
33255,Cowwan,,1,25,31,56
33256,SheepleAlarmClock,,1,1,2,3
33257,insidiousfckr,,1,72,9,81
33258,buttson,,1,3,9,12
33259,owlie_s,,1,6,4,10
33260,jkramar,,1,24,43,67
33261,bluetech,,1,1,6,7
33262,broohaha,,1,616,521,1137
33263,theslip74,,1,2,6,8
33264,RickS2,,1,2,3,5
33265,ajb44,,1,2,6,8
33266,norinea,,1,1,1,2
33267,tictactactics,,1,19,3,22
33268,happystinky,,1,4,3,7
33269,aeturnum,,1,1,1,2
33270,fuzzwonder,,1,1,1,2
33271,Fratm,,1,20,8,28
33272,athfalcon,,1,3,1,4
33273,drjaffiliate,,1,2,6,8
33274,tdaonp,,1,61,16,77
33275,nickgarner,,1,22,2,24
33276,clausy,,1,116,108,224
33277,mg_reddit,,1,1,3,4
33278,llvmaster,,1,21,5,26
33279,lansingite,,1,89,63,152
33280,varungoswami01,,1,2,1,3
33281,sherijr,,1,1,1,2
33282,Anjin,,1,156,70,226
33283,Tymeteller,,1,118,93,211
33284,michael2367,,1,2,2,4
33285,znook,,1,1,1,2
33286,Vinay92,,1,60,101,161
33287,IvanB,,1,9,1,10
33288,inf1ni,,1,1,1,2
33289,vende,,1,7,10,17
33290,iStig,,1,4,10,14
33291,sitstaygoodblog,,1,2,4,6
33292,moah099,,1,54,1,55
33293,brobak,,1,211,187,398
33294,ihateyoumost,,1,56,90,146
33295,Joelawl,,1,2,2,4
33296,grishnackh,,1,5,2,7
33297,loyuka,,1,1,2,3
33298,whiffybatter,,1,69,80,149
33299,clickclickbang,,1,9,11,20
33300,isankit,,1,110,171,281
33301,TootAndComeIn,,1,1,1,2
33302,MUD,,1,1,1,2
33303,thorshammer,,1,151,86,237
33304,Junior1919,,1,81,77,158
33305,dmightx,,1,7,12,19
33306,muimui69,,1,388,24,412
33307,whosthemac,,1,1,1,2
33308,hrm,,1,1,3,4
33309,coolflower,,1,3,15,18
33310,not_really_google_it,,1,1,1,2
33311,sugeknight,,1,3,7,10
33312,theblackdane,,1,7,4,11
33313,mookusaki,,1,1,2,3
33314,CritterM72800,,1,5,5,10
33315,bbq,,1,11,7,18
33316,sjpjeep,,1,5,4,9
33317,kamean,,1,1,1,2
33318,gmcnaughton,,1,3,2,5
33319,tugrul,,1,1,1,2
33320,boiboi2000,,1,3,7,10
33321,jgbiggs,,1,2,3,5
33322,chiefster,,1,15,22,37
33323,muffin-noodle,,1,95,75,170
33324,planetmcd,,1,1,1,2
33325,saradipity,,1,2,5,7
33326,varjag,,1,34,78,112
33327,aioujvcklsadj,,1,3,2,5
33328,nicky7,,1,169,255,424
33329,regisb,,1,58,11,69
33330,fantasticplastic,,1,40,69,109
33331,underdawg,,1,19,38,57
33332,jsragman,,1,21,110,131
33333,Madameshabbs,,1,2,5,7
33334,Fltar2,,1,1,4,5
33335,javguerre,,1,103,162,265
33336,laptopfanaddict,,1,13,4,17
33337,evanvolm,,1,549,191,740
33338,naikrovek,,1,5,3,8
33339,factician,,1,6,2,8
33340,remfrebr,,1,1,1,2
33341,Neodymion,,1,55,70,125
33342,k4st,,1,126,208,334
33343,ibm5_25,,1,3,2,5
33344,Homunculiheaded,,1,82,96,178
33345,PatFlorida,,1,3,1,4
33346,omepiet,,1,205,255,460
33347,probabilityzero,,1,12,1,13
33348,pesveld,,1,3,1,4
33349,Mpromptu,,1,408,2,410
33350,MetricMike,,1,2,2,4
33351,nikola_tesla,,1,1,7,8
33352,cowdr,,1,1,1,2
33353,PathDaemon,,1,21,31,52
33354,CreepingTurnip,,1,2,1,3
33355,flagg,,1,19,22,41
33356,Tokenwhitemale,,1,2,2,4
33357,cocoon56,,1,183,193,376
33358,anomalousman,,1,1,1,2
33359,maxp0wah,,1,3,8,11
33360,56d6v5s,,1,1,1,2
33361,grandwino,,1,2,2,4
33362,coparpeticiggio,,1,2,1,3
33363,xxxkubd,,1,1,1,2
33364,Hereticked,,1,2,1,3
33365,dizzyk2008,,1,85,127,212
33366,magnao,,1,1,1,2
33367,gridlock_is_good,,1,3,2,5
33368,nukethewhales42,,1,1,7,8
33369,pjriot,,1,1,2,3
33370,majsucks,,1,7,2,9
33371,McSand,,1,2,1,3
33372,onlywhenimstoned,,1,1,4,5
33373,jonnyamsterdam,,1,2,5,7
33374,fef56,,1,16,33,49
33375,zombispokelsespirat,,1,31,6,37
33376,devmode,,1,53,86,139
33377,bustedagain,,1,62,154,216
33378,fabiocoil,,1,36,7,43
33379,rickiewatters,,1,37,10,47
33380,feebie,,1,313,589,902
33381,confused_canuk,,1,3,8,11
33382,john1725,,1,13,26,39
33383,Mercifool,,1,12,40,52
33384,testtubebaby,,1,88,82,170
33385,NonReligiousPopette,,1,4,5,9
33386,smokebogey,,1,2,5,7
33387,jasondj_at_work,,1,34,28,62
33388,odwyerda,,1,11,2,13
33389,pbkobold,,1,40,49,89
33390,morganstanley,,1,9,2,11
33391,mynameisdave,,1,495,951,1446
33392,jofo,,1,26,54,80
33393,Loch_Ness_Monster,,1,1,3,4
33394,1001noisycameras,,1,54,3,57
33395,sarcasm_repair,,1,1,1,2
33396,jk3us,,1,1119,779,1898
33397,blakesterz,,1,1,1,2
33398,supernovacore,,1,30,15,45
33399,markiek,,1,1,1,2
33400,skorgu,,1,69,118,187
33401,spaceagedisco,,1,3,11,14
33402,the_nomad,,1,3,2,5
33403,de_Selby,,1,113,213,326
33404,ukchris,,1,126,151,277
33405,biGgulp,,1,4,5,9
33406,7rini7y,,1,2,1,3
33407,BlueSteelRose,,1,3,4,7
33408,ultramk,,1,1,1,2
33409,PREZman,,1,18,2,20
33410,1tsm3,,1,4,12,16
33411,flashtastic,,1,72,41,113
33412,pflanz,,1,65,114,179
33413,Tommah,,1,225,555,780
33414,bondagegirl,,1,159,144,303
33415,davywybiral,,1,4,3,7
33416,robkinyon,,1,5,10,15
33417,jrizzo1,,1,2,1,3
33418,ParaJaredDiddle,,1,6,8,14
33419,antifreze,,1,48,49,97
33420,poelmanc,,1,252,367,619
33421,natalyadkmode,,1,33,93,126
33422,tubosalt,,1,9,8,17
33423,Naomarik,,1,17,18,35
33424,JerseyBricklayer,,1,4,3,7
33425,n0tab0t,,1,3,1,4
33426,timdaw,,1,4,3,7
33427,inst,,1,31,10,41
33428,Bodger,,1,8,8,16
33429,steveinrio,,1,13,11,24
33430,ass_clown,,1,37,2,39
33431,kapuchinski,,1,1,6,7
33432,paperhat,,1,70,68,138
33433,bobwagner,,1,74,38,112
33434,clobwhirl,,1,84,127,211
33435,l3enman,,1,1,1,2
33436,lessofthat,,1,35,42,77
33437,meshosh,,1,1,3,4
33438,natolee,,1,1,2,3
33439,key1234,,1,3,3,6
33440,noarchy,,1,31,55,86
33441,hepcecob,,1,1,3,4
33442,redneckhatr,,1,11,21,32
33443,Word_of_the_Day,,1,7,28,35
33444,ginty,,1,1,4,5
33445,workoutiq,,1,13,2,15
33446,CarlosHamburgerJr,,1,2,5,7
33447,sexualpredator,,1,12,13,25
33448,feliandrade,,1,213,68,281
33449,rhartman,,1,139,127,266
33450,beefparty,,1,2,3,5
33451,anderskitson,,1,3,5,8
33452,Ryan0617,,1,328,120,448
33453,dVnt,,1,3,6,9
33454,SpiceMustFlow,,1,301,463,764
33455,_racist_,,1,2,4,6
33456,the-wise-fool,,1,3,2,5
33457,amberfool,,1,1,3,4
33458,jimssc,,1,2,1,3
33459,elliao,,0,2,1,3
33460,thisguy,,1,1,1,2
33461,weasel8,,1,7,11,18
33462,LegokeyChAin,,1,1,3,4
33463,eks,,1,565,226,791
33464,tbogatchev,,1,1,1,2
33465,James_Bong,,1,116,79,195
33466,monkeymanD,,1,80,88,168
33467,carlingford,,1,38,106,144
33468,strixvarius,,1,2,4,6
33469,Jezkah,,1,22,15,37
33470,drstrauss,,1,2,1,3
33471,corporeality,,1,1,5,6
33472,breshnev2,,1,2,1,3
33473,oniram,,1,108,53,161
33474,tjharman,,1,5,9,14
33475,indorock,,1,619,374,993
33476,toooooob,,1,109,139,248
33477,unireg,,1,1,1,2
33478,El_Fajitas1,,1,31,48,79
33479,unsigner,,1,9,1,10
33480,mescalitospoke,,1,7,5,12
33481,Rolthein,,1,4,3,7
33482,trebular,,1,6,21,27
33483,nmichelewicz,,1,1,1,2
33484,bryalflet,,1,1,7,8
33485,Onomatopeer,,1,3,2,5
33486,fronko,,1,2,8,10
33487,zetx,,1,2,3,5
33488,nothingbutjelly,,1,12,3,15
33489,hackenberry,,1,3,4,7
33490,quit_complaining,,1,462,568,1030
33491,qwerty101,,1,1,1,2
33492,ishaq,,1,2,5,7
33493,hopestarr,,1,1,2,3
33494,ghale,,1,36,33,69
33495,Owy2001,,1,5,2,7
33496,sintaks,,1,16,27,43
33497,busman,,1,67,19,86
33498,TruePresence,,1,2,2,4
33499,Spelling-Nazi,,1,1,1,2
33500,kobie,,1,10,10,20
33501,freeplatypus,,1,1,3,4
33502,k00charski,,1,10,12,22
33503,BigCliff,,1,14,25,39
33504,phredderf,,1,3,1,4
33505,lawpoop,,1,2,6,8
33506,lewah,,1,73,29,102
33507,heavyarms,,1,3,3,6
33508,abudabu,,1,1756,332,2088
33509,Jerp,,1,30,61,91
33510,mobius88,,1,33,11,44
33511,bobajoba,,1,52,31,83
33512,marketmou,,1,4,11,15
33513,jpzygnerski,,1,1,2,3
33514,ohmywordxxx,,1,1,1,2
33515,johncabell,,1,14,3,17
33516,mashtun,,1,34,54,88
33517,cmiller1,,1,176,210,386
33518,gsg927,,1,29,49,78
33519,uvm87,,1,208,43,251
33520,SLAS,,1,5,4,9
33521,CptWifeSwap,,1,1,8,9
33522,jack_spankin,,1,92,92,184
33523,SpaizKadett,,1,506,286,792
33524,fareb,,1,1,1,2
33525,TheKarlHungus,,1,36,52,88
33526,redditric,,1,7,3,10
33527,ka-pai,,1,54,131,185
33528,DAN191535,,1,18,10,28
33529,anti-troller,,1,1,1,2
33530,rockinjoe,,1,4,5,9
33531,Steph_C,,1,10,9,19
33532,mateja7,,1,46,3,49
33533,TechNewsSource,,1,1,3,4
33534,tnjohnso,,1,19,25,44
33535,episodic,,1,7,8,15
33536,kelsoATX,,1,40,43,83
33537,alexandrogdl,,1,1,5,6
33538,hdthefishfish,,1,2,9,11
33539,cswetenham,,1,1,3,4
33540,cccv0612,,1,33,29,62
33541,mjeffrey,,1,4,4,8
33542,mhyquel,,1,3,2,5
33543,roddyr2,,1,25,50,75
33544,stonedinxs,,1,1,2,3
33545,FrankBlack,,1,45,112,157
33546,dcb720,,1,113,175,288
33547,diabolicacid,,1,1,1,2
33548,netsui,,1,13,28,41
33549,kedelbrock,,1,27,4,31
33550,borque,,1,38,74,112
33551,almanac528,,1,1,1,2
33552,gsundheim,,1,2,1,3
33553,markng,,1,11,16,27
33554,WaltBusterkeys,,1,13,14,27
33555,Panda_Sex,,1,1,2,3
33556,brhanse,,1,3,2,5
33557,LeonidasRebooted,,1,22,24,46
33558,erebus,,1,327,90,417
33559,cheesemonky,,1,2,2,4
33560,biggy2pac,,1,3,16,19
33561,dondonno,,1,3,5,8
33562,Manitcor,,1,105,139,244
33563,eliben,,1,73,59,132
33564,Cyclops0T8,,1,23,54,77
33565,Thespoian,,1,14,2,16
33566,uwjames,,1,986,1336,2322
33567,hyper24m,,1,1,1,2
33568,zornrot,,1,15,14,29
33569,rm999,,1,322,432,754
33570,allnewecho,,1,63,43,106
33571,twincitylines,,1,1,1,2
33572,usersaurus,,1,1,2,3
33573,genocideisforme,,1,2,1,3
33574,Dea7hLeprachaun,,1,5,4,9
33575,tadrinth,,1,85,73,158
33576,timburrell,,1,2,3,5
33577,just_someguy,,1,2,2,4
33578,foobarbaz,,1,16,3,19
33579,thepeacemaker,,1,20,21,41
33580,GnuSniffer,,1,11,2,13
33581,herpes,,1,1,3,4
33582,champlain32,,1,143,77,220
33583,jimmysack,,1,30,12,42
33584,bothways,,1,1,1,2
33585,ratzero,,1,277,85,362
33586,rickrolled2,,1,1,1,2
33587,momarortotinon,,1,8,9,17
33588,DudeYamaha,,1,1,1,2
33589,guyro,,1,139,17,156
33590,gregny2002,,1,413,482,895
33591,monocasa,,1,164,285,449
33592,pedromarin,,1,1,1,2
33593,adamc83,,1,44,49,93
33594,Palladin001,,1,17,35,52
33595,mediocretes,,1,43,71,114
33596,johnyquest,,1,100,185,285
33597,illectronic,,1,13,1,14
33598,trisomy21,,1,30,36,66
33599,coskier,,1,1,1,2
33600,mdma,,1,2,1,3
33601,BROKENSARCASMDETECT,,1,7,1,8
33602,housecat,,1,12,19,31
33603,ej00807,,1,10,41,51
33604,Discredited,,1,1,1,2
33605,energeek,,1,50,22,72
33606,Enygma,,1,16,8,24
33607,andreyvo,,1,1,1,2
33608,basset_frog,,1,12,6,18
33609,merle93,,1,25,22,47
33610,michaelpaulhartman,,1,96,161,257
33611,aagee,,1,16,8,24
33612,palmTree,,1,22,22,44
33613,jh99,,1,286,317,603
33614,rigobert,,1,12,8,20
33615,dantams,,1,1,1,2
33616,ruaidhri,,1,368,198,566
33617,sogod,,1,5,10,15
33618,bakotaco,,1,4,3,7
33619,bjupton,,1,200,308,508
33620,batcountry421,,1,15,18,33
33621,Vishnu69,,1,2,4,6
33622,rgm70,,1,150,26,176
33623,voltron013,,1,29,55,84
33624,gthiruva,,1,1,2,3
33625,zafiroblue05,,1,141,122,263
33626,frustrated,,1,38,10,48
33627,Twylite,,1,8,1,9
33628,raiseup151z,,1,1,4,5
33629,biscuitbee,,1,10,4,14
33630,saucetenuto,,1,6,8,14
33631,caturday,,1,28,27,55
33632,fishboy1,,1,284,388,672
33633,foodpk,,1,20,22,42
33634,robbyyy,,1,21,1,22
33635,tenmilekyle,,1,1,7,8
33636,face_palm,,1,5,12,17
33637,acdha,,1,43,41,84
33638,lidko,,1,1,1,2
33639,assortedslog,,1,24,16,40
33640,edubs7,,1,342,153,495
33641,Kietedan,,1,1,2,3
33642,ikeed,,1,61,112,173
33643,introspeck,,1,26,18,44
33644,GregEvangelista,,1,2,7,9
33645,kawa,,1,53,40,93
33646,Herbaceous,,1,55,68,123
33647,onepound,,1,2,2,4
33648,antasi,,1,31,5,36
33649,cuethedanger,,1,6,12,18
33650,freznowine,,1,3,1,4
33651,sexymotherfucker,,1,7,10,17
33652,mrcarson2,,1,5,3,8
33653,eddio101,,1,1,1,2
33654,BaboTron,,1,30,73,103
33655,d64,,1,122,146,268
33656,Kingcook85,,1,10,15,25
33657,jimgagnon,,1,72,18,90
33658,aplus_betty,,1,8,8,16
33659,pi31415916,,1,1,1,2
33660,Nekomancer,,1,145,244,389
33661,madir,,1,2,2,4
33662,KingQueen,,1,5,8,13
33663,cereal,,1,119,105,224
33664,liamvictor,,1,31,10,41
33665,kteague,,1,41,57,98
33666,w0wy,,1,4,7,11
33667,outpt,,1,2,6,8
33668,thereviewer,,1,5,7,12
33669,niladmirari,,1,5,5,10
33670,Martha9,,1,45,9,54
33671,volunteer,,1,2,1,3
33672,seagreensky,,1,9,21,30
33673,huckleberry,,1,11,17,28
33674,jbreckman,,1,53,26,79
33675,sakabako,,1,13,21,34
33676,taligent,,1,195,176,371
33677,lololdl,,1,2,2,4
33678,truthrewards,,1,9,10,19
33679,dionysian,,1,9,16,25
33680,gregtmills,,1,18,27,45
33681,Gygy,,1,1,2,3
33682,wreckingball,,1,1,1,2
33683,adamfalkofske,,1,26,43,69
33684,neuro,,1,12,55,67
33685,Megasphaera,,1,133,200,333
33686,ImJustRick,,1,13,15,28
33687,padmeamidala,,1,26,100,126
33688,dbredesen,,1,1,1,2
33689,tmb12,,1,9,12,21
33690,CapnDeviance,,1,7,12,19
33691,Coolhawks,,1,4,23,27
33692,Pazu,,1,3,2,5
33693,alloydwhitlock,,1,2,4,6
33694,chortle,,1,1,2,3
33695,jpotteiger,,1,1,1,2
33696,cozm,,1,8,17,25
33697,figgle,,1,11,11,22
33698,ilikerutypoon,,1,270,133,403
33699,kabu24,,1,3,7,10
33700,Bornhuetter,,1,145,34,179
33701,idikuci,,1,56,132,188
33702,SallyForth,,1,1,10,11
33703,subcinco,,1,2,3,5
33704,marirs,,1,1,1,2
33705,redditors_r_cunts,,1,1,3,4
33706,winampman,,1,100,134,234
33707,JonyEpsilon,,1,1,1,2
33708,saejo,,1,1,1,2
33709,flaake,,1,17,2,19
33710,kanachandra,,1,28,32,60
33711,stuckinreality,,1,1,1,2
33712,oodlesofmoodles,,1,2,1,3
33713,localstatic,,1,26,39,65
33714,simonowens,,1,13,3,16
33715,blackolive2,,1,2,1,3
33716,titlepolicemustdie,,1,4,4,8
33717,NickGK,,1,4,3,7
33718,lessthanjakedude,,1,20,16,36
33719,bjorn,,1,24,11,35
33720,vagif,,1,548,739,1287
33721,cowboyneal,,1,44,105,149
33722,eyebelieve,,1,1,1,2
33723,navadasha,,1,2,1,3
33724,fuzoid,,1,7,1,8
33725,bermuda,,1,12,4,16
33726,heyimmarc,,1,1,1,2
33727,contrarian,,1,1706,2003,3709
33728,RealDeuce,,1,103,149,252
33729,south_beach_nerd,,1,12,21,33
33730,jansseba,,1,26,46,72
33731,cruisn223,,1,2,2,4
33732,tedhenry10,,1,3,1,4
33733,minglemangle,,1,81,120,201
33734,Kes1980,,1,5,7,12
33735,flynnguy,,1,2,2,4
33736,erp,,1,6,16,22
33737,mayankgupta,,1,3,4,7
33738,Shpox,,1,1,5,6
33739,tnjm,,1,1,1,2
33740,pretendperson,,1,75,43,118
33741,OsamaBeanLaden,,1,1,1,2
33742,miguelstil,,1,16,11,27
33743,americanuck,,1,390,553,943
33744,calladus,,1,2,2,4
33745,boomboomroom,,1,23,23,46
33746,fragglecat,,1,3,2,5
33747,SublimeWill,,1,25,2,27
33748,tubeguy,,1,2,4,6
33749,OmicronPersei8,,1,96,101,197
33750,meerkat78,,1,1,3,4
33751,anthony_dadragon,,1,1,1,2
33752,Nagyman,,1,11,25,36
33753,hawkxor,,1,15,23,38
33754,migshark,,1,16,32,48
33755,drekar,,1,20,22,42
33756,enkrates,,1,4,6,10
33757,desimusxvii,,1,101,89,190
33758,kingjehu,,1,156,337,493
33759,Kifoth,,1,26,25,51
33760,choochy,,1,86,83,169
33761,hoorayforleah,,1,4,1,5
33762,joker80,,1,4,6,10
33763,ekal,,1,4,2,6
33764,mist929292,,1,1,1,2
33765,lost-theory,,1,161,185,346
33766,chilehead,,1,90,191,281
33767,karthik3186,,1,9,1,10
33768,Lar-Shemp,,1,117,182,299
33769,phenotype,,1,66,1,67
33770,kogu,,1,1,3,4
33771,livetoad,,1,12,18,30
33772,rachismo,,1,48,57,105
33773,Masihaa,,1,316,24,340
33774,msmarmalade,,1,7,6,13
33775,kwaigon_ginger,,1,1,1,2
33776,smileylich,,1,8,2,10
33777,Maddog_Delphi97,,1,6,5,11
33778,Al_Bundy_,,1,46,32,78
33779,jebbielax,,1,1,1,2
33780,loupgarou21,,1,138,197,335
33781,wwnexc,,1,5,3,8
33782,emp783,,1,1,1,2
33783,kernelkhertz,,1,15,24,39
33784,turkishdelight83,,1,6,1,7
33785,arunan,,1,62,49,111
33786,wenwon,,1,14,8,22
33787,semiquaver,,1,1,1,2
33788,wellyuk,,1,1,2,3
33789,nocent7,,1,37,52,89
33790,pawned,,1,3,4,7
33791,nees,,1,2,2,4
33792,shapattack,,1,131,5,136
33793,SoftwareSimian,,1,1,2,3
33794,jillmwo,,1,4,3,7
33795,majikmike,,1,1,8,9
33796,greganem,,1,18,27,45
33797,OpenOffice,,1,1,1,2
33798,koorogi,,1,18,21,39
33799,friednerds,,1,3,7,10
33800,OneSalientOversight,,1,387,217,604
33801,p3do,,1,237,165,402
33802,HeliumFlash,,1,213,14,227
33803,jskeetjr,,1,33,13,46
33804,redass,,1,15,1,16
33805,miero,,1,12,13,25
33806,waddupeverybody,,1,15,1,16
33807,eclecticgamer,,1,1,2,3
33808,jasonkolb,,1,12,15,27
33809,cryptorchidism,,1,133,244,377
33810,oregeno,,1,1,1,2
33811,jvgreene,,1,13,10,23
33812,tjstix,,1,14,8,22
33813,CaptainSnuggleBunny,,1,101,18,119
33814,festivus,,1,11,9,20
33815,teem,,1,4,2,6
33816,pfunkmunk,,1,6,8,14
33817,djrok212,,1,12,10,22
33818,ssam,,1,30,48,78
33819,flieslikeabeagle,,1,21,18,39
33820,jcharum,,1,28,31,59
33821,lepetitoiseau,,1,4,7,11
33822,Zman11588,,1,79,66,145
33823,silentchaos,,1,1,2,3
33824,davidthedrake,,1,148,17,165
33825,megamerican,,1,11,3,14
33826,BeatnikDude,,1,85,177,262
33827,goldguy,,1,2,1,3
33828,punjabikura,,1,5,9,14
33829,toothravisher,,1,5,1,6
33830,wquintero,,1,4,1,5
33831,moongirl,,1,1,1,2
33832,kwanbis,,1,4,3,7
33833,LiveBackwards,,1,90,70,160
33834,smartbomb,,1,1,1,2
33835,pickle-head,,1,4,12,16
33836,nlevend,,1,1,2,3
33837,tkang,,1,16,15,31
33838,laughingplague,,1,3,7,10
33839,pavaranda,,1,4,1,5
33840,eltictac,,1,26,7,33
33841,SandyFaye,,1,9,12,21
33842,nutmeg,,1,3,9,12
33843,bkudria,,1,24,32,56
33844,rararasputin,,1,3,7,10
33845,truckmonkey,,1,9,12,21
33846,bluGill,,1,702,1339,2041
33847,ForthRightAfter,,1,1,3,4
33848,MesopotamianBowl,,1,1,1,2
33849,awj,,1,180,275,455
33850,dune2098,,1,10,4,14
33851,phathiker,,1,253,281,534
33852,macros,,1,3,2,5
33853,ninjaa,,1,1,1,2
33854,kapaka,,1,23,18,41
33855,DirtyBinLV,,1,107,113,220
33856,techlyc,,1,15,21,36
33857,brianjherman,,1,10,37,47
33858,neelakantha,,1,97,22,119
33859,squareball,,1,45,65,110
33860,r_schleufer,,1,2,4,6
33861,markbesada,,1,7,11,18
33862,doberboy,,1,35,20,55
33863,hpgrenade,,1,4,3,7
33864,clarkstud,,1,10,17,27
33865,aduric,,1,13,13,26
33866,thaxor,,1,1,2,3
33867,yoshhash,,1,57,52,109
33868,USBrownShirts,,1,2,1,3
33869,allegedmark,,1,1,1,2
33870,TeaParty,,1,227,289,516
33871,etotheprimez,,1,120,368,488
33872,Emouri,,1,2,2,4
33873,alzorus,,1,1,1,2
33874,gnossos,,1,29,50,79
33875,rojerton,,1,2,1,3
33876,tinytouchneednocalib,,1,1,1,2
33877,milominderbinder,,1,5,1,6
33878,juliejgirl,,1,3,2,5
33879,anyfoo,,1,347,116,463
33880,jeffwong,,1,40,46,86
33881,kwarren84,,1,2,2,4
33882,pavedwalden,,1,120,210,330
33883,kras8live,,1,1,1,2
33884,sassanix,,1,107,106,213
33885,desiever,,1,16,19,35
33886,tableturns77,,1,17,67,84
33887,grignr,,1,578,635,1213
33888,roblightbody,,1,32,31,63
33889,bizzy,,1,30,5,35
33890,xxxMDKxxx,,1,5,10,15
33891,theawesomelucas,,1,10,6,16
33892,e_0r,,1,2,1,3
33893,wcchandler,,1,123,112,235
33894,yqiang,,1,5,2,7
33895,booch,,1,10,17,27
33896,rarebit,,1,10,7,17
33897,yourkamden,,1,5,2,7
33898,mbrownerhamlin,,1,35,11,46
33899,derekpaco,,1,10,19,29
33900,pluke,,1,248,213,461
33901,Bertwad,,1,7,19,26
33902,carycary,,1,1,1,2
33903,sk11,,1,160,135,295
33904,zxymkd,,1,9,9,18
33905,fps,,1,3,2,5
33906,sage99,,1,1,1,2
33907,benjorino,,1,9,9,18
33908,anthem123,,1,19,3,22
33909,truncheon,,1,6,6,12
33910,qryan,,1,1,1,2
33911,OXMWEPW,,1,35,62,97
33912,aquadoctorbob,,1,3,1,4
33913,SlimBackwater,,1,4,5,9
33914,Bing11,,1,359,390,749
33915,michael333,,1,109,315,424
33916,Kinakuta,,1,1,4,5
33917,AtlasEditorials,,1,3,11,14
33918,pirateddit,,1,4,3,7
33919,TomDLux,,1,1,1,2
33920,bedfordn,,1,21,22,43
33921,Grimpuppy,,1,171,37,208
33922,EverestFreeman,,1,6,1,7
33923,Golgo13,,1,26,48,74
33924,diafygi,,1,65,7,72
33925,matt2500,,1,11,6,17
33926,x_gas,,1,2,1,3
33927,elihu,,1,1,3,4
33928,tmoertel,,1,11,15,26
33929,Stigmataman,,1,21,16,37
33930,redditoked,,1,2,1,3
33931,inkieminstrel,,1,215,220,435
33932,forever497,,1,6,12,18
33933,mosby,,1,2,1,3
33934,pyrmont,,1,1,8,9
33935,adr,,1,2,4,6
33936,roguevalley,,1,30,48,78
33937,jward,,1,18,33,51
33938,NCRider,,1,11,13,24
33939,hack4cash,,1,1,2,3
33940,plopgun,,1,4,6,10
33941,bryarcanium,,1,2,2,4
33942,stoned_dog_race_fan,,1,1,1,2
33943,graynut,,1,3,7,10
33944,beckka,,1,1,3,4
33945,zooch76,,1,339,401,740
33946,thadudesbro,,1,93,109,202
33947,devacon,,1,28,28,56
33948,Vacuum_Tube,,1,1,1,2
33949,jreza2k3,,1,66,78,144
33950,gandalfian,,1,17,29,46
33951,jadanzzy,,1,20,10,30
33952,awb,,1,448,331,779
33953,HellSpam,,1,9,3,12
33954,freenowdude,,1,4,14,18
33955,HunterST,,1,1,1,2
33956,turdfurg,,1,15,24,39
33957,RonaldMJR,,1,1,2,3
33958,downvoter1,,1,1,2,3
33959,dogchasecars,,1,1,2,3
33960,loulan,,1,1,1,2
33961,africandave,,1,5,7,12
33962,comradeluke,,1,13,9,22
33963,lubos,,1,21,17,38
33964,AndrewKemendo,,1,303,263,566
33965,WillPheeler,,1,128,36,164
33966,redudown,,1,38,59,97
33967,eonwe,,1,32,7,39
33968,hglman,,1,34,68,102
33969,toddritt,,1,2,1,3
33970,Fox318,,1,11,31,42
33971,notfrench,,1,4,3,7
33972,pseudoswamy,,1,34,89,123
33973,ukerinfo,,1,1,1,2
33974,joeyeh,,1,11,13,24
33975,physicistjedi,,1,96,1,97
33976,brandonrambo,,1,4,1,5
33977,Causemos,,1,57,119,176
33978,michnuc,,1,32,67,99
33979,delaware,,1,26,14,40
33980,alyoshaPo,,1,68,21,89
33981,derg,,1,9,8,17
33982,xianpryde,,1,7,5,12
33983,bnizzz,,1,10,28,38
33984,Jessapow,,1,8,5,13
33985,JewStyleKungfu,,1,74,86,160
33986,berberine,,1,986,230,1216
33987,kermie1,,1,2,1,3
33988,imitationcheese,,1,239,96,335
33989,berklee,,1,30,40,70
33990,Willum,,1,7,12,19
33991,ahalsall,,1,7,2,9
33992,tvoglou,,1,1,2,3
33993,flen_paris,,1,20,14,34
33994,mihrz,,1,6,13,19
33995,GTFO_NAO,,1,1,1,2
33996,omellet,,1,13,20,33
33997,Nemesoid,,1,25,27,52
33998,gooneruk,,1,117,135,252
33999,keeganspeck,,1,1,1,2
34000,dominateastheking,,1,3,6,9
34001,jax9999,,1,639,1316,1955
34002,ashes2ashes4040,,1,1,1,2
34003,dogbait,,1,37,70,107
34004,DrSausage,,1,153,207,360
34005,erichhaubrich,,1,6,4,10
34006,spaceywilly,,1,6,7,13
34007,normansoddy,,1,325,242,567
34008,astrochicken,,1,11,11,22
34009,danjayh,,1,2,2,4
34010,GuidoLibido,,1,74,26,100
34011,snort_,,1,2,1,3
34012,DrJosh2,,1,9,1,10
34013,oldstyle21,,1,2,2,4
34014,moomooman,,1,34,24,58
34015,hairyman,,1,3,3,6
34016,marcosh08,,1,1,1,2
34017,Copperhe4d,,1,21,27,48
34018,uassholes,,1,4,7,11
34019,mrBlonde,,1,133,233,366
34020,rolandboard,,1,20,65,85
34021,treitter,,1,4,4,8
34022,zerostar,,1,2,8,10
34023,fryguy8,,1,9,11,20
34024,elysiumarie,,1,3,2,5
34025,cobain_angel,,1,28,75,103
34026,craigmj,,1,6,7,13
34027,yolfer,,1,2,2,4
34028,wefwefwef,,1,2,2,4
34029,Bennifer,,1,9,6,15
34030,crashkg,,1,547,469,1016
34031,Captain_Obvious_,,1,4,5,9
34032,spgarbet,,1,45,32,77
34033,mm911,,1,1,2,3
34034,bradisdrab,,1,2,1,3
34035,djsaturnine,,1,29,9,38
34036,NovaSupreme,,1,3,1,4
34037,righty,,1,136,177,313
34038,charlieboy,,1,929,43,972
34039,idonotlikereddit,,1,6,2,8
34040,iraebrasil,,1,2,4,6
34041,fallenangel42,,1,2,14,16
34042,turbothy,,1,42,77,119
34043,zpinter,,1,1,1,2
34044,search9,,1,1,1,2
34045,Franco_Tacotacotaco,,1,1,1,2
34046,Vette,,1,21,17,38
34047,silberj,,1,3,8,11
34048,targetx,,1,3,11,14
34049,danswim393,,1,2,5,7
34050,jflanger,,1,1,4,5
34051,jimll,,1,7,2,9
34052,catamorphism,,1,8,12,20
34053,anonymgrl,,1,1684,175,1859
34054,klusha,,1,3,2,5
34055,the_foo_maker,,1,98,56,154
34056,SheilaBroflovski,,1,6,19,25
34057,rancmeat,,1,490,951,1441
34058,reddit_men_r_creepy,,1,5,4,9
34059,poorjeff,,1,17,38,55
34060,yogihaji,,1,81,92,173
34061,Sephian,,1,33,65,98
34062,shawnjan,,1,2,2,4
34063,bloggaplease,,1,49,67,116
34064,adzling7,,1,4,1,5
34065,mcfunley,,1,73,48,121
34066,bananahead,,1,766,1051,1817
34067,Towels,,1,83,185,268
34068,dcoolidge,,1,6,10,16
34069,TitaniumLizzard,,1,9,3,12
34070,gr8whitesavage,,1,15,12,27
34071,confidencecow,,1,6,7,13
34072,ICLW,,1,86,40,126
34073,auggie,,1,115,17,132
34074,Sutibu,,1,756,1329,2085
34075,twiggzor,,1,1,3,4
34076,redrumjack,,1,13,12,25
34077,callott,,1,7,9,16
34078,WillyPete,,1,85,129,214
34079,stern54,,1,3,4,7
34080,TriangleMan,,1,17,28,45
34081,jackattack102,,1,1,2,3
34082,vclarke,,1,2,5,7
34083,pipecad,,1,8,9,17
34084,lickme,,1,10,1,11
34085,apassy,,1,3,9,12
34086,scheme,,1,9,26,35
34087,bauhaus31,,1,4,1,5
34088,illmonk,,1,3,4,7
34089,pinewhine,,1,2,1,3
34090,sbhixon,,1,1,2,3
34091,blueeyedmonster,,1,58,19,77
34092,Jinbuhuan,,1,478,837,1315
34093,jpo415,,1,6,8,14
34094,electrocuting,,1,62,77,139
34095,gr3yasp,,1,83,167,250
34096,jsimms,,1,3,7,10
34097,croser,,1,1,1,2
34098,rkeller4,,1,15,26,41
34099,glengineer,,1,9,13,22
34100,aecarol,,1,86,67,153
34101,bcoleman,,1,7,8,15
34102,egoviri,,1,14,13,27
34103,guruscotty,,1,2,3,5
34104,prettyprinceofparty,,1,1,1,2
34105,Pierredenorvege,,1,3,4,7
34106,kwen25,,1,90,171,261
34107,primoris_causa,,1,216,391,607
34108,purpmint008,,1,8,7,15
34109,beagle3,,1,8,9,17
34110,hechacker1,,1,146,184,330
34111,viniosity,,1,8,7,15
34112,mythin,,1,46,76,122
34113,Arclight,,1,107,163,270
34114,orestis,,1,32,18,50
34115,skitz0,,1,1,4,5
34116,eveisdawning,,1,14,18,32
34117,hstern,,1,4,8,12
34118,Iznik,,1,82,159,241
34119,miriad,,1,7,3,10
34120,Mikul,,1,5,5,10
34121,nebm,,1,579,108,687
34122,erwerew,,1,1,1,2
34123,AttackTheRight,,1,1,1,2
34124,processinformation,,1,3,2,5
34125,datawocky,,1,1,2,3
34126,t-train,,1,1,1,2
34127,andy_rogers,,1,2,1,3
34128,trunkboy,,1,32,2,34
34129,Scyth3,,1,91,58,149
34130,JohnStays44,,1,1,5,6
34131,Ferris,,1,1,1,2
34132,poign9,,1,2,3,5
34133,Tyrone_LVL20_Wizard,,1,2,1,3
34134,erasser999,,1,4,1,5
34135,hyperkill,,1,6,7,13
34136,brw,,1,2,3,5
34137,qpalzm,,1,14,16,30
34138,b111,,1,19,14,33
34139,Politikil,,1,5,6,11
34140,ballinintransylvania,,1,4,1,5
34141,undidredo,,1,1,1,2
34142,yakobusan,,1,21,1,22
34143,myopiczeal,,1,46,77,123
34144,bjtuna,,1,48,57,105
34145,Arkansan,,1,4,10,14
34146,snowcrash81,,1,33,42,75
34147,directrixx,,1,24,45,69
34148,whatthedude,,1,3,7,10
34149,parkamark,,1,3,3,6
34150,CliffsNotes,,1,8,16,24
34151,Pitfan,,1,2,3,5
34152,LetsGoHawks,,1,237,273,510
34153,eugene_spencer,,1,3,5,8
34154,Daniel_SJ,,1,239,216,455
34155,domlachowicz,,1,28,27,55
34156,sioked,,1,3,3,6
34157,Fairdeal,,1,21,63,84
34158,jimic79,,1,2,2,4
34159,ubikuor,,1,2,3,5
34160,secret6,,1,102,189,291
34161,leapetra,,1,1,2,3
34162,braahyan,,1,14,21,35
34163,Brenbren25,,1,114,142,256
34164,charleycoyote,,1,5,5,10
34165,Renegade98,,1,2,1,3
34166,Hellevator,,1,14,21,35
34167,dt403,,1,6,4,10
34168,ptangirala,,1,17,15,32
34169,duplico,,1,84,42,126
34170,pr0nmee,,1,1,3,4
34171,rawkeye,,1,3,3,6
34172,vk0,,1,3,4,7
34173,MazdaEric,,1,41,96,137
34174,kbot777,,1,6,10,16
34175,Field_Effect,,1,1,1,2
34176,Kevin_Ar18,,1,10,11,21
34177,diamondtron,,1,78,130,208
34178,krush_groove,,1,7,7,14
34179,Fidodo,,1,362,624,986
34180,tumtum,,1,3,4,7
34181,chinchillla,,1,15,16,31
34182,schickm,,1,3,4,7
34183,spiky_boy,,1,1,1,2
34184,hydIndian,,1,15,23,38
34185,drhull,,1,55,35,90
34186,denier,,1,1,2,3
34187,flashmcgallion,,1,53,41,94
34188,snalien,,1,1,1,2
34189,galaxy67,,1,5,5,10
34190,ranprieur,,1,414,227,641
34191,daphaze,,1,20,17,37
34192,drzaeus,,1,9,9,18
34193,taninsam,,1,3,1,4
34194,ckendrick,,1,1,1,2
34195,Piyh,,1,3,2,5
34196,rollotomnasi,,1,2,3,5
34197,mothsmoke,,1,3,4,7
34198,MorningThrush,,1,3,3,6
34199,nognir,,1,55,16,71
34200,xibalba89,,1,63,63,126
34201,omrifiv,,1,1,1,2
34202,subscript,,1,15,4,19
34203,knew,,1,27,2,29
34204,sinscriven,,1,1,3,4
34205,gmontague0205,,1,1,1,2
34206,uvarov,,1,76,115,191
34207,oodja,,1,30,54,84
34208,billtron,,1,4,11,15
34209,chbrules,,1,333,409,742
34210,gensek,,1,325,510,835
34211,MarquisDeSaid,,1,2,1,3
34212,dramaticChipmunk,,1,95,12,107
34213,komokuten,,1,11,1,12
34214,treyjp,,1,15,40,55
34215,manganese,,1,36,47,83
34216,jus1haz2,,1,78,13,91
34217,neimadmt,,1,1,1,2
34218,bigrjsuto,,1,6,9,15
34219,mssnlayam,,1,8,6,14
34220,BostonBlackie,,1,1,5,6
34221,leapsntwirls,,1,6,14,20
34222,argo97,,1,357,16,373
34223,marcandre,,1,6,11,17
34224,AmusedMuse,,1,2,10,12
34225,Shreela,,1,21,68,89
34226,ChrisMatthews,,1,2,4,6
34227,amansman,,1,26,34,60
34228,juvel,,1,1,3,4
34229,smoove,,1,27,32,59
34230,Cosmin1,,1,3,7,10
34231,xerodeth,,1,2,4,6
34232,jazzyb,,1,9,22,31
34233,jetpack,,1,11,15,26
34234,barracuda150965,,1,1,6,7
34235,pseudohippie,,1,3,1,4
34236,rogerdrabbit,,1,2,7,9
34237,marsz-marsz,,1,1,2,3
34238,old_folkie,,1,2,4,6
34239,Wi-Fi-Guy,,1,3,11,14
34240,Gsuslovesme,,1,67,104,171
34241,SkipperMedia,,1,129,8,137
34242,disturbd,,1,206,262,468
34243,_KS,,1,33,9,42
34244,polychrome,,1,1,3,4
34245,frelling_drenn,,1,4,10,14
34246,den31,,1,5,6,11
34247,tonyhajdu,,1,8,12,20
34248,Toastums,,1,1,4,5
34249,can_i_haz_cheez,,1,22,26,48
34250,StoneMe,,1,658,602,1260
34251,zaradox,,1,329,11,340
34252,free888,,1,42,102,144
34253,vvy,,1,2,6,8
34254,moonguidex,,1,28,47,75
34255,cochico,,1,28,54,82
34256,AngledLuffa,,1,502,627,1129
34257,erlich,,1,2,1,3
34258,XeroQ,,1,2,2,4
34259,scott127,,1,1,1,2
34260,silverstreak,,1,274,64,338
34261,gnuvince,,1,728,493,1221
34262,volleyballmaniac,,1,2,1,3
34263,psynix,,1,7,4,11
34264,jolhoeft,,1,1,1,2
34265,greyspace,,1,6,15,21
34266,grahamlester,,1,501,115,616
34267,expectingrain,,1,522,625,1147
34268,brite2006,,1,2,1,3
34269,olympicherojohn,,1,2,2,4
34270,virtigo311,,1,3,3,6
34271,KlassyGuy,,1,211,251,462
34272,el_pie_eater,,1,3,10,13
34273,Satguy,,1,2,2,4
34274,annodomini,,1,72,73,145
34275,lockmary,,1,1,1,2
34276,maskull,,1,1,1,2
34277,DannyRhodesHaugh,,1,7,11,18
34278,USMC_Megladon,,1,27,45,72
34279,optimmal,,1,2,1,3
34280,turnrighttogoleft,,1,89,102,191
34281,ashlea555,,1,5,6,11
34282,tourgee,,1,8,4,12
34283,42nt1,,1,4,8,12
34284,z_at_detonate,,1,3,1,4
34285,riddlar,,1,11,8,19
34286,xysm,,1,1,2,3
34287,jamesinc,,1,130,239,369
34288,martizzle,,1,4,10,14
34289,cacci,,1,2,1,3
34290,babakshirazi,,1,19,18,37
34291,danamcdaniel,,1,8,7,15
34292,suckup,,1,5,7,12
34293,Chelsea_Clinton,,1,3,4,7
34294,Atlai,,1,111,92,203
34295,andy_63392,,1,15,27,42
34296,amph,,1,53,51,104
34297,davidlt,,1,2,2,4
34298,turbotito,,1,1,5,6
34299,coleman57,,1,205,325,530
34300,vividvew,,1,1,2,3
34301,suziebee,,1,1,1,2
34302,stormyreddit,,1,21,1,22
34303,bork99,,1,6,6,12
34304,saralk,,1,213,209,422
34305,gitwtf,,1,5,3,8
34306,chefranden,,1,1173,147,1320
34307,AndrewCoja,,1,5,5,10
34308,Surfer51,,1,1,4,5
34309,ericrtrue,,1,2,3,5
34310,zenbit,,1,20,31,51
34311,DrNeutral,,1,36,3,39
34312,doesntmatter,,1,1,3,4
34313,alekti,,1,8,12,20
34314,daliuso,,1,3,5,8
34315,EricKow,,1,32,43,75
34316,lkjhg,,1,10,7,17
34317,dianaND,,1,1,2,3
34318,schammy,,1,74,90,164
34319,awesley,,1,50,89,139
34320,Sikul,,1,9,12,21
34321,rasbill,,1,2,2,4
34322,thristian99,,1,35,13,48
34323,whenchristianattack,,1,1,1,2
34324,dbnull,,1,22,30,52
34325,reallynotme,,1,2,1,3
34326,hans1193,,1,677,396,1073
34327,mrcsmith,,1,3,4,7
34328,happyjuggler0,,1,329,369,698
34329,ABSTINENCEKILLS,,1,4,3,7
34330,burichi,,1,3,8,11
34331,hammer74,,1,1,1,2
34332,0x44,,1,14,32,46
34333,mikeriley,,1,1,2,3
34334,fudged71,,1,137,239,376
34335,redheadjessica,,1,15,11,26
34336,jake27,,1,3,3,6
34337,brendankohler,,1,39,66,105
34338,eidetic,,1,6,18,24
34339,bennc,,1,26,28,54
34340,whys,,1,1,1,2
34341,svoldbaek,,1,4,4,8
34342,the1,,1,4,8,12
34343,shamen_uk,,1,27,30,57
34344,stoic_penguin,,1,14,17,31
34345,sonnichj,,1,1,1,2
34346,thsunifeelas0ne,,1,23,30,53
34347,sigjuice,,1,1,3,4
34348,Pylly,,1,178,101,279
34349,pupppet,,1,5,1,6
34350,ffsffsffs,,1,3,7,10
34351,fsjobs,,1,1,1,2
34352,laughingoutloud,,1,4,8,12
34353,The_Cake_Is_A_Lie,,1,206,294,500
34354,aeronumen,,1,1,1,2
34355,genpfault,,1,114,240,354
34356,rootleaf,,1,4,1,5
34357,dasbill,,1,3,1,4
34358,zlhill,,1,1,4,5
34359,sussyfan,,1,2,2,4
34360,swicklund,,1,31,32,63
34361,tehrahl,,1,12,1,13
34362,singhpr,,1,10,22,32
34363,vmass20,,1,11,24,35
34364,BeleiverTDW,,1,1,1,2
34365,demonstro,,1,404,301,705
34366,funshine,,1,16,17,33
34367,WafflCopterz,,1,25,34,59
34368,nht007,,1,3,2,5
34369,nikke10292,,1,4,1,5
34370,Symphic,,1,1,1,2
34371,Poleris,,1,12,4,16
34372,kd5lct,,1,4,13,17
34373,45441,,1,1,4,5
34374,paperface,,1,37,46,83
34375,sid0,,1,39,61,100
34376,ainokami,,1,52,33,85
34377,rigbypat,,1,1,3,4
34378,msposato,,1,2,4,6
34379,Fallout,,1,22,18,40
34380,screamingshillalert,,1,3,6,9
34381,manyou,,1,3,1,4
34382,edwin177,,1,48,15,63
34383,felix,,1,9,2,11
34384,rkzda,,1,3,1,4
34385,kareems,,1,91,83,174
34386,isre,,1,3,7,10
34387,7thString,,1,28,14,42
34388,bigethan,,1,8,9,17
34389,x-fi,,1,1,2,3
34390,posterxx,,1,29,1,30
34391,gunguy,,1,2,3,5
34392,shannonest,,1,11,11,22
34393,johnny2k,,1,2,3,5
34394,clows,,1,5,1,6
34395,eplan,,1,15,4,19
34396,jeresig,,1,181,114,295
34397,PrimeExample,,1,2,1,3
34398,janesinclair,,1,15,1,16
34399,monkeytron,,1,1,2,3
34400,pun_Krawk,,1,3,5,8
34401,outshined,,1,18,23,41
34402,jj555298,,1,30,44,74
34403,blackf1sh,,1,93,81,174
34404,BabyBoomer47,,1,1,1,2
34405,lemonjuicefake,,1,28,20,48
34406,SocialSoundSystem,,1,48,49,97
34407,pinkeyes,,1,6,1,7
34408,dlrow,,1,2,4,6
34409,haschischii,,1,5,4,9
34410,mathmoi,,1,1,1,2
34411,besttrousers,,1,5,1,6
34412,midwesthousewife,,1,2,2,4
34413,stevarino,,1,29,34,63
34414,suader,,1,1,1,2
34415,pavee,,1,1,1,2
34416,jff,,1,1,1,2
34417,zzjodan,,1,1,1,2
34418,jamesmoroni,,1,5,2,7
34419,dickroll,,1,1,1,2
34420,infotekt,,1,1,2,3
34421,PenguinClover,,1,1,2,3
34422,gini_,,1,15,12,27
34423,Soviet_America,,1,2,3,5
34424,readit08,,1,248,24,272
34425,cesef,,1,2,1,3
34426,sydlab99,,1,5,2,7
34427,alk509,,1,89,49,138
34428,tehdiplomat,,1,35,57,92
34429,chaptanon,,1,2,3,5
34430,tearsofmysoul99,,1,2,2,4
34431,Wiry,,1,3,8,11
34432,rockinrollin,,1,2,1,3
34433,starcow,,1,40,63,103
34434,xrousti,,1,4,1,5
34435,mhrogers,,1,11,11,22
34436,Khimiara,,1,187,325,512
34437,reckoner15,,1,60,104,164
34438,foibly,,1,81,103,184
34439,brokenearth02,,1,471,841,1312
34440,skyimp,,1,1,11,12
34441,aberen,,1,41,78,119
34442,ldskye,,1,1,2,3
34443,temporaryaccount1,,1,3,5,8
34444,viama,,1,1,1,2
34445,blackwhitegrey,,1,97,172,269
34446,here1am,,1,1,3,4
34447,kashiwagi,,1,8,14,22
34448,Tychee,,1,7,1,8
34449,vmarker,,1,4,2,6
34450,bigsammer,,1,2,3,5
34451,capuchin,,1,2,2,4
34452,Lacuna,,1,8,17,25
34453,khromium,,1,2,2,4
34454,bloggirl13,,1,11,2,13
34455,sovator,,1,48,53,101
34456,Zal91,,1,18,18,36
34457,spliffy,,1,222,384,606
34458,Alex3917,,1,135,72,207
34459,blah999,,1,5,6,11
34460,belair,,1,189,45,234
34461,snackmaster99,,1,1,4,5
34462,zmobie,,1,4,5,9
34463,Anti-Dentite,,1,36,54,90
34464,xtianpretard,,1,1,2,3
34465,dre1983,,1,1,1,2
34466,Kimmiko,,1,1,2,3
34467,friddysan,,1,2,1,3
34468,nicnic3,,1,4,5,9
34469,Hagai,,1,20,27,47
34470,forgenboards,,1,1,1,2
34471,ldamerow,,1,1,3,4
34472,sim99,,1,9,12,21
34473,Taerk,,1,1,3,4
34474,raymond8,,2,3,5,8
34475,CainerWolf,,1,1,2,3
34476,onebit,,1,368,573,941
34477,yupko,,1,66,162,228
34478,leocha,,1,1,2,3
34479,theinevitable,,1,1,4,5
34480,meammouse,,1,4,7,11
34481,joshualander,,1,3,4,7
34482,taumeson,,1,10,6,16
34483,the_crooked_toe,,1,4,3,7
34484,mfuria,,1,1,1,2
34485,davepp,,1,15,26,41
34486,beegee73,,1,8,1,9
34487,mwmani,,1,3,14,17
34488,AdmiralBumblebee,,1,76,94,170
34489,sxreader,,1,7,4,11
34490,NetPhantom,,1,71,56,127
34491,avac,,1,11,6,17
34492,Ateoto,,1,31,49,80
34493,LordZodd,,1,147,110,257
34494,xochi99,,1,11,18,29
34495,the_sheeple,,1,6,7,13
34496,p0stal,,1,1,1,2
34497,crazyirish,,1,4,2,6
34498,DarkHelmet,,1,12,8,20
34499,Sneezer,,1,9,12,21
34500,Syriako,,1,15,20,35
34501,nmaunder,,1,43,16,59
34502,antiproton,,1,138,148,286
34503,jayzer,,1,7,12,19
34504,mattclark_1,,1,8,10,18
34505,dmy999,,1,5,5,10
34506,barryqu,,1,1,2,3
34507,SmirkingJerk,,1,2,2,4
34508,wdpp8ntba11er,,1,5,4,9
34509,Yoprig,,1,44,72,116
34510,ladyreporter,,1,1,2,3
34511,bonescotch,,1,1,1,2
34512,kwatz,,1,3,3,6
34513,RossPerot,,1,1,2,3
34514,e5india,,1,5,10,15
34515,PGRfilms,,1,123,29,152
34516,dw0rm,,1,5,1,6
34517,TheSpore,,1,29,21,50
34518,springboks,,1,8,12,20
34519,MadAce,,1,95,174,269
34520,neonic,,1,437,695,1132
34521,wintremute,,1,264,504,768
34522,lvl10troll,,1,2,2,4
34523,SianTam,,1,173,326,499
34524,amdar_reddit,,1,6,12,18
34525,imalloutoflove,,1,1,3,4
34526,davidw,,1,417,317,734
34527,boo66,,1,36,80,116
34528,fearofcorners,,1,22,18,40
34529,dismember,,1,146,133,279
34530,andyzoob,,1,19,23,42
34531,Kicking-Fire,,1,8,9,17
34532,d0gmat1c,,1,123,152,275
34533,Fishsticks,,1,33,68,101
34534,exhuma,,1,1,1,2
34535,mrjules44,,1,2,1,3
34536,nuknukjuk,,1,60,248,308
34537,grabmyblog33,,1,2,1,3
34538,n2dasun,,1,9,11,20
34539,joshddy,,1,2,3,5
34540,xiuz,,1,2,1,3
34541,theray78,,1,54,37,91
34542,eastcoast1978,,1,1,2,3
34543,erikpdx,,1,1,2,3
34544,kingfishr,,1,6,9,15
34545,rayed,,1,6,7,13
34546,larryo,,1,5,6,11
34547,Lapp,,1,2,1,3
34548,enaged,,1,1,1,2
34549,helring,,1,16,19,35
34550,thareus,,1,15,10,25
34551,twingecko56,,1,2,1,3
34552,powerfox,,1,3,1,4
34553,zeitgeiber,,1,11,1,12
34554,Malcorin,,1,19,33,52
34555,slurppypurr,,1,6,4,10
34556,sub_o,,1,9,10,19
34557,PeterMaclellan,,1,1,1,2
34558,dbaderf,,1,41,9,50
34559,negative_cool,,1,1,1,2
34560,dreamersblues,,1,47,5,52
34561,Ono-Sendai,,1,70,65,135
34562,femix,,1,3,11,14
34563,mathieugothax2,,1,3,4,7
34564,jeffxl,,1,3,8,11
34565,flipgimble,,1,42,17,59
34566,XxDeathxxStarxX,,1,1,1,2
34567,EyeInThePyramid,,1,82,56,138
34568,intelligen,,1,3,3,6
34569,sixtytwo,,1,1,1,2
34570,cigerect,,1,52,64,116
34571,caboteria,,1,3,5,8
34572,Nougat,,1,1145,1198,2343
34573,IronDonut,,1,8,2,10
34574,poopenschaft,,1,2,1,3
34575,fopkins,,1,178,97,275
34576,GoingApeSpit,,1,76,25,101
34577,billybennett,,1,7,11,18
34578,hadronzoo,,1,8,1,9
34579,Thezealot,,1,2,5,7
34580,jsolson,,1,157,277,434
34581,madchicken,,1,2,14,16
34582,pltnz64,,1,24,25,49
34583,quadtodfodder,,1,172,244,416
34584,fellowmellow,,1,133,157,290
34585,dazfromtheshell,,1,1,1,2
34586,not_me,,1,4,3,7
34587,schwah,,1,1,1,2
34588,Ezaroth,,1,1,1,2
34589,dabears1020,,1,657,199,856
34590,dutch,,1,95,9,104
34591,YoMama,,1,5,14,19
34592,roary,,1,1,2,3
34593,bayvet,,1,9,8,17
34594,xenox,,1,32,56,88
34595,EvilSporkMan,,1,127,177,304
34596,kin-d,,1,1,10,11
34597,styroteqe,,1,2,2,4
34598,Quarter-,,1,12,19,31
34599,Tsen,,1,99,155,254
34600,potsd4rn,,1,1,2,3
34601,DrBettyMartini,,1,1,1,2
34602,roblie,,1,1,2,3
34603,ratboythis,,1,1,1,2
34604,anechoic,,1,58,126,184
34605,OllyOllyO,,1,77,16,93
34606,forward,,1,1,3,4
34607,usercc,,1,3,5,8
34608,WuhDeyFuh,,1,4,10,14
34609,codese38,,1,36,21,57
34610,britus,,1,8,9,17
34611,takeda64,,1,350,618,968
34612,zite,,1,5,7,12
34613,monroetransfer,,1,6,15,21
34614,lukewarm,,1,10,5,15
34615,PSUstoekl,,1,1,1,2
34616,IamBriggs,,1,2,1,3
34617,bducanh,,1,2,2,4
34618,Axilla4,,1,29,17,46
34619,grakker,,1,10,14,24
34620,MrPhil,,1,3,3,6
34621,userspacename,,1,2,2,4
34622,babyshake,,1,2,1,3
34623,pthorton,,1,8,14,22
34624,bertrancito,,1,1,1,2
34625,The17,,1,7,8,15
34626,stp2007,,1,84,172,256
34627,vellaem,,1,8,18,26
34628,awol21,,1,6,5,11
34629,_jameshales,,1,33,60,93
34630,neonstereo,,1,134,82,216
34631,notentirely,,1,96,3,99
34632,takeaki,,1,26,26,52
34633,DiskoVilante,,1,373,94,467
34634,lipar,,1,1,1,2
34635,arribous,,1,9,14,23
34636,fromedome,,1,82,3,85
34637,spdygnlz,,1,1,2,3
34638,djcharlechaz,,1,9,8,17
34639,denimboy,,1,6,5,11
34640,cruise02,,1,149,179,328
34641,andrewkendall,,1,2,1,3
34642,buddyx,,1,76,2,78
34643,InRussetShadows,,1,23,27,50
34644,meriwether,,1,14,2,16
34645,notregistered,,1,9,10,19
34646,reddog_x2000,,1,5,2,7
34647,plainolme123,,1,37,7,44
34648,firdaus,,1,7,1,8
34649,TrisMcC,,1,3,2,5
34650,ToeCracker69,,1,279,87,366
34651,frothyfist,,1,6,8,14
34652,Stegg,,1,15,23,38
34653,discombobulator,,1,3,1,4
34654,tdrapeau,,1,1,1,2
34655,kelly2thec,,1,19,12,31
34656,MDKAOD,,1,94,104,198
34657,ndewitt,,1,1,1,2
34658,bogit,,1,1,1,2
34659,psommerfeld,,1,2,1,3
34660,Twenty-Grand,,1,4,1,5
34661,shqc,,1,2,1,3
34662,chefmac,,1,1,6,7
34663,flukk,,1,1,1,2
34664,Pandafox,,1,1,5,6
34665,rightwingnutjob,,1,66,65,131
34666,saurellia,,1,26,44,70
34667,ryan---,,1,6,2,8
34668,geosmack,,1,5,8,13
34669,CrunchyFrog,,1,17,13,30
34670,Seachicken,,1,13,25,38
34671,twanky,,1,9,1,10
34672,nikoliko66,,1,96,161,257
34673,tjstankus,,1,12,27,39
34674,abdelkrim,,1,1,2,3
34675,chubs512,,1,17,30,47
34676,rileyclinky,,1,4,1,5
34677,jcriddle4,,1,2,5,7
34678,gmz,,1,1,1,2
34679,randmcnally,,1,2,2,4
34680,salamandee,,1,2,1,3
34681,forevererratic,,1,51,55,106
34682,clconway,,1,1,1,2
34683,menno,,1,3,2,5
34684,popx,,1,1,1,2
34685,eyeswide,,1,18,18,36
34686,AModernMother,,1,7,1,8
34687,Catman_Doo,,1,7,6,13
34688,dnnk,,1,9,8,17
34689,ricer,,1,91,139,230
34690,thelightfixture,,1,1,1,2
34691,abattoir,,1,3,6,9
34692,gsmbk,,1,1,1,2
34693,diN0bot,,1,141,186,327
34694,Hopeformankind,,1,12,16,28
34695,azeem,,1,4,1,5
34696,decompyler,,1,10,30,40
34697,LuiseC,,1,16,10,26
34698,sciencebzzt,,1,7,1,8
34699,diversionmary,,1,133,238,371
34700,justsomeguyoverhere,,1,37,104,141
34701,pratn,,1,79,46,125
34702,kdamschen,,1,6,2,8
34703,Snullbug,,1,104,253,357
34704,victorria,,1,87,62,149
34705,suha,,1,1,1,2
34706,guitrhr0,,1,6,3,9
34707,Vequeth,,1,36,17,53
34708,karlrovesnosehair,,1,4,1,5
34709,fapman,,1,754,1510,2264
34710,phaaq,,1,2,1,3
34711,Cassio,,1,2,9,11
34712,sontek,,1,2,2,4
34713,danielcavanagh,,1,1,1,2
34714,MarkeD1,,1,1,2,3
34715,ArthurD,,1,1,5,6
34716,jamiew,,1,2,1,3
34717,cronus695,,1,61,60,121
34718,Taffaz,,1,1,1,2
34719,DigiSage,,1,5,3,8
34720,scholar33,,1,55,63,118
34721,schwarzedrache,,1,16,22,38
34722,DobleK86,,1,11,9,20
34723,frugnal,,1,5,7,12
34724,SyrioForel,,1,260,205,465
34725,d1ffEcult,,1,4,11,15
34726,yazzo,,1,32,50,82
34727,DJPho3nix,,1,13,25,38
34728,andon,,1,13,25,38
34729,maweaver,,1,24,42,66
34730,DimBimbleby,,1,11,1,12
34731,rufflesdance,,1,7,18,25
34732,ExxonMcCain,,1,85,63,148
34733,angelinblue942,,1,14,17,31
34734,sharons,,1,4,1,5
34735,the_rara_avis,,1,1,1,2
34736,revquill,,1,2,1,3
34737,okami,,1,9,3,12
34738,malfore,,1,7,6,13
34739,JamesBruni,,1,4,2,6
34740,Beanis,,1,2,2,4
34741,duquesne,,1,5,7,12
34742,mospat,,1,22,31,53
34743,Lyrad1000,,1,336,588,924
34744,karmapolice,,1,10,2,12
34745,wdgiles,,1,1,1,2
34746,stumbles047,,1,27,29,56
34747,andrewingram,,1,7,19,26
34748,g9yuayon,,1,31,10,41
34749,si1entdave,,1,4,6,10
34750,xyuvrot,,1,5,15,20
34751,sillywabbit,,1,11,30,41
34752,wahoorob,,1,252,475,727
34753,jeffotron,,1,12,12,24
34754,decepticrat,,1,10,12,22
34755,31337357,,1,41,88,129
34756,MrMike,,1,28,6,34
34757,Axman6,,1,5,6,11
34758,mrmojorisingi,,1,369,385,754
34759,substance_d,,1,8,6,14
34760,blean1,,1,9,16,25
34761,Halcyon07,,1,1,1,2
34762,RavenNights,,1,5,7,12
34763,Keith_Olbermann,,1,1,1,2
34764,jasonk1234,,1,15,4,19
34765,salmanstacksmoney,,1,2,2,4
34766,recursion27,,1,3,4,7
34767,kryptobs2000,,1,421,607,1028
34768,ICanHazMoo,,1,10,13,23
34769,relevant,,1,17,19,36
34770,ducksauce,,1,36,71,107
34771,AndrewJackson,,1,48,71,119
34772,kunjaan,,1,16,8,24
34773,paulterp,,1,6,5,11
34774,LonestarRanger,,1,21,14,35
34775,chicagodude,,1,12,10,22
34776,razzd,,1,1,1,2
34777,parrotguy63,,1,14,15,29
34778,isharq,,1,119,58,177
34779,reedy,,1,38,49,87
34780,flumphead,,1,61,115,176
34781,saijm,,1,1,4,5
34782,23444858,,1,88,126,214
34783,larfburger,,1,24,20,44
34784,moom,,1,445,372,817
34785,AnalogZero,,1,1,1,2
34786,AuhsojSivart,,1,88,134,222
34787,ZeroOne42,,1,4,2,6
34788,rhapsodyinpurple,,1,2,6,8
34789,eggoeater,,1,34,1,35
34790,endlessvoid94,,1,166,182,348
34791,finfo,,1,15,20,35
34792,warmpita,,1,105,199,304
34793,akumal,,1,79,109,188
34794,dugfresh,,1,105,32,137
34795,ungulate,,1,28,48,76
34796,plouj,,1,58,66,124
34797,pandasonic,,1,459,618,1077
34798,tail,,1,1,1,2
34799,snoosnoo,,1,188,9,197
34800,grotgrot,,1,16,15,31
34801,moomoocow,,1,4,4,8
34802,angryofficemanager,,1,4,10,14
34803,uhmlol,,1,1,2,3
34804,loganis,,1,45,111,156
34805,roserob,,1,2,2,4
34806,Word_of_the_Minute,,1,1,1,2
34807,iobuddha,,1,57,53,110
34808,chaircatmeow,,1,2,2,4
34809,SonD,,1,385,517,902
34810,hintze,,1,20,28,48
34811,HeyTruly,,1,1,1,2
34812,EddieP,,1,6,7,13
34813,k1lg0re,,1,30,53,83
34814,doyoulikeworms,,1,820,1274,2094
34815,BordrGuy108,,1,75,83,158
34816,stephhicks68,,1,5,10,15
34817,tommyhanks,,1,80,112,192
34818,Pilate,,1,113,223,336
34819,TonyBLiar,,1,799,216,1015
34820,PrsPirate,,1,43,61,104
34821,gignam,,1,85,116,201
34822,TommyFarmer,,1,5,2,7
34823,havk,,1,10,14,24
34824,MobiusCoffee,,1,3,3,6
34825,obama_is_god,,1,2,1,3
34826,cthulhudarren,,1,6,16,22
34827,norik,,1,1,1,2
34828,cj8585,,1,26,31,57
34829,ohbeone,,1,2,1,3
34830,ds022b,,1,1,2,3
34831,mexicatl,,1,35,38,73
34832,superjew,,1,1,1,2
34833,vintagecarole,,1,2,1,3
34834,cypherus,,1,38,52,90
34835,verbpreposition,,1,4,3,7
34836,skatetokil,,1,9,9,18
34837,wheresthebeef,,1,6,2,8
34838,evanscotb,,1,50,65,115
34839,notyavgkat,,1,88,5,93
34840,pib,,1,9,2,11
34841,markseger,,1,1,1,2
34842,JanaPinkster,,3,5,3,8
34843,mtndewqueen88,,1,62,36,98
34844,meatloafsurprise,,1,182,266,448
34845,Surye,,1,1,1,2
34846,ImperfectlyInformed,,1,26,20,46
34847,ddddddddddd,,1,43,3,46
34848,fox_man,,1,5,4,9
34849,binkomatic,,1,1,3,4
34850,MuletTheGreat,,1,16,29,45
34851,GalacticOverlord,,1,30,32,62
34852,bluetytanium,,1,1,1,2
34853,erykdb,,1,2,2,4
34854,SoyChemist,,1,31,10,41
34855,mambotomato,,1,1,1,2
34856,Palladian,,1,63,36,99
34857,MadroxKran,,1,46,88,134
34858,johnny_yuma,,1,5,2,7
34859,jonro,,1,1,3,4
34860,wizlevard,,1,49,60,109
34861,PrivateFreedom,,1,71,82,153
34862,mayapetties,,1,8,9,17
34863,slothman608,,1,2,3,5
34864,LieBot,,1,1,2,3
34865,summerchilde,,1,144,168,312
34866,tropicflite,,1,25,34,59
34867,volume4,,1,76,1,77
34868,ColinPowell,,1,1,1,2
34869,MrGravityPants,,1,8,5,13
34870,donmcc,,1,2,1,3
34871,tlog333,,1,1,1,2
34872,hunmik,,1,1,4,5
34873,Tallon5,,1,1,3,4
34874,hairyjerk,,1,2,4,6
34875,sillyputti,,1,21,19,40
34876,insaladwehavetomato,,1,2,3,5
34877,Sherrodzilla,,1,6,10,16
34878,r4a,,1,5,5,10
34879,FreddyDeus,,1,115,11,126
34880,HiggsBoson,,1,80,163,243
34881,jungoh,,1,6,9,15
34882,soooiiieee,,1,1,7,8
34883,ns2k2,,1,2,3,5
34884,kasperlapp,,1,9,11,20
34885,warriormare,,1,2,2,4
34886,GOD_IS_SELFLESS_LOVE,,1,20,7,27
34887,mrsugar,,1,16,27,43
34888,IAmInHateWithSatan,,1,6,5,11
34889,pengo,,1,6,13,19
34890,Christophe,,1,34,84,118
34891,old_gill,,1,229,226,455
34892,wsgeek,,1,1,1,2
34893,S_H_E_E_P_L_E,,1,44,63,107
34894,Ethanmike,,1,4,1,5
34895,igouy,,1,71,122,193
34896,ligyron,,1,4,3,7
34897,kopolee11,,1,84,103,187
34898,stevenconrad,,1,41,34,75
34899,Dunk010,,1,28,10,38
34900,tellner,,1,46,64,110
34901,hikaru87,,1,49,2,51
34902,subutai,,1,17,10,27
34903,gojasonw,,1,49,57,106
34904,amaxen,,1,7,8,15
34905,winson,,1,1,1,2
34906,dnissley,,1,6,12,18
34907,chime,,1,335,347,682
34908,bowzman_26,,1,1,1,2
34909,potent_potable,,1,3,2,5
34910,spicycode,,1,8,8,16
34911,amm,,1,6,3,9
34912,dulieu,,1,13,12,25
34913,qarp,,1,22,30,52
34914,bloosteak,,1,23,49,72
34915,eusephus,,1,172,314,486
34916,nonom,,1,6,4,10
34917,kilranian,,1,32,31,63
34918,Ukonu,,1,4,3,7
34919,bluedeviltide,,1,310,160,470
34920,CaptainConstitution,,1,35,44,79
34921,dave_colorado,,1,35,69,104
34922,Acidictadpole,,1,3,4,7
34923,yourdime,,1,1,1,2
34924,quickhorn,,1,94,110,204
34925,wtfkeyhole2pro,,1,6,6,12
34926,updog,,1,4,11,15
34927,5lashd07,,1,5,7,12
34928,rj3sp,,1,64,42,106
34929,sorbix,,1,209,189,398
34930,h0b0,,1,3,2,5
34931,thehypnotoad9,,1,1,1,2
34932,zouhair,,1,556,1150,1706
34933,ChicksNBabes,,1,59,47,106
34934,noelsusman,,1,197,231,428
34935,deminhead,,1,1,2,3
34936,alvisbrigis,,1,4,10,14
34937,kxar,,1,56,65,121
34938,curson,,1,138,142,280
34939,socketpuppet,,1,9,17,26
34940,ktgm,,1,37,13,50
34941,iggybdawg,,1,126,118,244
34942,acepiloto,,1,3,3,6
34943,sweetlou,,1,78,22,100
34944,Clent,,1,1,1,2
34945,chango,,1,53,23,76
34946,simrenk,,1,205,4,209
34947,nessi,,1,5,10,15
34948,ale402,,1,4,1,5
34949,meccanikal,,1,8,6,14
34950,scotchi,,1,2,1,3
34951,insin,,1,13,29,42
34952,happysinger,,1,667,818,1485
34953,sandharm,,1,1,1,2
34954,apropos_gc,,1,24,2,26
34955,brotherbeal,,1,2,3,5
34956,parallax7d,,1,299,520,819
34957,doctortofu,,1,10,9,19
34958,silence_hr,,1,445,743,1188
34959,dramatic,,1,1,1,2
34960,MankyTed,,1,13,13,26
34961,Aidenag,,1,7,1,8
34962,sixthgear,,1,4,2,6
34963,zoinks,,1,184,276,460
34964,megahurts,,1,1,1,2
34965,The_Borderpatrol,,1,19,6,25
34966,v8lifestyle,,1,3,3,6
34967,anaslex,,1,212,22,234
34968,phucked,,1,1,1,2
34969,whatsnew34,,1,3,1,4
34970,sextastic,,1,2,1,3
34971,tomeedee,,1,1,1,2
34972,UCaudio,,1,2,1,3
34973,monofonik,,1,10,20,30
34974,SkwatTheWorlD,,1,17,30,47
34975,sht,,1,10,18,28
34976,PlayatWork,,1,14,12,26
34977,Caldosa,,1,7,11,18
34978,now,,1,52,13,65
34979,sofreshandsoclean,,1,5,11,16
34980,drudgeman,,1,314,15,329
34981,giantjamsandwich,,1,17,1,18
34982,feelfree82,,1,2,2,4
34983,yangw,,1,47,73,120
34984,regasit,,1,2,1,3
34985,sabayon,,1,65,149,214
34986,chepprey,,1,5,2,7
34987,honeyfly,,1,11,2,13
34988,Mitijea,,1,62,102,164
34989,noneof,,1,2,4,6
34990,dostoevsky2007,,1,13,12,25
34991,oleg_k,,1,3,2,5
34992,system_monitor,,1,1,1,2
34993,kingoftitans,,1,3,2,5
34994,hb_alien,,1,137,301,438
34995,physics-package,,1,7,7,14
34996,lil_nohreaga,,1,5,3,8
34997,mepnosis,,1,105,99,204
34998,h2o2,,1,77,142,219
34999,Dark-Star,,1,688,1027,1715
35000,bipsbop,,1,100,123,223
35001,Envark,,1,250,416,666
35002,Tuviere,,1,5,7,12
35003,dasFisch,,1,4,6,10
35004,codefrog,,1,7,9,16
35005,kessel,,1,55,88,143
35006,iterator,,1,1,1,2
35007,NYCubsFan,,1,75,105,180
35008,Craptain,,1,8,4,12
35009,c04ddbk,,1,4,1,5
35010,luneunion,,1,2,1,3
35011,MountainViews,,1,1,1,2
35012,xkyjuanno,,1,2,2,4
35013,packetinspector,,1,11,12,23
35014,ianbishop,,1,14,12,26
35015,foepaws,,1,6,4,10
35016,flipflip55,,1,1125,2,1127
35017,PrinceVern,,1,1,2,3
35018,jgault,,1,5,4,9
35019,whoadave,,1,608,138,746
35020,gosko,,1,14,3,17
35021,fromagewiz,,1,192,258,450
35022,gmpalmer,,1,9,8,17
35023,Musfuut,,1,1,3,4
35024,Blackstaff,,1,72,172,244
35025,DOUCHEEPLE,,1,1,1,2
35026,machupichu,,1,47,102,149
35027,Llewdin,,1,51,85,136
35028,Hyperbio,,1,1,1,2
35029,hector031,,1,1,1,2
35030,Bedrovelsen,,1,361,388,749
35031,memekiller,,1,4,11,15
35032,kmonee,,1,11,3,14
35033,tringpad,,1,6,22,28
35034,xfrog,,1,22,21,43
35035,jonmac,,1,5,2,7
35036,heidavey,,1,333,106,439
35037,brwilliams,,1,36,40,76
35038,jaybamm,,1,36,54,90
35039,mtrump,,1,8,6,14
35040,Subjunctive_Police,,1,12,11,23
35041,savethebeast,,1,46,79,125
35042,samirshah,,1,12,28,40
35043,goodigg,,1,3,1,4
35044,aemon,,1,10,15,25
35045,prohm,,1,198,273,471
35046,afosterw,,1,11,11,22
35047,mystermarque,,1,131,2,133
35048,bimd,,1,1,1,2
35049,jmw,,1,54,13,67
35050,ky7le,,1,106,197,303
35051,brandar,,1,5,8,13
35052,LynMarcus,,1,1,3,4
35053,Lemmih,,1,1,7,8
35054,queshuns,,1,7,4,11
35055,10101010101010,,1,3,2,5
35056,Shelleen,,1,55,97,152
35057,mrgrackle,,1,122,151,273
35058,strig,,1,3,11,14
35059,paed,,1,25,17,42
35060,notsewkram,,1,3,2,5
35061,SVTBert,,1,5,9,14
35062,jacobmross,,1,6,13,19
35063,usamaizm,,1,5,5,10
35064,5430jx,,1,1,1,2
35065,admanb,,1,236,387,623
35066,Inherit,,1,6,3,9
35067,turtlestack,,1,146,125,271
35068,43P04T34,,1,1082,1602,2684
35069,kensav,,1,1,5,6
35070,andorphin,,1,1,4,5
35071,buckybadger,,1,81,97,178
35072,kftaylor,,1,7,1,8
35073,LukeAtThis,,1,1,1,2
35074,FLY180,,1,1,2,3
35075,stateful,,1,6,4,10
35076,slapsack,,1,5,14,19
35077,alreadystanding,,1,58,38,96
35078,jpkeisala,,1,6,27,33
35079,Morlovitch,,1,4,4,8
35080,unitmike,,1,49,68,117
35081,Nightlight,,1,79,167,246
35082,mbauermeister,,1,3,1,4
35083,xauriel,,1,319,289,608
35084,turk440,,1,14,29,43
35085,amg,,1,12,16,28
35086,AfterShock,,1,2,12,14
35087,jquipp,,1,9,22,31
35088,redditorslashtexan,,1,1,1,2
35089,deserted,,1,16,24,40
35090,atlantis69,,1,5,5,10
35091,JollyRogerBass,,1,3,7,10
35092,mctdotname,,1,45,8,53
35093,DCintheUK,,1,29,14,43
35094,banzai26,,1,3,2,5
35095,Captain-Picard,,1,3,7,10
35096,Kitt84,,1,8,10,18
35097,khazeh,,1,398,570,968
35098,CommentKing,,1,4,6,10
35099,vraylle,,1,3,3,6
35100,kailashnadh,,1,31,65,96
35101,Haven,,1,983,905,1888
35102,grovulent,,1,117,78,195
35103,the-fritz,,1,126,122,248
35104,Agoniscool,,1,275,409,684
35105,dbcoder,,1,8,7,15
35106,joshgi,,1,64,136,200
35107,lightdrizzle,,1,5,2,7
35108,20man,,1,12,34,46
35109,qevlhma,,1,5,10,15
35110,lograh,,1,4,8,12
35111,3th0s,,1,11,33,44
35112,lopi777,,1,5,7,12
35113,Jalisciense,,1,86,117,203
35114,yuyuyuyu,,1,1,1,2
35115,bonniec,,1,1,1,2
35116,danielwarwick,,1,86,8,94
35117,Dasugo,,1,3,9,12
35118,Clinton2008,,1,5,2,7
35119,without_feathers,,1,4,7,11
35120,railrulez,,1,5,12,17
35121,xianny,,1,1,2,3
35122,scruzia,,1,2,4,6
35123,Sthughes1,,1,2,7,9
35124,mustafanap,,1,42,80,122
35125,mo-riah,,1,4,7,11
35126,moehamid69,,1,74,122,196
35127,pedanticist,,1,308,453,761
35128,DrewInBalto,,1,30,37,67
35129,kleeka,,1,5,10,15
35130,reddof,,1,19,41,60
35131,aleahey,,1,7,2,9
35132,ad00d,,1,118,26,144
35133,Straight_Man,,1,15,2,17
35134,Charleym,,1,80,54,134
35135,indifference_engine,,1,71,58,129
35136,caffeinebump,,1,1,1,2
35137,Tantalina,,1,60,3,63
35138,The_Engineer,,1,105,188,293
35139,anothermanoutoftime,,1,51,127,178
35140,radicalheadphone,,1,10,4,14
35141,davidboyd,,1,2,4,6
35142,bgrundman,,1,37,5,42
35143,baysbenj,,1,1,1,2
35144,greenvortex,,1,89,108,197
35145,jballreno,,1,1,1,2
35146,themusicgod1,,1,340,506,846
35147,jules_siegel,,1,41,10,51
35148,isere,,1,4,5,9
35149,moonnigger,,1,1,2,3
35150,Psythik,,1,6,7,13
35151,mastema,,1,1,2,3
35152,alheim,,1,2,2,4
35153,Finardi,,1,2,1,3
35154,asol,,1,1,2,3
35155,sonQUAALUDE,,1,131,264,395
35156,jiggawoot,,1,7,8,15
35157,SwitchBlade430,,1,7,2,9
35158,mgmcmahon,,1,3,2,5
35159,drosdin,,1,58,106,164
35160,BibleNut,,1,3,1,4
35161,mistythescientist,,1,12,9,21
35162,bobcoyote,,1,3,4,7
35163,thamer,,1,78,23,101
35164,gocsick,,1,1,3,4
35165,KennyDeJonnef,,1,32,59,91
35166,idyll,,1,17,3,20
35167,HazKaz,,1,47,17,64
35168,Nshorn,,1,7,8,15
35169,diaf,,1,126,183,309
35170,moyix,,1,9,20,29
35171,miconrender,,1,35,56,91
35172,dkmj17,,1,114,99,213
35173,EmoryM,,1,1,1,2
35174,funnelweb,,1,10,9,19
35175,SqueaksBCOD,,1,29,23,52
35176,kindadumb,,1,4,1,5
35177,DavidM01,,1,55,92,147
35178,BuffaloBuffalo,,1,5,7,12
35179,SemiNormal,,1,4,15,19
35180,nathanielj,,1,604,65,669
35181,gotoday,,1,1,1,2
35182,T-Lily,,1,5,1,6
35183,Loozmotion,,1,206,346,552
35184,lispninja,,1,70,4,74
35185,eximil,,1,2,1,3
35186,trogdor33,,1,166,236,402
35187,top_pops,,1,2,2,4
35188,sreljic,,1,8,5,13
35189,specialkake,,1,15,53,68
35190,nitetrip,,1,11,11,22
35191,birdseye,,1,363,13,376
35192,Melf26,,1,2,3,5
35193,k0mplex,,1,280,51,331
35194,Vibik,,1,45,1,46
35195,CalvinLawson,,1,15,24,39
35196,freakazoid412,,1,6,13,19
35197,randomanonymity,,1,29,58,87
35198,Remingtony,,1,47,2,49
35199,fatty37us,,1,1,1,2
35200,vanyalir,,1,11,5,16
35201,Paranoir,,1,2,4,6
35202,Goose45,,1,123,143,266
35203,jolef,,1,2,1,3
35204,DanMulvey,,1,11,14,25
35205,mrdzuibaisafucknut,,1,2,2,4
35206,jlam,,1,8,6,14
35207,Neeeeeeewop,,1,6,3,9
35208,updater,,1,1,1,2
35209,scycon,,1,13,24,37
35210,chwilliam,,1,7,13,20
35211,christopher100s,,1,36,50,86
35212,rubberyduckie,,1,2,7,9
35213,pbzp,,1,36,46,82
35214,TheThoughtPolice,,1,1,1,2
35215,redditis4leftwingers,,1,1,1,2
35216,scarecrow1,,1,82,135,217
35217,DiamondAge,,1,4,10,14
35218,kinguy,,1,11,2,13
35219,PABeachBum,,1,237,223,460
35220,thermite451,,1,7,14,21
35221,Altoid_Addict,,1,161,215,376
35222,McCain2008volunteer,,1,1,2,3
35223,antifolkhero,,1,1105,1286,2391
35224,ardent11,,1,1,1,2
35225,pix0r1,,1,1,1,2
35226,Earthday_Jim,,1,8,6,14
35227,mebrahim,,1,68,131,199
35228,flmax,,1,1,1,2
35229,pbgswd,,1,20,60,80
35230,rstaehli,,1,1,1,2
35231,hedbngr,,1,3,3,6
35232,erikengbrecht,,1,2,3,5
35233,Redeker,,1,352,62,414
35234,deux11,,1,3,1,4
35235,IRS,,1,1,1,2
35236,simondo,,1,9,9,18
35237,alphacoder,,1,20,5,25
35238,lunohuj,,1,1,1,2
35239,311wasapunkskaband,,1,37,14,51
35240,batttygirl,,1,1,1,2
35241,kaelstrom,,1,2,3,5
35242,ibsulon,,1,232,340,572
35243,gowoodard,,1,1,1,2
35244,avatar4d,,1,2,1,3
35245,greed,,1,3,3,6
35246,JDuke,,1,9,6,15
35247,rustyspy,,1,5,1,6
35248,gitgat,,1,4,11,15
35249,Facehammer,,1,67,151,218
35250,cts,,1,2,2,4
35251,migraine516,,1,38,74,112
35252,tboy321025,,1,113,22,135
35253,antipoet,,1,3,8,11
35254,fdw201,,1,37,2,39
35255,CommanderXenu,,1,6,2,8
35256,marklarg,,1,1,1,2
35257,avinashv,,1,21,16,37
35258,muchmoregooder,,1,6,7,13
35259,starwhal,,1,8,5,13
35260,tehoreoz,,1,2,2,4
35261,ajaxpath,,1,1,1,2
35262,loudthing,,1,12,7,19
35263,tomgillette83,,1,1,1,2
35264,48VDC,,1,9,10,19
35265,tsaylor,,1,23,25,48
35266,drewmanskitto,,1,1,1,2
35267,xzzap,,1,3,5,8
35268,krisdafish,,1,22,8,30
35269,SBStijn,,1,4,5,9
35270,nzfrio,,1,25,54,79
35271,vshioshvili,,1,263,208,471
35272,msiley,,1,15,21,36
35273,vickromanji,,1,2,12,14
35274,Saylar,,1,338,82,420
35275,slaphappyhubris,,1,5,10,15
35276,alevel27mage,,1,30,40,70
35277,j4g3r,,1,3,1,4
35278,Azhain,,1,1,1,2
35279,xabbott,,1,12,2,14
35280,GoFlight,,1,134,177,311
35281,sir5yko,,1,5,6,11
35282,stusmith,,1,13,1,14
35283,zenhabits,,1,15,2,17
35284,drgabriel,,1,5,22,27
35285,mattboston,,1,1,2,3
35286,cheetahtech,,1,31,5,36
35287,devguy,,1,11,1,12
35288,mikeypow,,1,1,1,2
35289,robbiest,,1,11,3,14
35290,thintalle,,1,9,19,28
35291,flatfoil,,1,23,31,54
35292,Z00lander,,1,16,2,18
35293,SteamPunkIsDead,,1,1,1,2
35294,christopherr,,1,15,20,35
35295,spudlyo,,1,37,72,109
35296,Marci_Milfs,,1,4,5,9
35297,TrinityDejavu,,1,17,29,46
35298,rpi22,,1,430,11,441
35299,SearchEngines,,1,51,1,52
35300,mwilson,,1,3,12,15
35301,cookfamily,,1,1,2,3
35302,joaquin,,1,146,56,202
35303,filox,,1,41,35,76
35304,scarferjoe,,1,20,33,53
35305,micha2305,,1,4,5,9
35306,noneofya,,1,7,13,20
35307,sightimestwo,,1,1,2,3
35308,bRYE04,,1,3,1,4
35309,bgolbaba,,1,44,36,80
35310,erpava,,1,14,38,52
35311,ERhyne,,1,13,3,16
35312,dumpc0r3,,1,48,2,50
35313,voidoid,,1,73,65,138
35314,scstraus,,1,262,550,812
35315,spilliton,,1,7,10,17
35316,devonrtfp,,1,1,1,2
35317,tigerthink,,1,610,925,1535
35318,igbert,,1,2,2,4
35319,shotintoeternity,,1,31,10,41
35320,babbass,,1,13,8,21
35321,Xtal,,1,633,674,1307
35322,SargentMajorBlatant,,1,2,3,5
35323,ebenonce,,1,2,1,3
35324,Boulderado,,1,11,56,67
35325,gemadouble,,1,42,61,103
35326,glitterotic,,1,1,3,4
35327,Barbilik1,,1,327,22,349
35328,amstrdamordeath,,1,1652,2418,4070
35329,bryndsi,,1,3,1,4
35330,cosmina123,,1,60,4,64
35331,countingspoons,,1,234,189,423
35332,brqqme,,1,14,13,27
35333,chebuctonian,,1,15,13,28
35334,philoneous,,1,43,63,106
35335,demosthenes1,,1,102,78,180
35336,papercup,,1,60,71,131
35337,howars,,1,153,12,165
35338,klik,,1,31,46,77
35339,patch5,,1,2,3,5
35340,tringtring,,1,16,23,39
35341,davenaff,,1,3,1,4
35342,Mrchocoborider,,1,103,170,273
35343,azdavy,,1,41,121,162
35344,corporaterebel,,1,79,111,190
35345,youfuckingmoron,,1,7,3,10
35346,lovehate,,1,22,48,70
35347,miloshh,,1,24,35,59
35348,scurge,,1,19,6,25
35349,padrephobos,,1,7,10,17
35350,bostux,,1,8,1,9
35351,reesespcs,,1,66,2,68
35352,Pazuzu,,1,1,3,4
35353,DiscusRapidus,,1,6,1,7
35354,testpattern,,1,6,12,18
35355,shivermetimberslads,,1,410,17,427
35356,samgts25,,1,4,7,11
35357,bolapara,,1,3,2,5
35358,Andross01,,1,26,24,50
35359,heartsjava,,1,89,183,272
35360,uhnope,,1,4,2,6
35361,discoloda,,1,3,12,15
35362,geckgeck,,1,1,5,6
35363,MinkyLeRue,,1,2,1,3
35364,GrammyM,,1,1,10,11
35365,yoasif,,1,55,66,121
35366,StringyLow,,1,390,1043,1433
35367,sdufh9,,1,1,1,2
35368,crazytiredguy,,1,127,135,262
35369,Jaymie13,,1,1,3,4
35370,wannahack,,1,3,2,5
35371,epik,,1,156,227,383
35372,hackinthebochs,,1,12,15,27
35373,kieranmullen,,1,44,85,129
35374,laflair13,,1,8,1,9
35375,yokohunter,,1,1,3,4
35376,sinn0304,,1,13,20,33
35377,john_nyc,,1,599,79,678
35378,ignorantsheep,,1,6,12,18
35379,scott,,1,269,382,651
35380,wingedsubmariner,,1,5,2,7
35381,Zespris,,1,37,3,40
35382,joefaz,,1,7,1,8
35383,doublejay999,,1,5,13,18
35384,plasticsoap,,1,6,7,13
35385,nonworse,,1,247,336,583
35386,diaboloney,,1,23,1,24
35387,English_Chef,,1,82,108,190
35388,wardy666,,1,7,10,17
35389,bobsimpson41,,1,1,3,4
35390,saksoz,,1,7,17,24
35391,dcronin90,,1,20,56,76
35392,yourdaftpunk,,1,2,3,5
35393,nyarlath0tep,,1,9,7,16
35394,pattihearst,,1,3,1,4
35395,bigprick,,1,50,72,122
35396,greebowarrior,,1,36,74,110
35397,twofifths,,1,3,5,8
35398,camonz,,1,6,24,30
35399,ComPanda,,1,1,2,3
35400,ILikeChickenILikeLiv,,1,2,3,5
35401,affan,,1,3,6,9
35402,GhostTramp,,1,2,2,4
35403,J-ohn,,1,115,161,276
35404,quimby08,,1,11,6,17
35405,marvinpandroid,,1,2,1,3
35406,Horward,,1,110,16,126
35407,sparsely,,1,17,34,51
35408,sfled,,1,3,2,5
35409,zhk,,1,2,4,6
35410,jjmarq,,1,1,2,3
35411,watershawl,,1,4,2,6
35412,Buckeye_Bill,,1,3,8,11
35413,captainarbitrage,,1,1,1,2
35414,jotunn,,1,3,1,4
35415,lstephen666,,1,8,5,13
35416,wilgamesh,,1,2,3,5
35417,G-M,,1,114,90,204
35418,syslog2000,,1,22,31,53
35419,delkarnu,,1,97,124,221
35420,frenetic,,1,81,2,83
35421,sweet_mackerel,,1,4,8,12
35422,magnacumlaudi,,1,2,1,3
35423,vince07,,1,4,7,11
35424,jton,,1,3,13,16
35425,suamain,,1,2,16,18
35426,trendmaker,,1,374,36,410
35427,say_no_to_rp,,1,3,3,6
35428,TheJBW,,1,3,1,4
35429,observer22,,1,8,20,28
35430,darkbarf,,1,12,25,37
35431,polonius,,1,8,8,16
35432,BartLA,,1,147,3,150
35433,MrMustard,,1,11,28,39
35434,aarthi1,,1,6,8,14
35435,kluenitou,,1,151,20,171
35436,Slinky31,,1,1,1,2
35437,razrx,,1,1,1,2
35438,justinkuto,,1,6,10,16
35439,wigglestick,,1,10,6,16
35440,tiglionabbit,,1,13,18,31
35441,Jonny0stars,,1,40,72,112
35442,duvergerslaw_nopaul,,1,1,1,2
35443,pute,,1,23,73,96
35444,Jeftrokat,,1,19,10,29
35445,bilange,,1,27,34,61
35446,RamdomString,,1,8,4,12
35447,ben_gslr,,1,13,26,39
35448,shahein,,1,11,7,18
35449,mingusrude,,1,36,35,71
35450,iaminhatewithjesus,,1,4,5,9
35451,mt_ski,,1,9,7,16
35452,raymendx,,1,1,3,4
35453,reyofish,,1,97,25,122
35454,salvadors,,1,98,9,107
35455,gomerfile,,1,68,3,71
35456,pyr3,,1,1,1,2
35457,techimi,,1,2,6,8
35458,casull,,1,5,6,11
35459,fuzz,,1,1,1,2
35460,Seanstex,,1,1,1,2
35461,ylph,,1,33,45,78
35462,andrew1184,,1,107,134,241
35463,sjsigler,,1,3,6,9
35464,gmfawcett,,1,50,76,126
35465,toeppen,,1,25,8,33
35466,archant,,1,34,60,94
35467,dunplease,,1,1,1,2
35468,s7aind,,1,38,34,72
35469,anton55,,1,3,1,4
35470,greenpix,,1,34,18,52
35471,gcanyon,,1,38,31,69
35472,dbrannan,,1,3,1,4
35473,incith,,1,16,50,66
35474,TreyBoudreau,,1,1,1,2
35475,Fristle,,1,50,75,125
35476,kyuz,,1,28,28,56
35477,oblivious_human,,1,532,823,1355
35478,LionofJudah,,1,3,6,9
35479,projecktzero,,1,25,54,79
35480,candyman682,,1,2,5,7
35481,jonasblue,,1,80,60,140
35482,CaptainEntropy,,1,1,2,3
35483,yortimer,,1,172,109,281
35484,d-_-b,,1,84,104,188
35485,dodgethegod,,1,2,3,5
35486,anasqtiesh,,1,27,35,62
35487,yukster,,1,37,19,56
35488,luchak,,1,9,4,13
35489,HFh,,1,203,236,439
35490,plasticbottle,,1,46,68,114
35491,mrdorian,,1,30,27,57
35492,azblaze,,1,2,4,6
35493,mishy_mo,,1,1,2,3
35494,gfixler,,1,612,920,1532
35495,dawhoo,,1,79,112,191
35496,yuk2k,,1,18,4,22
35497,GravityPhone,,1,22,31,53
35498,seths,,1,23,22,45
35499,benbot,,1,2,2,4
35500,Koreapsu,,1,20,10,30
35501,fooddit,,1,2,2,4
35502,OpenBSD_Developer,,1,4,12,16
35503,Zai_shanghai,,1,138,320,458
35504,heyt,,1,441,330,771
35505,rhabd0mancer,,1,103,147,250
35506,Nosredna,,1,2,3,5
35507,yjr2002,,1,5,5,10
35508,dentpuzz,,1,2,6,8
35509,32bites,,1,263,387,650
35510,cariann,,1,2,3,5
35511,hyperfat,,1,176,363,539
35512,JonAce,,1,359,311,670
35513,theinternets,,1,71,11,82
35514,lavanderson,,1,1,3,4
35515,cgoldberg,,1,37,12,49
35516,wongiseng,,1,27,31,58
35517,yoyodyne_propulsion,,1,90,135,225
35518,necrotic,,1,1,2,3
35519,mrkleen,,1,18,63,81
35520,ziegfried,,1,320,418,738
35521,starthorn,,1,7,7,14
35522,gadooble,,1,3,1,4
35523,Eskapismus,,1,12,18,30
35524,rob_brez,,1,36,80,116
35525,cowbellthunder,,1,61,86,147
35526,coreal07,,1,3,11,14
35527,andyandthetuna,,1,2,11,13
35528,mkv,,1,41,67,108
35529,purple_tooth,,1,26,14,40
35530,fresnik,,1,4,6,10
35531,ikean,,1,19,41,60
35532,jatanis,,1,4,2,6
35533,dca5612,,1,2,1,3
35534,Andria16,,1,6,18,24
35535,-K-,,1,5,3,8
35536,-J-,,1,432,730,1162
35537,AquaFox,,1,3,4,7
35538,sqweek,,1,3,4,7
35539,SparkleMotion,,1,1,3,4
35540,plonkder,,1,1,1,2
35541,SouthboundPachyderm,,1,2,1,3
35542,yesiamanostrich,,1,88,119,207
35543,jesuswuzanalien,,1,150,129,279
35544,dario1977,,1,78,8,86
35545,laddy,,1,1,5,6
35546,Billy_O_Reilly,,1,8,4,12
35547,ericmoritz,,1,14,22,36
35548,DangerRodneyfield,,1,1,4,5
35549,hisoka,,1,3,4,7
35550,wanakawoman1,,1,1,4,5
35551,Captain-Calumny,,1,4,6,10
35552,mashiyach,,1,1,6,7
35553,abusrur,,1,1,1,2
35554,chadz,,1,193,256,449
35555,DaniBicknell,,1,8,15,23
35556,benfaist,,1,1,3,4
35557,m_van_houten,,1,8,18,26
35558,forgivenessforall,,1,1,1,2
35559,rsenic,,1,2,2,4
35560,killfoot,,1,1,2,3
35561,Astrosexy,,1,3,9,12
35562,jimmux,,1,296,351,647
35563,ChannelCat,,1,17,8,25
35564,Aadje,,1,66,2,68
35565,elev,,1,52,30,82
35566,freesecrets,,1,4,2,6
35567,aUTOMATICuPVOTES,,1,122,201,323
35568,nsfw_handle,,1,2,2,4
35569,JamesIry,,1,37,52,89
35570,bilabrin,,1,8,12,20
35571,thisisafakeaccount,,1,1,1,2
35572,definiteform,,1,17,34,51
35573,jan,,1,73,66,139
35574,jewbama,,1,3,3,6
35575,amalthea,,1,3,2,5
35576,nekt,,1,207,342,549
35577,danhawkeye,,1,101,134,235
35578,SofianJ,,1,4,7,11
35579,Midas7g,,1,3,4,7
35580,zemmekkis,,1,29,15,44
35581,knackers,,1,7,30,37
35582,NilesLesh,,1,4,3,7
35583,hatepirate,,1,37,34,71
35584,Falkvinge,,1,2,1,3
35585,jskaines,,1,1,1,2
35586,Duffer,,1,1,7,8
35587,iQwerty,,1,4,3,7
35588,moosey,,1,27,44,71
35589,TheAbsquatulater,,1,7,5,12
35590,RX9735,,1,91,149,240
35591,lphoenix,,1,2,6,8
35592,abezontar,,1,3,2,5
35593,sox406,,1,15,47,62
35594,TommyTheCorc,,1,2,2,4
35595,monkeypickle,,1,1,1,2
35596,PRgeek82,,1,1,3,4
35597,asaturn,,1,483,1009,1492
35598,slow_as_light,,1,725,128,853
35599,acefearless,,1,1,4,5
35600,kjartanelli,,1,219,142,361
35601,Earthrise,,1,118,136,254
35602,stephanieebarr,,1,4,8,12
35603,benybomi,,1,33,1,34
35604,freshpowpow,,1,3,2,5
35605,ephekt,,1,4,10,14
35606,treasonholdings,,1,1,1,2
35607,sthussey,,1,41,36,77
35608,harryc,,1,11,6,17
35609,Pro8678,,1,1,1,2
35610,jakobjs,,1,3,4,7
35611,darkender,,1,8,18,26
35612,inverse,,1,47,61,108
35613,safety_party,,1,1,2,3
35614,YellowBrickAvenue,,1,58,13,71
35615,chaitan,,1,16,22,38
35616,mostsleek,,1,30,4,34
35617,antich,,1,1,1,2
35618,fartron,,1,239,176,415
35619,weaselmaster,,1,41,33,74
35620,7wheels,,1,22,1,23
35621,marjorie_L,,1,109,38,147
35622,The5thamigo,,1,2,2,4
35623,jhonyorah,,1,4,1,5
35624,lensless,,1,1,7,8
35625,shlomif,,1,4,1,5
35626,convictboy,,1,30,15,45
35627,JesusWasMetro,,1,27,23,50
35628,neeeeeep,,1,5,1,6
35629,creaothceann,,1,370,717,1087
35630,hotrod31337,,1,13,20,33
35631,cajolingwilhelm,,1,434,592,1026
35632,originalucifer,,1,35,33,68
35633,Remover,,1,15,30,45
35634,paulgb,,1,34,61,95
35635,whacknrd,,1,43,7,50
35636,ravidgemole,,1,15,9,24
35637,NtroP,,1,16,20,36
35638,stutheidiot,,1,67,65,132
35639,phlipski,,1,120,107,227
35640,scraun,,1,1,1,2
35641,chronichyjinx,,1,9,18,27
35642,nyinjewn,,1,18,2,20
35643,budoudoh,,1,2,2,4
35644,juventus1,,1,32,95,127
35645,pyejamma,,1,1,4,5
35646,jonathansaurus,,1,16,9,25
35647,krustykrab,,1,5,5,10
35648,lungfish59,,1,28,45,73
35649,rgladstein,,1,636,887,1523
35650,nuevo,,1,2,4,6
35651,Xavi-avi,,1,10,8,18
35652,subnet_rx,,1,32,29,61
35653,urfunylookin,,1,5,2,7
35654,Creator_1,,1,17,1,18
35655,DD32,,1,6,7,13
35656,wespog,,1,7,13,20
35657,ntchn,,1,9,1,10
35658,wackygonzo,,1,2,1,3
35659,citizenterminal,,1,7,5,12
35660,MNMark,,1,4,2,6
35661,schulte4e,,1,46,1,47
35662,ilistenisee08,,1,55,134,189
35663,unsung23,,1,20,12,32
35664,LiGht_UrpLe,,1,1,4,5
35665,morshehir,,1,1,1,2
35666,iKonoKlast,,1,123,45,168
35667,Cuchullain,,1,8,8,16
35668,jamesb43,,1,3,2,5
35669,almeisam,,1,1,6,7
35670,alv,,1,18,4,22
35671,spacemanotis,,1,2,6,8
35672,Swimfroggy,,1,1,1,2
35673,kgrashad,,1,7,4,11
35674,macfanboi,,1,86,137,223
35675,Lewsut,,1,10,21,31
35676,rhesuschrist,,1,3,2,5
35677,awesomeusername,,1,10,16,26
35678,elcrazon,,1,3,6,9
35679,MamaPalin,,1,5,3,8
35680,arnie_apesacrappin,,1,30,18,48
35681,leadingtone,,1,12,11,23
35682,shoyu,,1,4,8,12
35683,portablestaplefrog,,1,15,25,40
35684,EggRoll,,1,6,6,12
35685,Zungaar,,1,1,1,2
35686,Anthropoid1,,1,5,16,21
35687,Yossarian42,,1,88,87,175
35688,pfi,,1,8,7,15
35689,PyroLanfyre,,1,1,1,2
35690,Lave,,1,105,55,160
35691,bgieseler,,1,3,4,7
35692,andyc,,1,26,35,61
35693,joemc91,,1,1,1,2
35694,fakeslimshady,,1,10,13,23
35695,critdragon,,1,1,1,2
35696,mingthepanda,,1,24,39,63
35697,gillesthegreat,,1,5,1,6
35698,iBalls,,1,166,293,459
35699,wk2x,,1,11,19,30
35700,DigSomeMore,,1,23,17,40
35701,blaimjos,,1,2,3,5
35702,pbiggar,,1,12,12,24
35703,Guoguodi,,1,111,13,124
35704,jdougie,,1,4,2,6
35705,nobody7,,1,28,53,81
35706,mcfarrow,,1,37,46,83
35707,AllZoo,,1,68,48,116
35708,ralexander,,1,9,7,16
35709,CB201,,1,24,27,51
35710,dschaefer,,1,34,8,42
35711,misanthropegirl,,1,14,11,25
35712,wirbolwabol,,1,43,138,181
35713,jim_scott,,1,13,5,18
35714,rscynn,,1,1,1,2
35715,bephillips,,1,3,7,10
35716,jgator85,,1,1,1,2
35717,God__,,1,1,1,2
35718,isseki,,1,244,545,789
35719,eldermatic,,1,11,18,29
35720,LocoYoko,,1,1,1,2
35721,xaraya,,1,7,1,8
35722,unknown,,1,144,29,173
35723,magic_man8,,1,1,1,2
35724,Kestral,,1,213,279,492
35725,avar,,1,28,29,57
35726,FleeFlee,,1,1,1,2
35727,wookiemonster,,1,4,1,5
35728,BillDunlap,,1,1,1,2
35729,iliketoreadnews,,1,2,2,4
35730,ishmandoo,,1,10,1,11
35731,lainiep93,,1,1,1,2
35732,purrp,,1,106,92,198
35733,enolan,,1,34,20,54
35734,breakz,,1,1,2,3
35735,lordbrass,,1,46,59,105
35736,T8rfudgees,,1,1,2,3
35737,dainwaris,,1,97,114,211
35738,alqbeck,,1,1,3,4
35739,goodhairs,,1,1,1,2
35740,anirbas,,1,3,10,13
35741,MaximumCarter,,1,10,12,22
35742,boomgoesthedynamite,,1,14,14,28
35743,imabitlost,,1,2,3,5
35744,barryicide,,1,675,669,1344
35745,elduke187,,1,202,164,366
35746,patriot_act,,1,1,1,2
35747,ravijp,,1,2,1,3
35748,ecm27,,1,1,1,2
35749,AeroLeviathan,,1,7,8,15
35750,tibber,,1,8,5,13
35751,greenfrog,,1,360,415,775
35752,hfaber,,1,31,21,52
35753,njdfan1241,,1,134,93,227
35754,shamam,,1,31,32,63
35755,raindog,,1,3,8,11
35756,dumbledoreisgay,,1,4,1,5
35757,mnic001,,1,181,178,359
35758,pyramis,,1,20,3,23
35759,yury,,1,2,4,6
35760,ironmanxl1,,1,5,2,7
35761,Shuck,,1,74,31,105
35762,jswan,,1,4,11,15
35763,SuperConfused,,1,10,9,19
35764,benji,,1,2,6,8
35765,tek1024,,1,7,21,28
35766,dman928,,1,67,119,186
35767,eurobeing,,1,95,117,212
35768,rpfinn22,,1,41,19,60
35769,typical_reddit_user,,1,15,18,33
35770,nerdmanpap,,1,129,267,396
35771,spez,,1,644,245,889
35772,mispeled,,1,12,22,34
35773,ux500,,1,22,16,38
35774,asfsaersd,,1,1,2,3
35775,intresting,,1,5,8,13
35776,dsri,,1,4,3,7
35777,Anunnakki,,1,6,7,13
35778,maltokyo,,1,2,1,3
35779,Anon1299,,1,1,1,2
35780,Cheeeef,,1,6,2,8
35781,WednesdayLaw,,1,16,35,51
35782,kellyandbryan,,1,2,2,4
35783,BigPhun,,1,8,11,19
35784,jgfoto,,1,32,48,80
35785,zardoz73,,1,34,110,144
35786,julienbh,,1,8,11,19
35787,bcw19,,1,10,10,20
35788,texastornado,,1,1,1,2
35789,Danegerous,,1,15,13,28
35790,tsfn46290,,1,88,60,148
35791,hillbilly1980,,1,1,1,2
35792,taekwonjer,,1,8,1,9
35793,yajusdono,,1,1,2,3
35794,longini21,,1,14,9,23
35795,arow6k,,1,16,2,18
35796,Godott,,1,3,4,7
35797,ChelseaBlacker,,1,5,3,8
35798,greggles,,1,1,2,3
35799,xphilter,,1,22,35,57
35800,VMX,,1,4,3,7
35801,badarabdad,,1,38,49,87
35802,eagreeyes,,1,27,18,45
35803,cobber2005,,1,1,2,3
35804,surly,,1,3,6,9
35805,furiousidiot,,1,14,25,39
35806,bjorfr,,1,59,105,164
35807,injoy,,1,37,36,73
35808,climbit,,1,4,3,7
35809,bzhu5,,1,4,1,5
35810,drabbit,,1,1,2,3
35811,redhotkurt,,1,173,182,355
35812,lobsters2,,1,10,16,26
35813,jef396,,1,1,5,6
35814,v2r1,,1,8,6,14
35815,Trey_Mendus,,1,5,10,15
35816,Mikola7,,1,3,5,8
35817,miquelon,,1,42,51,93
35818,FrozenThetan,,1,7,3,10
35819,cking777,,1,4,2,6
35820,yolesaber,,1,17,15,32
35821,jj12345,,1,22,36,58
35822,powertool,,1,2,8,10
35823,manghole,,1,1,1,2
35824,netcraft,,1,6,10,16
35825,ido,,1,203,261,464
35826,lawyervon,,1,9,10,19
35827,Elle_Dee,,1,201,1,202
35828,rfulks,,1,22,15,37
35829,pkd,,1,42,3,45
35830,Saktoth,,1,1,2,3
35831,lythey,,1,8,4,12
35832,buckrice,,1,1,2,3
35833,kypen,,1,10,9,19
35834,melikespi,,1,2,3,5
35835,WhoKilledTeddyBear,,1,1083,1347,2430
35836,emont88,,1,7,9,16
35837,AdamToyota,,1,4,2,6
35838,pawnsushi,,1,1,1,2
35839,leoc,,1,112,195,307
35840,athayil,,1,1,1,2
35841,escapist13,,1,6,10,16
35842,tigermac10,,1,1,6,7
35843,Fat_Lady,,1,2,4,6
35844,oohal,,1,1,1,2
35845,stoprock,,1,75,107,182
35846,pjfry,,1,40,45,85
35847,dadenman,,1,3,7,10
35848,spiffyP,,1,38,59,97
35849,ktm1,,1,40,51,91
35850,pensacola,,1,3,1,4
35851,effektz,,1,37,19,56
35852,reggplant,,1,16,26,42
35853,RedditRuinedMyLife,,1,10,13,23
35854,nordbert,,1,36,43,79
35855,spike00,,1,21,21,42
35856,mposha,,1,294,118,412
35857,Morieris,,1,18,34,52
35858,hoppasaurus,,1,58,54,112
35859,twitch18,,1,3,4,7
35860,holyzylo,,1,1,2,3
35861,captnkurt,,1,1,2,3
35862,bumbletowne,,1,83,117,200
35863,MOE37x3,,1,360,203,563
35864,seringen,,1,1,1,2
35865,davemail,,1,2,2,4
35866,kerchov,,1,36,73,109
35867,cdougmah2,,1,11,3,14
35868,guyvatican,,1,1,1,2
35869,ddxChrist,,1,60,81,141
35870,yoyoo,,1,41,1,42
35871,psed,,1,38,55,93
35872,adambrault,,1,1,1,2
35873,Ron_Paul_says,,1,6,13,19
35874,contact287,,1,43,3,46
35875,whiteysale,,1,3,2,5
35876,wensheng,,1,3,4,7
35877,lobstah4,,1,2,13,15
35878,tsswope,,1,30,29,59
35879,jplank1983,,1,207,10,217
35880,gothicsmurf,,1,64,45,109
35881,jc4p,,1,26,16,42
35882,jarilindroos,,1,7,1,8
35883,sci_king1,,1,1,3,4
35884,Morally_Inept,,1,102,142,244
35885,silvercide,,1,1,1,2
35886,slx,,1,75,115,190
35887,msloyko,,1,15,1,16
35888,alexcq,,1,15,3,18
35889,Knowltey,,1,12,38,50
35890,OliverM,,1,10,4,14
35891,hyankov,,1,3,2,5
35892,opentubes,,1,233,299,532
35893,jimmyjoe2008,,1,1,1,2
35894,god-zilla,,1,3,3,6
35895,ksemel,,1,7,8,15
35896,fnule,,1,63,118,181
35897,batmanbury,,1,4,9,13
35898,babysharkjesus,,1,1,2,3
35899,voteman,,1,1,1,2
35900,qarl,,1,162,218,380
35901,MemePolice,,1,5,10,15
35902,joquarky,,1,25,44,69
35903,yuethomas,,1,1,3,4
35904,roger_,,1,352,489,841
35905,thespins,,1,5,9,14
35906,anders113,,1,2,1,3
35907,wakethefukup,,1,43,47,90
35908,mrbucket777,,1,3,6,9
35909,Ryan739,,1,9,5,14
35910,Andreides,,1,1,1,2
35911,ZypherBL,,1,23,33,56
35912,mgurf1,,1,131,47,178
35913,true_american_patrio,,1,22,28,50
35914,terrywagar,,1,2,5,7
35915,berbercarpet,,1,1,1,2
35916,TheSlinky,,1,80,129,209
35917,bustweiser,,1,3,2,5
35918,pandres,,1,1,6,7
35919,target,,1,7,4,11
35920,lanimil3,,1,7,1,8
35921,lftl,,1,41,35,76
35922,712weasel,,1,21,10,31
35923,2275617,,1,3,15,18
35924,kjhatch,,1,4,8,12
35925,m2c,,1,12,19,31
35926,Mithoran,,1,12,18,30
35927,wolfsleepy,,1,133,192,325
35928,rdingwall,,1,21,2,23
35929,pierre_rdy4actn,,1,5,11,16
35930,rebel,,1,20,32,52
35931,jamesfrazer,,1,4,1,5
35932,Cancerkitty,,1,7,4,11
35933,danielcloutier,,1,371,74,445
35934,modestokun,,1,278,453,731
35935,jk7195,,1,12,17,29
35936,godfatha,,1,101,8,109
35937,NoMoreJesus,,1,1,1,2
35938,ifjake,,1,22,28,50
35939,obama4pres08,,1,9,4,13
35940,S_Palin,,1,1,1,2
35941,Mourningblade,,1,93,108,201
35942,WhamBamThanksHo,,1,4,2,6
35943,clarkeee,,1,1,1,2
35944,southpark,,1,1,1,2
35945,jdmesp,,1,4,12,16
35946,fakityfakefake123,,1,1,1,2
35947,rshawgo,,1,3,1,4
35948,spectreblofeld,,1,1,2,3
35949,owlmonkey,,1,1,1,2
35950,Guillermo_the_Good,,1,1,3,4
35951,styrofoam,,1,1,1,2
35952,flapan,,1,1,2,3
35953,LauriL,,1,88,3,91
35954,Cederosa,,1,3,3,6
35955,rektide,,1,66,142,208
35956,Kilogram,,1,2,2,4
35957,jhd,,1,3,4,7
35958,BudWhite,,1,1,1,2
35959,hsuresh,,1,2,7,9
35960,zctaylor,,1,61,70,131
35961,bacchas,,1,1,1,2
35962,alex83,,1,1,3,4
35963,thesolitaire,,1,7,9,16
35964,cabbit,,1,276,337,613
35965,setuid_w00t,,1,312,410,722
35966,ravend13,,1,69,106,175
35967,jjf,,1,6,7,13
35968,Rudy69,,1,33,5,38
35969,sdoafgu,,1,1,1,2
35970,rizzledizzle,,1,3,6,9
35971,canuckian,,1,3,3,6
35972,maka,,1,10,6,16
35973,tdehnel,,1,360,561,921
35974,sonofabush,,1,135,150,285
35975,m4re,,1,2,1,3
35976,Masterminded,,1,24,40,64
35977,alteclansing,,1,2,3,5
35978,Vestan_Pance,,1,9,21,30
35979,tsa_goon,,1,1,6,7
35980,Avenestra,,1,18,14,32
35981,el-bi-ranchero,,1,2,2,4
35982,blackpete,,1,11,15,26
35983,maxwellb,,1,12,24,36
35984,jaciilyn,,1,65,56,121
35985,kris1363,,1,7,1,8
35986,sammy1982,,1,25,19,44
35987,mikeonatrike,,1,4,4,8
35988,KantLockeMeIn,,1,256,371,627
35989,enmand,,1,9,11,20
35990,Anita8B3,,1,1,1,2
35991,danselic,,1,9,4,13
35992,CuriousMind,,1,2,2,4
35993,Hoodwink,,1,121,254,375
35994,ohlala,,1,6,2,8
35995,trainer_,,1,5,20,25
35996,Marutar,,1,19,17,36
35997,tupton,,1,2,4,6
35998,Cakexploder,,1,10,20,30
35999,Vv0rd,,1,28,70,98
36000,serth,,1,3,4,7
36001,vangelos2,,1,1,1,2
36002,noblemaster,,1,8,20,28
36003,mzcora,,1,4,12,16
36004,Akeshi,,1,21,32,53
36005,CockerhamExperiment,,1,5,8,13
36006,MadrasahOsamaObama,,1,74,90,164
36007,hellomynameis,,1,3,2,5
36008,sluggermoore,,1,4,1,5
36009,stinkychild,,1,3,2,5
36010,schwanksta,,1,1,2,3
36011,torttu,,1,1,1,2
36012,bgoodwyn,,1,2,3,5
36013,simulacra10,,1,4,5,9
36014,kr90df,,1,15,1,16
36015,shreknel,,1,2,1,3
36016,foxtwofoxtwo,,1,84,120,204
36017,scrag45,,1,101,126,227
36018,only1rob,,1,5,4,9
36019,Edward_Teach,,1,3,2,5
36020,andar,,1,1,3,4
36021,wushu18t,,1,170,170,340
36022,genericdave,,1,1,1,2
36023,nonsensicaliciousnes,,1,2,1,3
36024,piecewise,,1,41,40,81
36025,yadidamean,,1,2,2,4
36026,peacemaker,,1,1,1,2
36027,darkphan,,1,2,5,7
36028,ekks,,1,21,39,60
36029,fakebook,,1,12,19,31
36030,kmb1794,,1,1,3,4
36031,aisa,,1,3,6,9
36032,petitefleur,,1,10,9,19
36033,microsoftie,,1,2,7,9
36034,crux_,,1,101,144,245
36035,h1ro,,1,10,29,39
36036,caffeind,,1,1,2,3
36037,lockbock,,1,30,3,33
36038,Mattack04,,1,67,33,100
36039,plato1123,,1,44,70,114
36040,mariuz,,1,2,1,3
36041,MrPenn,,1,8,7,15
36042,rfcmofo,,1,13,14,27
36043,civildefense,,1,33,48,81
36044,illlookforit,,1,5,15,20
36045,teentweensblog,,1,75,2,77
36046,lucide,,1,10,24,34
36047,geezas,,1,1,6,7
36048,TyPower,,1,174,99,273
36049,magicRob,,1,6,12,18
36050,yeahbuddy,,1,1,2,3
36051,BobbyFischer,,1,2,2,4
36052,fapfapfap,,1,1,23,24
36053,Kratoz,,1,70,43,113
36054,frijoles,,1,4,3,7
36055,sirreginaldwindage,,1,13,19,32
36056,ish123,,1,50,7,57
36057,Adelaidey,,1,2,4,6
36058,mcwm,,1,2,13,15
36059,m0o,,1,106,101,207
36060,gypsytalk,,1,13,14,27
36061,saxmanb,,1,1,3,4
36062,theeeggman,,1,350,359,709
36063,beattie,,1,6,13,19
36064,Soccerfan12,,1,31,21,52
36065,hoott,,1,6,14,20
36066,trueg,,1,293,266,559
36067,SamHealer,,1,342,376,718
36068,nurdd,,1,1,1,2
36069,japple,,1,263,45,308
36070,relix,,1,108,160,268
36071,tedrrrr,,1,7,2,9
36072,bamonster,,1,201,237,438
36073,schizobullet,,1,585,722,1307
36074,AcidMaX,,1,2,3,5
36075,IainIainIain,,1,6,15,21
36076,ktwar,,1,2,6,8
36077,pashupat,,1,9,10,19
36078,hakzorz,,1,21,16,37
36079,thaabit,,1,7,17,24
36080,koshinn,,1,1,2,3
36081,redditcop,,1,5,7,12
36082,glob,,1,118,173,291
36083,nubberytuckie,,1,3,8,11
36084,glaster,,1,143,173,316
36085,subschool,,1,6,8,14
36086,kylehoff,,1,12,12,24
36087,kzielinski,,1,2,1,3
36088,nicholasaa,,1,1,1,2
36089,11421172,,1,40,52,92
36090,clarity101,,1,3,4,7
36091,Coloradofire,,1,213,309,522
36092,ewald,,1,2,3,5
36093,trannylegba,,1,35,36,71
36094,dr-steve,,1,72,70,142
36095,GoneToCanada,,1,8,7,15
36096,vanessarivers82,,1,29,28,57
36097,robotfuel,,1,215,301,516
36098,five9a2,,1,76,89,165
36099,njhardc0re,,1,2,3,5
36100,somethinlike,,1,1,6,7
36101,Leviathant,,1,12,14,26
36102,FakenameMcAlius,,1,171,108,279
36103,PrinsFoo,,1,19,23,42
36104,bottar,,1,3,13,16
36105,hobbit55,,1,16,1,17
36106,propagandhist,,1,3,2,5
36107,atomictaco,,1,2,1,3
36108,herewegoagainagain,,1,8,10,18
36109,andrewbadera,,1,6,7,13
36110,notcaptainkirk,,1,247,270,517
36111,n_mills007,,1,19,2,21
36112,lj535i,,1,9,10,19
36113,ehundrieser,,1,1,3,4
36114,optionshift3,,1,8,46,54
36115,OA-5599,,1,233,310,543
36116,olavk,,1,50,60,110
36117,Fuuz,,1,28,3,31
36118,abgaffe,,1,128,306,434
36119,trebonius,,1,33,36,69
36120,faulx,,1,4,10,14
36121,Internet_User_001,,1,1,1,2
36122,WaltFrench,,1,1,1,2
36123,MarkCC,,1,2,3,5
36124,Jean_Luc_Picard,,1,17,24,41
36125,Tristan2007,,1,6,7,13
36126,kakes,,1,1,2,3
36127,FatherBusa,,1,4,2,6
36128,b0b0b0b,,1,13,21,34
36129,jboy55,,1,64,64,128
36130,welsinc,,1,1,1,2
36131,logicize,,1,105,5,110
36132,dboothe,,1,1,1,2
36133,testingtesting123,,1,1,1,2
36134,koosh,,1,2,1,3
36135,bmurph83,,1,39,54,93
36136,byronsucks,,1,31,46,77
36137,jthurman,,1,79,31,110
36138,collegeKid,,1,10,27,37
36139,digitalistic,,1,72,114,186
36140,mfarah,,1,20,27,47
36141,jisakujien,,1,6,12,18
36142,toolman667,,1,65,30,95
36143,barack_hussein_obama,,1,7,8,15
36144,Thewhitedsepulchre,,1,114,41,155
36145,riyten,,1,39,21,60
36146,faustoc4,,1,4,9,13
36147,bolder_is_online,,1,1,5,6
36148,juryDuty,,1,2,2,4
36149,gomer,,1,8,3,11
36150,Shinuza,,1,100,61,161
36151,trohil,,1,1,1,2
36152,redpig9,,1,72,85,157
36153,spoiled11,,1,173,297,470
36154,Kitanax1,,1,8,13,21
36155,kansasbob,,1,2,1,3
36156,ri0tnrrd,,1,7,17,24
36157,nohart,,1,1,1,2
36158,ibgeek,,1,5,7,12
36159,thecheatah,,1,245,304,549
36160,nouse4aname247,,1,16,1,17
36161,Bbaily,,1,330,270,600
36162,coolio5391,,1,54,9,63
36163,dave_L,,1,447,677,1124
36164,Obama4Chavez,,1,2,1,3
36165,arthurujn2,,1,7,14,21
36166,fordprefectace,,1,6,5,11
36167,ss6sam6,,1,28,24,52
36168,s-m-a-c-k,,1,128,215,343
36169,butch5555,,1,227,242,469
36170,rayski,,1,9,19,28
36171,mikekole,,1,3,7,10
36172,Tecmobo,,1,217,185,402
36173,sriram_2001,,1,8,2,10
36174,szczupak,,1,1,1,2
36175,BrockObama,,1,2,1,3
36176,mindblast,,1,111,151,262
36177,Syjefroi,,1,25,42,67
36178,bouleverser,,1,11,16,27
36179,lobster-random,,1,5,4,9
36180,whiteboy,,1,367,245,612
36181,markcycle,,1,1,1,2
36182,winnith,,1,13,5,18
36183,darko87,,1,20,32,52
36184,stratospark,,1,32,21,53
36185,bsg75,,1,80,33,113
36186,kashicat,,1,14,2,16
36187,Hatari,,1,1,1,2
36188,sylvan,,1,1632,1655,3287
36189,flamingfenix,,1,2,3,5
36190,DeadwoodInternet,,1,1,1,2
36191,CaptainJesusHood,,1,443,436,879
36192,wsteinh,,1,11,3,14
36193,sharkhunter,,1,7,8,15
36194,aliasbex,,1,3,7,10
36195,joshuazed,,1,22,38,60
36196,W3bbo,,1,2,2,4
36197,elockloran,,1,4,2,6
36198,kmccormick,,1,1,1,2
36199,spudcrazy,,1,1,1,2
36200,PixlNinja,,1,2,3,5
36201,knud,,1,259,313,572
36202,roaringrepublican,,1,10,2,12
36203,Diomedes8,,1,24,7,31
36204,seiga,,1,1,1,2
36205,federalist1981,,1,1,1,2
36206,drewism,,1,15,15,30
36207,Zifna,,1,318,355,673
36208,PinGUY,,1,9,5,14
36209,djshiva,,1,1,3,4
36210,personaehiro,,1,8,12,20
36211,stdlib,,1,3,1,4
36212,oxide7,,1,5,1,6
36213,allholy1,,1,10,22,32
36214,roml,,1,44,153,197
36215,LetYouDown,,1,2,1,3
36216,Leischa,,1,28,34,62
36217,bleemins,,1,4,1,5
36218,roffert,,1,4,11,15
36219,flipswitch,,1,2,2,4
36220,steve_b,,1,14,16,30
36221,Mystitat,,1,4,2,6
36222,regnillub,,1,10,3,13
36223,200iso,,1,26,8,34
36224,phenomenalgat,,1,249,168,417
36225,rhymenocerous__,,1,3,2,5
36226,SayingFucktardIsCool,,1,1,1,2
36227,TakeItDownMikEee,,1,2,1,3
36228,jyanefsk,,1,10,5,15
36229,imrand,,1,4,1,5
36230,manwiththeplan,,1,132,8,140
36231,bitwize,,1,314,554,868
36232,ascii,,1,136,126,262
36233,gananand,,1,67,110,177
36234,NeoYankee,,1,2,6,8
36235,geek_dave,,1,1,1,2
36236,gregjor,,1,52,24,76
36237,tadjik,,1,1,2,3
36238,phatangrywiccan,,1,67,118,185
36239,porscheguy19,,1,20,34,54
36240,cerot,,1,15,33,48
36241,knuta,,1,1,1,2
36242,deivys20,,1,15,25,40
36243,colechristensen,,1,12,20,32
36244,jaquelinehyde,,1,1,2,3
36245,0rbytal,,1,1,1,2
36246,danhs,,1,2,3,5
36247,jtt25c,,1,9,19,28
36248,xopherg,,1,20,6,26
36249,gtani,,1,4,4,8
36250,mrdm242,,1,22,47,69
36251,spork65,,1,42,5,47
36252,Enterprize,,1,1,1,2
36253,hablamierda,,1,142,159,301
36254,turrican,,1,31,64,95
36255,rossriley,,1,77,35,112
36256,euderma44,,1,6,2,8
36257,awfuck,,1,2,2,4
36258,jamiequint,,1,12,15,27
36259,iodine,,1,1,1,2
36260,MrClean88,,1,1,1,2
36261,aussiecynic,,1,2,2,4
36262,Mello_Jello,,1,11,13,24
36263,slackeur,,1,4,5,9
36264,Gorsh,,1,1,1,2
36265,TheWeinerCircle,,1,1,1,2
36266,philipn,,1,72,23,95
36267,desertrat75,,1,7,5,12
36268,borgconsulting,,1,48,64,112
36269,cornbrain,,1,33,34,67
36270,rtjac,,1,1,7,8
36271,riverwalolololk,,1,1,1,2
36272,architectzero,,1,303,257,560
36273,thespiff,,1,1,2,3
36274,Drunken_Monkey,,1,1,1,2
36275,mudra,,1,1,4,5
36276,Boye,,1,290,341,631
36277,Elwood19k20,,1,2,1,3
36278,napalm,,1,15,12,27
36279,wumbo,,1,9,4,13
36280,lief79,,1,481,381,862
36281,thirdlip32,,1,64,51,115
36282,sball352,,1,2,3,5
36283,joelparkerhenderson,,1,1,3,4
36284,zondler,,1,1,1,2
36285,Charel,,1,12,10,22
36286,dujour,,1,2,6,8
36287,feckineejit,,1,92,135,227
36288,alexcarson,,1,39,26,65
36289,bdarbs,,1,599,28,627
36290,edddie,,1,3,1,4
36291,TheCid,,1,411,481,892
36292,xsrevolt,,1,4,9,13
36293,mdemeny,,1,1,3,4
36294,jfpbookworm,,1,183,267,450
36295,supermoo,,1,1,4,5
36296,dondimon,,1,2,2,4
36297,feelphones,,1,20,12,32
36298,bokononon,,1,69,62,131
36299,enyoron,,1,86,91,177
36300,Halgrind,,1,30,37,67
36301,psantora,,1,4,3,7
36302,quadrofolio,,1,33,37,70
36303,samshady,,1,1,2,3
36304,njantirice,,1,32,77,109
36305,Mr_Anderson,,1,1,2,3
36306,thestraightblade,,1,457,3,460
36307,sockstar,,1,26,10,36
36308,radrik,,1,20,30,50
36309,ottobott,,1,15,38,53
36310,obomba,,1,230,199,429
36311,alpenglow,,1,38,13,51
36312,fredcamino,,1,23,20,43
36313,reynante,,1,1,1,2
36314,Bjartur,,1,31,29,60
36315,Darkshine807,,1,2,3,5
36316,lu88ke,,1,24,61,85
36317,yasth,,1,293,380,673
36318,realnowhereman,,1,19,19,38
36319,Mithryn,,1,146,208,354
36320,rubinelli,,1,28,53,81
36321,groanad2,,1,9,13,22
36322,beegl,,1,3,1,4
36323,ninti,,1,66,62,128
36324,inevereveni,,1,3,8,11
36325,egamipeaks,,1,9,14,23
36326,MrRipley15,,1,69,119,188
36327,genghis_mute,,1,6,23,29
36328,TMills,,1,21,24,45
36329,lucidguppy,,1,2,6,8
36330,ontheroadsal,,1,5,22,27
36331,biocs_nerd,,1,223,188,411
36332,hweeny,,1,4,2,6
36333,mod_nobody,,1,5,19,24
36334,Wyrm,,1,313,198,511
36335,Arkaein,,1,88,142,230
36336,abeliangrape,,1,1,7,8
36337,shapul,,1,13,13,26
36338,o6uoq,,1,23,8,31
36339,flubberyduckie,,1,3,10,13
36340,chews,,1,60,4,64
36341,dinkumator,,1,35,38,73
36342,drunklemur,,1,9,8,17
36343,bwa5099,,1,1,2,3
36344,1310nm,,1,5,9,14
36345,naveedjavaid,,1,5,6,11
36346,dbpatterson,,1,44,65,109
36347,berger47,,1,2,1,3
36348,dale_dribble,,1,1,2,3
36349,ibbe,,1,3,3,6
36350,mhsouthpaw,,1,9,17,26
36351,yourvoicenewvision,,1,7,1,8
36352,dpkonofa,,1,4,12,16
36353,lself,,1,2,1,3
36354,thewidowmaker,,1,41,74,115
36355,sgr,,1,3,4,7
36356,amaenza,,1,1,2,3
36357,allan_a,,1,32,44,76
36358,gottaredit,,1,5,13,18
36359,janeybgood,,1,3,14,17
36360,deit9000,,1,1,1,2
36361,mission_to_mars,,1,3,4,7
36362,bernardrieux,,1,1,2,3
36363,dropdibdab,,1,1,1,2
36364,puzl,,1,2,3,5
36365,shamansun,,1,109,68,177
36366,miraimari,,1,8,17,25
36367,RussG,,1,4,5,9
36368,sideways,,1,167,35,202
36369,hypnotoad9000,,1,9,24,33
36370,Monty_Hall,,1,2,1,3
36371,johlin,,1,2,2,4
36372,bluman,,1,2,8,10
36373,cmhdave73,,1,16,41,57
36374,O_O,,1,14,14,28
36375,goodbyeUSA,,1,8,1,9
36376,interjay,,1,1,6,7
36377,mibu9,,1,6,13,19
36378,Jakkli,,1,8,6,14
36379,gizzledos,,1,30,55,85
36380,drklutch,,1,1,1,2
36381,balljoint,,1,6,4,10
36382,FurryMoistAvenger,,1,115,64,179
36383,hellfaucet,,1,1,2,3
36384,theScatman,,1,1,1,2
36385,raket,,1,1,2,3
36386,rockstar1o9,,1,25,32,57
36387,blahblah98,,1,105,109,214
36388,darkmark7,,1,82,24,106
36389,ahpro,,1,26,41,67
36390,prelim,,1,208,44,252
36391,USAF_NCO,,1,686,816,1502
36392,jbot,,1,20,35,55
36393,cactusrex,,1,217,302,519
36394,bwojdyla,,1,7,8,15
36395,jarred00,,1,21,2,23
36396,seopher,,1,371,265,636
36397,AGivant,,1,19,7,26
36398,hexix,,1,4,3,7
36399,William_Occam,,1,1,1,2
36400,wildwomyn,,1,1,3,4
36401,oubiwann,,1,1,5,6
36402,kidmonsters,,1,36,34,70
36403,supertasticfool,,1,18,29,47
36404,aurG,,1,1,3,4
36405,SteveScallion,,1,8,10,18
36406,d3vmax,,1,57,54,111
36407,gdenfield,,1,19,39,58
36408,burndive,,1,4,4,8
36409,EdwinWaugh,,1,8,17,25
36410,rdjj69x,,1,10,3,13
36411,Clev,,1,42,31,73
36412,Dumbledee,,1,2,3,5
36413,ItsLilJon,,1,2,1,3
36414,shivak,,1,2,3,5
36415,Kalima,,1,2,2,4
36416,Blipperpa,,1,4,3,7
36417,FormKing,,1,93,122,215
36418,psynautic,,1,3,4,7
36419,lundman,,1,2,3,5
36420,seand,,1,5,28,33
36421,theallseeingeye,,1,6,1,7
36422,isabella_corona,,1,3,2,5
36423,lysine23,,1,305,401,706
36424,gyrovagus,,1,2,4,6
36425,babylonburning,,1,1,2,3
36426,reddit4820,,1,123,137,260
36427,BullBear,,1,8,2,10
36428,meatdigg,,1,6,11,17
36429,vill4no,,1,5,2,7
36430,nubckaes,,1,16,23,39
36431,templetron,,1,9,13,22
36432,reddog093,,1,140,164,304
36433,agscala,,1,71,54,125
36434,aolley,,1,1,7,8
36435,Foo1io,,1,3,3,6
36436,josephsh,,1,15,1,16
36437,rzala,,1,92,7,99
36438,mktwo,,1,2,1,3
36439,harmony2,,1,1,2,3
36440,simonfoley,,1,1,1,2
36441,redditboss,,1,91,5,96
36442,Kuvaldin,,1,58,130,188
36443,DarkXanthos,,1,47,47,94
36444,digitalbuzz,,1,4,20,24
36445,Wikijo,,1,2,3,5
36446,pindaddy,,1,1,1,2
36447,rivardja,,1,18,16,34
36448,schnuck,,1,399,656,1055
36449,queenmaeve,,1,96,180,276
36450,cyranthus,,1,1,4,5
36451,jkillian,,1,10,6,16
36452,bendylan,,1,13,12,25
36453,mattrock,,1,11,6,17
36454,plecostomus,,1,13,21,34
36455,sjek,,1,7,3,10
36456,Ragoczy,,1,2,3,5
36457,Traceyer,,1,6,3,9
36458,seattlegirluw,,1,621,99,720
36459,dapf,,1,28,47,75
36460,jtyost2,,1,5,3,8
36461,Coca_Cola,,1,10,2,12
36462,forty8roadster,,1,3,1,4
36463,Didimos,,1,20,2,22
36464,hjo3,,1,235,325,560
36465,hayoo,,1,3,6,9
36466,NDhatt1981,,1,2,2,4
36467,dellis,,1,703,1175,1878
36468,newhen,,1,5,12,17
36469,jrpinsd,,1,15,14,29
36470,virtuexru,,1,45,10,55
36471,HopefulNebula,,1,304,75,379
36472,andepthman,,1,3,7,10
36473,soopajane,,1,2,1,3
36474,tinymarae,,1,10,1,11
36475,miaogyver,,1,8,15,23
36476,Elrondaelf,,1,3,1,4
36477,darter22,,1,2,7,9
36478,gcod,,1,1,1,2
36479,Nomara,,1,1,1,2
36480,MXN,,1,1,1,2
36481,ryand,,1,1,2,3
36482,dbqpdb,,1,13,12,25
36483,HamsterNibbles,,1,5,6,11
36484,Charlie24601,,1,241,395,636
36485,kminsull,,1,19,11,30
36486,mitchey,,1,1,1,2
36487,ElCookie,,1,13,24,37
36488,Lev0n,,1,1,1,2
36489,aplindsay,,1,27,34,61
36490,MarlburrowMan,,1,11,4,15
36491,robinei,,1,1,1,2
36492,grayshanks,,1,2,3,5
36493,pooka,,1,5,3,8
36494,NippleNutz,,1,18,22,40
36495,stickoversquare,,1,1,1,2
36496,NakedOni,,1,19,34,53
36497,paizon,,1,15,9,24
36498,artzoom,,1,3,4,7
36499,dstroyr,,1,3,1,4
36500,jitterz,,1,5,5,10
36501,fumbler1417,,1,1,4,5
36502,highwind,,1,88,76,164
36503,nikehat,,1,16,16,32
36504,mannix,,1,71,77,148
36505,xlance,,1,38,29,67
36506,Butterknuckle,,1,49,8,57
36507,digitalmoto,,1,265,17,282
36508,robvedder,,1,1,1,2
36509,youareivan,,1,1,2,3
36510,mashiroikaze,,1,11,15,26
36511,obrysii,,1,128,103,231
36512,PANIC_MAN,,1,12,26,38
36513,SoftwareMaven,,1,20,36,56
36514,cuer,,1,1,2,3
36515,elfgod,,1,10,14,24
36516,buxmeister,,1,1,1,2
36517,Secretus,,1,31,34,65
36518,bryanl,,1,37,5,42
36519,dividendpirate,,1,53,10,63
36520,Anelly85,,1,9,9,18
36521,31337z3r0,,1,4,13,17
36522,afair,,1,1,1,2
36523,Politaction,,1,6,2,8
36524,Lysergic,,1,4,4,8
36525,ABabyAteMyDingo,,1,779,999,1778
36526,korhalf,,1,24,25,49
36527,wasylm,,1,38,45,83
36528,jcmcbeth,,1,86,122,208
36529,jonintc,,1,4,5,9
36530,aseidel,,1,63,47,110
36531,Battleloser,,1,1027,1438,2465
36532,fokker32,,1,43,33,76
36533,marlinspike,,1,8,11,19
36534,web20sucks,,1,105,34,139
36535,marc-kd,,1,555,57,612
36536,Ksam8,,1,5,6,11
36537,tells,,1,2,5,7
36538,jeroenh,,1,3,4,7
36539,raptor3x,,1,1,2,3
36540,ActivationEnergy,,1,1,1,2
36541,ryanvsrobots,,1,6,4,10
36542,gregag,,1,1,1,2
36543,vpetro,,1,1,3,4
36544,jrow,,1,1,1,2
36545,redditrasberry,,1,218,288,506
36546,raveon,,1,2,4,6
36547,mexicodoug,,1,1723,3782,5505
36548,slater,,1,1,1,2
36549,waste,,1,2,8,10
36550,tbmbob,,1,1,2,3
36551,bjpremore,,1,1,3,4
36552,onceuponageek,,1,89,6,95
36553,mattley,,1,1,3,4
36554,lannm,,1,2,3,5
36555,moozxy,,1,1,3,4
36556,samburney,,1,1,3,4
36557,imasaltedpretzel,,1,1,2,3
36558,risdn,,1,4,19,23
36559,kennon,,1,1,2,3
36560,dir21,,1,3,9,12
36561,Pro28,,1,1,3,4
36562,wdlewis47,,1,5,1,6
36563,SFLTimmay,,1,5,3,8
36564,justmytwocents,,1,4,1,5
36565,LoveGoblin,,1,326,610,936
36566,relin,,1,176,22,198
36567,jdgolfster,,1,2,2,4
36568,sixolive,,1,47,3,50
36569,kinebud,,1,53,76,129
36570,aleksey11,,1,3,2,5
36571,joke_account,,1,1,1,2
36572,one0them,,1,121,312,433
36573,petraska,,1,2,3,5
36574,enkeedu,,1,12,13,25
36575,CIA_Agent,,1,57,67,124
36576,rackaboy,,1,10,12,22
36577,tisn,,1,24,38,62
36578,emeidi,,1,1,4,5
36579,Harfish,,1,6,12,18
36580,LordKaT,,1,219,9,228
36581,ah171504,,1,1,1,2
36582,carsonce,,1,176,163,339
36583,tharealmegaman,,1,117,57,174
36584,IVotedForKodos,,1,220,348,568
36585,chag,,1,3,5,8
36586,ywgdana,,1,3,5,8
36587,arlok789,,1,50,6,56
36588,dawnfire999,,1,76,35,111
36589,khabrain,,1,16,1,17
36590,HonestAbe29,,1,2,2,4
36591,wewewawa,,1,52,58,110
36592,zues,,1,2,9,11
36593,agatheredwetness,,1,2,3,5
36594,changuich,,1,2,1,3
36595,mizprint,,1,2,2,4
36596,alllo,,1,48,8,56
36597,douglask,,1,3,6,9
36598,kguill42,,1,14,21,35
36599,cannabia,,1,6,6,12
36600,naxet,,1,5,11,16
36601,crash-hinezumi,,1,1,1,2
36602,culture,,1,341,30,371
36603,cronin1024,,1,301,196,497
36604,thatperlguy,,1,5,2,7
36605,Doblon,,1,1,2,3
36606,brazil101,,1,25,40,65
36607,shaunc,,1,232,233,465
36608,chrisforbes,,1,90,156,246
36609,LyingBackstabbingFuk,,1,5,6,11
36610,kyller,,1,1,1,2
36611,conanite,,1,14,9,23
36612,rayzincrisp,,1,13,11,24
36613,fakeusername2,,1,11,2,13
36614,guestuser,,1,1,1,2
36615,TS409,,1,24,52,76
36616,buhlink,,1,1,1,2
36617,iperry,,1,47,13,60
36618,BobbyKen,,1,109,209,318
36619,balthe,,1,1,11,12
36620,hangbush,,1,1,1,2
36621,isthistakentoo,,1,1,3,4
36622,r3d,,1,90,85,175
36623,guterhund,,1,4,1,5
36624,marduk,,1,70,83,153
36625,mattdbab,,1,31,4,35
36626,egonkasper,,1,8,15,23
36627,IVTmusic,,1,9,1,10
36628,tsphillips,,1,1,1,2
36629,kdeez,,1,3,2,5
36630,evilfoo,,1,8,1,9
36631,genug,,1,1,1,2
36632,Drmonkeydonkey,,1,3,5,8
36633,Phersu,,1,15,18,33
36634,chsonnu,,1,4,6,10
36635,tmpman,,1,1,1,2
36636,nothing_at_all,,1,2,2,4
36637,winter_limelight,,1,6,9,15
36638,psycho79,,1,7,7,14
36639,duck_typing,,1,1,1,2
36640,dogas,,1,4,8,12
36641,CrazedHippie,,1,4,25,29
36642,GeorgeWalkerBush,,1,2,6,8
36643,iDemonix,,1,1,2,3
36644,xkcdzombie,,1,6,1,7
36645,GodHatesFags,,1,17,25,42
36646,Mr-D-uh,,1,2,4,6
36647,saisumimen,,1,69,106,175
36648,pacpub,,1,1,3,4
36649,PacerFan,,1,23,5,28
36650,IkeSW,,1,5,3,8
36651,greyrl,,1,1,2,3
36652,TheBigLewinski,,1,197,83,280
36653,udd,,1,3,6,9
36654,CheatorBeat,,1,55,11,66
36655,OldStonyface,,1,1,4,5
36656,oostevo,,1,11,10,21
36657,frank26080115,,1,29,39,68
36658,electrolegs,,1,4,6,10
36659,Lol_Lolovici,,1,1,2,3
36660,danielalfredsson,,1,1,2,3
36661,kconnors,,1,18,39,57
36662,khmr33,,1,5,10,15
36663,trevdak2,,1,281,279,560
36664,etorreborre,,1,1,1,2
36665,daniel_buchanan,,1,10,22,32
36666,silas0069,,1,12,18,30
36667,rahmad,,1,79,85,164
36668,kevs,,1,3,1,4
36669,FrankLen0607,,1,14,2,16
36670,ottmar,,1,1,1,2
36671,ryanknapper,,1,331,529,860
36672,chavette,,1,1,1,2
36673,w1nt3rmut3,,1,3,2,5
36674,Wikipedo,,1,4,2,6
36675,jellystones,,1,108,13,121
36676,DreamSurfer,,1,50,7,57
36677,tc326,,1,2,4,6
36678,Vystril,,1,140,155,295
36679,iskyoork,,1,13,17,30
36680,scogle,,1,1,2,3
36681,david_z,,1,16,10,26
36682,hahamoviequote,,1,52,72,124
36683,69105,,1,1,1,2
36684,soapyj,,1,2,2,4
36685,Ultimateamp,,1,29,25,54
36686,kingzilch,,1,1,1,2
36687,cmm,,1,19,21,40
36688,boshj,,1,2,3,5
36689,blizz81,,4,4,5,9
36690,md2020,,1,23,50,73
36691,parapliers,,1,69,22,91
36692,joyork,,1,1209,500,1709
36693,To1kien,,1,33,5,38
36694,ChagrinRiddle,,1,71,73,144
36695,Unconquerable88,,1,1,1,2
36696,IRainShitOnUrParade,,1,2,1,3
36697,honoruru,,1,1,2,3
36698,Jesus_Captain,,1,2,1,3
36699,runesmith,,1,2,4,6
36700,futurestack,,1,12,14,26
36701,D-Style,,1,530,535,1065
36702,sabrebutt,,1,16,33,49
36703,duckspeak,,1,1,5,6
36704,lilaz,,1,273,6,279
36705,karlrovesdoublechin,,1,1,3,4
36706,geon,,1,182,244,426
36707,IdeaR,,1,2,3,5
36708,jan_g,,1,26,29,55
36709,yushir0,,1,1,1,2
36710,JeremyBanks,,1,235,292,527
36711,swhitt,,1,2,11,13
36712,culled,,1,1,1,2
36713,ClevelandGirl,,1,1,1,2
36714,ChendaNgak,,1,1,1,2
36715,danger1,,1,12,19,31
36716,evans_simon,,1,33,53,86
36717,kemodan,,1,8,5,13
36718,dbueno,,1,5,17,22
36719,r3su,,1,91,166,257
36720,chitoiup,,1,12,19,31
36721,pbarmasher,,1,6,21,27
36722,blinder,,1,4,5,9
36723,smoothmann,,1,1,7,8
36724,stan205,,1,7,3,10
36725,ZenMastersBlog,,1,55,6,61
36726,ddixonr,,1,53,43,96
36727,ERGOfuturus,,1,1,2,3
36728,Pun_isher,,1,142,84,226
36729,drdorf,,1,23,40,63
36730,dwinder1,,1,3,4,7
36731,bixsciurus,,1,2,2,4
36732,chohoh,,1,8,11,19
36733,Terry_Spadge,,1,2,2,4
36734,Loblaw,,1,182,17,199
36735,mayhym,,1,3,1,4
36736,blackbanner88,,1,4,13,17
36737,Kyarii,,1,33,39,72
36738,TR0N,,1,3,1,4
36739,SassyBlackGirl,,1,1,1,2
36740,bigtunacan,,1,8,7,15
36741,kyleect,,1,108,160,268
36742,jeremyribbink,,1,1,1,2
36743,frugalfran,,1,59,53,112
36744,JoDAWG,,1,1,2,3
36745,jrrl,,1,408,269,677
36746,digits12,,1,198,16,214
36747,jeffredd,,1,19,30,49
36748,JesseOnReddit2,,1,2,4,6
36749,tubetown,,1,3,8,11
36750,dionysos,,1,1,2,3
36751,zeekx4,,1,19,31,50
36752,haniam,,1,1,1,2
36753,optional,,1,4,3,7
36754,perrako,,1,8,7,15
36755,pergus,,1,6,5,11
36756,nivek,,1,24,31,55
36757,micje,,1,9,4,13
36758,LausXY,,1,9,30,39
36759,Netzapper,,1,3,6,9
36760,thegeoman,,1,88,141,229
36761,atlsingh,,1,42,94,136
36762,executor67,,1,1,1,2
36763,heathlander,,1,55,11,66
36764,kidnoodle,,1,4,4,8
36765,mjsolaro,,1,869,1126,1995
36766,MrLove,,1,10,10,20
36767,beavioso,,1,2,1,3
36768,bendl,,1,2,2,4
36769,ropsic,,1,1,2,3
36770,jadedconformist,,1,89,119,208
36771,staplermasta,,1,7,6,13
36772,RIAAgoon,,1,5,2,7
36773,wake_me_up,,1,19,6,25
36774,HukdUnFonx,,1,3,6,9
36775,dccse3k,,1,50,88,138
36776,bchisom99,,1,1,2,3
36777,frenchguy,,1,11,18,29
36778,alephnil,,1,144,248,392
36779,larholm,,1,472,616,1088
36780,forkkkd,,1,1,5,6
36781,ALOT,,1,1,1,2
36782,robeph,,1,406,838,1244
36783,18thstreetmike,,1,2,1,3
36784,acornwa,,1,13,27,40
36785,addicted_to_bass,,1,35,43,78
36786,djork,,1,479,640,1119
36787,geno149,,1,9,6,15
36788,Justagardener,,1,1,1,2
36789,RobinReborn,,1,473,687,1160
36790,BamaStangGuy,,1,84,112,196
36791,iknowzitall,,1,5,11,16
36792,fanboy121,,1,3,6,9
36793,nouggatage,,1,1,3,4
36794,nomie,,1,2,3,5
36795,Alcorsu,,1,5,8,13
36796,willwork4rmb,,1,84,142,226
36797,Tarindel,,1,93,83,176
36798,johnsonjohnson,,1,2,4,6
36799,fazeman9,,1,25,18,43
36800,sdmitry,,1,19,21,40
36801,gn3xu5,,1,109,62,171
36802,zeroquest,,1,122,33,155
36803,BoofBop,,1,31,12,43
36804,zizou_president,,1,14,20,34
36805,Recoil42,,1,1311,1046,2357
36806,cyzoonic,,1,1,2,3
36807,siqtictorn,,1,101,85,186
36808,Shadotek,,1,218,516,734
36809,rufusdog,,1,28,42,70
36810,jungl,,1,9,3,12
36811,berwyn,,1,1,1,2
36812,meridious,,1,2,1,3
36813,vbl,,1,273,399,672
36814,tjogin,,1,493,781,1274
36815,DeepTruth,,1,1,3,4
36816,chris2930,,1,82,97,179
36817,Deeprblue,,1,25,33,58
36818,tvor,,1,1,2,3
36819,nikov,,1,11,11,22
36820,nlangmaid,,1,5,7,12
36821,Conundrum123,,1,9,6,15
36822,chitza,,1,8,19,27
36823,gypsydoctor,,1,246,106,352
36824,iNPHiD3L,,1,25,5,30
36825,miauka,,1,3,4,7
36826,smoked1up,,1,18,21,39
36827,dpm11,,1,15,6,21
36828,billdouglas,,1,31,6,37
36829,phlip,,1,1,2,3
36830,hosemaster,,1,51,29,80
36831,chersolly,,1,89,140,229
36832,britishben,,1,122,241,363
36833,melsue,,1,22,5,27
36834,dreallen,,1,4,1,5
36835,hater2,,1,7,18,25
36836,rudy13,,1,1,1,2
36837,jdh30,,1,48,79,127
36838,mang90,,1,3,11,14
36839,keyshark,,1,162,8,170
36840,koft,,1,52,59,111
36841,ssnider,,1,31,17,48
36842,craftyscreenwriting,,1,5,5,10
36843,cabanaboy,,1,8,10,18
36844,tommyschoolbruh,,1,6,13,19
36845,babua,,1,53,82,135
36846,rick2530,,1,1,2,3
36847,BeardedNoOne,,1,3,11,14
36848,njakubow,,1,95,72,167
36849,mostlyferal,,1,8,2,10
36850,stealthfiction,,1,2,2,4
36851,cardmagic,,1,1,2,3
36852,kabdib,,1,50,96,146
36853,konataizumi,,1,29,35,64
36854,grantaccess,,1,100,54,154
36855,Match_Point,,1,5,10,15
36856,logistix,,1,10,13,23
36857,comcraptic,,1,2,5,7
36858,ertyseidel,,1,6,1,7
36859,noonespecial,,1,7,15,22
36860,tmahmood,,1,10,12,22
36861,MsDrury,,3,36,31,67
36862,jayp12323,,1,1,4,5
36863,snuxoll,,1,15,32,47
36864,eliah,,1,17,8,25
36865,Pooh_Bear,,1,17,23,40
36866,acidflask,,1,3,7,10
36867,ludinom,,1,3,3,6
36868,drapton,,1,1,1,2
36869,Avengelist,,1,6,6,12
36870,ThomW,,1,9,12,21
36871,nkbrockhoff,,1,35,57,92
36872,ThaiTai,,1,30,34,64
36873,xHackAttackx,,1,1,1,2
36874,Clanc,,1,299,570,869
36875,org,,1,1,2,3
36876,dokument,,1,11,6,17
36877,notests,,1,4,6,10
36878,Strikethrough,,1,1,2,3
36879,kyle9456,,1,2,2,4
36880,doshiamit,,1,100,60,160
36881,luisawoods,,1,6,4,10
36882,pjmarsz,,1,1,2,3
36883,p3d0,,1,3,2,5
36884,blogstar,,1,5,4,9
36885,soldier4Jahiliyyah,,1,21,11,32
36886,movin2victoria,,1,1,1,2
36887,drc500free,,1,25,34,59
36888,deadsoon,,1,594,1091,1685
36889,joepeg,,1,8,8,16
36890,RickRolled,,1,172,145,317
36891,sonap,,1,3,4,7
36892,nemesmith,,1,34,59,93
36893,lazylland,,1,2,3,5
36894,joesmoe10,,1,12,27,39
36895,Fattytumor,,1,4,5,9
36896,Mentari,,1,2,7,9
36897,cmdaz,,1,1,1,2
36898,WyoBuckeye,,1,91,61,152
36899,zonyc,,1,31,21,52
36900,nemokrad,,1,3,2,5
36901,rebop,,1,259,394,653
36902,media_lush,,1,16,10,26
36903,HyperspaceHero,,1,21,16,37
36904,alarmist,,1,60,114,174
36905,Truami,,1,5,6,11
36906,blindsyde,,1,2,2,4
36907,kidoblivious,,1,1,2,3
36908,deltageek,,1,27,32,59
36909,Summergirl_94,,1,5,12,17
36910,lunke,,1,17,17,34
36911,had3z,,1,11,8,19
36912,wibblesnark,,1,101,74,175
36913,RespondsToEveryReply,,1,13,19,32
36914,BCSd,,1,3,1,4
36915,Manutd77,,1,5,1,6
36916,BeerRiot,,1,2,5,7
36917,millonzi,,1,1,1,2
36918,eileenfleming,,1,1,1,2
36919,lemonoust,,1,3,4,7
36920,bambadamba,,1,1,6,7
36921,Foxblood,,1,8,14,22
36922,tipu,,1,31,13,44
36923,rkhrkh,,1,5,7,12
36924,Domza,,1,12,19,31
36925,cornedpig,,1,19,27,46
36926,Reddit-Fan,,1,185,13,198
36927,happyspleen,,1,8,10,18
36928,elpollodemuerto,,1,1,3,4
36929,Belgain_Roffles,,1,40,70,110
36930,destro1382,,1,1,1,2
36931,pointblank,,1,146,2,148
36932,mogelbumm,,1,5,2,7
36933,zigi,,1,1,1,2
36934,dunmalg,,1,2,3,5
36935,redvis,,1,9,1,10
36936,bgthigfist,,1,2,3,5
36937,cluuxz,,1,2,4,6
36938,wholl311,,1,1,1,2
36939,bournefree,,1,1,2,3
36940,KingCrimson,,1,1,1,2
36941,cacoreeby,,1,8,1,9
36942,isospace,,1,22,12,34
36943,thingsomething,,1,16,95,111
36944,ababysgiggle,,1,1,1,2
36945,THEGOVT,,1,2,2,4
36946,stunksys,,1,1,1,2
36947,Helland,,1,1,1,2
36948,maksa,,1,4,8,12
36949,egregiousfdl,,1,13,7,20
36950,terranosaurus,,1,165,141,306
36951,eezynow,,1,12,10,22
36952,earl_the_sausage,,1,27,45,72
36953,ltx,,1,324,181,505
36954,Asaf-Shelly,,1,1,2,3
36955,newboner,,1,2,3,5
36956,owevr,,1,1,2,3
36957,beedeecee,,1,1,1,2
36958,pkoi,,1,1,5,6
36959,akkmedk,,1,19,5,24
36960,Izzo,,1,186,234,420
36961,apgwoz,,1,5,9,14
36962,totoneila,,1,1,2,3
36963,maxwgl,,1,16,13,29
36964,jlw,,1,26,37,63
36965,Callahad,,1,94,145,239
36966,jurvis,,1,17,12,29
36967,SithLordMohawk,,1,6,31,37
36968,glennvtx,,1,13,11,24
36969,j7uy5,,1,1,1,2
36970,Bjork,,1,7,3,10
36971,makuserusukotto,,1,5,5,10
36972,jujubees,,1,4,4,8
36973,grdmck,,1,1,1,2
36974,akenaten,,1,2,1,3
36975,Sigma7,,1,60,76,136
36976,wlievens,,1,16,29,45
36977,angry_fat_boy,,1,209,429,638
36978,PatrickSauncy,,1,1,2,3
36979,thing-fish,,1,13,19,32
36980,Leahn,,1,182,366,548
36981,landscapeofsuits,,1,2,5,7
36982,robertcrowther,,1,54,44,98
36983,Starguard,,1,1,1,2
36984,captain_credit,,1,10,7,17
36985,heystoopid,,1,1,2,3
36986,kizzahq,,1,1,1,2
36987,somepancakes,,1,1,2,3
36988,tincholio,,1,12,9,21
36989,Aerik,,1,2302,1382,3684
36990,grimetooth,,1,4,15,19
36991,dogfase,,1,2,2,4
36992,Bumbaclaat,,1,88,50,138
36993,trenholm,,1,34,44,78
36994,NelsonMuntz,,1,2,2,4
36995,twowheels,,1,235,375,610
36996,missourijoe,,1,16,17,33
36997,plunkettt,,1,1,1,2
36998,odgforlife,,1,38,47,85
36999,sparkypine,,1,5,20,25
37000,Infraggable_Krunk,,1,9,18,27
37001,stinkerb,,1,1,3,4
37002,bposert,,1,4,7,11
37003,BCCstu,,1,86,13,99
37004,dfg59,,1,9,16,25
37005,jcatcw,,1,23,11,34
37006,Wadsw0rth,,1,2,1,3
37007,super_crazy,,1,97,156,253
37008,gmanp,,1,2,2,4
37009,SamsChoice,,1,1,2,3
37010,maxbeachguy,,1,179,1,180
37011,Decius,,1,4,6,10
37012,supermike,,1,14,21,35
37013,MichaelCollins,,1,2,4,6
37014,bCabulon,,1,425,731,1156
37015,junkieman,,1,4,1,5
37016,aver,,1,193,192,385
37017,straightcash,,1,3,6,9
37018,ultimo1,,1,51,4,55
37019,JackyBrown,,1,10,1,11
37020,javanperl,,1,2,2,4
37021,mccutchen,,1,32,22,54
37022,tobytripp,,1,2,2,4
37023,tobybuk,,1,180,106,286
37024,phy6uva,,1,101,29,130
37025,inconvenient_truth,,1,14,7,21
37026,MomandGrandma,,1,13,6,19
37027,RedditAddictedChimp,,1,4,3,7
37028,dandy,,1,2,3,5
37029,mchadw,,1,5,7,12
37030,Shinee,,1,1,3,4
37031,Erdrick,,1,258,112,370
37032,hapax,,1,1,2,3
37033,zerophnx,,1,1,9,10
37034,aneworder,,1,9,4,13
37035,dannite,,1,13,18,31
37036,LGarou,,1,3,6,9
37037,happajin,,1,2,1,3
37038,Blackmane,,1,187,237,424
37039,raykwonx,,1,42,22,64
37040,kmh01,,1,96,118,214
37041,Erinjb,,1,2,8,10
37042,elight,,1,2,4,6
37043,Tinidril,,1,342,556,898
37044,azriel777,,1,113,147,260
37045,mhp,,1,3,4,7
37046,sriram_sun,,1,2,6,8
37047,Random_McEric,,1,1,2,3
37048,intheclouds,,1,2,3,5
37049,ccjrbassist,,1,20,7,27
37050,Tiefighter,,1,6,5,11
37051,prof_rhino,,1,4,2,6
37052,Diamonddave1022,,1,1,3,4
37053,kcerb,,1,8,2,10
37054,justonevoice,,1,151,32,183
37055,someguy1,,1,1,1,2
37056,jricher42,,1,101,219,320
37057,sjf,,1,39,34,73
37058,bluecalx2,,1,31,58,89
37059,glib,,1,12,15,27
37060,tophers,,1,6,1,7
37061,tupulus,,1,2,1,3
37062,dimitee,,1,1,1,2
37063,Optimuskong,,1,17,11,28
37064,knightofni451,,1,53,53,106
37065,thegreathal,,1,33,26,59
37066,dagny_t,,1,1,1,2
37067,jussei,,1,19,25,44
37068,halo5,,1,3,1,4
37069,Slonk,,1,32,27,59
37070,anrahman,,1,5,6,11
37071,walkerb,,1,26,26,52
37072,yobi21,,1,7,2,9
37073,wheresandrew,,1,61,135,196
37074,phidda,,1,2,2,4
37075,Sniperman,,1,2,2,4
37076,jake3988,,1,6,9,15
37077,hibby,,1,1,1,2
37078,1968eric,,1,10,5,15
37079,DrKane,,1,4,6,10
37080,windmilltheory,,1,241,348,589
37081,molexrules,,1,34,17,51
37082,ynd,,1,19,9,28
37083,sannysanoff,,1,9,10,19
37084,webbuzzard,,1,5,7,12
37085,Darkfold,,1,2,7,9
37086,djwhitt,,1,66,100,166
37087,arsal,,1,2,5,7
37088,PunctuationWound,,1,8,14,22
37089,0_0,,1,1,1,2
37090,csolallo,,1,1,1,2
37091,snuggl,,1,19,35,54
37092,awooster,,1,52,89,141
37093,swamy_g,,1,11,8,19
37094,benwikler,,1,2,2,4
37095,nate43,,1,1,1,2
37096,ajkucy,,1,19,8,27
37097,paulmg,,1,20,21,41
37098,tycy,,1,3,2,5
37099,btucker,,1,8,7,15
37100,davidkaifuku,,1,1,8,9
37101,zeank,,1,1,1,2
37102,carlgorn,,1,62,54,116
37103,iwishiknew,,1,6,6,12
37104,doubleo7,,1,29,26,55
37105,portugal_the_man,,1,242,407,649
37106,jjrs,,1,873,555,1428
37107,gapus,,1,21,23,44
37108,hhm,,1,35,21,56
37109,smittyarbuckle,,1,15,15,30
37110,Dejime,,1,35,1,36
37111,rhapsody,,1,2,7,9
37112,hockeyschtick,,1,217,268,485
37113,plaidlemur,,1,33,18,51
37114,gauriemma,,1,214,327,541
37115,pete205,,1,30,28,58
37116,funnypla,,1,41,8,49
37117,mdasen,,1,12,10,22
37118,paranoidgeek,,1,17,28,45
37119,tierra_hammer,,1,46,68,114
37120,snipersock,,1,2,4,6
37121,widowdogood,,1,11,45,56
37122,senthil_reddit,,1,4,2,6
37123,coffeenut,,1,1,1,2
37124,shardsofcrystal,,1,14,22,36
37125,masamunexs,,1,18,19,37
37126,Surf314,,1,24,15,39
37127,geekvicious,,1,104,180,284
37128,deadlogic,,1,42,53,95
37129,kip0130,,1,9,8,17
37130,ericd543,,1,27,72,99
37131,HiImFromDigg,,1,5,1,6
37132,purvel,,1,11,30,41
37133,damir,,1,4,1,5
37134,cholly,,1,2,10,12
37135,blahblah6376,,1,1,1,2
37136,psywar,,1,16,2,18
37137,ajwitte,,1,128,185,313
37138,enigmatic_prose,,1,3,2,5
37139,hot_pastrami,,1,8,10,18
37140,jgilliam,,1,57,15,72
37141,Iterr,,1,145,104,249
37142,syzygy3,,1,2,3,5
37143,plastictreeofdoom,,1,8,4,12
37144,jiffy55,,1,2,10,12
37145,Phazon,,1,782,781,1563
37146,34934898,,1,3,4,7
37147,tayl1967,,1,12,23,35
37148,wetsndlvr,,1,1,1,2
37149,didjital,,1,1,7,8
37150,PHTX,,1,27,38,65
37151,sungsam,,1,15,22,37
37152,taylorwilsdon,,1,1,1,2
37153,ChaplainXan,,1,1,1,2
37154,diethyl_ether,,1,4,3,7
37155,amy31415,,1,2,1,3
37156,grips,,1,2,1,3
37157,rogerbadger,,1,3,2,5
37158,erulabs,,1,356,431,787
37159,willbilln,,1,1,1,2
37160,AtheistAvenger,,1,4,10,14
37161,fmcfad01,,1,2,6,8
37162,Praxxus,,1,3,2,5
37163,iconoklast,,1,4,1,5
37164,bwigfield,,1,5,1,6
37165,xnumbersx,,1,20,47,67
37166,pjakubo86,,1,81,58,139
37167,mangolicious,,1,2,1,3
37168,billmeyersriggs,,1,91,104,195
37169,feliz23,,1,1,1,2
37170,ecochick,,1,4,12,16
37171,ArgabargaJones,,1,4,3,7
37172,johnyaya,,1,3,6,9
37173,I_am_not_a_sock,,1,1,3,4
37174,flushing_goldfish,,1,48,92,140
37175,51mona,,1,173,3,176
37176,dandare71,,1,40,24,64
37177,sideshowbarker,,1,10,10,20
37178,Damian808,,1,1,1,2
37179,bufordtwain,,1,10,16,26
37180,textibule,,1,1,1,2
37181,chrisdsn,,1,1,2,3
37182,hst,,1,2,3,5
37183,hmahonen,,1,1,3,4
37184,hammerandsickle,,1,1,3,4
37185,touchor,,1,8,23,31
37186,chaosmachine,,1,627,121,748
37187,abrasax,,1,374,417,791
37188,justing1319,,1,4,6,10
37189,happy__teapot,,1,3,10,13
37190,MasterAaron01,,1,18,14,32
37191,creoderiot,,1,1,2,3
37192,mudkipzez,,1,1,1,2
37193,zlochko,,1,7,3,10
37194,backside180,,1,38,12,50
37195,______o_o______,,1,4,4,8
37196,red7,,1,18,27,45
37197,polymyxin12,,1,86,142,228
37198,PlanetPluto,,1,4,1,5
37199,nickster,,1,3,1,4
37200,Atnan,,1,52,116,168
37201,bkhl,,1,1,2,3
37202,w-g,,1,75,96,171
37203,fo7Jithi,,1,3,2,5
37204,ru469,,1,13,22,35
37205,thadd,,1,3,11,14
37206,goldbug,,1,2,4,6
37207,dizangfoo,,1,3,4,7
37208,HowardWCampbell,,1,10,39,49
37209,somas,,1,95,12,107
37210,toto27,,1,1,2,3
37211,bluesecurity,,1,125,211,336
37212,RNHurt,,1,161,69,230
37213,SilentJay74,,1,2,5,7
37214,Legolas-the-elf,,1,252,322,574
37215,gvn,,1,7,3,10
37216,AmericanGladiator,,1,16,12,28
37217,didyouwoof,,1,3,2,5
37218,pandemic,,1,159,161,320
37219,jpsc,,1,6,12,18
37220,hellchick,,1,53,64,117
37221,xinhoj,,1,831,1404,2235
37222,Sonic_Eternity,,1,3,12,15
37223,joetherugger,,1,16,35,51
37224,ordep,,1,1,3,4
37225,ramdulara,,1,9,7,16
37226,phallacy,,1,30,18,48
37227,goatbreath,,1,36,74,110
37228,herzog31,,1,25,4,29
37229,peted1884,,1,148,295,443
37230,shiner76,,1,2,4,6
37231,superjarvo123,,1,28,32,60
37232,TheEngineer2008,,1,1,1,2
37233,Smelltastic,,1,13,21,34
37234,Mike735,,1,1,1,2
37235,jerguismi,,1,35,26,61
37236,sugarbabe,,1,17,27,44
37237,lauraka,,1,1,1,2
37238,californiascuba,,1,47,74,121
37239,Cynical_Bastard,,1,1,1,2
37240,bneises,,1,9,9,18
37241,ComicPolice,,1,1,1,2
37242,makemeking706,,1,3,2,5
37243,kevwil,,1,2,14,16
37244,placidified,,1,47,25,72
37245,qurashee,,1,7,4,11
37246,jenn79,,1,1,1,2
37247,elephantitis,,1,12,17,29
37248,MonkeyPilot,,1,22,8,30
37249,cratuki,,1,159,203,362
37250,johndarippah,,1,15,1,16
37251,fredhondaman,,1,1,1,2
37252,stilesjp,,1,716,469,1185
37253,qqqqq5,,1,37,51,88
37254,meccano,,1,1,3,4
37255,jeff61813,,1,3,7,10
37256,levyc,,1,2,5,7
37257,kkiran7,,1,12,12,24
37258,Elfin,,1,1,2,3
37259,vlodrac,,1,10,8,18
37260,bobiks,,1,68,3,71
37261,someguy432,,1,1,2,3
37262,gatesclone,,1,146,5,151
37263,enomar,,1,6,2,8
37264,theeth,,1,723,1131,1854
37265,Vid4554,,1,9,10,19
37266,olloe,,1,1,1,2
37267,zeeteekiwi,,1,3,3,6
37268,element8,,1,13,29,42
37269,redditation,,1,7,7,14
37270,snowKFH,,1,3,3,6
37271,RiotGrrrl,,1,10,8,18
37272,artsrc,,1,3,8,11
37273,Aleut,,1,212,228,440
37274,shyven,,1,1,3,4
37275,rane56,,1,9,18,27
37276,yyzed76,,1,20,20,40
37277,rhsarod,,1,1,4,5
37278,acticube,,1,4,1,5
37279,eleventyseven,,1,2,1,3
37280,marney,,1,15,27,42
37281,icStatic,,1,2,4,6
37282,Japface,,1,28,64,92
37283,xento,,1,1,3,4
37284,DARGONTeraAlpha,,1,13,3,16
37285,noneMediocre29,,1,1,1,2
37286,lakhwaira,,1,38,59,97
37287,rboucher,,1,7,4,11
37288,mackerel_pudding,,1,1,2,3
37289,glock22ownr,,1,4,15,19
37290,euphist,,1,3,3,6
37291,ThreadKiller,,1,35,66,101
37292,asev0,,1,25,38,63
37293,saprian,,1,10,9,19
37294,sc0ticus,,1,74,23,97
37295,innocentcriminal,,1,6,13,19
37296,zeos,,1,1,6,7
37297,lost_patriot,,1,2,1,3
37298,jabamodern,,1,4,1,5
37299,bopper,,1,1,2,3
37300,Aidenn0,,1,4,5,9
37301,meiostin,,1,1,2,3
37302,zyb09,,1,29,32,61
37303,henrix,,1,45,96,141
37304,diddy0071,,1,238,494,732
37305,ariagloris,,1,2,6,8
37306,Draders,,1,93,253,346
37307,zamba,,1,20,26,46
37308,GhostyBoy,,1,30,37,67
37309,fxscreamer,,1,11,12,23
37310,eronanke,,1,281,480,761
37311,thewhall,,1,1,3,4
37312,sstrader,,1,57,108,165
37313,pompitous_of_love,,1,46,109,155
37314,nabla,,1,3,7,10
37315,cjbprime,,1,2,1,3
37316,godsmack,,1,6,7,13
37317,berkut,,1,3,13,16
37318,gezas,,1,46,83,129
37319,sv0f,,1,1,1,2
37320,DublinBen,,1,39,46,85
37321,mistermajik2000,,1,597,322,919
37322,RANDOM_UPMOD,,1,6,14,20
37323,veracity024,,1,488,113,601
37324,thewazman,,1,3,2,5
37325,Cochise91,,1,2,1,3
37326,tva,,1,3,1,4
37327,Cheesejaguar,,1,11,11,22
37328,burnitdown666,,1,6,12,18
37329,mistergin,,1,1,2,3
37330,mikelly1220,,1,8,3,11
37331,higgledy,,1,6,11,17
37332,thewarriorclan,,1,6,5,11
37333,c130,,1,8,23,31
37334,davet111,,1,56,46,102
37335,FunkDaddy,,1,7,11,18
37336,2090nen,,1,1,1,2
37337,vertibird,,1,30,45,75
37338,btryan,,1,2,2,4
37339,yelloueze,,1,75,68,143
37340,whitey,,1,30,58,88
37341,blorg,,1,154,251,405
37342,alienRR,,1,12,7,19
37343,ShillOReilly,,1,5,10,15
37344,kobebryant,,1,4,3,7
37345,djrock3k,,1,1,5,6
37346,thepaulm,,1,4,5,9
37347,brandocraig,,1,7,5,12
37348,geigerwf,,1,1,1,2
37349,moonlet,,1,1,1,2
37350,bnw2001,,1,2,2,4
37351,whuddafugger,,1,30,58,88
37352,klyde,,1,684,1284,1968
37353,bejitunksu,,1,2,6,8
37354,pitbull4life,,1,1,2,3
37355,OkcPowerplayer,,1,122,121,243
37356,itookyerjob,,1,58,94,152
37357,funnyhel,,1,1,2,3
37358,vorgalsint,,1,20,47,67
37359,MooseGoggles,,1,27,32,59
37360,CausticPuppy,,1,61,55,116
37361,iDigg,,1,6,11,17
37362,mekanic,,1,1,1,2
37363,FredricBastiat,,1,2,1,3
37364,KNOW_IT_ALL_DOUCHE,,1,2,1,3
37365,nycballer,,1,20,24,44
37366,duncanforthright,,1,15,16,31
37367,quikness,,1,27,15,42
37368,sethph,,1,8,13,21
37369,psdtocode,,1,127,181,308
37370,johngault,,1,12,19,31
37371,douche_bag,,1,1,2,3
37372,FMERCURY,,1,294,390,684
37373,jazo,,1,14,4,18
37374,MoreCowbells,,1,38,87,125
37375,casual_observer,,1,300,231,531
37376,christiangenco,,1,22,15,37
37377,evgen,,1,114,179,293
37378,rfschmid,,1,1,3,4
37379,eternalseptember,,1,21,52,73
37380,shimali,,1,10,1,11
37381,Gamblore742,,1,5,16,21
37382,unforgotten,,1,121,23,144
37383,slalka,,1,2,6,8
37384,pmather007,,1,6,9,15
37385,kristikursty72,,1,1,1,2
37386,gizzywump,,1,5,4,9
37387,wariscrime,,1,29,1,30
37388,yorosa,,1,849,18,867
37389,alexbl,,1,7,3,10
37390,r1c1,,1,16,4,20
37391,ajiusdc,,1,3,5,8
37392,toastercookie,,1,32,42,74
37393,zacha,,1,61,105,166
37394,quakerob,,1,21,8,29
37395,lochlanmasters,,1,23,36,59
37396,athueryt,,1,32,1,33
37397,clueless_grammarian,,1,7,9,16
37398,aelfy,,1,81,73,154
37399,obscurant,,1,130,88,218
37400,mattculbreth,,1,49,24,73
37401,kmad,,1,16,12,28
37402,purfler,,1,6,5,11
37403,MatthewWhitworth,,1,1,1,2
37404,Burgessww,,1,21,5,26
37405,krsvbg,,1,5,9,14
37406,UnreasonableThursday,,1,15,13,28
37407,Technohazard,,1,2,3,5
37408,employee3831,,1,1,1,2
37409,TheGS,,1,1,4,5
37410,aligon,,1,7,5,12
37411,ahmic,,1,4,15,19
37412,chaz64,,1,1,1,2
37413,cup,,1,992,408,1400
37414,oyvindra,,1,9,24,33
37415,resutidder,,1,42,43,85
37416,Erlebnis,,1,7,1,8
37417,AngerIsAGift,,1,4,13,17
37418,FHReddit,,1,29,31,60
37419,goobershank,,1,1,2,3
37420,b4711k,,1,2,1,3
37421,mediaarts,,1,57,114,171
37422,Fr0C,,1,4,8,12
37423,Stormflux,,1,635,745,1380
37424,mitchandre,,1,486,259,745
37425,annagorn,,1,1,2,3
37426,cwj14,,1,1,1,2
37427,Negative_3,,1,2,3,5
37428,beersmith,,1,1,1,2
37429,politicass,,1,12,13,25
37430,mazza07,,1,17,33,50
37431,rlwimi,,1,11,8,19
37432,dinglecherry,,1,2,2,4
37433,yaxu,,1,57,7,64
37434,ssc,,1,4,6,10
37435,SometimesTheFur,,1,21,46,67
37436,kamalfariz,,1,2,1,3
37437,Haron237,,1,1,1,2
37438,TerriSchiavo,,1,2,13,15
37439,ashnayde,,1,5,4,9
37440,wbxp99,,1,4,2,6
37441,jtarchie,,1,3,6,9
37442,DamnRightAnonymous,,1,2,3,5
37443,ShootTheMoon,,1,6,5,11
37444,freemarketsocialist,,1,2,2,4
37445,omarimous,,1,113,45,158
37446,spanky_munkee,,1,1,1,2
37447,VeganZombie,,1,11,16,27
37448,jcn333,,1,4,3,7
37449,lazylion,,1,2,5,7
37450,framob,,1,2,1,3
37451,Popperian,,1,75,116,191
37452,mattflight,,1,9,29,38
37453,southamerica,,1,3,16,19
37454,dougn,,1,1,2,3
37455,hellsbelles,,1,171,188,359
37456,gxti,,1,243,433,676
37457,robjarvis,,1,4,6,10
37458,wyakin,,1,4,8,12
37459,stfu_noob,,1,1,1,2
37460,pilotofthefuture,,1,56,9,65
37461,minerva66,,1,1,1,2
37462,thehippestcat,,1,7,11,18
37463,crosscreek,,1,1,2,3
37464,thedaemon,,1,56,93,149
37465,iiiiiiiiiiiiiiiiiiii,,1,12,11,23
37466,adelcambre,,1,2,2,4
37467,k-zed,,1,2,1,3
37468,ohnoherewegoagain,,1,1,10,11
37469,mazman23,,1,26,36,62
37470,rarebit13,,1,24,3,27
37471,Socioillogica,,1,15,40,55
37472,sstoks,,1,1,1,2
37473,Kamakazi,,1,8,7,15
37474,MechanTOurS,,1,6,16,22
37475,eoliveri,,1,118,236,354
37476,lostmoya,,1,38,6,44
37477,elquesogrande,,1,1093,232,1325
37478,xFUCKTHISx,,1,1,4,5
37479,sujaymahajan,,1,3,1,4
37480,slipkid,,1,134,112,246
37481,THEMACGOD,,1,79,163,242
37482,aeroevan,,1,1,3,4
37483,pilois,,1,17,24,41
37484,Karinett,,1,71,9,80
37485,cuetip,,1,1,1,2
37486,frommyperspective,,1,1,1,2
37487,skribeiv,,1,3,3,6
37488,nom_de_guerre,,1,89,57,146
37489,roses4u,,1,1,1,2
37490,thundirbird,,1,8,12,20
37491,heminator,,1,5,8,13
37492,kssreeram,,1,22,5,27
37493,jast,,1,47,6,53
37494,atorch,,1,1,1,2
37495,redditers_for_units,,1,1,1,2
37496,GrammarMan,,1,1,4,5
37497,clicksnapshot,,1,41,19,60
37498,Happy31,,1,50,60,110
37499,aar0nm,,1,1,7,8
37500,supermansuper,,1,3,3,6
37501,igiveyouahamburger,,1,1,1,2
37502,grigri55,,1,2,3,5
37503,zgress,,1,25,28,53
37504,scipio007,,1,2,4,6
37505,thievedrelic,,1,3,2,5
37506,anions,,1,393,618,1011
37507,down_river,,1,5,8,13
37508,littledan,,1,36,53,89
37509,hexayurt,,1,129,80,209
37510,trevorturk,,1,28,19,47
37511,rmal,,1,12,2,14
37512,knight666,,1,1103,1141,2244
37513,Spell,,1,63,111,174
37514,TheKettle,,1,3,1,4
37515,deuteros,,1,2972,2688,5660
37516,codewaffle,,1,10,7,17
37517,papaia,,1,5,12,17
37518,infaereld,,1,102,17,119
37519,voodoo123,,1,1,1,2
37520,my_complaint_about,,1,8,7,15
37521,financegeek,,1,28,1,29
37522,coloradosteve,,1,111,8,119
37523,duus,,1,1041,2294,3335
37524,krugerlive,,1,1639,1319,2958
37525,truckee,,1,1,1,2
37526,TitanBane,,1,97,50,147
37527,powerdeamon,,1,25,92,117
37528,cotterbo,,1,8,20,28
37529,talios,,1,1,1,2
37530,basf,,1,3,2,5
37531,emice,,1,1,3,4
37532,answerguru,,1,14,29,43
37533,hayzooz,,1,1,5,6
37534,JohnLayman,,1,85,62,147
37535,tchorix,,1,1,1,2
37536,MissMozo,,1,58,41,99
37537,ow1n,,1,105,191,296
37538,TheChameleon84,,1,54,82,136
37539,dirtside,,1,8,3,11
37540,bethy08,,1,266,4,270
37541,sirslim,,1,1,2,3
37542,JustinTheBear,,1,1,2,3
37543,ravi86,,1,10,12,22
37544,kernelpanik,,1,20,22,42
37545,techtonix,,1,1074,43,1117
37546,tarded,,1,44,32,76
37547,groundctrl,,1,100,70,170
37548,Dwersteg,,1,6,7,13
37549,ctkeene,,1,1,1,2
37550,doctorperv,,1,71,75,146
37551,vr6vdub,,1,2,7,9
37552,jamierc,,1,619,662,1281
37553,tgriffin,,1,5,13,18
37554,asleepy0,,1,74,85,159
37555,rdhatt,,1,11,10,21
37556,moviewhoremania,,1,1,7,8
37557,dreqmer37,,1,8,15,23
37558,caryw,,1,1,4,5
37559,eviljames,,1,96,140,236
37560,mbrown758,,1,12,11,23
37561,axthos,,1,4,19,23
37562,freeklicious,,1,1,1,2
37563,bmar,,1,1,1,2
37564,dialector,,1,4,2,6
37565,Hasteur,,1,7,7,14
37566,dwu2,,1,3,1,4
37567,davecrist,,1,3,5,8
37568,Work45,,1,248,158,406
37569,playwithmywii,,1,12,9,21
37570,prophit,,1,35,49,84
37571,fru1t,,1,1,1,2
37572,harryf,,1,224,85,309
37573,tomata,,1,11,12,23
37574,dagneytaggart,,1,8,8,16
37575,basilv,,1,7,1,8
37576,badr0b0t,,1,2,5,7
37577,Dyphy,,1,1,2,3
37578,derb,,1,1,8,9
37579,turbo,,1,166,199,365
37580,taggat,,1,40,74,114
37581,lykeless,,1,37,26,63
37582,pechinburger,,1,675,228,903
37583,highmy7829900,,1,8,1,9
37584,attrib-s-h-r,,1,7,19,26
37585,kripkenstein,,1,556,522,1078
37586,marsanyi,,1,2,2,4
37587,INaktivist,,1,38,83,121
37588,jvdais,,1,7,6,13
37589,goandeatsomestuff,,1,2,4,6
37590,manhands7,,1,1,7,8
37591,lalafalala,,1,52,70,122
37592,Chaoticmass,,1,26,30,56
37593,myname,,1,24,48,72
37594,MrForeskin,,1,165,178,343
37595,r00by,,1,4,6,10
37596,weoh,,1,11,6,17
37597,kaldrazidrim,,1,46,70,116
37598,sbenson,,1,1,1,2
37599,douchemcgee,,1,13,8,21
37600,heyiamt,,1,9,9,18
37601,zack_morris,,1,2,3,5
37602,amaurer,,1,633,83,716
37603,Enlightenment777,,1,40,65,105
37604,england,,1,3,7,10
37605,phaedruss,,1,18,8,26
37606,drokly,,1,10,8,18
37607,gerst-a-burger,,1,4,6,10
37608,newmethod,,1,3,1,4
37609,file-exists-p,,1,17,21,38
37610,TinaBeth,,1,5,6,11
37611,wyclif,,1,41,45,86
37612,dfdffddf,,1,1,4,5
37613,whitey12785,,1,1,2,3
37614,gomoses,,1,647,95,742
37615,WallPhone,,1,69,148,217
37616,pebcak,,1,2,2,4
37617,Tonybonaventura,,1,47,111,158
37618,projomni,,1,11,3,14
37619,illpacin0,,1,10,8,18
37620,eatmyspam08,,1,35,9,44
37621,z5h,,1,22,20,42
37622,kafka0622,,1,9,15,24
37623,Drizzt_DoUrden,,1,2,1,3
37624,zinnate,,1,5,10,15
37625,joelagnel,,1,1,7,8
37626,farfignewton,,1,30,52,82
37627,fargosucks,,1,16,31,47
37628,summernot,,1,285,382,667
37629,fwtskm,,1,10,12,22
37630,mikekfoley,,1,136,8,144
37631,kunkie,,1,2,2,4
37632,GDtrax,,1,4,10,14
37633,warsteiner,,1,56,57,113
37634,Saintstace,,1,8,26,34
37635,chatmonchy,,1,38,10,48
37636,klinny,,1,124,36,160
37637,codoholic,,1,4,3,7
37638,genesai,,1,12,14,26
37639,Beefington,,1,22,35,57
37640,sportsstar67,,1,9,6,15
37641,Fedge,,1,30,36,66
37642,kretik,,1,200,213,413
37643,elucubra,,1,29,40,69
37644,vicissitude,,1,2,2,4
37645,Splody,,1,3,5,8
37646,davebg8r,,1,5,4,9
37647,dizzle67,,1,2261,77,2338
37648,redgrave,,1,1,2,3
37649,drowning,,1,268,16,284
37650,stockefeller,,1,2,2,4
37651,_Hillary_Clinton_,,1,2,1,3
37652,FW190,,1,1,7,8
37653,shinigami3,,1,38,14,52
37654,yamil,,1,11,4,15
37655,weak,,1,49,10,59
37656,rockchops,,1,1,5,6
37657,kilonad,,1,6,9,15
37658,Saiing,,1,752,745,1497
37659,bowiebellapeatipursi,,1,16,2,18
37660,jtbob,,1,23,26,49
37661,rissotto,,1,8,4,12
37662,d00kiestain,,1,34,6,40
37663,gabor,,1,8,7,15
37664,howNowBrownSow,,1,15,33,48
37665,chrishouser,,1,1,1,2
37666,wockyman,,1,337,374,711
37667,GravyJefferson,,1,7,16,23
37668,antiskub,,1,3,2,5
37669,lolomfgkthxbai,,1,365,538,903
37670,fishizell,,1,1,1,2
37671,kru5h,,1,213,323,536
37672,norkakn,,1,62,111,173
37673,jconnell,,1,65,41,106
37674,The_Chaos_Pope,,1,2,2,4
37675,mtx,,1,270,394,664
37676,sneg,,1,30,26,56
37677,Step1Mark,,1,7,20,27
37678,becda289,,1,3,4,7
37679,k4p,,1,4,8,12
37680,egregious,,1,75,306,381
37681,DocOBackbush,,1,38,41,79
37682,FatPhil,,1,60,33,93
37683,kooknboo,,1,3,9,12
37684,ddfreyne,,1,25,27,52
37685,davy_crockett,,1,386,487,873
37686,hypergeek,,1,3,2,5
37687,heywoodidaho,,1,10,33,43
37688,thechrispy,,1,2,1,3
37689,vitali_y,,5,9,5,14
37690,fuckoffcuntface,,1,1,1,2
37691,NancyGracesTesticles,,1,661,1015,1676
37692,Howard_Beale,,1,12,22,34
37693,aperion,,1,1,1,2
37694,fishb0t,,1,1,6,7
37695,joeljohnson,,1,2,1,3
37696,stivnan,,1,1,4,5
37697,flywheel,,1,297,479,776
37698,MackDaddy1,,1,95,6,101
37699,-So-,,1,6,9,15
37700,marthirial,,1,327,375,702
37701,wizardofoz,,1,4,17,21
37702,turbotron,,1,79,75,154
37703,threesheds,,1,7,15,22
37704,lexfor,,1,8,17,25
37705,lazyant,,1,12,9,21
37706,rizzomegav,,1,5,11,16
37707,OMLE,,1,11,4,15
37708,shempey,,1,3,6,9
37709,fartographer,,1,1,1,2
37710,livefree2day,,1,1,2,3
37711,wsoccerl6,,1,9,8,17
37712,Gandhilion,,1,4,4,8
37713,goonsquad,,1,138,57,195
37714,IamTCM,,1,41,44,85
37715,Sweetpipe,,1,2,5,7
37716,radioprotector,,1,4,4,8
37717,sheepster26,,1,1,2,3
37718,steve_g,,1,41,5,46
37719,kratsnitram,,1,1,4,5
37720,derleth,,1,15,14,29
37721,mwickens,,1,1,1,2
37722,clidiere,,1,1,1,2
37723,Holdthepickle,,1,9,22,31
37724,iodian,,1,62,126,188
37725,johnvanveen,,1,34,51,85
37726,eremitix,,1,1,3,4
37727,affffacebooke,,1,1,4,5
37728,qacek,,1,68,59,127
37729,quiso,,1,14,13,27
37730,feylar,,1,9,11,20
37731,cameroncox,,1,12,11,23
37732,eckliptic,,1,18,26,44
37733,sirmizzle,,1,10,8,18
37734,avigesaa,,1,7,12,19
37735,sonofgram,,1,5,7,12
37736,agentq512,,1,11,4,15
37737,arpie,,1,27,11,38
37738,p-o-s-t-a-l,,1,3,5,8
37739,McHenry,,1,3,3,6
37740,runrunwootwoot,,1,719,395,1114
37741,Jamie_Rules,,1,1,3,4
37742,xtn,,1,5,4,9
37743,Gillios,,1,1,4,5
37744,SenatorGovernment,,1,2,8,10
37745,djtomr941,,1,24,32,56
37746,crushedbyadwarf,,1,18,24,42
37747,vlemx,,1,6,5,11
37748,iamnot,,1,8,26,34
37749,ThumperNM,,1,2,4,6
37750,drev,,1,40,30,70
37751,xman2000,,1,21,15,36
37752,Ramb0,,1,115,4,119
37753,troywrestler2002,,1,1,2,3
37754,beedogs,,1,350,408,758
37755,lippop,,1,3,5,8
37756,fuqtard,,1,5,7,12
37757,burntsushi,,1,22,8,30
37758,vlance,,1,8,4,12
37759,tacapd42,,1,4,6,10
37760,I_Think_Youre_Stupid,,1,3,5,8
37761,macaddct1984,,1,2,1,3
37762,joshfern,,1,117,168,285
37763,itsfundamenthole,,1,3,8,11
37764,unusedusername,,1,7,7,14
37765,vornan19,,1,20,50,70
37766,mrmonkey,,1,54,8,62
37767,AchmedDeadTerrorist,,1,1,1,2
37768,Dan_Forden,,1,1,1,2
37769,enlzen,,1,159,216,375
37770,gavinjones,,1,13,9,22
37771,icebird,,1,34,58,92
37772,periodic,,1,57,50,107
37773,GodShapedBullet,,1,72,39,111
37774,amp108,,1,19,16,35
37775,adaptable,,1,37,5,42
37776,PanicBot,,1,7,5,12
37777,RiteJoe,,1,1,9,10
37778,kickm3,,1,2,4,6
37779,fermatapiola,,1,8,1,9
37780,miparasito,,1,140,194,334
37781,kniteshade,,1,13,21,34
37782,ianrhett,,1,2,3,5
37783,sshanky,,1,17,16,33
37784,hencethus,,1,43,43,86
37785,castle9mm,,1,8,15,23
37786,msawyer3,,1,5,1,6
37787,zjunk,,1,30,21,51
37788,nicxvan,,1,198,236,434
37789,sdn,,1,256,316,572
37790,blacky12,,1,1,1,2
37791,jotaroh,,1,581,997,1578
37792,nkosi,,1,10,11,21
37793,samwisefoxburr,,1,9,7,16
37794,wulfilia,,1,76,134,210
37795,erOhead,,1,1,2,3
37796,leedo,,1,2,2,4
37797,chubbiguy40,,1,10,12,22
37798,NashMcCabe,,1,49,71,120
37799,poonerton,,1,5,3,8
37800,rational1212,,1,23,29,52
37801,dadagiri,,1,7,14,21
37802,namesbc,,1,2,1,3
37803,albaum,,1,12,4,16
37804,sean_galt,,1,10,9,19
37805,coding-time,,1,12,5,17
37806,skubajon,,1,7,2,9
37807,kimsagro,,1,1,1,2
37808,simonbh,,1,3,1,4
37809,polipsy,,1,2,6,8
37810,Skamandrios,,1,4,7,11
37811,bhn1997,,1,5,4,9
37812,550,,1,30,8,38
37813,jeremybub,,1,226,365,591
37814,zvisus,,1,9,5,14
37815,cheald,,1,69,85,154
37816,seacreeks,,1,8,14,22
37817,mikec23,,1,18,50,68
37818,Balso,,1,1,1,2
37819,philodespotos,,1,1,1,2
37820,emkat,,1,3,3,6
37821,jr308,,1,6,10,16
37822,cryptyk,,1,103,50,153
37823,zyron,,1,1,1,2
37824,The_Doc,,1,2,6,8
37825,spamly,,1,7,19,26
37826,market,,1,53,42,95
37827,swieton,,1,17,13,30
37828,wesdyer,,1,3,1,4
37829,murphee_,,1,52,10,62
37830,mad4,,1,1,1,2
37831,nsoonhui,,1,113,8,121
37832,observantAlien,,1,5,5,10
37833,Butt_Scratcher,,1,43,68,111
37834,ashuri2,,1,50,30,80
37835,HUAONE,,1,26,42,68
37836,BCTripster,,1,1,4,5
37837,DennisRMortensen,,1,3,1,4
37838,scar_face,,1,1,2,3
37839,Pystt,,1,1,1,2
37840,TanisDLC,,1,1,2,3
37841,BruceSanchez,,1,1,2,3
37842,olivepit,,1,3,4,7
37843,foolinator,,1,64,120,184
37844,joeldsouza,,1,2,1,3
37845,spamelita,,1,7,3,10
37846,runenes,,1,6,12,18
37847,sharpeskii,,1,1,2,3
37848,HappyHarryHardOn,,1,6,12,18
37849,juuley,,1,2,7,9
37850,tangus,,1,32,48,80
37851,CinDan,,1,1,1,2
37852,Uggy,,1,7,7,14
37853,locusto03,,1,47,26,73
37854,asylumua,,1,7,7,14
37855,kingprem,,1,11,6,17
37856,flamable221,,1,19,30,49
37857,wote89,,1,12,12,24
37858,jeff76767,,1,2,9,11
37859,eggnogdog,,1,235,273,508
37860,gersoid,,1,10,9,19
37861,danglingwrangler,,1,6,1,7
37862,gruelin1,,1,1,2,3
37863,cjz0r,,1,2,1,3
37864,mellowcreme,,1,3,7,10
37865,rjuliani,,1,17,21,38
37866,knomb,,1,7,2,9
37867,sa4720k,,1,5,8,13
37868,Starrydancer,,1,1,4,5
37869,jonnyfrag,,1,1,1,2
37870,yess-s,,1,3,3,6
37871,Blackheart,,1,26,44,70
37872,Seakneeboy,,1,5,13,18
37873,dattaway,,1,35,61,96
37874,I_AM_A_NEOCON,,1,902,543,1445
37875,aminakodugumpici,,1,1,1,2
37876,Cdresden,,1,140,261,401
37877,lalemon,,1,74,112,186
37878,LonelyGuy,,1,15,6,21
37879,C_Marivs,,1,30,45,75
37880,hare2dacore,,1,5,7,12
37881,epheron,,1,2,8,10
37882,cableshaft,,1,87,76,163
37883,myworld,,1,32,4,36
37884,BeRoKaViCh,,1,118,137,255
37885,Snoww,,1,98,76,174
37886,Spacksack,,1,1068,802,1870
37887,stevie_h,,1,5,1,6
37888,psi_,,1,9,9,18
37889,pfile,,1,1,2,3
37890,InterPunct,,1,81,116,197
37891,PhotoJim,,1,2,4,6
37892,paulgone,,1,1,1,2
37893,vtwizzie,,1,7,5,12
37894,jer2665,,1,1,1,2
37895,sliter9,,1,4,5,9
37896,maryelens,,1,1,2,3
37897,dmunky,,1,4,7,11
37898,UmberGryphon,,1,61,68,129
37899,ganko,,1,2,1,3
37900,helpingfriendlybook,,1,1,2,3
37901,INKRIMINATOR,,1,5,5,10
37902,clemecha,,1,1,1,2
37903,uglypopstar,,1,10,37,47
37904,stgeorgiew,,1,1,1,2
37905,HattoriHanzo,,1,117,147,264
37906,xakh,,1,49,108,157
37907,last_chance,,1,1,2,3
37908,CyberSol,,1,7,15,22
37909,zamfi,,1,1,3,4
37910,vanblah,,1,2,2,4
37911,veni_vidi_verily,,1,21,3,24
37912,ukeagle,,1,1,2,3
37913,Wolfgangg,,1,2,1,3
37914,NoMcBush,,1,80,65,145
37915,Jawmaster,,1,26,57,83
37916,node1217,,1,1,3,4
37917,Ken_Breadbox,,1,71,78,149
37918,CR1M1N4L,,1,80,87,167
37919,lephron,,1,15,8,23
37920,randomguy348,,1,24,24,48
37921,jonbro,,1,2,1,3
37922,scoomdot,,1,3,2,5
37923,jetfar,,1,259,37,296
37924,TheSchalter,,1,7,1,8
37925,michael111,,1,9,3,12
37926,f0000,,1,2,3,5
37927,BeTheChange,,1,60,78,138
37928,mkfa10,,1,18,31,49
37929,Nimnio,,1,3,7,10
37930,didactus,,1,2,2,4
37931,othermaciej,,1,67,65,132
37932,cheshirepuss,,1,46,76,122
37933,astro,,1,4,11,15
37934,inquisitor5,,1,20,14,34
37935,JesusHusseinChrist,,1,40,61,101
37936,the-gray-squirrel,,1,76,109,185
37937,stickynotes,,1,5,1,6
37938,HunterTV,,1,747,865,1612
37939,merrijk,,1,3,1,4
37940,tyghbn,,1,2,3,5
37941,digidante,,1,15,29,44
37942,shriphani,,1,1,1,2
37943,logos_flux,,1,1,1,2
37944,streem84,,1,160,240,400
37945,mcguyver,,1,6,16,22
37946,Zambtibabuloustic,,1,1,2,3
37947,effervescence,,1,3,2,5
37948,beerboy1,,1,1,1,2
37949,kimol,,1,1,1,2
37950,jakedakat,,1,10,12,22
37951,aeoutfitters33,,1,1,1,2
37952,RagingKegger,,1,32,30,62
37953,ruth3,,1,2,1,3
37954,leonhyral,,1,36,63,99
37955,axonxorz,,1,22,22,44
37956,wang-sucker,,1,1,1,2
37957,aeric,,1,20,31,51
37958,Aliens_From_Saturn,,1,2,2,4
37959,pls,,1,2,3,5
37960,pantsu,,1,20,19,39
37961,digdugdang,,1,3,7,10
37962,zl_xyz_lz,,1,2,2,4
37963,famousbirds,,1,2,4,6
37964,scafe,,1,1,1,2
37965,IamAnt,,1,7,3,10
37966,mrbook,,1,1,4,5
37967,coachFox,,1,90,73,163
37968,aknightnarmor,,1,73,1,74
37969,Sammi72,,1,4,17,21
37970,fashionrobot,,1,3,2,5
37971,eobanb,,1,129,116,245
37972,ichthis,,1,43,33,76
37973,sixthree,,1,24,27,51
37974,bearhunter,,1,2,1,3
37975,failtrain,,1,3,8,11
37976,linuxrebel,,1,23,11,34
37977,Barnlinger,,1,193,153,346
37978,yuurei,,1,31,44,75
37979,monchavo,,1,19,25,44
37980,macadamian,,1,20,38,58
37981,wjessup,,1,1,1,2
37982,Noose,,1,25,27,52
37983,Karrionhardt,,1,4,5,9
37984,bongoboy,,1,4,1,5
37985,mike_at_ysm,,1,1,1,2
37986,tehsma,,1,7,13,20
37987,pr073u5,,1,5,5,10
37988,ekoleda,,1,25,7,32
37989,maxmartin,,1,245,222,467
37990,monkeybanana,,1,1,1,2
37991,serenity450,,1,15,30,45
37992,thealphateam,,1,3,4,7
37993,gregwolejko,,1,18,3,21
37994,asundevil,,1,143,92,235
37995,infectedmushroom,,1,3,3,6
37996,knome,,1,78,111,189
37997,Tantalon,,1,919,12,931
37998,satanist,,1,125,169,294
37999,antihostile,,1,344,375,719
38000,12_strangers,,1,77,127,204
38001,jeremyh42,,1,16,25,41
38002,TheZorch,,1,105,142,247
38003,djreed,,1,12,18,30
38004,Ramonster,,1,117,173,290
38005,funkalicious,,1,3,1,4
38006,hardcoded,,1,65,16,81
38007,Eth4n,,1,12,14,26
38008,ll0l00,,1,1,2,3
38009,simoretu,,1,9,1,10
38010,huttson,,1,9,3,12
38011,jamiemccarthy,,1,20,9,29
38012,iamweasel1022,,1,12,17,29
38013,rrabbits,,1,1,2,3
38014,RickHoncho,,1,1,1,2
38015,jcy,,1,68,95,163
38016,TheMoralOfTheStory,,1,1,1,2
38017,Cody2sDown,,1,1,2,3
38018,mattbob,,1,1,3,4
38019,newPre,,1,8,13,21
38020,alrond,,1,2,1,3
38021,agingpopstar,,1,17,48,65
38022,jmnugent,,1,129,36,165
38023,rufenstein,,1,2,5,7
38024,theDrWho,,1,690,1129,1819
38025,stevesreb,,1,1,1,2
38026,MichaelMelen,,1,1,5,6
38027,random_hyp,,1,2,2,4
38028,nelud,,1,10,3,13
38029,woodeye,,1,79,97,176
38030,woodrail,,1,23,43,66
38031,polarbobbear,,1,187,167,354
38032,flashgeek,,1,5,5,10
38033,barsik_,,1,72,4,76
38034,Jaefster,,1,10,24,34
38035,leieva,,1,8,14,22
38036,d_crosil,,1,1,3,4
38037,spoortehtf,,1,65,81,146
38038,mtdynamics,,1,15,47,62
38039,political,,1,131,105,236
38040,eldre,,1,83,86,169
38041,zoominyoomin,,1,1,2,3
38042,calmlikeabomb,,1,186,223,409
38043,smux,,1,1,1,2
38044,schoolisdeath,,1,24,17,41
38045,Kitchenfire,,1,21,39,60
38046,TacoJackson,,1,3,5,8
38047,cybernuda,,1,5,14,19
38048,meanmeosh,,1,26,15,41
38049,strombom,,1,9,8,17
38050,seemikedraw,,1,4,4,8
38051,crististm,,1,20,3,23
38052,kflasch,,1,24,37,61
38053,markstos,,1,25,17,42
38054,liedel,,1,13,5,18
38055,leosoto,,1,9,17,26
38056,Nidonocu,,1,6,5,11
38057,jeyoung,,1,11,18,29
38058,woolleybear,,1,12,31,43
38059,billydreamer,,1,2,7,9
38060,mango_feldman,,1,4,2,6
38061,davinox,,1,19,27,46
38062,juanjodic,,1,47,90,137
38063,YawningDog,,1,2,3,5
38064,pavlik_fan,,1,2,1,3
38065,lumpy1981,,1,199,313,512
38066,gyani,,1,9,12,21
38067,mac,,1,25,10,35
38068,kristopolous,,1,137,187,324
38069,mccartichoke,,1,16,6,22
38070,Brittix1023,,1,21,15,36
38071,jenks,,1,17,31,48
38072,droolingmnky,,1,1,1,2
38073,brettwojo,,1,1,1,2
38074,Eyesaw,,1,840,15,855
38075,banter_,,1,1,1,2
38076,billyneverdies,,1,6,7,13
38077,Redditman,,1,2,5,7
38078,SumDood,,1,60,1,61
38079,gogobyte,,1,2,9,11
38080,reeseallen,,1,234,70,304
38081,kastlerouge,,1,1,4,5
38082,rainfosys,,1,523,27,550
38083,timecrash,,1,14,8,22
38084,GetsEclectic,,1,10,17,27
38085,g1bb,,1,48,25,73
38086,DAWTSF,,1,46,74,120
38087,CecilBenedict,,1,6,1,7
38088,sbo1,,1,1,1,2
38089,bluebuddha,,1,1,1,2
38090,kubalaa,,1,68,67,135
38091,hypo11,,1,472,425,897
38092,ragor,,1,54,68,122
38093,abofh,,1,13,9,22
38094,almega,,1,50,22,72
38095,guccigirlie01,,1,1,1,2
38096,pdk,,1,9,4,13
38097,jlucamaroz28,,1,15,25,40
38098,naixn,,1,21,11,32
38099,Havage,,1,80,99,179
38100,tick113,,1,6,9,15
38101,neilien,,1,16,34,50
38102,DJGibbon,,1,9,9,18
38103,notanidiot,,1,4,6,10
38104,jaquehamr,,1,37,69,106
38105,annoyed,,1,98,152,250
38106,2tall,,1,9,26,35
38107,cloudform,,1,1,2,3
38108,keithchegwin,,1,8,14,22
38109,jculbertson,,1,3,1,4
38110,lhnz,,1,2,7,9
38111,tuber,,1,1195,1748,2943
38112,donp17,,1,3,2,5
38113,mhrnjad,,1,14,7,21
38114,kurtu5,,1,208,437,645
38115,MissLiberty,,1,1,1,2
38116,olav,,1,1,1,2
38117,Helicon1,,1,28,9,37
38118,self_promotion_whore,,1,2,2,4
38119,Fenrise,,1,17,7,24
38120,SoulShock,,1,50,12,62
38121,serkel,,1,1,1,2
38122,jonsayer,,1,12,13,25
38123,redmouse,,1,1,1,2
38124,dionysis,,1,39,26,65
38125,conspiracy_theorist,,1,299,389,688
38126,spiff56747,,1,2,6,8
38127,Farsay,,1,262,427,689
38128,The_Yeti,,1,449,845,1294
38129,madprophet,,1,2,7,9
38130,robrobrob,,1,3,3,6
38131,justa1timethang,,1,1,1,2
38132,girlsansshoes,,1,1,1,2
38133,capsid,,1,66,52,118
38134,placidwilbur,,1,7,14,21
38135,genron1111,,1,21,50,71
38136,blirg,,1,2,1,3
38137,DigitalHubris,,1,95,115,210
38138,troubleondemand,,1,123,238,361
38139,beef73,,1,1,1,2
38140,Yivo,,1,6,7,13
38141,dlfelps,,1,8,1,9
38142,eb007,,1,175,6,181
38143,mactart,,1,1,2,3
38144,surburban,,1,24,1,25
38145,bananatalk,,1,1323,114,1437
38146,OniNiubbo,,1,14,21,35
38147,Gargilius,,1,688,1103,1791
38148,PlasmaWhore,,1,834,966,1800
38149,GodForbid,,1,61,41,102
38150,Wormwoods,,1,1,1,2
38151,NVShacker,,1,34,46,80
38152,lassef,,1,12,12,24
38153,tremor_tj,,1,2,5,7
38154,koonts51,,1,10,22,32
38155,mmeijeri,,1,91,155,246
38156,sadstate,,1,4,7,11
38157,knowknowledge,,1,262,290,552
38158,maci01,,1,3,16,19
38159,elchupacabra,,1,52,3,55
38160,chengiz,,1,351,314,665
38161,kanokamblameo,,1,6,16,22
38162,Lomaxx,,1,8,8,16
38163,Kale,,1,18,14,32
38164,wheezy360,,1,1,1,2
38165,hoppus,,1,3,3,6
38166,kilvenic,,1,3,10,13
38167,vade,,1,19,47,66
38168,daylight,,1,115,228,343
38169,mbrown,,1,5,5,10
38170,Piratedan200,,1,2,2,4
38171,nickit,,1,1,1,2
38172,ThatcherPark,,1,4,3,7
38173,Jabberwockey,,1,3,7,10
38174,firklar,,1,40,43,83
38175,virmagnus,,1,5,7,12
38176,yoshevhoshev,,1,4,1,5
38177,AdamCohn,,1,3,2,5
38178,woodwater,,1,42,122,164
38179,repeatextension,,1,5,4,9
38180,kc2702,,1,9,18,27
38181,omgzrob,,1,1,5,6
38182,neoporcupine,,1,22,41,63
38183,Mr_Smartypants,,1,1598,2415,4013
38184,DeepThoughts,,1,3,1,4
38185,MikeDimmick,,1,1,1,2
38186,tina306090,,1,6,8,14
38187,1smartasss,,1,2,1,3
38188,accon,,1,6,13,19
38189,s19aw,,1,2,2,4
38190,Palchez,,1,54,81,135
38191,quiller,,1,1336,1805,3141
38192,gardenmandy,,1,153,10,163
38193,youremom,,1,302,457,759
38194,kaythecraven,,1,1,1,2
38195,ami77,,1,4,10,14
38196,nadare,,1,1,2,3
38197,nbuet,,1,5,2,7
38198,read_tfa,,1,2,1,3
38199,shmozz,,1,3,2,5
38200,Duke_,,1,2,4,6
38201,Tordek,,1,36,86,122
38202,tengu,,1,10,19,29
38203,amsterdamn,,1,17,7,24
38204,snoconegypsy,,1,35,1,36
38205,dpholmes,,1,1,2,3
38206,Kawasaki,,1,23,90,113
38207,Mithridates,,1,636,197,833
38208,leoboiko,,1,288,267,555
38209,Ladarzak,,1,133,120,253
38210,wuddersup,,1,392,128,520
38211,quote_bot,,1,1,4,5
38212,asleeponthesun,,1,2,9,11
38213,Jared80KA,,1,2,6,8
38214,mifrai,,1,4,2,6
38215,hoju,,1,66,45,111
38216,Valdus_Pryme,,1,98,321,419
38217,blackbeansandrice,,1,23,25,48
38218,echoman,,1,3,1,4
38219,xblingdaddy2005x,,1,5,12,17
38220,JMV290,,1,61,104,165
38221,Buttercup50,,1,9,10,19
38222,mncaudill,,1,18,21,39
38223,starpage85,,1,1,3,4
38224,cantguesspword,,1,2,8,10
38225,rvidal,,1,3,1,4
38226,hellbox,,1,5,4,9
38227,dcr1256,,1,1,1,2
38228,SmileyChris,,1,3,10,13
38229,jmcguckin,,1,4,6,10
38230,recursivejon,,1,2,4,6
38231,dracovich,,1,57,10,67
38232,itsadok,,1,4,3,7
38233,daviangel,,1,3,3,6
38234,giantsfan134,,1,18,24,42
38235,Madmanden,,1,52,85,137
38236,copperdomebodha,,1,297,192,489
38237,LotR_Rachlin,,1,1,1,2
38238,darylcagle,,1,2,4,6
38239,rz2000,,1,154,265,419
38240,xoctor,,1,175,303,478
38241,hunterjunk,,1,3,6,9
38242,bloodylip,,1,93,130,223
38243,profiteerer,,1,4,3,7
38244,RCSka,,1,11,23,34
38245,longdong,,1,4,1,5
38246,swanyl,,1,407,3,410
38247,XSV_Fizz_,,1,2,7,9
38248,cakeycakes,,1,1,1,2
38249,Icecaste,,1,14,3,17
38250,pappugulal,,1,4,16,20
38251,dh1,,1,7,12,19
38252,tavid,,1,8,1,9
38253,frognutsthe3rd,,1,1,6,7
38254,bogeywebdesign,,1,6,3,9
38255,yanik,,1,7,4,11
38256,Gigwave,,1,2,11,13
38257,tanger,,1,95,118,213
38258,q-_-p,,1,3,6,9
38259,jjash,,1,19,14,33
38260,ravedave,,1,192,252,444
38261,azertus,,1,1,2,3
38262,dorshorst,,1,106,114,220
38263,ANDTHATSAFACT,,1,1,2,3
38264,locklin,,1,28,23,51
38265,niimma,,1,3,1,4
38266,draconnery,,1,28,70,98
38267,CurtisLemay,,1,1,5,6
38268,bxyldy,,1,48,75,123
38269,malexan,,1,27,16,43
38270,jasperjohns,,1,1,3,4
38271,matthavener,,1,4,3,7
38272,Pendin,,1,38,52,90
38273,whynottry,,1,16,21,37
38274,strifeless,,1,19,31,50
38275,rinocom,,1,1,2,3
38276,geppe,,1,99,88,187
38277,Geegee101,,1,2,1,3
38278,100thm0nkey,,1,237,247,484
38279,IvanLeopold,,1,8,15,23
38280,jumpy_monkey,,1,120,105,225
38281,LizzieP,,1,28,33,61
38282,paro,,1,722,935,1657
38283,Desiccant,,1,1,1,2
38284,charles_darwin2,,1,135,63,198
38285,anthesiac,,1,2,2,4
38286,JamesFromCanada,,1,50,99,149
38287,railroadrum,,1,1,2,3
38288,ExtraDigit,,1,5,6,11
38289,Jave27,,1,44,5,49
38290,stkman57,,1,1,2,3
38291,foomp,,1,11,11,22
38292,NinjaOxygen,,1,13,16,29
38293,guilhem,,1,6,5,11
38294,PsychoPenguinGrl,,1,14,30,44
38295,smoknjuan,,1,73,128,201
38296,spencerv,,1,5,2,7
38297,bgates6666,,1,8,6,14
38298,asura0,,1,24,75,99
38299,leesonis,,1,15,14,29
38300,j-smith,,1,1,3,4
38301,foo-tard,,1,34,52,86
38302,Peaker,,1,132,177,309
38303,babylon_drifter,,1,1,2,3
38304,ixeos,,1,7,3,10
38305,OToole,,1,298,389,687
38306,Bimble,,1,25,51,76
38307,boothinator,,1,7,11,18
38308,orbitz,,1,86,125,211
38309,splidge,,1,15,33,48
38310,senko,,1,1,1,2
38311,alleng1,,1,3,1,4
38312,snacktivity,,1,26,45,71
38313,chickenpuff,,1,4,1,5
38314,ugeert,,1,3,2,5
38315,briebert,,1,67,122,189
38316,KrazyGimp,,1,19,31,50
38317,sloak,,1,3,2,5
38318,drdania,,1,15,25,40
38319,iiiiiii,,1,1,1,2
38320,riled,,1,3,1,4
38321,m8m8m8,,1,507,6,513
38322,Silentio,,1,142,248,390
38323,tiff1122,,1,1,1,2
38324,seunosewa,,1,9,15,24
38325,riger99,,1,20,4,24
38326,eplanit,,1,5,6,11
38327,psykotic,,1,370,493,863
38328,agarren,,1,1,1,2
38329,RationalUser,,1,112,76,188
38330,elnon,,1,6,11,17
38331,Snowspot,,1,124,123,247
38332,NanoStuff,,1,36,62,98
38333,mallio,,1,27,21,48
38334,PintOfGuinness,,1,986,439,1425
38335,rev_null,,1,9,9,18
38336,aerialkabuki,,1,1,3,4
38337,MitchAubin,,1,15,25,40
38338,Rhoozer,,1,1,7,8
38339,trf,,1,6,10,16
38340,Whose_Chariot,,1,1,3,4
38341,thurstastic,,1,33,12,45
38342,wufoo,,1,164,113,277
38343,LastAXEL,,1,39,74,113
38344,arnedh,,1,111,125,236
38345,chicomathmom,,1,192,108,300
38346,interestingedamame,,1,2,4,6
38347,mderrick15,,1,9,4,13
38348,elunico28,,1,6,10,16
38349,plexluthor,,1,205,194,399
38350,Cwal37,,1,10,3,13
38351,Cuselax5,,1,1,1,2
38352,vanchunks,,1,5,13,18
38353,mattyxo,,1,87,215,302
38354,lamas,,1,1,1,2
38355,g8rgeek,,1,12,9,21
38356,leftsaidfred,,1,39,4,43
38357,melsonome,,1,1,4,5
38358,tutwabee,,1,177,230,407
38359,stpdrdnk,,1,4,7,11
38360,stats,,1,61,64,125
38361,MetropolisPt31,,1,1,4,5
38362,cjd415,,1,23,17,40
38363,mphafner,,1,6,4,10
38364,shandie,,1,8,10,18
38365,ravy,,1,5,6,11
38366,oldcrow,,1,401,669,1070
38367,myownsummersi,,1,8,7,15
38368,stealthzeus,,1,266,421,687
38369,exiork,,1,37,87,124
38370,twilightearth,,1,18,1,19
38371,Curiosity,,1,9,9,18
38372,gibbdibbofive,,1,2,1,3
38373,Comowl,,1,52,27,79
38374,sakebomb69,,1,1116,1846,2962
38375,openthink,,1,137,19,156
38376,JB5480,,1,1,2,3
38377,CrAzYMaST,,1,5,7,12
38378,derangedsheep,,1,12,14,26
38379,delfinom,,1,4,4,8
38380,sovok,,1,20,35,55
38381,coeal1,,1,1,2,3
38382,shea241,,1,47,17,64
38383,enlightenedgooglist,,1,10,21,31
38384,HaloOnFire,,1,3,2,5
38385,FenPhen,,1,373,517,890
38386,Marvel27,,1,265,180,445
38387,Rhinoceros,,1,20,48,68
38388,qtuner,,1,3,10,13
38389,gregkr,,1,72,55,127
38390,penrynchips,,1,40,10,50
38391,CountRumford,,1,4,6,10
38392,cm03d,,1,11,13,24
38393,alepuzio,,1,3,1,4
38394,heatbreak839,,1,1,1,2
38395,zorno,,1,988,793,1781
38396,jailbushnow,,1,4,1,5
38397,spitdog,,1,1,1,2
38398,labboypro,,1,17,65,82
38399,reverie,,1,2,3,5
38400,Syrp,,1,7,5,12
38401,FeepingCreature,,1,169,267,436
38402,slowridesleazy,,1,5,3,8
38403,sockppet,,1,1,5,6
38404,aspartam,,1,2,8,10
38405,zangrene22,,1,9,1,10
38406,dotcoma,,1,284,389,673
38407,ltcolonelnemo,,1,99,19,118
38408,madmop,,1,1,1,2
38409,AntoninScalia,,1,1,1,2
38410,understudy,,1,3,15,18
38411,sv3n,,1,6,10,16
38412,muaddib420,,1,51,30,81
38413,zorander,,1,1,8,9
38414,richhickey,,1,19,24,43
38415,nebouxii,,1,2,6,8
38416,pdanese,,1,32,41,73
38417,asokoloski,,1,100,141,241
38418,redavni,,1,185,232,417
38419,srparish,,1,5,10,15
38420,ppc1040,,1,275,173,448
38421,gizmo490,,1,13,17,30
38422,funwheel,,1,2,3,5
38423,serifoblique,,1,10,32,42
38424,dutchdyke,,1,1,1,2
38425,snowco,,1,4,8,12
38426,JohnnyRB,,1,15,1,16
38427,prepgroove,,1,1,1,2
38428,191wasadyslexicjob,,1,7,8,15
38429,avavra,,4,46,54,100
38430,ZeroInput,,1,9,15,24
38431,technesis,,1,1,4,5
38432,djamesmanny,,1,4,2,6
38433,tjndaltx,,1,2,1,3
38434,edeloso,,1,13,21,34
38435,cardinalReason,,1,5,8,13
38436,joet86,,1,1,2,3
38437,jumbles1234,,1,1,3,4
38438,keitharoo,,1,12,13,25
38439,mermermer1,,1,1,1,2
38440,cheezdoodlez,,1,2,1,3
38441,modusponens66,,1,22,34,56
38442,w1shEX,,1,2,1,3
38443,546mpster,,1,1,1,2
38444,qazzwer,,1,1,2,3
38445,theg33kshow,,1,55,79,134
38446,fergie,,1,74,107,181
38447,eljeffe,,1,34,1,35
38448,weoriu293r8,,1,1,1,2
38449,RJCantrell,,1,35,25,60
38450,admiralANCHOR,,1,5,5,10
38451,paddyoloughlin,,1,4,2,6
38452,Halliburton-Shill,,1,27,9,36
38453,danceswithbabes,,1,9,10,19
38454,YouSaidWhat,,1,1,1,2
38455,RocketNinja,,1,22,12,34
38456,keedon,,1,3,2,5
38457,CatMan_Dude,,1,17,10,27
38458,jonathan_,,1,15,29,44
38459,turangaziza,,1,5,18,23
38460,knobgoblin,,1,2,2,4
38461,fletcherkildren,,1,28,11,39
38462,rodelrod,,1,19,28,47
38463,lemekim,,1,3,4,7
38464,Serious-Bizness,,1,58,57,115
38465,pandamoniumheaven,,1,2,3,5
38466,ceallo,,1,36,27,63
38467,zyzzogeton,,1,513,592,1105
38468,greenconspiracy,,1,37,7,44
38469,mcwiggin,,1,5,2,7
38470,turbotard,,1,25,24,49
38471,jeffdavis,,1,1,1,2
38472,shenglong,,1,2109,444,2553
38473,dorbak,,1,14,22,36
38474,RoundSparrow,,1,5,13,18
38475,attilad,,1,17,25,42
38476,CollegeStud3nt,,1,1,2,3
38477,bmore_leader,,1,2,2,4
38478,stupidgit,,1,11,13,24
38479,adrij,,1,27,17,44
38480,icanhasreddit,,1,17,27,44
38481,artmetz,,1,16,25,41
38482,noneforme,,1,1,1,2
38483,pint,,1,6,6,12
38484,pepe234,,1,1,1,2
38485,drewjoh,,1,1,2,3
38486,greg_rutter,,1,1,4,5
38487,tomchappell,,1,35,32,67
38488,bigkazzyry,,1,6,2,8
38489,sabixatzil,,1,2,1,3
38490,nollig,,1,1,1,2
38491,mezzab,,1,11,1,12
38492,safasdfasd,,1,1,1,2
38493,The_Monster,,1,9,14,23
38494,Thargor,,1,5,5,10
38495,mario_r,,1,10,12,22
38496,breakfast-pants,,1,276,391,667
38497,klhardy1,,1,3,1,4
38498,trumpy714,,1,75,53,128
38499,rockus,,1,14,9,23
38500,jump_the_next_train,,1,82,67,149
38501,2300cc,,1,1,1,2
38502,skalpelis,,1,101,166,267
38503,kokomo,,1,74,2,76
38504,DBpooper,,1,26,7,33
38505,FrozenOrb,,1,2,2,4
38506,ki4gmb,,1,1,2,3
38507,Makal,,1,2,12,14
38508,VeryBadThings,,1,3,4,7
38509,jason_f,,1,26,8,34
38510,glmory,,1,2541,811,3352
38511,Deck,,1,2,2,4
38512,iheartrms,,1,3,4,7
38513,Roentgenator,,1,3,5,8
38514,stfdmv,,1,5,2,7
38515,Jesus_DinoRider,,1,4,4,8
38516,feqgut9r7wat9g,,1,152,351,503
38517,carlief007,,1,18,2,20
38518,alphabetsoup,,1,32,1,33
38519,nemster,,1,15,1,16
38520,katui,,1,32,67,99
38521,pear1jamten,,1,42,23,65
38522,doit3d,,1,13,10,23
38523,bobzmuda,,1,9,8,17
38524,Tiver,,1,115,194,309
38525,fuego0699,,1,4,2,6
38526,boesse,,1,19,50,69
38527,kokon,,1,14,15,29
38528,LoWang,,1,16,42,58
38529,majeriisli,,1,2,1,3
38530,daburr,,1,1,10,11
38531,banjobill,,1,45,50,95
38532,coffeemug,,1,18,5,23
38533,Dildozer,,1,1143,1034,2177
38534,artied,,1,57,85,142
38535,cardinal23,,1,5,3,8
38536,pythwarrior,,1,9,10,19
38537,pesiroil,,1,6,6,12
38538,macroexpand,,1,32,63,95
38539,EsIeX3,,1,57,46,103
38540,tysonmiller,,1,1,2,3
38541,lifeisgoooooood,,1,431,32,463
38542,jrockIMSA08,,1,1,1,2
38543,bremid,,1,1,2,3
38544,nintendoll,,1,27,21,48
38545,OiOiWhatABoy,,1,4,6,10
38546,jackli,,1,23,8,31
38547,frog_99,,1,4,8,12
38548,glasshouse,,1,2,1,3
38549,eegreg,,1,55,52,107
38550,blackrayne,,1,8,13,21
38551,ndaprophet,,1,3,8,11
38552,hats21ricks,,1,121,237,358
38553,tricolon,,1,488,641,1129
38554,mknasty,,1,2,2,4
38555,logicinjection,,1,6,10,16
38556,technothrasher,,1,102,118,220
38557,dmbftp,,1,4,1,5
38558,kolebee,,1,1,1,2
38559,thehotelexperience,,1,22,17,39
38560,haile_unlikely,,1,28,38,66
38561,C-C-C-COMBO-BREAKER,,1,102,63,165
38562,kdeason,,1,1,3,4
38563,Runamok81,,1,1,2,3
38564,Axalon,,1,606,42,648
38565,steve2008,,1,1,1,2
38566,Jonny_5,,1,2,1,3
38567,GuybrushThreepwood,,1,30,22,52
38568,kungfuice,,1,5,5,10
38569,knotty66,,1,5,22,27
38570,szevvy,,1,4,12,16
38571,FUCKDOITLIVESFUCK,,1,2,1,3
38572,josephlucas,,1,2,1,3
38573,jlb1982,,1,4,5,9
38574,poppypig,,1,5,1,6
38575,kyledantarin,,1,7,17,24
38576,blackoliveeater,,1,23,8,31
38577,letsvote,,1,1,1,2
38578,smckenzie23,,1,8,8,16
38579,ihatetotti,,1,12,9,21
38580,Chuwero,,1,3,19,22
38581,stylensf,,1,4,1,5
38582,MilesZS,,1,23,32,55
38583,abroch,,1,85,7,92
38584,ceroptera,,1,50,2,52
38585,xach,,1,236,99,335
38586,wolker,,1,1,2,3
38587,cripister,,1,17,3,20
38588,Green84,,1,1592,8,1600
38589,thomasknowland,,1,21,20,41
38590,grimascent,,1,17,22,39
38591,dolladollabill,,1,18,24,42
38592,spamgobbler,,1,1,1,2
38593,growthy,,1,44,14,58
38594,juicyjames,,1,80,21,101
38595,orn,,1,27,29,56
38596,mrdarrenh,,1,35,59,94
38597,troublestarts,,1,132,231,363
38598,maddAddam,,1,10,12,22
38599,maketv,,1,3,1,4
38600,chrisrhee,,1,10,6,16
38601,TheVietnamWar,,1,2,2,4
38602,UpFromTheGut,,1,2,2,4
38603,thesunshinelive,,1,7,18,25
38604,ethicsfirst,,1,10,16,26
38605,ele7ven,,1,16,27,43
38606,Bytes_U,,1,1,5,6
38607,nicolaas86,,1,12,9,21
38608,RampagingRobots,,1,2,4,6
38609,emc2rae,,1,140,130,270
38610,pneuskool,,1,7,16,23
38611,macrohawk,,1,2,4,6
38612,kwh,,1,632,966,1598
38613,Laminar,,1,83,143,226
38614,rubyruy,,1,11,13,24
38615,bflaug32,,1,1,2,3
38616,pkulak,,1,135,108,243
38617,Hero_In,,1,3,3,6
38618,xexers,,1,1,1,2
38619,OneEyedSnake,,1,38,20,58
38620,miguelxt,,1,20,23,43
38621,Rod_Stewart,,1,13,16,29
38622,seamonkey,,1,2,1,3
38623,jeppr,,1,52,39,91
38624,eatenbyagrue,,1,5,7,12
38625,milkk,,1,17,11,28
38626,gunn666,,1,2,2,4
38627,ealfert,,1,1,3,4
38628,Beriadan,,1,23,37,60
38629,selrahc,,1,56,61,117
38630,plasticquart,,1,91,82,173
38631,nice_halibut,,1,21,27,48
38632,Web_Weasel,,1,16,46,62
38633,pseudosinusoid,,1,12,25,37
38634,ghostlikeswayze,,1,1,1,2
38635,mastershan,,1,3,1,4
38636,muddyalcapones,,1,52,61,113
38637,Shooter,,1,9,5,14
38638,hemetae,,1,76,118,194
38639,Kvetch,,1,12,30,42
38640,badalchemy,,1,23,18,41
38641,bperki8,,1,2,1,3
38642,Garak,,1,316,356,672
38643,ffox28,,1,2,2,4
38644,z0ot,,1,3,8,11
38645,bottom_punch_fu,,1,1,1,2
38646,seabre,,1,326,347,673
38647,expressn,,1,2,7,9
38648,adamjohnson,,1,2,4,6
38649,an7agonist,,1,304,88,392
38650,michpeo,,1,1,2,3
38651,mcdonc,,1,2,4,6
38652,smwhit,,1,2,2,4
38653,jonr,,1,182,258,440
38654,freegamer,,1,10,4,14
38655,reg_1013,,1,1,3,4
38656,hoopycat,,1,16,26,42
38657,wrongguy,,1,1,2,3
38658,datarefuge,,1,63,81,144
38659,itookwhite,,1,5,3,8
38660,jopari,,1,144,123,267
38661,etuxr,,1,10,13,23
38662,ivegotabetteridea,,1,1,1,2
38663,izrits0122,,1,22,23,45
38664,rampantbaboon,,1,4,7,11
38665,julesjacobs,,1,94,102,196
38666,IrishYankee,,1,11,1,12
38667,njetx,,1,56,17,73
38668,webauteur,,1,31,34,65
38669,Kindswinth,,1,29,29,58
38670,oscaronw,,1,3,12,15
38671,rome425,,1,122,140,262
38672,TheRussianFunk,,1,30,67,97
38673,grayputer,,1,6,6,12
38674,Haiku_attack,,1,3,7,10
38675,corjello,,1,1,1,2
38676,SecretAgentMan,,1,2,1,3
38677,Morgin_Black,,1,77,185,262
38678,ciresica,,1,2,2,4
38679,steverrb,,1,2,4,6
38680,Neuropolis,,1,98,106,204
38681,swyyft,,1,4,3,7
38682,unwind-protect,,1,12,6,18
38683,Matzerath,,1,2,7,9
38684,gunigugu,,1,1,1,2
38685,ka62c,,1,254,306,560
38686,dshipp,,1,6,10,16
38687,newfam1,,1,66,165,231
38688,talsit,,1,6,14,20
38689,totalcrap,,1,2,1,3
38690,kpw,,1,7,13,20
38691,thirdwave,,1,1,2,3
38692,yaserbuntu,,1,38,3,41
38693,GarethNZ,,1,1,7,8
38694,ankzap,,1,4,6,10
38695,poeticTroll,,1,3,3,6
38696,darkempath,,1,38,53,91
38697,zentimo,,1,15,1,16
38698,dminor,,1,2,3,5
38699,dest83,,1,1,1,2
38700,spacedout83,,1,5,2,7
38701,heretik,,1,3,8,11
38702,skaun,,1,15,24,39
38703,ihuk,,1,1,1,2
38704,ruddybaby,,1,1,3,4
38705,jtxx000,,1,62,67,129
38706,furtivefelon,,1,14,5,19
38707,spt48,,1,1,1,2
38708,pjdelport,,1,116,163,279
38709,submanifold,,1,33,23,56
38710,luckychicken,,1,3,3,6
38711,caseigl,,1,2,2,4
38712,Sisyphean,,1,1,1,2
38713,Daewwoo,,1,4,14,18
38714,lftjoinsbitches,,1,1,1,2
38715,jaargon,,1,3,7,10
38716,PhilR8,,1,37,44,81
38717,BrooksMoses,,1,2,11,13
38718,jhaluska,,1,73,128,201
38719,eruwaedhiel,,1,4,4,8
38720,Luke2012,,1,60,83,143
38721,bag-o-tricks,,1,1,4,5
38722,fuckedtwo,,1,3,3,6
38723,bayes,,1,5,3,8
38724,postjack,,1,1,1,2
38725,flit,,1,7,8,15
38726,whackker,,1,2,16,18
38727,atomic_rabbit,,1,77,88,165
38728,smeag0l,,1,1,1,2
38729,l124rd,,1,1,5,6
38730,qpwoei,,1,103,94,197
38731,andhelostthem,,1,444,312,756
38732,henry518,,1,44,26,70
38733,arbitus,,1,2,2,4
38734,SearchStudent,,1,2,4,6
38735,null_value,,1,52,80,132
38736,robbutto,,1,72,101,173
38737,kennethlove,,1,4,1,5
38738,ARS_,,1,700,64,764
38739,crapuser431,,1,1,3,4
38740,savage_zombie,,1,14,19,33
38741,skreed,,1,9,21,30
38742,newberry,,1,2,2,4
38743,BritainRitten,,1,11,22,33
38744,NiHao,,1,102,276,378
38745,SirSanfordFleming,,1,4,1,5
38746,skbelile,,1,1,1,2
38747,xDcSx,,1,2,5,7
38748,evvk,,1,15,17,32
38749,desmond_tutu,,1,4,2,6
38750,GreenGod,,1,11,10,21
38751,ioxoi,,1,24,57,81
38752,DebtOn,,1,378,566,944
38753,miroxy,,1,2,1,3
38754,DrunkMonkey,,1,54,95,149
38755,joeschmoe99,,1,2,1,3
38756,ZennouRyuu,,1,13,7,20
38757,joopjoob,,1,14,3,17
38758,oconnor0,,1,7,13,20
38759,lenny247,,1,27,33,60
38760,penyaskito,,1,3,3,6
38761,roryl,,1,101,155,256
38762,themac77,,1,23,16,39
38763,national_bee_council,,1,49,80,129
38764,FatherMario,,1,4,4,8
38765,thedopeness,,1,95,154,249
38766,ryuujin,,1,1,1,2
38767,samanthagreen,,1,3,8,11
38768,Parmeniooo,,1,40,53,93
38769,tdoris,,1,18,5,23
38770,Jimmy,,1,401,500,901
38771,mrevelle,,1,9,20,29
38772,vampirate,,1,7,23,30
38773,atkuku,,1,1,1,2
38774,eqweqewq,,1,2,2,4
38775,Dmitrius22,,1,58,90,148
38776,ericnicolaas,,1,16,1,17
38777,brick_tamblin,,1,1,1,2
38778,gnewsuk,,1,8,5,13
38779,acorscadden,,1,15,12,27
38780,SunnyDLight,,1,2,3,5
38781,GeorgeWLincoln,,1,3,1,4
38782,jl1987,,1,22,31,53
38783,RedditingDrunk,,1,1,2,3
38784,dadamyata,,1,4,1,5
38785,Nikola_S,,1,387,537,924
38786,MoonMan99,,1,2,5,7
38787,qpyh2,,1,1,1,2
38788,Draconis_SG,,1,9,17,26
38789,b3378x,,1,37,48,85
38790,pingpants,,1,1,1,2
38791,BrakTalk,,1,18,35,53
38792,Diet_of_Worms,,1,36,49,85
38793,clintonforbes,,1,4,3,7
38794,sunshinegroopie,,1,7,8,15
38795,aphex732,,1,1,3,4
38796,whism,,1,16,9,25
38797,cuffster,,1,4,8,12
38798,sniles,,1,185,257,442
38799,jmackinn,,1,3,4,7
38800,brendanlim,,1,4,3,7
38801,axodys,,1,2,1,3
38802,coloneltribune,,1,36,5,41
38803,brackish_dip,,1,150,102,252
38804,gedekran,,1,1,1,2
38805,lidaliqa,,1,38,43,81
38806,jfurycat,,1,61,95,156
38807,guPPer,,1,29,27,56
38808,frankus,,1,219,98,317
38809,jamietheking,,1,1,3,4
38810,Crizack,,1,12,21,33
38811,pryans,,1,2,4,6
38812,randroid,,1,470,621,1091
38813,flex_strongo,,1,5,13,18
38814,Hendronix,,1,1,1,2
38815,epriest,,1,8,9,17
38816,Cloud9,,1,20,49,69
38817,klaruz,,1,15,22,37
38818,StinkiePhish,,1,10,12,22
38819,alancabra,,1,1,1,2
38820,SouthFresh,,1,1,2,3
38821,ratn9ne,,1,2,1,3
38822,noidi,,1,8,11,19
38823,ArtificialMorality,,1,3,6,9
38824,justo,,1,2,3,5
38825,dialmaster,,1,7,5,12
38826,shardex,,1,6,1,7
38827,robertfischer,,1,9,11,20
38828,nightbiscuit,,1,201,271,472
38829,snozzberries,,1,229,32,261
38830,nazghash,,1,2,5,7
38831,accurepl,,1,11,3,14
38832,katanoki,,1,2,3,5
38833,wilsonfrisk,,1,5,2,7
38834,Vorsic,,1,12,26,38
38835,garc,,1,5,6,11
38836,snakeshands,,1,1,1,2
38837,corripio,,1,10,6,16
38838,flkdsjflsd,,1,10,12,22
38839,TangoWhisky,,1,8,14,22
38840,whencowsattack99,,1,3,7,10
38841,poukies,,1,2,3,5
38842,nhkenn,,1,97,162,259
38843,cg84,,1,14,4,18
38844,VeryApe,,1,5,5,10
38845,gondie644,,1,5,8,13
38846,duxx,,1,2,2,4
38847,ochizon,,1,15,33,48
38848,starskii,,1,41,1,42
38849,osteele,,1,2,1,3
38850,mrsnugglecow,,1,11,2,13
38851,Trey4,,1,9,3,12
38852,mr_libro,,1,16,14,30
38853,seawaves,,1,1585,26,1611
38854,fartknocker1,,1,47,59,106
38855,abrogate,,1,80,81,161
38856,katacrow,,1,26,21,47
38857,cdigioia,,1,27,21,48
38858,jhoomba,,1,33,2,35
38859,danielandrews,,1,27,59,86
38860,imk,,1,349,347,696
38861,101176,,1,6,4,10
38862,crawford_,,1,17,18,35
38863,fockzhound,,1,62,70,132
38864,akie,,1,90,69,159
38865,jammag,,1,411,7,418
38866,Propane,,1,56,28,84
38867,columbusguy,,1,537,1,538
38868,lloydsparkes,,1,4,5,9
38869,mots,,1,1,1,2
38870,jaazzman,,1,104,203,307
38871,jerleo,,1,1,1,2
38872,scorpion032,,1,40,30,70
38873,delcielo,,1,5,4,9
38874,ZCEREAL,,1,3,1,4
38875,people4power,,1,27,4,31
38876,Darth_Vader,,1,1,2,3
38877,john_amendall,,1,1,1,2
38878,chopchop2,,1,1,3,4
38879,ryg,,1,2,1,3
38880,redditer007,,1,2,5,7
38881,wodon,,1,16,9,25
38882,trominos,,1,140,30,170
38883,algernonymous,,1,3,3,6
38884,demosthenes02,,1,125,110,235
38885,Imperator,,1,75,126,201
38886,donkokse,,1,4,12,16
38887,uioreanu,,1,44,53,97
38888,BigPopaGamer,,1,2,4,6
38889,greenmonstah,,1,1,1,2
38890,stormmaster83,,1,3,5,8
38891,jsober,,1,12,7,19
38892,sasayins,,1,1,1,2
38893,ryles,,1,24,53,77
38894,jimejim,,1,10,16,26
38895,rollbiz,,1,6,13,19
38896,superphly,,1,15,2,17
38897,Communism,,1,1,2,3
38898,sjwalter,,1,3,3,6
38899,trnelson,,1,511,458,969
38900,mediea,,1,1,1,2
38901,vajav,,1,1624,1206,2830
38902,justbigenuffgov,,1,2,3,5
38903,adam-d,,1,2,4,6
38904,riffraff,,1,7,13,20
38905,ioerror,,1,1,3,4
38906,jarts,,1,28,6,34
38907,turnip,,1,9,7,16
38908,klemon,,1,4,8,12
38909,MegaPerv,,1,1,1,2
38910,middkidd,,1,48,47,95
38911,karifrances,,1,10,7,17
38912,Cataclysm,,1,41,65,106
38913,ebola,,1,114,270,384
38914,sparkleyflowers,,1,3,6,9
38915,kitkatkitkat,,1,78,102,180
38916,thatguy5057,,1,2,1,3
38917,Sergiykov,,1,1,1,2
38918,JMCtg,,1,19,23,42
38919,Augzodia,,1,6,3,9
38920,normanspencer,,1,22,21,43
38921,rahuls,,1,68,16,84
38922,this_movie_sucks,,1,1,2,3
38923,bloobloobloo,,1,2,3,5
38924,samurai_cyborg,,1,32,28,60
38925,gavinElster,,1,1,1,2
38926,inthemedium,,1,8,6,14
38927,Livpaamars,,1,2,1,3
38928,lvaruzza,,1,1,3,4
38929,AngelaMotorman,,1,567,962,1529
38930,powarblasta5000,,1,6,13,19
38931,annasaru,,1,18,35,53
38932,commentatorwannabe,,1,1,1,2
38933,gnfknr,,1,15,12,27
38934,lilspikey,,1,13,11,24
38935,ElLechero,,1,6,22,28
38936,LordVoldemort,,1,462,548,1010
38937,srv,,1,522,437,959
38938,ipsofacto,,1,15,7,22
38939,dtallee,,1,83,77,160
38940,wmleler,,1,372,67,439
38941,dontaskagain,,1,2,4,6
38942,jinki,,1,11,2,13
38943,famousde,,1,8,2,10
38944,ChaosChaser,,1,3,3,6
38945,Gorty,,1,5,4,9
38946,pactivate,,1,40,9,49
38947,nroht,,1,1,1,2
38948,Militree,,1,74,30,104
38949,theregoesjulie,,1,205,339,544
38950,Becco,,1,2,1,3
38951,Inferno,,1,66,128,194
38952,floriang,,1,31,35,66
38953,dak1486,,1,21,35,56
38954,plin,,1,20,10,30
38955,brettsplace,,1,1,5,6
38956,tofutu,,1,5,5,10
38957,pkenjora,,1,44,6,50
38958,DallasRPI,,1,22,2,24
38959,hobiwan,,1,22,42,64
38960,kmanracer,,1,2,2,4
38961,triconda,,1,5,4,9
38962,valera,,1,45,75,120
38963,christ_blowz,,1,3,3,6
38964,sethmonster,,1,1,2,3
38965,doktormabuse,,1,29,54,83
38966,jrfulbright,,1,75,56,131
38967,adimoga,,1,67,23,90
38968,dicroce,,1,1,1,2
38969,Gryph0n,,1,1,2,3
38970,sanimalp,,1,317,441,758
38971,ILoveLucy,,1,35,4,39
38972,defunkt,,1,10,2,12
38973,pdc,,1,275,93,368
38974,schlurp,,1,6,9,15
38975,everythingtwice,,1,3,6,9
38976,dww142,,1,5,1,6
38977,iNaNimAtE,,1,4,3,7
38978,tizz66,,1,54,56,110
38979,chuey_74,,1,1,2,3
38980,phuc_head,,1,1,7,8
38981,holyteach,,1,3,1,4
38982,cruzin,,1,18,32,50
38983,clumma,,1,156,253,409
38984,patrickyeon,,1,35,25,60
38985,yef99,,1,23,5,28
38986,DreamoftheEndless,,1,161,269,430
38987,funfunfun,,1,6,4,10
38988,papasmirk,,1,4,10,14
38989,prunetracy,,1,29,43,72
38990,concerned_citizen,,1,4,4,8
38991,sansphelps,,1,10,3,13
38992,nfrost,,1,3,9,12
38993,altaccount123,,1,39,2,41
38994,6562dp,,1,4,10,14
38995,tjcannon,,1,9,9,18
38996,OtengiM,,1,1,2,3
38997,Gobrite,,1,4,3,7
38998,ace2cloud,,1,4,2,6
38999,Pennifred,,1,2,4,6
39000,faol,,1,1,2,3
39001,ninpuukamui,,1,12,25,37
39002,soxy,,1,3,3,6
39003,peachykaren,,1,7,2,9
39004,matthewtb,,1,42,18,60
39005,chris083210,,1,18,4,22
39006,wally4711,,1,38,16,54
39007,HangedMan,,1,1,2,3
39008,ch00f,,1,1334,785,2119
39009,JoeWatchDog,,1,1,1,2
39010,gdm9000,,1,17,23,40
39011,bckids1208,,1,57,28,85
39012,triblady,,1,13,3,16
39013,bobwalker,,1,2,1,3
39014,GoAskAlice,,1,1,3,4
39015,stou,,1,7,7,14
39016,brickcheney,,1,2,1,3
39017,clamothe,,1,4,5,9
39018,jersey_emt,,1,1,1,2
39019,cavadela,,1,40,26,66
39020,chucker23n,,1,29,24,53
39021,spiffiness,,1,10,14,24
39022,d46ron1337,,1,2,2,4
39023,xandercruise,,1,27,7,34
39024,data64,,1,2,1,3
39025,jerryjacky,,1,7,1,8
39026,psyph3r,,1,1,1,2
39027,sean_m_flannery,,1,31,1,32
39028,agsinger,,1,3,11,14
39029,paranormal,,1,1,1,2
39030,theycallhimdon,,1,2,3,5
39031,hfreanzr,,1,3,4,7
39032,laniik,,1,3,2,5
39033,Etni3s,,1,33,29,62
39034,Smellypuce,,1,12,39,51
39035,YourLettersStink,,1,3,7,10
39036,rahvin1,,1,3,10,13
39037,pmrx,,1,7,7,14
39038,bozohiggs,,1,8,2,10
39039,moldycricket,,1,1,1,2
39040,maskaler,,1,2,9,11
39041,theninjagreg,,1,4,4,8
39042,petrux,,1,47,8,55
39043,harvesteroftruth,,1,400,82,482
39044,hynkle,,1,190,261,451
39045,noflashlight,,1,84,68,152
39046,junglecat,,1,52,4,56
39047,boeuf,,1,20,31,51
39048,JoshTwolittle,,1,1,3,4
39049,zbelljegger,,1,13,18,31
39050,darxkies,,1,1,3,4
39051,admiral-zombie,,1,94,91,185
39052,kidmotors,,1,8,5,13
39053,JonAmonster,,1,6,4,10
39054,ncontorno,,1,58,7,65
39055,earthboundchild2,,1,2,3,5
39056,delelles,,1,520,24,544
39057,kennethgack,,1,16,14,30
39058,suzane,,1,1,2,3
39059,owlMaster,,1,1,1,2
39060,scott9380,,1,3,4,7
39061,Brahma111,,1,2,5,7
39062,HenryJonesJr,,1,6,10,16
39063,axel618,,1,2,5,7
39064,seanadb,,1,2,8,10
39065,spookycox,,1,2,14,16
39066,homergonerson,,1,24,76,100
39067,rb2k,,1,29,40,69
39068,mtVessel,,1,62,99,161
39069,Demikhov,,1,9,1,10
39070,tacyppah,,1,10,15,25
39071,utbandit,,1,1438,808,2246
39072,asdlfkjweioruwersdkl,,1,5,18,23
39073,cbob27410,,1,3,2,5
39074,jae3Zu7r,,1,2,1,3
39075,who8877,,1,12,13,25
39076,jpcooper,,1,24,25,49
39077,booster_flush,,1,6,6,12
39078,facingup,,1,6,7,13
39079,bradleydsmith,,1,1,1,2
39080,choppinbroccoli,,1,12,14,26
39081,JoePenn,,1,8,3,11
39082,funkybob,,1,8,12,20
39083,Reddit-is-ruined,,1,18,26,44
39084,slackerIII,,1,100,18,118
39085,AntisemitismIsEvil,,1,6,4,10
39086,neandorman,,1,66,127,193
39087,FixedThatForYou,,1,3,9,12
39088,ender422,,1,2,7,9
39089,cpwtf,,1,14,21,35
39090,rastafurfarian,,1,11,20,31
39091,felipec,,1,1,2,3
39092,schadwick,,1,1,1,2
39093,quirked,,1,90,62,152
39094,silviot,,1,37,21,58
39095,rodimius,,1,23,17,40
39096,free_julie_amero,,1,94,20,114
39097,CaveMike,,1,24,36,60
39098,circusricardo,,1,4,4,8
39099,cejung,,1,1,1,2
39100,PatrickLeahy,,1,33,50,83
39101,JuliusH,,1,7,9,16
39102,shmendrick,,1,8,14,22
39103,Ostrich159,,1,206,178,384
39104,nedbatchelder,,1,1,2,3
39105,ma1kel,,1,89,136,225
39106,snookums,,1,1115,1005,2120
39107,sh33ple,,1,59,76,135
39108,religionvirus,,1,81,1,82
39109,r3x4h,,1,9,18,27
39110,afaik,,1,9,19,28
39111,Time2paint,,1,1,1,2
39112,onewatt,,1,1,1,2
39113,jarvolt,,1,11,8,19
39114,nigret,,1,4,2,6
39115,bswen,,1,97,3,100
39116,svnftgmp,,1,94,7,101
39117,screamsionara,,1,32,51,83
39118,cluster1,,1,8,19,27
39119,friscobob,,1,81,49,130
39120,nerdlor,,1,12,11,23
39121,Chalax,,1,1,2,3
39122,writetoalok,,1,20,16,36
39123,L33tminion,,1,50,95,145
39124,Ellusive,,1,4,4,8
39125,IrmatDen,,1,1,1,2
39126,monkjunkie,,1,2,3,5
39127,tahirbutt,,1,3,1,4
39128,sobriquet,,1,2,4,6
39129,farthinder,,1,49,24,73
39130,beader,,1,9,3,12
39131,Zolty,,1,19,43,62
39132,Paisano1,,1,85,14,99
39133,mkosmo,,1,1,2,3
39134,ohcroatia,,1,16,2,18
39135,brandonthebuck,,1,5,7,12
39136,LuciferH,,1,83,76,159
39137,cryariver,,1,39,75,114
39138,rzocee,,1,1,3,4
39139,Hinstavonin,,1,2,4,6
39140,Daph,,1,7,16,23
39141,heinb,,1,1,1,2
39142,jamesturk,,1,86,20,106
39143,pineappleye,,1,1,5,6
39144,SumErgoCogito,,1,1,1,2
39145,bexmex,,1,1,3,4
39146,prominairy,,1,1,3,4
39147,jprice,,1,8,11,19
39148,makismagoo99,,1,6,6,12
39149,toosas,,1,10,33,43
39150,SterlingCamden5,,1,7,4,11
39151,BossHat,,1,34,55,89
39152,HPIguy,,1,5,3,8
39153,bladeforge,,1,7,7,14
39154,Zepp,,1,2,1,3
39155,whi73rav3n,,1,384,4,388
39156,nickelplate,,1,2,5,7
39157,jgfoot,,1,9,6,15
39158,Killerkirby,,1,4,2,6
39159,FightTheFED,,1,5,7,12
39160,Anthet,,1,3,6,9
39161,majeric,,1,2,4,6
39162,justinmk,,1,68,92,160
39163,postdarwin,,1,249,512,761
39164,JpMaxMan,,1,3,1,4
39165,diso2,,1,1,4,5
39166,robotnixon,,1,237,277,514
39167,moseeds,,1,5,13,18
39168,quraid,,1,40,54,94
39169,jrobelen,,1,285,209,494
39170,phq,,1,1,4,5
39171,pullo,,1,2,3,5
39172,housingbear2007,,1,600,56,656
39173,bitchbang,,1,1,4,5
39174,FarwellRob,,1,1,4,5
39175,Ra____,,1,3,4,7
39176,mageling,,1,35,26,61
39177,FamousMortimer,,1,146,96,242
39178,scoreboard,,1,489,40,529
39179,jamesinraro,,1,59,56,115
39180,DBoone,,1,1,1,2
39181,strider24,,1,1,3,4
39182,jingle2020,,1,21,3,24
39183,Chief123,,1,2,2,4
39184,tmcmh,,1,2,1,3
39185,maceelk,,1,56,60,116
39186,achilles,,1,560,215,775
39187,willia4,,1,12,25,37
39188,DougBTX,,1,1,2,3
39189,indieaz,,1,4,4,8
39190,thedollarisdead,,1,39,15,54
39191,DWRoelands,,1,70,48,118
39192,transisto,,1,22,45,67
39193,lteo,,1,12,7,19
39194,abscissa,,1,9,7,16
39195,saveusjesus,,1,2,1,3
39196,detbar,,1,2,4,6
39197,0sn,,1,44,85,129
39198,matthia,,1,1,3,4
39199,PatRiot21,,1,8,6,14
39200,behemothaur,,1,90,139,229
39201,YasserM,,1,12,17,29
39202,Relativity,,1,2,1,3
39203,ab3nnion,,1,277,395,672
39204,HankScorpioJr,,1,1,1,2
39205,swindler,,1,7,3,10
39206,ra1ndr0p,,1,1,3,4
39207,Codebender,,1,636,957,1593
39208,Hangshai,,1,1,1,2
39209,Kaneda,,1,2,3,5
39210,elsalgo,,1,43,54,97
39211,ubernoggin,,1,164,5,169
39212,Ron_Artest,,1,1,1,2
39213,TruLiberal,,1,51,1,52
39214,dfrifrifri,,1,3,2,5
39215,pinkfan66,,1,1,2,3
39216,OMouse,,1,1004,1204,2208
39217,nataliezmama,,1,1,2,3
39218,reallystatic,,1,2,1,3
39219,boondoggle,,1,2,1,3
39220,marsvolta,,1,20,21,41
39221,jeargle,,1,5,11,16
39222,k4f123,,1,2,1,3
39223,raven737,,1,3,2,5
39224,boogiepop,,1,1,1,2
39225,DrMabuse,,1,4,6,10
39226,TheGreatOldOne,,1,3,1,4
39227,robotrampage,,1,1,2,3
39228,goodbyeworld,,1,573,323,896
39229,charminggeek,,1,203,110,313
39230,chanko,,1,1,2,3
39231,msisaves,,1,1,1,2
39232,vestige,,1,2,3,5
39233,greyox,,1,24,27,51
39234,IO-_-OI,,1,9,11,20
39235,johnm,,1,84,22,106
39236,yuuuuasdlasd,,1,1,1,2
39237,JonathanHarford,,1,688,526,1214
39238,tirador,,1,4,1,5
39239,zorplex,,1,1,1,2
39240,yt314,,1,30,7,37
39241,ccondon,,1,5,9,14
39242,kickelephant,,1,1,1,2
39243,quinientos_uno,,1,17,24,41
39244,ajfa,,1,18,19,37
39245,PlantfoodCuisinart,,1,24,47,71
39246,Alvina,,1,1,1,2
39247,ujewbot,,1,4,5,9
39248,Sigmalmtd,,1,8,3,11
39249,kittychow,,1,9,13,22
39250,BuddyJ,,1,4,1,5
39251,h0ju,,1,1,1,2
39252,arnimann,,1,6,2,8
39253,Tiabin,,1,149,255,404
39254,ecuzzillo,,1,6,6,12
39255,cunningbanana,,1,17,33,50
39256,phoenix42,,1,1,2,3
39257,bldl,,1,2,2,4
39258,PocketOSunshine,,1,18,37,55
39259,btgoss,,1,43,53,96
39260,redsarmy,,1,7,3,10
39261,unexpected,,1,28,22,50
39262,sdflbiy,,1,2,2,4
39263,cheetor,,1,26,24,50
39264,orDover,,1,2,1,3
39265,Wallywart,,1,19,31,50
39266,RobotAdam,,1,9,10,19
39267,Nex3,,1,8,6,14
39268,01208500,,1,1,3,4
39269,art_ross54,,1,3,2,5
39270,captainron,,1,72,168,240
39271,aadnk,,1,6,10,16
39272,joxenford,,1,7,3,10
39273,fluffnfluff,,1,2,3,5
39274,romerom,,1,20,12,32
39275,Fitcheron,,1,131,22,153
39276,scrambrad,,1,1,2,3
39277,bubba_the_cat,,1,18,9,27
39278,CommonTater,,1,2,3,5
39279,Defektiv,,1,333,540,873
39280,entropyfu,,1,22,55,77
39281,msbunky,,1,2,4,6
39282,plutocrat,,1,203,136,339
39283,Rosenthal,,1,3,7,10
39284,ih8evilstuff,,1,268,384,652
39285,xenoguy,,1,61,38,99
39286,nbrntrt,,1,2,3,5
39287,primo44,,1,1,2,3
39288,throwaway2,,1,1,2,3
39289,eichenlaub,,1,16,20,36
39290,infin,,1,40,80,120
39291,slicedbread,,1,90,133,223
39292,kathologist,,1,21,33,54
39293,mitr,,1,24,38,62
39294,drew1234567890,,1,81,6,87
39295,Frohizzle,,1,2,2,4
39296,night0wl,,1,2,3,5
39297,n3wtz,,1,107,93,200
39298,daesun,,1,5,1,6
39299,vtgorilla,,1,36,35,71
39300,rhsumner,,1,4,7,11
39301,Nogwater,,1,14,11,25
39302,jrsmith,,1,4,8,12
39303,Nordlibris,,1,2,3,5
39304,Guns-to-ploughshares,,1,18,21,39
39305,limitbreakerx,,1,3,2,5
39306,mpeters,,1,7,1,8
39307,extemporaneous,,1,2,2,4
39308,khatcin,,1,6,8,14
39309,entor,,1,411,466,877
39310,dropfry,,1,89,95,184
39311,mclin,,1,23,32,55
39312,Mugger15,,1,1,1,2
39313,psylon,,1,66,31,97
39314,wilse,,1,62,46,108
39315,matthewhughes,,1,5,1,6
39316,_bruce_,,1,1,1,2
39317,maynoth,,1,21,22,43
39318,Montage,,1,3,1,4
39319,Quasigoto,,1,7,13,20
39320,Doomed,,1,233,264,497
39321,JeffBlancoII,,1,2,6,8
39322,HaveSomeSTFU,,1,1,3,4
39323,werehippy,,1,3,7,10
39324,urababoon,,1,6,1,7
39325,edavis,,1,103,24,127
39326,courane01,,1,1,1,2
39327,tjm5501,,1,2,3,5
39328,BCHarvey,,1,67,148,215
39329,aantix,,1,29,30,59
39330,MisterSquishy,,1,14,3,17
39331,hunterorion,,1,21,30,51
39332,nkktwotwozero,,1,241,267,508
39333,fjarlq,,1,6,3,9
39334,uglytime,,1,1,1,2
39335,iamamartian,,1,6,1,7
39336,EmptyTon,,1,25,41,66
39337,Baboso,,1,7,30,37
39338,ProfessorOY,,1,1,1,2
39339,godgavemeafacial,,1,17,13,30
39340,iampivot,,1,8,2,10
39341,rtpmatt,,1,20,18,38
39342,Kyleaxe,,1,12,37,49
39343,CelebritySexyWhite,,1,1,2,3
39344,astrashe,,1,2,4,6
39345,matlyles,,1,4,4,8
39346,cmatthias,,1,1,3,4
39347,matsie,,1,1,1,2
39348,Sobchak,,1,3,2,5
39349,IIGrudge,,1,62,113,175
39350,alsiola,,1,17,3,20
39351,randomredditor,,1,2,2,4
39352,tarla,,1,21,19,40
39353,required3,,1,98,104,202
39354,venuism,,1,3,3,6
39355,pholden,,1,3,9,12
39356,oldmanjank,,1,1,4,5
39357,Capulan,,1,17,17,34
39358,toddly,,1,2,1,3
39359,kamaloo,,1,1213,100,1313
39360,rvqbl,,1,2,1,3
39361,sillysir,,1,3,10,13
39362,edf,,1,1,2,3
39363,higdonius,,1,3,5,8
39364,penprthesword,,1,86,38,124
39365,Octoguy,,1,11,15,26
39366,dnewstep,,1,1,1,2
39367,frickel,,1,160,268,428
39368,aigenarn,,1,9,10,19
39369,arthurujm,,1,1,4,5
39370,oakmac,,1,9,4,13
39371,thcman420,,1,5,3,8
39372,derivative,,1,1,3,4
39373,james_taylor,,1,17,5,22
39374,not-my-username,,1,1,1,2
39375,adampieniazek,,1,507,304,811
39376,Lyrell,,1,2,1,3
39377,EvilKarl,,1,1,3,4
39378,dave84,,1,4,9,13
39379,logi,,1,4,10,14
39380,earthboundkid,,1,1148,725,1873
39381,magookle,,1,1,2,3
39382,alamandrax,,1,136,233,369
39383,Moodle,,1,10,13,23
39384,thelawenforcer,,1,35,70,105
39385,jPurch,,1,8,8,16
39386,kennyreborn,,1,20,25,45
39387,limegreenhero,,1,17,8,25
39388,Shloppy,,1,2,3,5
39389,oth3r,,1,2,1,3
39390,stf210,,1,22,6,28
39391,drdolgoldur,,1,1,1,2
39392,durandal,,1,23,30,53
39393,bronco92,,1,14,30,44
39394,sdbear,,1,21,75,96
39395,b4freedom,,1,21,29,50
39396,smj,,1,3,2,5
39397,brassmonkeys,,1,1,1,2
39398,Venti,,1,1,2,3
39399,agave1968,,1,18,9,27
39400,cmvkk,,1,7,3,10
39401,Cronx,,1,1,1,2
39402,rlee0001,,1,164,221,385
39403,Gexus,,1,1,2,3
39404,PenguinOfDoom,,1,3,2,5
39405,bobsil1,,1,197,283,480
39406,Schlaefer,,1,1,2,3
39407,GreenWire,,1,1,1,2
39408,parla,,1,83,105,188
39409,cap0319,,1,8,7,15
39410,Cmdrfrog,,1,2,1,3
39411,drpocter,,1,1,2,3
39412,MTsoul,,1,16,4,20
39413,nationalizer,,1,4,1,5
39414,Millsley,,1,3,5,8
39415,Kemuel,,1,23,41,64
39416,mattroid,,1,2,1,3
39417,DuncanSmart,,1,58,17,75
39418,Mapex2323,,1,11,36,47
39419,sdgfawefawef,,1,1,1,2
39420,eaturbrainz,,1,1008,1867,2875
39421,quilby,,1,8,1,9
39422,yayhooray,,1,7,8,15
39423,mjpboi,,1,3,3,6
39424,maddvibe,,1,4,9,13
39425,scirocco,,1,7,6,13
39426,rio_web,,1,1,3,4
39427,king_felix,,1,30,39,69
39428,radioRaheem,,1,89,152,241
39429,selfish_meme,,1,35,23,58
39430,peter_kay,,1,1,1,2
39431,srkiboy,,1,8,2,10
39432,absolutkaos,,1,32,9,41
39433,timtux,,1,9,13,22
39434,foodcoop,,1,3,7,10
39435,nerve,,1,42,63,105
39436,organicboy,,1,12,1,13
39437,kafitz22,,1,11,8,19
39438,yurtra,,1,1,1,2
39439,RckmRobot,,1,103,46,149
39440,robofunk,,1,65,76,141
39441,carnieguy,,1,11,1,12
39442,realnewworldorder,,1,30,34,64
39443,jbellis,,1,222,245,467
39444,dmdm,,1,6,4,10
39445,DonGiulio,,1,43,6,49
39446,markelliott,,1,80,110,190
39447,686,,1,5,1,6
39448,Sanit,,1,2,2,4
39449,syuk,,1,162,215,377
39450,TheFoxHound,,1,2,1,3
39451,hyperspeed,,1,38,22,60
39452,jpeirce,,1,166,16,182
39453,CatCrap,,1,11,12,23
39454,ow3n,,1,51,66,117
39455,Typhlosion,,1,2,4,6
39456,45bur,,1,35,54,89
39457,gspot113,,1,16,21,37
39458,aramach,,1,1,2,3
39459,cowboy_k,,1,2,4,6
39460,hipnerd,,1,4,2,6
39461,invisibleandpink,,1,1,1,2
39462,redditIsBecomingSh1t,,1,2,1,3
39463,sex_in_the_face,,1,37,61,98
39464,Ender0910,,1,15,10,25
39465,exSO2,,1,3,7,10
39466,TooSmugToFail,,1,11,33,44
39467,lkir,,1,2,2,4
39468,sandiegojoe,,1,93,114,207
39469,ayamami,,1,1,30,31
39470,piratenaapje,,1,88,33,121
39471,richiverse,,1,15,25,40
39472,c0mpl3x1ty,,1,1,1,2
39473,nathanaver,,1,54,61,115
39474,thetoastyone,,1,20,30,50
39475,Shumina,,1,50,119,169
39476,RiverMise,,1,9,5,14
39477,dya1001,,1,7,4,11
39478,zopster,,1,4,5,9
39479,devision,,1,8,29,37
39480,skyshoes,,1,11,39,50
39481,zachv,,1,101,126,227
39482,treetrouble,,1,13,32,45
39483,Sfmindtrap,,1,18,18,36
39484,paidtopublish,,1,1,1,2
39485,twoplustwoisfive,,1,1,1,2
39486,fotoman,,1,27,61,88
39487,politicalcalcs,,1,2,2,4
39488,realtime24,,1,1,1,2
39489,hdklinke,,1,4,1,5
39490,stealthroot,,1,24,22,46
39491,mralex,,1,253,478,731
39492,mr_mcse,,1,399,511,910
39493,saltyjazz_413,,1,4,3,7
39494,ixx,,1,1,2,3
39495,Fountainhead,,1,598,574,1172
39496,Chelle68691,,1,39,14,53
39497,matatk,,1,7,3,10
39498,b100dian,,1,222,284,506
39499,wtfftw,,1,1,2,3
39500,generic_handle,,1,1415,2646,4061
39501,BrandChopian,,1,78,105,183
39502,xirekaj,,1,139,316,455
39503,shavenwarthog,,1,4,14,18
39504,eastern,,1,10,2,12
39505,lyrabee,,1,1,2,3
39506,soccerman,,1,41,62,103
39507,krabz,,1,1,1,2
39508,honkus,,1,3,4,7
39509,thingsarecontextual,,1,1,1,2
39510,itslarry,,1,4,2,6
39511,londonskater,,1,56,3,59
39512,dhogarty,,1,9,9,18
39513,i77,,1,8,13,21
39514,joo_truther,,1,1,2,3
39515,redhatnation,,1,46,51,97
39516,BrendanCAV,,1,1,2,3
39517,rebus,,1,17,16,33
39518,BarracksRoomLawyer,,1,3,8,11
39519,smurfystar,,1,3,2,5
39520,quantboy,,1,2,8,10
39521,darkenergy,,1,1,2,3
39522,dean,,1,16,11,27
39523,dlfnation,,1,4,2,6
39524,dminternet,,1,2,1,3
39525,gcnovus,,1,1,1,2
39526,Wasted99,,1,106,32,138
39527,darnright,,1,8,2,10
39528,theambassadors,,1,98,25,123
39529,Kroc44,,1,84,67,151
39530,boyhowdy,,1,2,1,3
39531,Temp777,,1,1,1,2
39532,otterley,,1,15,15,30
39533,clovertt,,1,12,26,38
39534,lightstorm,,1,82,17,99
39535,informedcrab,,1,3,5,8
39536,BiggerBalls,,1,54,62,116
39537,emfh,,1,22,24,46
39538,theshame,,1,8,17,25
39539,redchicken2,,1,3,2,5
39540,ftpcharlie,,1,13,12,25
39541,psr111975,,1,2,2,4
39542,lbgrowl,,1,3,1,4
39543,Maj12,,1,6,8,14
39544,kucinich_9000,,1,7,3,10
39545,JamesF,,1,6,8,14
39546,mesmeriffic,,1,13,23,36
39547,nadiasindi,,1,12,1,13
39548,jerrygofixit,,1,334,736,1070
39549,ravickanth,,1,2,3,5
39550,BosAnon,,1,18,7,25
39551,l00pee,,1,16,17,33
39552,weavejester,,1,118,187,305
39553,idontgetit,,1,85,91,176
39554,koobe,,1,17,1,18
39555,kofrad,,1,73,55,128
39556,morelikeprincessdied,,1,1,1,2
39557,xardox,,1,34,36,70
39558,nevinera,,1,329,610,939
39559,jimbokun,,1,185,272,457
39560,armor1,,1,58,75,133
39561,Celsias,,1,243,39,282
39562,anahogben,,1,7,12,19
39563,bicyclemom,,1,46,66,112
39564,slowernet,,1,105,2,107
39565,calebsdaddy,,1,1,3,4
39566,Numberwang,,1,285,65,350
39567,xenopho,,1,163,48,211
39568,btipling,,1,106,22,128
39569,Supdawg,,1,1,1,2
39570,typewriteRrrrr,,1,62,75,137
39571,meloveyoulongtime,,1,104,4,108
39572,897,,1,2,1,3
39573,waywardduck,,1,5,1,6
39574,planetearth,,1,4,3,7
39575,sonofgrace,,1,2,1,3
39576,grimtooth,,1,13,41,54
39577,SeriousDude,,1,1,1,2
39578,SlipstreamInsane,,1,22,31,53
39579,kermityfrog,,1,1141,1997,3138
39580,leolegend,,1,2,2,4
39581,stevefolta,,1,38,43,81
39582,TruthSifter,,1,5,6,11
39583,Greenery,,1,12,7,19
39584,superjj,,1,3,4,7
39585,inkslave,,1,1,2,3
39586,Noneedtopanic,,1,44,137,181
39587,zeal3000,,1,4,11,15
39588,thesuker,,1,2,2,4
39589,ieuryas,,1,1,1,2
39590,helio462,,1,27,40,67
39591,enoughgimmicks,,1,1,2,3
39592,snowman,,1,2,1,3
39593,ostinlt,,1,6,1,7
39594,cargoboy45,,1,48,49,97
39595,dschep,,1,39,69,108
39596,Seyen,,1,52,83,135
39597,grandson,,1,76,2,78
39598,mikedt,,1,39,68,107
39599,abgazelle,,1,1,1,2
39600,neat_stuff,,1,233,392,625
39601,jeykottalam,,1,37,44,81
39602,annadel,,1,7,1,8
39603,redmorgan,,1,2,2,4
39604,rabbitspade,,1,4,10,14
39605,yanksn6,,1,6,12,18
39606,langdog,,1,1,1,2
39607,fuchsia,,1,26,24,50
39608,bradhart,,1,3,2,5
39609,kennytilton,,1,4,11,15
39610,bar_skank,,1,1,1,2
39611,QueenMary,,1,7,6,13
39612,txzuke,,1,2,2,4
39613,lemuelf,,1,2,4,6
39614,Cute_Little_Bunny,,1,1,1,2
39615,jwiz,,1,49,63,112
39616,nemodat,,1,3,2,5
39617,oddbod,,1,30,73,103
39618,DrakeBishoff,,1,104,105,209
39619,talkent,,1,1,1,2
39620,superluminal,,1,18,30,48
39621,historian,,1,17,1,18
39622,telemundo,,1,489,493,982
39623,g33kphr33k,,1,3,5,8
39624,PeeWeePangolin,,1,5,6,11
39625,vinylrichie,,1,15,4,19
39626,canen,,1,32,59,91
39627,treadingwater,,1,9,12,21
39628,808,,1,6,5,11
39629,spinspin,,1,230,383,613
39630,Brecca,,1,101,2,103
39631,ReallyEvilCanine,,1,42,44,86
39632,CheckandBalance,,1,69,95,164
39633,tommy-linux,,1,1,3,4
39634,paperboy187,,1,3,1,4
39635,theaustrian,,1,75,17,92
39636,jamesjoh,,1,16,11,27
39637,iamr00t,,1,8,8,16
39638,hellkeeper71,,1,8,11,19
39639,nkspas,,1,14,3,17
39640,Boeing,,1,3,5,8
39641,CrzyMke,,1,11,15,26
39642,mkbehr,,1,2,5,7
39643,bostonvaulter,,1,389,524,913
39644,lorenzo,,1,7,7,14
39645,Turkilla,,1,2,11,13
39646,azeemforever,,1,2,1,3
39647,cxyl,,1,26,65,91
39648,laketrout,,1,22,13,35
39649,xzxzzx,,1,529,742,1271
39650,bman236,,1,246,261,507
39651,tbotcotw,,1,373,534,907
39652,Athas,,1,109,97,206
39653,Savet,,1,4,2,6
39654,Sleezebug3,,1,9,7,16
39655,bufordt,,1,2,4,6
39656,d4n3,,1,25,22,47
39657,docboss,,1,187,277,464
39658,hiro6380,,1,2,4,6
39659,CaptainObvious,,1,7,15,22
39660,mrsolutions,,1,772,44,816
39661,luckenbach,,1,1,6,7
39662,honahursey,,1,3,5,8
39663,financialbabe,,1,397,4,401
39664,robinhouston,,1,9,2,11
39665,lally,,1,19,26,45
39666,cryanweb,,1,2,1,3
39667,I_downmod_you,,1,1,6,7
39668,aleger,,1,32,15,47
39669,MrShlee,,1,2,2,4
39670,largos,,1,21,33,54
39671,ElloChum,,1,3,2,5
39672,potholesgt,,1,5,7,12
39673,frivol1ty,,1,43,41,84
39674,albatrick,,1,1,1,2
39675,jianlin,,0,2,2,4
39676,soundmoney,,1,3,1,4
39677,Capitalism,,1,73,104,177
39678,ballboing,,1,8,7,15
39679,Senator_Roberts,,1,39,41,80
39680,McCorrr,,1,15,14,29
39681,twoodfin,,1,725,949,1674
39682,peteroc,,1,2,3,5
39683,zedoriah,,1,88,101,189
39684,discohead,,1,20,37,57
39685,Rammer12185,,1,6,8,14
39686,ahuramazda,,1,6,9,15
39687,medium_lebowski,,1,1,1,2
39688,hopeseekr,,1,274,111,385
39689,CakeBomb,,1,6,3,9
39690,OK_Eric,,1,46,78,124
39691,JasperO,,1,11,22,33
39692,smatty1,,1,1128,149,1277
39693,quantax,,1,3,11,14
39694,mattahan,,1,2,9,11
39695,supersan,,1,530,303,833
39696,fgw_three,,1,2,2,4
39697,opunim,,1,1,1,2
39698,dontstopnow,,1,1,5,6
39699,psychicpilot,,1,124,172,296
39700,skitzh0,,1,275,380,655
39701,Michaelabehsera,,1,9,4,13
39702,aduck,,1,4,4,8
39703,catxors,,1,44,70,114
39704,schooch,,1,1,2,3
39705,nat1192,,1,16,22,38
39706,protonfish,,1,33,24,57
39707,macrumpton,,1,95,128,223
39708,sciencegirl,,1,1,3,4
39709,BeliefSuspended2008,,1,2,2,4
39710,swax,,1,6,13,19
39711,xmjmx,,1,8,2,10
39712,Saddam_Hussein,,1,1,3,4
39713,Senseitaco,,1,1,2,3
39714,_-_-_,,1,6,2,8
39715,familygeek,,1,1,1,2
39716,goodanevil,,1,7,8,15
39717,ImpulseControl,,1,1,1,2
39718,jda,,1,14,11,25
39719,GeminiRat,,1,4,7,11
39720,ivirtual,,1,3,9,12
39721,Hixie,,1,150,166,316
39722,perei17354,,1,10,1,11
39723,thegom,,1,23,19,42
39724,kansasgirl18,,1,2,3,5
39725,z4ck,,1,6,2,8
39726,krelian,,1,549,286,835
39727,manchegoo,,1,30,29,59
39728,bentcorner,,1,8,4,12
39729,talhaasifdar,,1,1,1,2
39730,automata,,1,1,1,2
39731,one,,1,37,5,42
39732,psykocrime,,1,12,15,27
39733,crazybus,,1,9,10,19
39734,michaelp,,1,13,9,22
39735,hypermark,,1,7,7,14
39736,Psiplex,,1,1,9,10
39737,hotstyle765,,1,12,11,23
39738,bluephile,,1,1,1,2
39739,TheRovingPoet,,1,2,8,10
39740,drakkar4,,1,170,161,331
39741,dmiv,,1,9,10,19
39742,sdkcsdc,,1,1,3,4
39743,stelund,,1,1,1,2
39744,mockjr,,1,1,1,2
39745,deadaluspark,,1,242,218,460
39746,bryklaus,,1,4,3,7
39747,Nafa228,,1,5,12,17
39748,stmfreak,,1,16,26,42
39749,heatindex,,1,24,1,25
39750,hotnakedme,,1,2,1,3
39751,Gabriello,,1,2,2,4
39752,serif,,1,2,4,6
39753,jlwong,,1,1,1,2
39754,crapuser436,,1,1,3,4
39755,asst2drsalary,,1,11,4,15
39756,irishfairy123,,1,9,17,26
39757,josh64,,1,1,3,4
39758,redsymbol,,1,7,5,12
39759,JoshTheGoat,,1,40,37,77
39760,subsaver,,1,1,1,2
39761,soniyashrma,,1,331,32,363
39762,rouzelt,,1,1,1,2
39763,akbusiness,,1,9,12,21
39764,Gahahaha,,1,120,122,242
39765,I_AM_A_LOLICON,,1,33,24,57
39766,jones4590,,1,1,1,2
39767,PunjabPete,,1,10,3,13
39768,firewire2035,,1,126,159,285
39769,sarafina42,,1,18,7,25
39770,skywalker7861,,1,29,1,30
39771,American_Media,,1,1,1,2
39772,mikeymillions,,1,27,7,34
39773,ccookdsc,,1,1,2,3
39774,matthewmpls,,1,38,59,97
39775,SomeIrishGuy,,1,9,12,21
39776,bitmaster20,,1,5,3,8
39777,BlondeTeenageFemale,,1,2,4,6
39778,pdpdjh,,1,28,1,29
39779,sorandom,,1,5,2,7
39780,kenderbunny,,1,1,2,3
39781,la_gib,,1,4,3,7
39782,fkbszfn,,1,13,17,30
39783,jgrimes,,1,1,1,2
39784,murrayrothbardlives,,1,64,39,103
39785,ianmfried,,1,21,4,25
39786,oalsaker,,1,654,1027,1681
39787,beathead,,1,9,9,18
39788,stigurv,,1,1,1,2
39789,longnow,,1,1,6,7
39790,viosca,,1,1,1,2
39791,nohlo,,1,1,8,9
39792,Philipp,,1,433,179,612
39793,tskapo,,1,1,1,2
39794,redfishvanish,,1,81,147,228
39795,treefrog,,1,25,38,63
39796,leeschill,,1,14,2,16
39797,tabris,,1,154,205,359
39798,Mtrey,,1,52,17,69
39799,muhfuhkuh,,1,163,230,393
39800,leakyfaucet,,1,6,7,13
39801,reallybigleaf,,1,33,1,34
39802,ehnonnymouse,,1,17,32,49
39803,PaamayimNekudotayim,,1,21,19,40
39804,Sheeplike,,1,19,20,39
39805,thearchduke,,1,6,5,11
39806,patw85,,1,9,8,17
39807,night,,1,22,8,30
39808,PantsMan,,1,1,1,2
39809,i1chocolat,,1,2,20,22
39810,nickcrz,,1,207,380,587
39811,zulubanshee,,1,247,176,423
39812,Mikkel04,,1,15,27,42
39813,Johnnysimms,,1,9,8,17
39814,robbinzo,,1,5,2,7
39815,bgstratt,,1,17,30,47
39816,anjanb,,1,2,2,4
39817,peeweejd,,1,13,10,23
39818,vote,,1,146,25,171
39819,slacker22,,1,71,77,148
39820,WHGatesIII,,1,1,1,2
39821,cec4242,,1,3,2,5
39822,netengineer10,,1,23,27,50
39823,Aldous,,1,9,8,17
39824,retromadder,,1,17,37,54
39825,BenVic,,1,3,4,7
39826,ilovesaeri,,1,1,1,2
39827,ethytes,,1,3,6,9
39828,yxhuvud,,1,82,87,169
39829,secondkennedy,,1,11,26,37
39830,Cahoots,,1,1,1,2
39831,mcmick,,1,1,1,2
39832,nipuL,,1,43,28,71
39833,maukka,,1,34,3,37
39834,ebenchell,,1,10,3,13
39835,quietlight,,1,2,8,10
39836,afranke,,1,1,1,2
39837,megamike23,,1,5,8,13
39838,aacharya,,1,32,15,47
39839,karaganZoo,,1,2,1,3
39840,xabstract,,1,14,10,24
39841,montag813,,1,15,5,20
39842,acScience,,1,107,38,145
39843,bdu,,1,35,58,93
39844,ganlet20,,1,4,15,19
39845,rory096,,1,423,624,1047
39846,dmagz37,,1,319,27,346
39847,braneworld,,1,1132,356,1488
39848,buellersway,,1,1,5,6
39849,trannypunk,,1,179,296,475
39850,tmbrwolf19,,1,88,82,170
39851,Vacuum_Hooker,,1,206,22,228
39852,mariox19,,1,6,8,14
39853,st3892,,1,3,3,6
39854,astera,,5,2,1,3
39855,mekkelekkahi,,1,7,1,8
39856,clipmann,,1,270,308,578
39857,herdrick,,1,33,27,60
39858,anees243,,1,21,1,22
39859,thymidine,,1,2,4,6
39860,cyklone,,1,2,2,4
39861,TheCleric,,1,37,85,122
39862,dons,,1,1276,589,1865
39863,troll_captain,,1,3,1,4
39864,MoonChildCY,,1,21,4,25
39865,radiowires,,1,3,3,6
39866,anonymous-coward,,1,839,1142,1981
39867,borg,,1,68,102,170
39868,bluj420,,1,2,9,11
39869,sexydarin,,1,26,46,72
39870,harveyswik,,1,38,56,94
39871,gordo65,,1,65,65,130
39872,fusi0n,,1,15,40,55
39873,windsofwar,,1,12,13,25
39874,ichimunki,,1,1,1,2
39875,OttoVonBismarkk,,1,16,8,24
39876,peste,,1,2,1,3
39877,the_architect,,1,239,157,396
39878,Northbrig,,1,5,3,8
39879,count757,,1,41,44,85
39880,spencerwalsh,,1,26,14,40
39881,biggusJmanus,,1,1,2,3
39882,gadget_uk,,1,124,118,242
39883,Chesh,,1,6,14,20
39884,dutter,,1,35,64,99
39885,alexwilhelm,,1,3,5,8
39886,mellolizard,,1,1,1,2
39887,dr3dg,,1,3,21,24
39888,rugulator1,,1,5,14,19
39889,edgesmash,,1,8,5,13
39890,SirHLO,,1,1,2,3
39891,blackstar9000,,1,1002,445,1447
39892,d267,,1,1,2,3
39893,Shaggsa,,1,2,1,3
39894,madse147,,1,2,3,5
39895,jingidy,,1,4,7,11
39896,FatBlog,,1,18,43,61
39897,mazingerZ,,1,2,1,3
39898,notbob,,1,46,22,68
39899,Herzenslust,,1,14,5,19
39900,agreyarea,,1,2,5,7
39901,Logic_Nazi,,1,29,24,53
39902,gordan_freeman,,1,5,2,7
39903,pghjavaman,,1,8,1,9
39904,Agathos,,1,30,49,79
39905,ccheath,,1,1,1,2
39906,easybakeevan,,1,7,7,14
39907,alex10819,,1,8,2,10
39908,aidan_walsh,,1,3,1,4
39909,FilleAmericain,,1,26,74,100
39910,slowbear,,1,1,2,3
39911,greatdepression,,1,2,1,3
39912,kungtotte,,1,161,220,381
39913,Icewurm,,1,5,3,8
39914,colibius,,1,1,1,2
39915,slovett,,1,1,2,3
39916,wblair8689,,1,44,12,56
39917,MeltedUFO,,1,35,35,70
39918,nosneros,,1,7,29,36
39919,CC440,,1,74,71,145
39920,tjay,,1,13,21,34
39921,marcusf,,1,14,25,39
39922,thor666,,1,12,3,15
39923,calliphoridae,,1,167,125,292
39924,Kiedy,,1,1,2,3
39925,soocha,,1,2,3,5
39926,jellydonot,,1,285,29,314
39927,cmhh,,1,1,1,2
39928,AsDumbAsYou,,1,10,37,47
39929,kopchickm,,1,10,14,24
39930,ahendo10,,1,28,53,81
39931,Squeal,,1,1,2,3
39932,fool_on_the_hill,,1,78,83,161
39933,barkythedog,,1,30,10,40
39934,kkrev,,1,238,154,392
39935,walkingwtheghost,,1,55,89,144
39936,thomasthomas,,1,2,6,8
39937,hhhmmm,,1,2,7,9
39938,jredbone,,1,88,176,264
39939,RicardoWilliams,,1,9,21,30
39940,senrad,,1,11,21,32
39941,khirbat,,1,3,3,6
39942,GuigzForAll,,1,214,337,551
39943,katebond,,1,1,3,4
39944,patrick__bateman,,1,6,9,15
39945,reslez,,1,265,338,603
39946,tsunake,,1,9,9,18
39947,SitnikovI,,1,7,8,15
39948,fwrizzi,,1,11,25,36
39949,eville,,1,3,2,5
39950,szembek,,1,1,2,3
39951,BedtimeForSheeple,,1,41,68,109
39952,hortiub,,1,4,2,6
39953,mayoff,,1,31,12,43
39954,karmaB4tards080125,,1,3,11,14
39955,Direct_Link_Nazi,,1,13,11,24
39956,KGK,,1,4,5,9
39957,threads88,,1,9,2,11
39958,pktolar,,1,1,2,3
39959,bettybacon,,1,1,1,2
39960,pizzapops,,1,1,5,6
39961,FrancisC,,1,608,634,1242
39962,p0ppe,,1,14,12,26
39963,natelloyd,,1,94,33,127
39964,Rudy_Giuliani,,1,193,217,410
39965,Path3,,1,8,8,16
39966,schallstrom,,1,1,1,2
39967,buba1243,,1,352,460,812
39968,isaactr,,1,39,33,72
39969,ButterstheBear,,1,25,32,57
39970,brick_tamlin,,1,1,1,2
39971,BTSavage,,1,23,19,42
39972,exactLee,,1,3,19,22
39973,komboje,,1,1,4,5
39974,lemonlimeandbitters,,1,4,3,7
39975,keif,,1,1,3,4
39976,NWoodley,,1,1,1,2
39977,Moosebyte,,1,15,11,26
39978,pearcewg,,1,3,4,7
39979,clickfire,,1,1,2,3
39980,rjhazelwood,,1,11,17,28
39981,TuPapi,,1,5,4,9
39982,ul5255,,1,2,4,6
39983,Leeopus,,1,1,3,4
39984,pianist,,1,350,80,430
39985,sthomas314,,1,1,1,2
39986,tdellaringa,,1,22,18,40
39987,bottombitchdetroit,,1,88,26,114
39988,kirwanator,,1,1,1,2
39989,tekla,,1,1,1,2
39990,Slackerboy,,1,12,16,28
39991,elxx,,1,13,13,26
39992,redditer036,,1,1,1,2
39993,perzosodor,,1,37,8,45
39994,prelawstudent,,1,1,1,2
39995,tthomas,,1,1,1,2
39996,mrmunchies84,,1,2,6,8
39997,eigenmouse,,1,20,13,33
39998,alf77,,1,1,1,2
39999,curi,,1,9,4,13
40000,Skjef,,1,1,5,6
40001,Bloodhound,,1,1,1,2
40002,tetramou,,1,4,1,5
40003,ddon,,1,7,9,16
40004,djkym,,1,1,3,4
40005,fishmammal,,1,2,3,5
40006,ortusdux,,1,127,79,206
40007,kinokonoko,,1,2,11,13
40008,ericje,,1,57,139,196
40009,rataylor,,1,29,28,57
40010,crelm_toothpaste,,1,93,178,271
40011,argeaux,,1,429,533,962
40012,SFauconnier,,1,58,11,69
40013,dakotahawkins,,1,8,18,26
40014,w1sh3s,,1,2,1,3
40015,arrrrg,,1,1,1,2
40016,Gronk,,1,4,2,6
40017,Greenchunks,,1,62,51,113
40018,drodeznop,,1,61,34,95
40019,minks,,1,4,1,5
40020,explicitmemory,,1,225,73,298
40021,garduque,,1,10,22,32
40022,coldwinds,,1,1,2,3
40023,dementedwallaby,,1,28,25,53
40024,darkfrog13,,1,5,7,12
40025,bi_curious_yaktavist,,1,2,1,3
40026,LIONOS,,1,4,11,15
40027,adricm,,1,3,2,5
40028,lunatic604,,1,15,24,39
40029,ArmInAss,,1,13,9,22
40030,suler,,1,1,2,3
40031,ILoveJackDaniels,,1,36,73,109
40032,thebruce,,1,8,8,16
40033,blank,,1,10,21,31
40034,j0yb0y,,1,4,2,6
40035,fredamerican,,1,3,4,7
40036,cloudcyrex,,1,19,1,20
40037,stuckwithjesus,,1,13,1,14
40038,egarland,,1,38,34,72
40039,Uakaris,,1,41,16,57
40040,secede,,1,5,10,15
40041,Stercrazy2002,,1,5,8,13
40042,heatherkh,,1,6,15,21
40043,technogeeky,,1,33,43,76
40044,rigidtools,,1,1,1,2
40045,merf,,1,9,2,11
40046,Paul_Rockbottom,,1,2,2,4
40047,aprilhall,,1,19,18,37
40048,bobovski,,1,332,499,831
40049,mikestarrunner,,1,50,32,82
40050,bigkidbrowser,,1,14,42,56
40051,skew,,1,6,18,24
40052,edcox,,1,1,5,6
40053,jchrisa,,1,3,2,5
40054,esobchenko,,1,4,9,13
40055,frenchrose,,1,8,4,12
40056,sparcxl,,1,2,3,5
40057,MagikalGoat,,1,53,70,123
40058,agbullet,,1,35,49,84
40059,littlezipper,,1,1,1,2
40060,salkin,,1,1,1,2
40061,knv,,1,2,3,5
40062,henningg,,1,1,1,2
40063,regular_voter,,1,1,3,4
40064,truspect0r,,1,20,38,58
40065,sweetsassymalassy,,1,3,6,9
40066,burt_flaxton,,1,113,107,220
40067,doctorcaligari,,1,1,2,3
40068,chobit,,1,4,8,12
40069,jenrzzz,,1,1,1,2
40070,Reddit_Goes_Pathetic,,1,6,17,23
40071,ramses0,,1,16,18,34
40072,happyofficcworker,,1,56,34,90
40073,kriskelly,,1,3,2,5
40074,raizyr,,1,16,16,32
40075,skacr0w,,1,4,2,6
40076,danmichelle2004,,1,8,6,14
40077,ender3456,,1,763,8,771
40078,BernardMarx,,1,33,48,81
40079,rwmjones,,1,41,50,91
40080,liquidpele,,1,709,932,1641
40081,kdkdlskdjfkdj,,1,4,6,10
40082,funkadeliczipper,,1,1,4,5
40083,bobwoodshed,,1,1,1,2
40084,pankus,,1,8,16,24
40085,d1gp1g,,1,208,16,224
40086,EasilyAnnoyed,,1,140,116,256
40087,ilovemullets,,1,1,2,3
40088,mightyjoe,,1,7,6,13
40089,dharmatech,,1,16,6,22
40090,mt33,,1,9,16,25
40091,slimerr,,1,5,8,13
40092,daedalusman,,1,55,34,89
40093,ethanz,,1,9,13,22
40094,hyperartpro,,1,1,1,2
40095,cobweb,,1,15,30,45
40096,bloeboe,,1,9,4,13
40097,smackmybishop,,1,13,26,39
40098,Neurowhoa,,1,3,1,4
40099,enaeseth,,1,2,2,4
40100,bill-of-rights,,1,1,1,2
40101,pets_or_meat,,1,843,357,1200
40102,paryal,,1,2,3,5
40103,corysama,,1,3,6,9
40104,jim45804,,1,20,9,29
40105,catfishman,,1,4,12,16
40106,temroT,,1,1,1,2
40107,joelpt,,1,1,4,5
40108,MrMorden,,1,1,1,2
40109,sporkyy,,1,3,3,6
40110,microsofat,,1,100,158,258
40111,coltonrose,,1,12,3,15
40112,Zest,,1,2,4,6
40113,puns,,1,57,124,181
40114,mle1,,1,2,1,3
40115,Hindean,,1,6,3,9
40116,SeanConnery,,1,71,65,136
40117,pkpkpkpk,,1,20,21,41
40118,mstoehr,,1,30,7,37
40119,ew73,,1,1,1,2
40120,mahnahmahnah,,1,7,24,31
40121,oiballs,,1,1,1,2
40122,JustSayNOBAMA,,1,7,12,19
40123,jimmyjazz14,,1,2,13,15
40124,temporalg,,1,3,3,6
40125,Porges,,1,248,333,581
40126,chirayuk,,1,3,7,10
40127,koannaok,,1,16,14,30
40128,jamesbritt,,1,285,385,670
40129,elements,,1,1,1,2
40130,mrmod,,1,5,6,11
40131,fohat,,1,80,136,216
40132,EarendilStar,,1,12,10,22
40133,Peach,,1,4,1,5
40134,discobreakin,,1,309,282,591
40135,lucianot,,1,30,40,70
40136,Slaky311,,1,45,99,144
40137,pdiddyisme,,1,2,2,4
40138,arecanut,,1,6,10,16
40139,Steppenwolfdoo,,1,189,307,496
40140,pedro_voteforme,,1,44,49,93
40141,SirChasm,,1,9,5,14
40142,lenocinor,,1,7,3,10
40143,catsi,,1,109,163,272
40144,clackerd,,1,200,320,520
40145,SuperHappyPanda,,1,3,11,14
40146,markostyle,,1,1,2,3
40147,forwhat,,1,2,1,3
40148,AKofSpades,,1,1,1,2
40149,deepvote,,1,220,431,651
40150,Gary_Malhotra,,1,2,3,5
40151,MostlyHarmless19,,1,2,8,10
40152,ThePimpOfSound,,1,1,1,2
40153,rickdiculus,,1,2,1,3
40154,maxbarkly,,1,2,2,4
40155,diffyQ,,1,7,15,22
40156,keepingitcivil,,1,122,57,179
40157,hxcadillac,,1,22,10,32
40158,benbernards,,1,12,9,21
40159,Karabasan,,1,9,13,22
40160,Geoffzonit,,1,1,2,3
40161,gnurf,,1,1,2,3
40162,lamabodo,,1,1,5,6
40163,sabat,,1,13,15,28
40164,ghostofyesterday,,1,1,4,5
40165,zeny,,1,8,19,27
40166,jtikalsky,,1,5,5,10
40167,atl,,1,2,1,3
40168,stephenjoos,,1,2,3,5
40169,aurele,,1,9,13,22
40170,Kronikarz,,1,34,29,63
40171,Emowomble,,1,7,9,16
40172,taintedhero,,1,113,224,337
40173,t0mmy85,,1,4,12,16
40174,llmikeb,,1,21,13,34
40175,mikej,,1,2,1,3
40176,palish,,1,20,18,38
40177,krouw,,1,1,1,2
40178,I_AM_XENU,,1,4,19,23
40179,divad1978,,1,2,6,8
40180,phubaba,,1,61,77,138
40181,fjolliton,,1,9,3,12
40182,jimmm33,,1,1,1,2
40183,usian82938,,1,37,50,87
40184,ackza,,1,170,232,402
40185,M0b1u5,,1,532,954,1486
40186,TwistedAnimator,,1,4,2,6
40187,srodrigo,,1,4,9,13
40188,eikelestijn,,1,2,3,5
40189,illiaster,,1,21,22,43
40190,Kaelia,,1,13,11,24
40191,stoetzels,,1,1,1,2
40192,PortConflict,,1,3,3,6
40193,grudes7s,,1,11,2,13
40194,Oplace,,1,1,1,2
40195,vanschelven,,1,1,1,2
40196,Jayizdaman,,1,10,19,29
40197,enoonsti,,1,5,13,18
40198,kitepaint,,1,4,4,8
40199,seanbride,,1,3,3,6
40200,zulucious,,1,3,7,10
40201,perkam,,1,220,319,539
40202,snagster,,1,1,1,2
40203,cobainbc15,,1,24,22,46
40204,Urantia,,1,1,1,2
40205,ieatGUTS,,1,17,32,49
40206,ashipman,,1,1,1,2
40207,scottzed,,1,89,89,178
40208,kryptiskt,,1,44,51,95
40209,emacsen,,1,72,75,147
40210,tedivm,,1,9,8,17
40211,ndot,,1,16,28,44
40212,MrSharkey,,1,2,3,5
40213,fuckitydoda,,1,5,4,9
40214,nat5an,,1,164,37,201
40215,lemonidas,,1,2,1,3
40216,jamasaru,,1,26,30,56
40217,shaggy0798,,1,818,274,1092
40218,ooutland,,1,78,88,166
40219,deavon,,1,1,4,5
40220,sohail,,1,43,12,55
40221,gymz3,,1,1,1,2
40222,presidentmilf,,1,1,1,2
40223,antifeds,,1,6,3,9
40224,tagor,,1,22,32,54
40225,ideaprone,,1,18,12,30
40226,huntersd,,1,1,2,3
40227,thekgb,,1,9,12,21
40228,BrandonRushing,,1,29,28,57
40229,sakananyc,,1,32,8,40
40230,andrewdutko,,1,100,138,238
40231,sirebril,,1,2,1,3
40232,geekussr,,1,2,10,12
40233,Noxieas,,1,10,19,29
40234,unavoidable,,1,12,6,18
40235,jiyunatori,,1,5,13,18
40236,capisce,,1,10,5,15
40237,Arrogancy,,1,14,17,31
40238,capper42,,1,61,3,64
40239,macmancpb,,1,4,4,8
40240,captainbarky,,1,2,7,9
40241,jacksonh,,1,43,72,115
40242,Lonelobo,,1,168,68,236
40243,firewolf,,1,42,3,45
40244,icthus7,,1,2,3,5
40245,BoondockDeacon,,1,1,1,2
40246,MrWizard,,1,22,28,50
40247,rotidder,,1,1,1,2
40248,Zoot,,1,1,1,2
40249,tehxaton,,1,179,262,441
40250,Rawsock,,1,30,51,81
40251,cowsonfire,,1,12,20,32
40252,Dakart,,1,98,138,236
40253,jimbobb860,,1,6,13,19
40254,Orthography_Nazi,,1,5,7,12
40255,Recluse,,1,64,195,259
40256,bingowingo,,1,1,1,2
40257,amyapotheosis,,1,2,4,6
40258,jessecore,,1,1,2,3
40259,inopia,,1,343,240,583
40260,Aesir,,1,27,29,56
40261,lua21,,1,3,1,4
40262,evildeer,,1,6,10,16
40263,axmt,,1,19,2,21
40264,ginxed,,1,6,4,10
40265,jr93087,,1,1,2,3
40266,gumugum,,1,1,1,2
40267,droberts1982,,1,48,27,75
40268,HardwareLust,,1,768,1120,1888
40269,doiveo,,1,114,21,135
40270,miller3790,,1,33,16,49
40271,titoonster,,1,16,34,50
40272,liberals_r_noobs,,1,100,145,245
40273,actualair,,1,3,9,12
40274,jhoneycutt,,1,16,1,17
40275,voltairewildedumas,,1,1,1,2
40276,abjurer,,1,58,63,121
40277,homeworld,,1,1866,992,2858
40278,jms18,,1,3,7,10
40279,treenaks,,1,68,46,114
40280,briankuhn,,1,3,11,14
40281,jairtrejo,,1,24,5,29
40282,chickenwing21,,1,1,2,3
40283,Ed_Wuncler_III,,1,1,1,2
40284,tompiatelli,,1,3,14,17
40285,thunderbird,,1,1,1,2
40286,otterplay,,1,700,1257,1957
40287,ebschiller,,1,2,3,5
40288,stefalex,,1,3,1,4
40289,absolutecero,,1,29,29,58
40290,filecabinet,,1,3,1,4
40291,MaxStax,,1,31,33,64
40292,ith,,1,8,5,13
40293,nonamegirl,,1,42,2,44
40294,the_classifier,,1,1,3,4
40295,mmmelissaaa,,1,27,46,73
40296,SpitfireRed,,1,63,74,137
40297,seanneko,,1,1,1,2
40298,marcushe,,1,50,71,121
40299,neosiv,,1,1,1,2
40300,jtp51,,1,2,12,14
40301,petermichaux,,1,37,28,65
40302,stacyelizabeth,,1,2,2,4
40303,astroid0,,1,6,20,26
40304,dtimo,,1,2,1,3
40305,archju01,,1,36,54,90
40306,lallen,,1,5,8,13
40307,norstar,,1,1,3,4
40308,nirs,,1,26,33,59
40309,Rooster113,,1,20,38,58
40310,unforgyvn,,1,163,270,433
40311,mlw72z,,1,7,10,17
40312,dodecalogue,,1,75,203,278
40313,Ernesttoo,,1,18,1,19
40314,thetedster180,,1,1,3,4
40315,pricklypear69,,1,1,1,2
40316,xfire301,,1,2,2,4
40317,addps4cat,,1,15,14,29
40318,mturk,,1,351,506,857
40319,baropithecus,,1,61,43,104
40320,unabiker,,1,12,24,36
40321,Antebios,,1,306,445,751
40322,fooforthecity,,1,1,1,2
40323,hpot,,1,3,3,6
40324,Ilich,,1,16,16,32
40325,happytron,,1,10,16,26
40326,mypurplelighter,,1,102,155,257
40327,syroncoda,,1,596,1064,1660
40328,Imson,,1,3,6,9
40329,Prometheus25,,1,32,38,70
40330,ifonlywecouldstopjef,,1,48,1,49
40331,Paczesiowa,,1,139,216,355
40332,bbzed,,1,1,1,2
40333,chucky,,1,2,5,7
40334,GDSM,,1,15,10,25
40335,atomofconsumption,,1,17,23,40
40336,softwareperson,,1,2,5,7
40337,taigaIV,,1,3,4,7
40338,spookyvision,,1,162,246,408
40339,omar12,,1,4,7,11
40340,derek985,,1,10,18,28
40341,addingzeros,,1,7,8,15
40342,sniper1rfa,,1,172,301,473
40343,generichandle,,1,2,1,3
40344,captchinchilla,,1,14,9,23
40345,Time2fish,,1,20,12,32
40346,Ellenka,,1,1,1,2
40347,webpimp,,1,30,11,41
40348,Harriv,,1,37,4,41
40349,zagorko,,1,2,1,3
40350,xl-brain,,1,12,12,24
40351,vontrapp,,1,8,12,20
40352,Elleo,,1,16,14,30
40353,protek,,1,1,3,4
40354,steelfrog,,1,19,28,47
40355,SeattleTomy,,1,69,114,183
40356,softwareprogrammer,,1,1,1,2
40357,spaceman77,,1,12,58,70
40358,ruser0,,1,1,1,2
40359,parsap,,1,66,1,67
40360,cratylus,,1,134,178,312
40361,1point618,,1,28,23,51
40362,grodisattva,,1,1,5,6
40363,faaron,,1,3,6,9
40364,bryanut,,1,44,32,76
40365,dreamlax,,1,258,338,596
40366,dokden,,1,11,20,31
40367,mrvix,,1,11,19,30
40368,ryanx27,,1,976,2115,3091
40369,izjay,,1,1,2,3
40370,robotthink,,1,26,43,69
40371,xian,,1,13,29,42
40372,TKappe,,1,18,14,32
40373,reddista2,,1,1,1,2
40374,bazfoo,,1,20,31,51
40375,jonknee,,1,704,953,1657
40376,rolson,,1,86,62,148
40377,knotted_donuts,,1,2,5,7
40378,eroq,,1,79,193,272
40379,substill,,1,62,72,134
40380,seanbateman,,1,1,1,2
40381,chancemaster,,1,1,2,3
40382,Zelbinian,,1,11,33,44
40383,Branyers,,1,58,94,152
40384,panthersrock,,1,44,23,67
40385,realdpk,,1,276,335,611
40386,nicolas11,,1,383,13,396
40387,waste49,,1,8,3,11
40388,sheepskin,,1,139,259,398
40389,Clarke101,,1,3,17,20
40390,scranklin,,1,5,5,10
40391,lavareef,,1,1,1,2
40392,melnormal,,1,38,4,42
40393,toast28,,1,3,9,12
40394,xxxsagaxxx,,1,291,688,979
40395,john_wayne,,1,1,1,2
40396,redditto,,1,316,550,866
40397,DiggerDan,,1,2,6,8
40398,Fishmachine,,1,1,1,2
40399,arrakis-cDc,,1,4,4,8
40400,manole10,,1,3,11,14
40401,dangerousbehavior,,1,1,2,3
40402,joshk0,,1,1,2,3
40403,GBs4DsGs,,1,15,11,26
40404,jimbo78255,,1,111,179,290
40405,cubicarts,,1,19,32,51
40406,mithra,,1,2,9,11
40407,Layali,,1,75,17,92
40408,opticalfader,,1,20,41,61
40409,Either-Or,,1,5,11,16
40410,ncoderre,,1,1,1,2
40411,thumper242,,1,1,1,2
40412,seven999,,1,1,2,3
40413,ih8registrations,,1,514,1017,1531
40414,seventimes,,1,1,1,2
40415,shiner_man,,1,1332,1128,2460
40416,CaptainHypocrisy,,1,3,6,9
40417,Threedcoder,,1,12,16,28
40418,MikeInVB,,1,10,11,21
40419,kinkmeister,,1,17,4,21
40420,steveokay,,1,8,1,9
40421,Asystole,,1,31,18,49
40422,pudo,,1,2,1,3
40423,billdoe,,1,21,53,74
40424,jvdomino,,1,38,9,47
40425,IvyMike,,1,607,419,1026
40426,sirmuffinman,,1,20,32,52
40427,shashankr,,1,5,1,6
40428,BbIT,,1,24,41,65
40429,Uncle_Sam,,1,5,19,24
40430,lokkij,,1,3,9,12
40431,fwchristie,,1,5,3,8
40432,ForzaIbra,,1,1,5,6
40433,wheregator,,1,51,29,80
40434,jimsf,,1,1,1,2
40435,thoomfish,,1,144,166,310
40436,zaim,,1,22,38,60
40437,samimy,,1,1,1,2
40438,joej,,1,6,9,15
40439,cliffordp,,1,73,7,80
40440,qrswave,,1,217,58,275
40441,charliejon,,1,1,1,2
40442,artimas,,1,7,8,15
40443,heyredditaddict,,1,183,14,197
40444,womms,,1,9,3,12
40445,AchieveMaster,,1,1,1,2
40446,indigoshift,,1,342,927,1269
40447,bobbybuilder,,1,2,4,6
40448,sstevesstrong,,1,2,2,4
40449,r04rk,,1,1,2,3
40450,reddeb,,1,911,974,1885
40451,drrobotlove,,1,2,2,4
40452,spookyjon,,1,9,10,19
40453,alfryd,,1,23,19,42
40454,Tanoku,,1,8,4,12
40455,tm8992,,1,48,2,50
40456,coheedcollapse,,1,44,70,114
40457,aclashingcolour,,1,1,1,2
40458,stubob,,1,327,450,777
40459,aleks1980,,1,52,10,62
40460,the_marsupial,,1,22,27,49
40461,bartley,,1,2,1,3
40462,jonasistaken,,1,2,5,7
40463,tomlikestorock,,1,2,1,3
40464,Chris-Hansen,,1,1,3,4
40465,Fat_Dumb_Americans,,1,396,876,1272
40466,JudeanPeoplesFront,,1,5,4,9
40467,clausb,,1,2,3,5
40468,shanem,,1,203,217,420
40469,cheatham,,1,2,2,4
40470,segv00,,1,2,3,5
40471,Grokmoo,,1,70,51,121
40472,cowholio4,,1,6,5,11
40473,autisticmongoloid,,1,18,16,34
40474,bschmalhofer,,1,1,2,3
40475,tomato84,,1,1,1,2
40476,somecunt,,1,2,2,4
40477,zehoppa,,1,1,1,2
40478,akair,,1,20,46,66
40479,cinemascopian,,1,2,1,3
40480,adambard,,1,16,3,19
40481,Austy,,1,1,3,4
40482,zeldamaster666,,1,121,290,411
40483,Newsmyway,,1,9,2,11
40484,jenkstom,,1,1,4,5
40485,doodads,,1,1,2,3
40486,pitou-4,,1,1,3,4
40487,flinxmeister2,,1,1,1,2
40488,Live-love-leave,,1,1,1,2
40489,snarblarg,,1,12,16,28
40490,kramo1,,1,1,1,2
40491,mavetech,,1,4,4,8
40492,Akany,,1,21,8,29
40493,brandonwardlaw,,1,83,36,119
40494,Sortra77,,1,11,21,32
40495,thetruthbeknown,,1,32,69,101
40496,quitehairy,,1,4,4,8
40497,mart_at_reddit,,1,4,8,12
40498,keyforce,,1,15,22,37
40499,algorithmic,,1,4,1,5
40500,enkiv2,,1,6,10,16
40501,HolisticResources,,1,4,4,8
40502,rutabaga,,1,5,4,9
40503,ghosthacked,,1,41,65,106
40504,pinkrabbit,,1,15,5,20
40505,splurb,,1,4,9,13
40506,Ledwick,,1,19,44,63
40507,phono,,1,2,1,3
40508,BeerOtter,,1,271,402,673
40509,codemac,,1,12,21,33
40510,ZXQ,,1,1,2,3
40511,authorblues,,1,1,3,4
40512,Lieutenant-Obvious,,1,5,8,13
40513,the_future,,1,4,10,14
40514,arjie,,1,68,93,161
40515,twitterpaters,,1,43,5,48
40516,jns_reddit_already,,1,18,20,38
40517,beezel666,,1,2,1,3
40518,Offal,,1,2,1,3
40519,revb,,1,36,12,48
40520,tjdick,,1,78,110,188
40521,aezell,,1,47,51,98
40522,huracan,,1,4,5,9
40523,christifor,,1,1,4,5
40524,Retsoka,,1,98,186,284
40525,Willy0Panhandle,,1,6,24,30
40526,brickne3,,1,58,36,94
40527,olddigspices,,1,1,1,2
40528,coopr,,1,6,8,14
40529,mzbin,,1,3,1,4
40530,65daysofstatic,,1,7,4,11
40531,revoman,,1,1433,1493,2926
40532,yogigluv,,1,4,4,8
40533,generaux,,1,2,1,3
40534,Phssthpok,,1,5,4,9
40535,diode1001,,1,1,3,4
40536,bango_lassie,,1,1,2,3
40537,foood,,1,11,12,23
40538,tarapurasson,,1,26,21,47
40539,anonomous_cowerd,,1,12,11,23
40540,random508972509,,1,10,19,29
40541,johndoe75338,,1,5,1,6
40542,p3on,,1,30,64,94
40543,webaddict,,1,1,2,3
40544,ignatiusloyola,,1,6,8,14
40545,DJiK,,1,3,16,19
40546,livedog,,1,64,48,112
40547,superdude4agze,,1,32,49,81
40548,SDgoon,,1,2,3,5
40549,Caluen,,1,74,106,180
40550,fknlo,,1,15,14,29
40551,mogden,,1,3,1,4
40552,Viat,,1,7,10,17
40553,fluffincake,,1,8,15,23
40554,myotheralt,,1,620,1171,1791
40555,MathNinja,,1,23,23,46
40556,JenniferLeh,,1,4,1,5
40557,WonkoDeSane,,1,14,32,46
40558,heypans,,1,19,18,37
40559,Saucemaster,,1,4,6,10
40560,Vajrapani,,1,4,6,10
40561,silconman,,1,27,1,28
40562,abronzan,,1,2,1,3
40563,madma,,1,2,2,4
40564,intangible-tangerine,,1,567,780,1347
40565,jstalin456,,1,3,3,6
40566,NovaBandit,,1,2,2,4
40567,TheWeLikeToParty,,1,1,1,2
40568,skuzzy,,1,1,2,3
40569,dghughes,,1,683,896,1579
40570,GodOfAtheism,,1,48,102,150
40571,kurby125v2,,1,19,6,25
40572,b0jangl3s,,1,28,34,62
40573,imagium,,1,7,3,10
40574,jacques_chester,,1,57,66,123
40575,Yesh,,1,11,15,26
40576,redditer002,,1,2,4,6
40577,sambyfleet,,1,1,3,4
40578,karmafactory,,1,1,1,2
40579,paulbian,,1,19,20,39
40580,krnldmp,,1,68,108,176
40581,linkboi,,1,6,14,20
40582,lufcpdx,,1,20,20,40
40583,majin157,,1,2,1,3
40584,cliffnotes,,1,151,188,339
40585,deathhand,,1,22,39,61
40586,camperman,,1,7,13,20
40587,TMFC,,1,1,1,2
40588,schawt,,1,120,97,217
40589,imaredsfan,,1,5,7,12
40590,ichschnof,,1,4,9,13
40591,wakeupmrfox,,1,3,2,5
40592,libertao,,1,116,146,262
40593,burning_iceman,,1,1,2,3
40594,honeyjew,,1,22,34,56
40595,middlename,,1,34,79,113
40596,andrew1193,,1,13,14,27
40597,VulcanJaded,,1,2,1,3
40598,Pixelatedcow1,,1,1,1,2
40599,Billy_Gates,,1,16,14,30
40600,joelman0,,1,6,1,7
40601,dsl,,1,8,4,12
40602,gyronica,,1,54,60,114
40603,sb76117,,1,17,64,81
40604,condeh,,1,8,13,21
40605,markV101,,1,68,69,137
40606,bathninja,,1,64,45,109
40607,hittingbig,,1,67,1,68
40608,nenolod,,1,4,1,5
40609,brettorical,,1,108,146,254
40610,godtvisken,,1,102,48,150
40611,MisterEggs,,1,275,431,706
40612,johnneat,,1,327,32,359
40613,Shadrach77,,1,5,8,13
40614,ZebraSafari,,1,2,1,3
40615,truedat,,1,3,7,10
40616,Hedonopoly,,1,61,79,140
40617,Fried_Gorilla,,1,107,139,246
40618,heymark,,1,23,17,40
40619,gryph1,,1,11,13,24
40620,bshufham,,1,6,3,9
40621,relato,,1,16,9,25
40622,dogchef,,1,1,3,4
40623,zimm0who0net,,1,134,114,248
40624,-ov-,,1,92,16,108
40625,arcticStylings,,1,6,8,14
40626,the-point,,1,27,38,65
40627,fremcos,,1,2,1,3
40628,fleg123,,1,4,3,7
40629,allanl,,1,38,70,108
40630,davbo,,1,1,1,2
40631,TheOneTrueEric,,1,1,2,3
40632,reflibman,,1,1685,820,2505
40633,raphaelb,,1,2,5,7
40634,jacobolus,,1,75,74,149
40635,samnmax,,1,11,10,21
40636,Jger,,1,8,13,21
40637,Kapidux,,1,62,16,78
40638,B2point1,,1,1,1,2
40639,cloudcityproblems,,1,2,8,10
40640,mrak,,1,1,1,2
40641,pkgraham,,1,1,1,2
40642,encloser,,1,3,1,4
40643,nonex,,1,9,19,28
40644,Kluny,,1,2,5,7
40645,jj666,,1,132,211,343
40646,mikenuman,,1,1,1,2
40647,ablaize,,1,2,2,4
40648,chaosgone,,1,244,264,508
40649,mtech,,1,13,10,23
40650,ohlieoh,,1,1,2,3
40651,zublay,,1,6,3,9
40652,puhnitor,,1,1,4,5
40653,Barack2012,,1,3,4,7
40654,jonaphin,,1,20,7,27
40655,antido,,1,45,15,60
40656,lavantin,,1,1,2,3
40657,nostromo,,1,113,134,247
40658,hexagonalfacepack,,1,6,13,19
40659,ShushanEduth,,1,39,9,48
40660,throp,,1,3,2,5
40661,dfick,,1,1,4,5
40662,andrewnealon,,1,114,98,212
40663,jtbandes,,1,6,4,10
40664,eamon,,1,2,6,8
40665,PatronizingPatriot,,1,3,3,6
40666,meanfish,,1,29,35,64
40667,dickie,,1,1,2,3
40668,gghhddjj,,1,6,10,16
40669,Annom,,1,39,33,72
40670,TCPIP,,1,8,22,30
40671,poliphilo,,1,4,7,11
40672,foxandlion,,1,1,1,2
40673,musashiXXX,,1,208,335,543
40674,guppie,,1,10,6,16
40675,flip314,,1,101,251,352
40676,Replicatorinc,,1,2,5,7
40677,robsnell,,1,15,16,31
40678,pwang99,,1,142,134,276
40679,floodcasso2,,1,76,3,79
40680,howzzat,,1,19,22,41
40681,Scrumtrilescent,,1,44,42,86
40682,zdkm,,1,45,62,107
40683,hillbilly1,,1,9,15,24
40684,Poison1990,,1,4,7,11
40685,squidboots,,1,1022,704,1726
40686,rossoonline,,1,13,8,21
40687,catacombus,,1,15,19,34
40688,keff,,1,47,30,77
40689,jjjsssfff,,1,1,3,4
40690,bestnameever,,1,17,30,47
40691,r00bythen00by,,1,6,23,29
40692,Yaaraina,,1,13,1,14
40693,adrianassecret,,1,5,10,15
40694,terryphi,,1,21,26,47
40695,wingsofseraphim,,1,203,389,592
40696,wwwwolf,,1,5,3,8
40697,spark3d,,1,6,7,13
40698,ddrager,,1,41,52,93
40699,mattpopzzz,,1,5,6,11
40700,KyleVarner,,1,7,2,9
40701,rad157,,1,3,7,10
40702,keithburgun,,1,50,63,113
40703,StuckInNY,,1,33,74,107
40704,Gids,,1,1,1,2
40705,yourparadigm,,1,205,243,448
40706,mg115ca,,1,20,55,75
40707,s0cket,,1,227,267,494
40708,tpicot,,1,5,6,11
40709,bootsandtea,,1,18,21,39
40710,shahpilescliniq,,1,1,2,3
40711,royrodgers22,,1,15,17,32
40712,chrispine,,1,39,63,102
40713,WAKE_UP_SHEEPLE,,1,69,101,170
40714,stoptheshit,,1,2,1,3
40715,ThatOtherGirl,,1,68,126,194
40716,Kilomph,,1,58,91,149
40717,fossuser,,1,36,56,92
40718,hotfudgemonday,,1,25,27,52
40719,whatwentwrong,,1,5,8,13
40720,for_no_good_reason,,1,29,26,55
40721,coney27,,1,1,4,5
40722,neo1513,,1,7,8,15
40723,wowzler,,1,7,4,11
40724,jfv6956,,1,60,23,83
40725,Misinformation,,1,1,1,2
40726,leperkuhn,,1,6,2,8
40727,Nuggets,,1,3,1,4
40728,maddoxreddit,,1,1,1,2
40729,fresh,,1,8,4,12
40730,nighttime,,1,2,5,7
40731,accelleron,,1,173,295,468
40732,cursoryusername,,1,1,2,3
40733,i_work_there,,1,6,2,8
40734,lantech,,1,4,3,7
40735,sobri909,,1,23,23,46
40736,latro,,1,129,178,307
40737,romulcah,,1,47,37,84
40738,Free_Sirhan,,1,19,27,46
40739,LemonHerb,,1,8,14,22
40740,7md2,,1,59,9,68
40741,fuzzyl0gic,,1,8,13,21
40742,Tomble,,1,53,116,169
40743,centrinos,,1,1,2,3
40744,Saulace,,1,25,62,87
40745,uncopyright,,1,6,5,11
40746,IuleI434,,1,2,6,8
40747,redsectorA,,1,254,340,594
40748,jlee11,,1,113,130,243
40749,norm_macdonald,,1,1,2,3
40750,freedompower,,1,70,109,179
40751,mchrisneglia,,1,540,1050,1590
40752,tehrob,,1,26,27,53
40753,TakeBackUSA,,1,2,1,3
40754,barryfandango,,1,40,30,70
40755,slynn315,,1,17,3,20
40756,sarzec,,1,7,32,39
40757,delutz,,1,57,48,105
40758,mfloydc,,1,24,3,27
40759,cecole1,,1,2,4,6
40760,lucifercain,,1,83,99,182
40761,steelydaniel,,1,43,7,50
40762,MosquitoWipes,,1,58,44,102
40763,jasonhdavis,,1,1,2,3
40764,AcuraF1,,1,2,1,3
40765,thegrossman,,1,2,1,3
40766,Doctor,,1,109,209,318
40767,xixor,,1,4,14,18
40768,bman35,,1,37,43,80
40769,dand,,1,18,33,51
40770,sstid,,1,4,10,14
40771,saltfish,,1,22,33,55
40772,YanksRule,,1,3,1,4
40773,Scatterbrand,,1,6,5,11
40774,trolling_anonymously,,1,1,1,2
40775,NoSuchThingAsNoKill,,1,2,1,3
40776,darknebula,,1,110,208,318
40777,Jamer70,,1,7,12,19
40778,MrValdez,,1,21,20,41
40779,moizkhan,,1,2,2,4
40780,gdb,,1,2,1,3
40781,RE90,,1,1,5,6
40782,PresidentBarackObama,,1,2,1,3
40783,putneyswope,,1,2,1,3
40784,scottmartinnet,,1,33,30,63
40785,fluffyflora,,1,3,1,4
40786,PeaceLovingHippie,,1,4,11,15
40787,pr3d,,1,2,3,5
40788,woodreaux,,1,1,3,4
40789,allyant,,1,1,1,2
40790,FoRo,,1,91,120,211
40791,dollarfreefall_com,,1,63,102,165
40792,uilaniespinoza,,1,1,1,2
40793,ch8ind,,1,1,9,10
40794,Godspiral,,1,134,250,384
40795,lar1,,1,1,2,3
40796,Nick127,,1,3,5,8
40797,wonderloey,,1,19,39,58
40798,jsz,,1,226,260,486
40799,mathoms,,1,20,12,32
40800,ShirleyPhelpsRoper,,1,2,2,4
40801,YossarianLives,,1,16,29,45
40802,Orngarth,,1,10,12,22
40803,cryptopookie,,1,5,2,7
40804,BitBrain,,1,120,184,304
40805,natepoff,,1,5,2,7
40806,chris_ut,,1,34,21,55
40807,cowboy-bebop,,1,34,27,61
40808,thcobbs,,1,3,1,4
40809,BigMcLargeHuge,,1,11,23,34
40810,njharman,,1,603,903,1506
40811,skosuri,,1,12,9,21
40812,i_read_it,,1,156,195,351
40813,peasleer,,1,1,1,2
40814,shankargallery,,1,1,1,2
40815,alcorrr,,1,2,1,3
40816,acidity,,1,15,39,54
40817,reaganite,,1,7,7,14
40818,gutterbumber,,1,29,43,72
40819,istiamar,,1,32,72,104
40820,rmi77,,1,2,4,6
40821,ascendant23,,1,165,159,324
40822,polyesterfunk,,1,115,175,290
40823,lemonparty,,1,31,46,77
40824,chois,,1,2,4,6
40825,zombi1101,,1,13,1,14
40826,ameelabee,,1,23,19,42
40827,instntkrma,,1,4,4,8
40828,unlimited,,1,192,159,351
40829,MrSunshine,,1,6,5,11
40830,deathisbad,,1,2,8,10
40831,slothfist,,1,5,8,13
40832,JoeBlu,,1,81,114,195
40833,cledwards,,1,4,6,10
40834,thegoogle,,1,8,9,17
40835,JKrahn,,1,4,4,8
40836,quartz,,1,4,2,6
40837,assface,,1,23,39,62
40838,latatata,,1,1,1,2
40839,Vegeman,,1,1,2,3
40840,nullzero,,1,2,2,4
40841,Aeooo,,1,2,2,4
40842,jopejope,,1,169,154,323
40843,captdets,,1,5,5,10
40844,supakual,,1,62,51,113
40845,nomis80,,1,15,12,27
40846,nkallen,,1,1,3,4
40847,jasonmashak,,1,2,3,5
40848,cvonwallenstein,,1,6,2,8
40849,ipostme,,1,46,2,48
40850,sevhan,,1,6,14,20
40851,Catbert321,,1,44,55,99
40852,aveceasar,,1,251,411,662
40853,equallyunequal,,1,7,9,16
40854,tryagainhaters,,1,1,1,2
40855,johnston360,,1,1,2,3
40856,batypus,,1,67,68,135
40857,kej1701,,1,1,1,2
40858,instantopinion,,1,3,4,7
40859,senseless,,1,6,19,25
40860,jaimev,,1,1,1,2
40861,haporn,,1,37,7,44
40862,wickedwife,,1,5,8,13
40863,ronpaul2008now,,1,1,1,2
40864,CrunkleWotsit,,1,5,7,12
40865,Cilpot,,1,9,21,30
40866,ctrlsoft,,1,1,1,2
40867,nroth,,1,7,7,14
40868,telharsic,,1,3,1,4
40869,eouw0o83hf,,1,283,441,724
40870,skefarius,,1,1,5,6
40871,serious_face,,1,48,59,107
40872,LOUD_HOWARD,,1,6,8,14
40873,arcticfox,,1,129,304,433
40874,JohnnK,,1,259,43,302
40875,HookerBot5000,,1,5,12,17
40876,DrG,,1,9,11,20
40877,Rebooted,,1,1,1,2
40878,starspangledpickle,,1,99,123,222
40879,bigbadsi,,1,8,20,28
40880,scaz,,1,2,1,3
40881,fatmike85,,1,2,1,3
40882,slightlymoreinformed,,1,1,1,2
40883,topsul,,1,181,236,417
40884,atw,,1,6,1,7
40885,pfesta,,1,81,70,151
40886,ellsmall,,1,6,10,16
40887,lscritch,,1,5,5,10
40888,IbbleDibble,,1,15,29,44
40889,aconbere,,1,21,33,54
40890,nicolaslara,,1,8,1,9
40891,throwingks,,1,64,70,134
40892,vatul,,1,3,4,7
40893,recursive,,1,437,635,1072
40894,LankySplotch,,1,36,67,103
40895,aanaedwards,,1,1,8,9
40896,edge211,,1,2,4,6
40897,reddragn,,1,1,1,2
40898,the_argus,,1,1,2,3
40899,d_dreamer,,1,1,1,2
40900,procopio,,1,28,67,95
40901,skissors,,1,16,17,33
40902,Sissom,,1,1,3,4
40903,bissco,,1,2,1,3
40904,akreddit,,1,1,3,4
40905,abdeviation,,1,2,1,3
40906,ispice,,1,11,10,21
40907,buddhisaali,,1,1,4,5
40908,kapow53,,1,7,12,19
40909,f5button,,1,12,7,19
40910,sgoguen,,1,13,38,51
40911,cantusaeolus,,1,1,4,5
40912,LOUDNOISES,,1,1,1,2
40913,jaycliche,,1,8,1,9
40914,AHammer16,,1,2,2,4
40915,Dismal_Science,,1,25,51,76
40916,KetaKat,,1,4,6,10
40917,clin_reddit,,1,120,182,302
40918,xxvmarcvxx,,1,1,2,3
40919,PieceOfShoe,,1,1,3,4
40920,FlawlessKnockoff,,1,9,7,16
40921,scattyboy,,1,5,5,10
40922,Plurals,,1,28,10,38
40923,drapi,,1,1,1,2
40924,requiemforadream,,1,1,1,2
40925,Blakovitch,,1,20,1,21
40926,nick415,,1,115,124,239
40927,hotcha,,1,20,10,30
40928,oemta,,1,23,23,46
40929,eratner15,,1,4,3,7
40930,suhlash,,1,2,2,4
40931,vickibci,,1,8,7,15
40932,sandoval33,,1,1,1,2
40933,jmone,,1,1,3,4
40934,bluespapa,,1,102,294,396
40935,mourning_air,,1,4,10,14
40936,duckie,,1,1,2,3
40937,greasyjay,,1,2,6,8
40938,eicos,,1,33,45,78
40939,tmcwilly,,1,4,4,8
40940,crumpgeri,,1,1,2,3
40941,ncamren,,1,2,2,4
40942,jake103,,1,89,24,113
40943,cf26,,1,68,7,75
40944,blinkgeo,,1,40,4,44
40945,verycheeky,,1,7,3,10
40946,dougletts,,1,269,250,519
40947,kpanik,,1,11,24,35
40948,parm,,1,1,2,3
40949,Woodland,,1,1,1,2
40950,devilhorn,,1,1,3,4
40951,findlove,,1,1,1,2
40952,AlanIn2012,,1,2,1,3
40953,superamit,,1,1,1,2
40954,goddesspyxy,,1,1,2,3
40955,kwikie,,1,81,10,91
40956,Jimmni,,1,13,22,35
40957,chromaphobic,,1,1,1,2
40958,skeptica1,,1,34,49,83
40959,Klytus,,1,2,5,7
40960,Intellectual_Poverty,,1,4,4,8
40961,clojed_over_variable,,1,1,1,2
40962,Lyesit,,1,1,2,3
40963,michaelborchert,,1,4,7,11
40964,tonyskyday,,1,1,1,2
40965,erythrocyte,,1,4,12,16
40966,anotherex,,1,9,5,14
40967,corrupteire,,1,1,6,7
40968,mikeypoo,,1,9,9,18
40969,Ayman,,1,4,5,9
40970,Leviathan89,,1,1,6,7
40971,DarthGuru,,1,3,3,6
40972,bdelena,,1,1,1,2
40973,gfindlay,,1,74,64,138
40974,Cheeta66,,1,29,35,64
40975,BlueDeath,,1,43,36,79
40976,kzskzs,,1,47,5,52
40977,fasterdogs,,1,3,4,7
40978,opafaf,,1,5,5,10
40979,zxquarx,,1,3,5,8
40980,dcousineau,,1,78,35,113
40981,sleepingorange,,1,89,86,175
40982,InCaseOfEmergency,,1,63,113,176
40983,0394803948,,1,8,3,11
40984,cradle,,1,4,6,10
40985,sambeee,,1,1,5,6
40986,redditblue,,1,1,4,5
40987,mikeboers,,1,8,8,16
40988,crazy_phys,,1,3,7,10
40989,ramblasos,,1,68,5,73
40990,rubbertoad,,1,2,1,3
40991,ladyroxanne,,1,9,7,16
40992,glenc,,1,5,1,6
40993,Kichigai,,1,13,5,18
40994,wdsnizek,,1,36,31,67
40995,monikioo,,1,1,1,2
40996,LinusTorvalds2600,,1,2,1,3
40997,rtp,,1,172,134,306
40998,nobodysbusiness,,1,36,31,67
40999,soren_m,,1,1,1,2
41000,chenyu768,,1,32,28,60
41001,heff_in_virginia,,1,2,5,7
41002,shitfuckitwhocares,,1,1,1,2
41003,stevewolkrat,,1,9,3,12
41004,PaddyDX,,1,22,23,45
41005,YoHoMoFo,,1,1,1,2
41006,dman413,,1,71,13,84
41007,progressnerd,,1,250,30,280
41008,mercurytransit,,1,14,18,32
41009,shackleton1,,1,46,52,98
41010,franco9x,,1,3,6,9
41011,phatlikebuddha,,1,27,15,42
41012,HippieWithAGun,,1,14,42,56
41013,LillyFrance,,1,1,1,2
41014,flameboy,,1,4,5,9
41015,fonograph,,1,15,20,35
41016,ROFISH,,1,20,1,21
41017,xiaomai,,1,16,26,42
41018,EIderofzion,,1,335,140,475
41019,Sub_911insidejob,,1,5,5,10
41020,madcowga,,1,590,166,756
41021,DiggaPlease,,1,122,78,200
41022,charlesap,,1,1,1,2
41023,nihildeb,,1,2,2,4
41024,controlphreak,,1,11,7,18
41025,DJFlow,,1,8,4,12
41026,rategil7,,1,4,3,7
41027,realneil,,1,250,192,442
41028,mariet,,1,5,1,6
41029,stuckfugu,,1,1,1,2
41030,Coema,,1,1,1,2
41031,caiomoritz,,1,1,2,3
41032,ryalslawfirm,,1,6,14,20
41033,chebwa,,1,12,16,28
41034,DaveM191,,1,216,269,485
41035,stiennon,,1,99,43,142
41036,anforowicz,,1,4,3,7
41037,burtreynoldsmustache,,1,76,102,178
41038,chrisdew,,1,2,1,3
41039,joaquintides,,1,2,1,3
41040,Margrave,,1,13,43,56
41041,CarbonFire,,1,29,64,93
41042,BelieveIt,,1,2,2,4
41043,kublakhan,,1,230,243,473
41044,Flownominal,,1,43,40,83
41045,bocajuniors,,1,13,15,28
41046,2plus2equals11,,1,7,2,9
41047,rmeredit,,1,52,74,126
41048,wildtalon,,1,2,4,6
41049,deadsy,,1,17,21,38
41050,ladoof,,1,64,83,147
41051,SmooveO,,1,2,2,4
41052,mycroft2000,,1,263,143,406
41053,mui_mui,,1,2,3,5
41054,airbrushedvan,,1,92,167,259
41055,Pub1ius,,1,348,120,468
41056,SEVEREaspergers,,1,20,11,31
41057,mogthew,,1,3,3,6
41058,yonigut,,1,54,12,66
41059,Mitchco,,1,6,10,16
41060,hetero_sex_is_rape,,1,8,16,24
41061,simonmd,,1,11,7,18
41062,andrew1718,,1,2,2,4
41063,rajones85,,1,7,9,16
41064,someitguy,,1,56,93,149
41065,Admiral_Mike_Mullen,,1,1,2,3
41066,runswithscissors,,1,22,9,31
41067,grantimatter,,1,116,101,217
41068,TCal79,,1,1,5,6
41069,aaronny,,1,4,1,5
41070,mattjolsen,,1,18,19,37
41071,mpind,,1,262,22,284
41072,zipfe,,1,76,115,191
41073,evolvenow,,1,21,6,27
41074,Digitalabia,,1,2,2,4
41075,Daigain,,1,3,7,10
41076,gunnaf,,1,1,3,4
41077,alexwhitesides,,1,3,4,7
41078,abrahamafreen,,1,1,1,2
41079,georedd,,1,332,254,586
41080,donaloc,,1,2,1,3
41081,osceola,,1,31,30,61
41082,christophski,,1,22,29,51
41083,CaliforniaEagle,,1,47,11,58
41084,aardvark179,,1,1,3,4
41085,murderball,,1,12,14,26
41086,The_Fonz,,1,11,15,26
41087,Adimof,,1,1,1,2
41088,renison,,1,35,26,61
41089,reformislam,,1,166,42,208
41090,CaptainSmirk,,1,3,7,10
41091,johneth,,1,2,6,8
41092,pilikia,,1,3,5,8
41093,ctcherry,,1,1,1,2
41094,SQLwitch,,1,2,1,3
41095,flybot,,1,1,1,2
41096,foreskin,,1,2,2,4
41097,tommykk,,1,8,20,28
41098,LetsGetParty,,1,3,2,5
41099,SomethingClever,,1,21,35,56
41100,LakiTheGreat,,1,38,8,46
41101,laff,,1,8,18,26
41102,jonben,,1,1,2,3
41103,blackgekko,,1,188,286,474
41104,antarest,,1,3,2,5
41105,washwords,,1,2,5,7
41106,316charlesc,,1,1,1,2
41107,BKMateo,,1,21,28,49
41108,joelsephy,,1,1,1,2
41109,UnSuppressed,,1,1,4,5
41110,lovemorgul,,1,1243,81,1324
41111,andypflueger,,1,1,1,2
41112,nothix,,1,5,7,12
41113,oletizi,,1,1,1,2
41114,Kyderdog,,1,4,17,21
41115,ansong,,1,2,2,4
41116,neo_07,,1,5,10,15
41117,xakfuqua,,1,4,3,7
41118,Pandalicious,,1,23,21,44
41119,louisroy,,1,2,5,7
41120,dfranke,,1,183,185,368
41121,victorkiam,,1,37,6,43
41122,someguyz,,1,35,51,86
41123,mark1983,,1,20,11,31
41124,vladimirptn,,1,35,69,104
41125,Obejuan,,1,10,7,17
41126,AllisonsBrains,,1,14,16,30
41127,Cloakofthenight,,1,2,5,7
41128,Jiert,,1,16,10,26
41129,n0t_5hure,,1,783,556,1339
41130,prolog,,1,57,51,108
41131,dregan,,1,162,231,393
41132,Saoshyant,,1,17,9,26
41133,antischool,,1,5,8,13
41134,BigSexyChicken,,1,5,8,13
41135,Shesthefastest,,1,8,18,26
41136,fanten,,1,4,7,11
41137,manofredearth,,1,3,7,10
41138,heeb,,1,52,93,145
41139,knoit911,,1,16,11,27
41140,nelsonslament,,1,5,15,20
41141,Kapow751,,1,37,56,93
41142,mletonsa,,1,27,1,28
41143,jokertrumps,,1,3,2,5
41144,JUSTREDD,,1,4,13,17
41145,jsdalton,,1,57,12,69
41146,Moonbird,,1,4,4,8
41147,so_sleepy,,1,211,516,727
41148,pieterg,,1,1,1,2
41149,danhebs,,1,5,2,7
41150,tm317,,1,5,9,14
41151,Pituquasi,,1,3,2,5
41152,v1mp,,1,2,2,4
41153,namelessgerman,,1,8,6,14
41154,larsga,,1,576,405,981
41155,rogueman999,,1,119,194,313
41156,auntjomama,,1,1,1,2
41157,sl33percat,,1,2,2,4
41158,kookjr,,1,1,15,16
41159,marcusuperbus,,1,2,1,3
41160,tonetheman,,1,6,5,11
41161,k0ugar,,1,4,5,9
41162,digital,,1,3130,465,3595
41163,bearwave,,1,219,64,283
41164,RandyPonce,,1,24,6,30
41165,pasterhatt,,1,3,11,14
41166,starrj0548,,1,3,5,8
41167,heidola,,1,14,35,49
41168,emeraldcity,,1,916,91,1007
41169,raggifl,,1,1,1,2
41170,Jgrav,,1,4,3,7
41171,LizardKing,,1,62,4,66
41172,ashemedai,,1,7,16,23
41173,Bored,,1,909,602,1511
41174,frankm191,,1,3,3,6
41175,NancyFuckingDrew,,1,7,5,12
41176,xxtralarge,,1,6,10,16
41177,kaufmajm,,1,4,1,5
41178,B3nno,,1,2,2,4
41179,ClubSoda,,1,84,87,171
41180,louis4,,1,22,16,38
41181,th13rteen,,1,43,39,82
41182,barnett03,,1,3,1,4
41183,kolanos,,1,47,69,116
41184,grfgguvf,,1,49,65,114
41185,madbadger2000,,1,1,1,2
41186,titty_mcknockers,,1,8,9,17
41187,1fish2fish,,1,1,11,12
41188,muse345,,1,5,8,13
41189,jsh,,1,125,204,329
41190,crunchie_nut,,1,4,1,5
41191,jln,,1,66,37,103
41192,OCedHrt,,1,51,78,129
41193,Cid420,,1,109,162,271
41194,zombiesaregreat,,1,1,1,2
41195,Ari_Rahikkala,,1,1,5,6
41196,conservohippie,,1,23,28,51
41197,BleuBrenda,,1,1,1,2
41198,apollotiger,,1,34,38,72
41199,mcpeg,,1,4,1,5
41200,dne852,,1,1,2,3
41201,OldManRivers,,1,1,1,2
41202,boulax,,1,10,16,26
41203,hippomille,,1,30,4,34
41204,fedira,,1,428,165,593
41205,quantum-mechanic,,1,269,180,449
41206,Huuuuuge_Asshole,,1,2,3,5
41207,garretta,,1,9,7,16
41208,ironsam,,1,2,4,6
41209,iluvlinux81,,1,8,8,16
41210,Extreme_Moderate,,1,3,7,10
41211,themightyredwood,,1,29,33,62
41212,utexaspunk,,1,611,737,1348
41213,masfenix,,1,25,36,61
41214,NinthAgendaDotCom,,1,196,153,349
41215,NimChimpsky,,1,1,2,3
41216,johnla,,1,8,7,15
41217,cryogen,,1,179,293,472
41218,wilcon,,1,1,4,5
41219,cantastoria,,1,4,6,10
41220,SevereArtist,,1,9,8,17
41221,evolved,,1,66,114,180
41222,gabaji123,,1,2,3,5
41223,huevos,,1,9,7,16
41224,robertwrobel,,1,37,49,86
41225,gmacken,,1,12,10,22
41226,radaway,,1,24,38,62
41227,stainrat,,1,4,10,14
41228,Comrade604,,1,1,2,3
41229,sweet_regina,,1,1,3,4
41230,pinkmj,,1,5,3,8
41231,merkidemis,,1,5,3,8
41232,eggcream,,1,6,3,9
41233,Csai,,1,93,13,106
41234,Scandalous,,1,16,21,37
41235,pilt,,1,15,2,17
41236,RosstaPharian,,1,53,12,65
41237,ihaveindeedreddit,,1,1,1,2
41238,YouTubeComments,,1,5,5,10
41239,laurakl,,1,2,3,5
41240,WakeTFU,,1,5,6,11
41241,MysteryHEAD,,1,3,2,5
41242,iggywig,,1,1,1,2
41243,Traiguen,,1,2,4,6
41244,rolfr,,1,166,41,207
41245,fucknuggets,,1,1,1,2
41246,spiky2,,1,153,80,233
41247,memplant,,1,9,19,28
41248,vvv,,1,23,13,36
41249,Suseki,,1,1,3,4
41250,egmanoj,,1,80,19,99
41251,82ndbrat,,1,1,1,2
41252,JRosePC,,1,4,1,5
41253,leetsauce,,1,1,1,2
41254,Wyv,,1,51,105,156
41255,THJahar,,1,1,2,3
41256,harbo,,1,7,7,14
41257,grammamama,,1,3,2,5
41258,damieng,,1,2,1,3
41259,trojan1500,,1,1,1,2
41260,alexgreen,,1,39,59,98
41261,yetispaghetti69,,1,1,4,5
41262,FUCKINDOITLIVEFUCKNO,,1,5,8,13
41263,ctulhu,,1,14,1,15
41264,cdeponte,,1,13,26,39
41265,Prototek,,1,45,51,96
41266,joe_from_accounting,,1,63,80,143
41267,mad44,,1,3,4,7
41268,mech,,1,4,7,11
41269,matthew49,,1,3,2,5
41270,Paula18,,1,3,3,6
41271,filmratt,,1,7,4,11
41272,crasylemur,,1,9,5,14
41273,seeyardee,,1,40,101,141
41274,matthew26,,1,62,28,90
41275,gman1993,,1,1,11,12
41276,jmmcd,,1,260,397,657
41277,lyyphe23,,1,318,530,848
41278,iknowgeography,,1,1,1,2
41279,iamjason,,1,251,24,275
41280,ingreenheaven,,1,7,7,14
41281,footjo,,1,8,4,12
41282,sworsham,,1,1,2,3
41283,kcb2,,1,34,10,44
41284,saagar734,,1,1,1,2
41285,capitalwon,,1,313,3,316
41286,piojo,,1,7,9,16
41287,amrap,,1,17,17,34
41288,Lexitron,,1,5,9,14
41289,jvarden,,1,10,2,12
41290,spagls,,1,4,6,10
41291,jaims,,1,1,2,3
41292,CliffDropOver,,1,117,185,302
41293,sameboat,,1,1,6,7
41294,geekboy,,1,13,27,40
41295,apocalypse910,,1,85,143,228
41296,disposablename,,1,3,5,8
41297,ManifestoConform,,1,44,60,104
41298,gbarrancos,,1,4,9,13
41299,haytphul,,1,1,1,2
41300,MsJoanne,,1,10,2,12
41301,Ceticus,,1,1,2,3
41302,ketilkn,,1,2,2,4
41303,kneelconqueso,,1,24,30,54
41304,wudi,,1,1,1,2
41305,dane_tmln,,1,1,1,2
41306,a0peter,,1,3,1,4
41307,DCSven,,1,2,1,3
41308,rmn30,,1,3,5,8
41309,jhs,,1,30,20,50
41310,ApochPiQ,,1,11,10,21
41311,particlesaching,,1,11,9,20
41312,brian_c,,1,62,74,136
41313,tommij,,1,7,17,24
41314,cliff_martin,,1,4,4,8
41315,gbirdc,,1,11,15,26
41316,valeriac,,1,1,1,2
41317,mrsiffer,,1,3,7,10
41318,nsimpson,,1,3,3,6
41319,Arcphi,,1,3,1,4
41320,Bardo77n,,1,17,17,34
41321,illegible,,1,83,182,265
41322,Tezasaurus,,1,147,270,417
41323,infoaddicted,,1,198,164,362
41324,toofar,,1,2,2,4
41325,SmokeSerpent,,1,21,39,60
41326,arthurphandler,,1,6,26,32
41327,winkoff,,1,1,1,2
41328,Kaan,,1,2,2,4
41329,Sud,,1,1,1,2
41330,cheponis,,1,46,37,83
41331,danman108,,1,2,4,6
41332,chillywafer,,1,2,2,4
41333,rnicoll,,1,454,499,953
41334,otooleco,,1,2,4,6
41335,timothy331,,1,3,1,4
41336,derkdadurr,,1,4,1,5
41337,ComboBreaker,,1,3,8,11
41338,fenderrocker,,1,45,20,65
41339,VideoDromedary,,1,8,5,13
41340,Squaker,,1,1,5,6
41341,drewlb,,1,40,38,78
41342,abshack,,1,22,37,59
41343,Ahurricane,,1,3,3,6
41344,pilto,,1,711,1007,1718
41345,zulo,,1,1,1,2
41346,Julian_Tempest,,1,1,1,2
41347,IRAN_MIKE_TYSON,,1,176,264,440
41348,KatieR10381,,1,87,73,160
41349,raveland,,1,3,2,5
41350,poopster,,1,24,25,49
41351,cultfigure,,1,3,1,4
41352,Archaia,,1,14,4,18
41353,ebosia,,1,2,8,10
41354,IHaveAnIdea,,1,178,335,513
41355,pyres,,1,5,3,8
41356,corky2515,,1,6,6,12
41357,inthe80s,,1,116,89,205
41358,hodagboy,,1,1,1,2
41359,Royalhghnss,,1,3,5,8
41360,jrbattin,,1,2,2,4
41361,uspn,,1,46,79,125
41362,colinjay,,1,9,10,19
41363,isthis,,1,33,16,49
41364,neversummer427,,1,200,137,337
41365,MrMakeveli,,1,1,6,7
41366,Dethklok,,1,36,65,101
41367,debacle,,1,6,8,14
41368,Vreep-eep,,1,144,226,370
41369,ahmonster,,1,2,3,5
41370,NeoMonkey,,1,95,143,238
41371,idle,,1,16,28,44
41372,inter123net,,1,2,1,3
41373,stopredditcensorship,,1,4,6,10
41374,wormspit,,1,4,6,10
41375,roadkillJESUS,,1,2,3,5
41376,Kevin_Raven,,1,64,90,154
41377,merks,,1,1,1,2
41378,slythfox,,1,109,188,297
41379,gonzinator,,1,1,1,2
41380,bettr,,1,2,2,4
41381,radiantwave,,1,42,72,114
41382,msjgriffiths,,1,4,6,10
41383,schaueho,,1,29,28,57
41384,Aahana,,1,3,4,7
41385,Kektain,,1,7,14,21
41386,HighHorse,,1,1,5,6
41387,anzhansen,,1,32,42,74
41388,interstate,,1,595,774,1369
41389,PleadTheTenth,,1,2,2,4
41390,sleepnow,,1,1,1,2
41391,SisterRay,,1,11,29,40
41392,timran,,1,179,7,186
41393,Swiggy,,1,652,331,983
41394,ccbbb23,,1,1,1,2
41395,achzavoth,,1,1,1,2
41396,moorage,,1,25,2,27
41397,tapedeck,,1,85,123,208
41398,oooeeeoooahhahh,,1,2,9,11
41399,AAjax,,1,383,553,936
41400,ThucydidesNow,,1,81,32,113
41401,drbaskin,,1,2,4,6
41402,rickshawricky,,1,5,2,7
41403,luml0003,,1,3,8,11
41404,elizabklyn,,1,35,46,81
41405,diplowset,,1,21,12,33
41406,jpspeno,,1,4,1,5
41407,kla,,1,71,78,149
41408,buttlord,,1,6,5,11
41409,jherazob,,1,12,23,35
41410,mbemberoui,,1,1,3,4
41411,kzyck,,1,1,1,2
41412,Pythagoras,,1,16,29,45
41413,ffejnamhcab1,,1,1,1,2
41414,inigid,,1,1,2,3
41415,looseshoes,,1,12,23,35
41416,innocenti,,1,3,1,4
41417,blan,,1,2,2,4
41418,brittanyq,,1,1,5,6
41419,askegg,,1,5,13,18
41420,patrick2009sw,,1,2,4,6
41421,watchman,,1,22,4,26
41422,cmprsdchse,,1,42,55,97
41423,travelingwilbury,,1,7,1,8
41424,lobster280zx,,1,1,1,2
41425,MpVpRb,,1,11,24,35
41426,stomicron,,1,256,314,570
41427,TheRealRedditAlien,,1,1,1,2
41428,papandrew,,1,1,1,2
41429,truthslacker,,1,1,1,2
41430,solidad,,1,3,4,7
41431,SomeGuyNamedAl,,1,1,4,5
41432,gotwillk,,1,1,1,2
41433,Comrad_Pat,,1,2,8,10
41434,Captain-Obliviouss,,1,387,724,1111
41435,mongoloid3,,1,7,16,23
41436,Soulbow,,1,39,63,102
41437,ngn,,1,122,34,156
41438,joegester,,1,6,7,13
41439,smoove_criminal,,1,3,1,4
41440,flezgodrit,,1,246,160,406
41441,jludwi2,,1,1,1,2
41442,forgotmyothapassword,,1,54,40,94
41443,clefairy,,1,64,115,179
41444,zyl0x,,1,60,112,172
41445,amarok9,,1,22,13,35
41446,cbergeron,,1,25,53,78
41447,DarthTickle,,1,1,1,2
41448,ALUGO,,1,1,2,3
41449,bradanderson,,1,8,3,11
41450,jmerloni,,1,4,5,9
41451,bye123,,1,1,3,4
41452,blar,,1,4,2,6
41453,ToonArmy,,1,32,50,82
41454,benlong,,1,8,9,17
41455,btc08,,1,6,27,33
41456,LeroyInAJar,,1,1,6,7
41457,jtdgrz,,1,14,8,22
41458,dontbeatool,,1,55,114,169
41459,gromdul,,1,448,767,1215
41460,GRSCHAAF,,1,116,16,132
41461,toni_ch,,1,2,2,4
41462,nerdmom,,1,1,1,2
41463,iredditnewbie,,1,25,32,57
41464,subliminalpie,,1,1,1,2
41465,neuralzen,,1,94,51,145
41466,nemeth,,1,23,68,91
41467,redknob,,1,18,40,58
41468,Billistic,,1,17,58,75
41469,kephnos,,1,7,9,16
41470,Phayded,,1,74,54,128
41471,montresor,,1,55,120,175
41472,leemoore,,1,22,12,34
41473,realfinkployd,,1,17,20,37
41474,jediknight,,1,33,46,79
41475,iNewsit,,1,6,2,8
41476,wkdown,,1,87,212,299
41477,teu,,1,1,1,2
41478,typogenerator,,1,5,21,26
41479,ralpht,,1,6,5,11
41480,bobbyrotten,,1,3,3,6
41481,yogeshtk,,1,1,1,2
41482,er0k,,1,53,96,149
41483,NicholasNizib,,1,63,48,111
41484,goonbee,,1,3,10,13
41485,adamant777,,1,31,54,85
41486,ajv570,,1,7,34,41
41487,ayrsen,,1,1,3,4
41488,killq,,1,43,1,44
41489,Nicolay77,,1,97,349,446
41490,Tanath,,1,144,253,397
41491,mindovermatter,,1,19,12,31
41492,___God___,,1,1,2,3
41493,noshelter,,1,5,17,22
41494,sarahg,,1,1,1,2
41495,ilt,,1,75,116,191
41496,missiontodenmark,,1,18,12,30
41497,l3riann,,1,2,4,6
41498,redsalmon,,1,1,1,2
41499,Quintus,,1,4,2,6
41500,jimmykane,,1,27,45,72
41501,marakith,,1,42,38,80
41502,pheliak,,1,2,3,5
41503,Huuuuuuge_Asshole,,1,17,33,50
41504,TheEnturbulator,,1,17,29,46
41505,geesquire,,1,2,3,5
41506,bloby,,1,1,1,2
41507,URGENTCAPSLOCKMAN,,1,36,80,116
41508,nlee23,,1,2,1,3
41509,SarahPalinIsSatan,,1,73,72,145
41510,wilkinson,,1,11,8,19
41511,badee,,1,87,1,88
41512,greenmonstah04,,1,1,1,2
41513,Anim8me2,,1,24,8,32
41514,t1k,,1,1,2,3
41515,cnn,,1,2,9,11
41516,starrychloe,,1,583,587,1170
41517,joculartesticle,,1,8,11,19
41518,joshuag,,1,20,46,66
41519,LiberalHippies2,,1,121,211,332
41520,Mojah,,1,44,3,47
41521,thorgeir23,,1,25,51,76
41522,IsThisSilicone,,1,33,12,45
41523,quitstaringatme1,,1,1,3,4
41524,dblowe,,1,30,29,59
41525,freon,,1,10,13,23
41526,eshan,,1,5,6,11
41527,spooonmaan,,1,8,36,44
41528,Drainiac,,1,3,2,5
41529,lilipult,,1,2,2,4
41530,nichiyume,,1,43,56,99
41531,jolla,,1,4,5,9
41532,DwarfTheMike,,1,15,15,30
41533,barnutnewman,,1,1,3,4
41534,thecoolestcow,,1,135,102,237
41535,Koush,,1,3,4,7
41536,jnuglife,,1,1,1,2
41537,puredemo,,1,258,551,809
41538,huebner5000,,1,2,1,3
41539,Pluripotent,,1,3,3,6
41540,boogamama,,1,1,2,3
41541,rsmoling,,1,95,123,218
41542,Vince_Walker,,1,1,1,2
41543,salubrium,,1,36,49,85
41544,tpaulman,,1,1,1,2
41545,myglaven,,1,2,1,3
41546,le_piaf,,1,46,89,135
41547,bsr816,,1,7,23,30
41548,tony_landis,,1,10,7,17
41549,QuickThought,,1,11,8,19
41550,mastodan,,1,1,1,2
41551,phreshinger,,1,23,32,55
41552,allarise,,1,124,102,226
41553,hgg,,1,1,3,4
41554,vjack,,1,445,32,477
41555,medusa-zombie-eel,,1,1,1,2
41556,simulacrum,,1,8,4,12
41557,Neesh,,1,14,21,35
41558,robotsongs,,1,311,404,715
41559,cathexis,,1,9,1,10
41560,feltpelt,,1,2,1,3
41561,darwynn,,1,8,7,15
41562,smackjack,,1,65,29,94
41563,hurricaneheta,,1,3,5,8
41564,downwithbigbrother,,1,6,7,13
41565,trifolic,,1,5,7,12
41566,somefoo,,1,1,2,3
41567,chriguhose,,1,1,1,2
41568,agimat,,1,12,30,42
41569,audi_b5_driver_4_lif,,1,1,1,2
41570,iamstig,,1,10,2,12
41571,WealthBoy,,1,25,6,31
41572,killy971,,1,15,1,16
41573,pwilliards,,1,3,1,4
41574,yickster,,1,22,7,29
41575,zettabyte,,1,32,42,74
41576,LOLster,,1,1,5,6
41577,dlacone,,1,32,35,67
41578,frickthejews,,1,101,253,354
41579,stonedparadox,,1,53,78,131
41580,haxored,,1,163,201,364
41581,Zeulodin,,1,19,23,42
41582,xal,,1,12,12,24
41583,bigboi007,,1,1,1,2
41584,Glimjaur,,1,5,7,12
41585,jdc123,,1,128,153,281
41586,metalhead,,1,40,60,100
41587,mrbonglord,,1,4,4,8
41588,caboose263,,1,2,1,3
41589,goolglee,,1,39,16,55
41590,misfit410,,1,23,27,50
41591,blanute,,1,3,1,4
41592,misterthingy,,1,48,21,69
41593,nokie,,1,1,1,2
41594,scrod,,1,19,51,70
41595,malaislinn,,1,42,68,110
41596,cruxdestruct,,1,38,2,40
41597,flaco46,,1,2,1,3
41598,oheard,,1,1,3,4
41599,MozzNJ,,1,8,7,15
41600,archmaille,,1,2,3,5
41601,dave_tart,,1,1,3,4
41602,barrkel,,1,30,29,59
41603,4Chan_Ambassador,,1,9,15,24
41604,zhore182,,1,3,2,5
41605,xpollux,,1,2,1,3
41606,mutard7,,1,41,44,85
41607,welch6980,,1,42,52,94
41608,mattdonovan,,1,12,6,18
41609,bluebandit,,1,2,6,8
41610,majorlyannoyed,,1,24,44,68
41611,jboeke,,1,36,35,71
41612,rklophaus,,1,5,4,9
41613,rory236,,1,25,39,64
41614,thepastagod,,1,102,117,219
41615,oldbasara,,1,3,3,6
41616,aphrodites,,1,4,5,9
41617,sundevilsf,,1,47,14,61
41618,clearwaterlab,,1,24,16,40
41619,pirlok,,1,484,16,500
41620,jkff,,1,50,53,103
41621,hundredaire,,1,1,1,2
41622,asbjxrn,,1,4,14,18
41623,nat_pryce,,1,43,58,101
41624,smurton,,1,35,21,56
41625,7077Y,,1,2,1,3
41626,HeroicLife,,1,288,315,603
41627,yefxyhrxlvbtc,,1,1,1,2
41628,Nwallins,,1,123,201,324
41629,13above,,1,60,3,63
41630,fubberyfuckie,,1,3,3,6
41631,bucshtalk,,1,16,1,17
41632,lazythekid,,1,19,12,31
41633,arthurdenture,,1,114,102,216
41634,YAFZ,,1,9,7,16
41635,IfCelebsMoved2OKNazi,,1,1,1,2
41636,fabriciostudio,,1,3,2,5
41637,evehorizon,,1,4,3,7
41638,GT45,,1,1,10,11
41639,jevon,,1,57,69,126
41640,Black_Fusion,,1,1,4,5
41641,clenard,,1,3,1,4
41642,llurker,,1,9,13,22
41643,wild,,1,5,12,17
41644,marcov,,1,3,4,7
41645,efk,,1,86,213,299
41646,pondy,,1,369,7,376
41647,ryckmonster,,1,10,35,45
41648,jonhohle,,1,146,127,273
41649,dankirsh,,1,1,1,2
41650,SkiCaradhras,,1,37,35,72
41651,NovaX81,,1,48,19,67
41652,leonardoe,,1,44,2,46
41653,computergeek6933,,1,30,42,72
41654,KingofGleak1990,,1,9,9,18
41655,Aardvark1878,,1,3,3,6
41656,alins,,1,639,38,677
41657,cjpro,,1,28,35,63
41658,MrDNL,,1,24,1,25
41659,niomi,,1,22,32,54
41660,mouthofthefraser,,1,1,1,2
41661,peren488,,1,7,1,8
41662,xbillybobx,,1,73,61,134
41663,altaccount,,1,2,8,10
41664,bgaffneysep,,1,7,1,8
41665,DaffyDuck,,1,35,97,132
41666,ob2,,1,43,53,96
41667,schlenk,,1,57,80,137
41668,nk47,,1,1,1,2
41669,wupshaw,,1,2,1,3
41670,curoi,,1,3,2,5
41671,icantseeyou,,1,39,9,48
41672,bpar23,,1,9,7,16
41673,SurRea1,,1,6,5,11
41674,JBaker68,,1,50,9,59
41675,racerz,,1,29,46,75
41676,ismellawumpus,,1,1,1,2
41677,pjleonhardt,,1,12,21,33
41678,phreakre,,1,11,23,34
41679,wulfhound,,1,19,34,53
41680,headfake,,1,10,20,30
41681,busboy,,1,3,1,4
41682,time4drift,,1,3,4,7
41683,bob10,,1,3,2,5
41684,parshul,,1,86,183,269
41685,robdag2,,1,335,364,699
41686,bobbyopulent,,1,11,19,30
41687,MrSaru,,1,103,142,245
41688,f4hy,,1,60,54,114
41689,fredstopp,,1,109,222,331
41690,blake82,,1,16,6,22
41691,39489384848,,1,2,2,4
41692,hoffa_lives,,1,46,80,126
41693,onetimeonly,,1,5,1,6
41694,Oliverotto,,1,37,87,124
41695,watersong,,1,2,5,7
41696,bagels666,,1,20,42,62
41697,justbrowsing,,1,1,1,2
41698,zekester,,1,9,22,31
41699,mdedm,,1,497,304,801
41700,trophius,,1,14,17,31
41701,Belacqua,,1,1,2,3
41702,denvernomad,,1,31,12,43
41703,chcorreia,,1,4,6,10
41704,brrose,,1,86,85,171
41705,macainiac,,1,6,4,10
41706,mayAc,,1,1,5,6
41707,rufusatemylunch,,1,6,1,7
41708,longlivedeath,,1,23,36,59
41709,robbied462,,1,8,4,12
41710,AlekseyP,,1,227,403,630
41711,s810,,1,181,173,354
41712,Drachis,,1,12,16,28
41713,zambal,,1,1,3,4
41714,peterhogg2,,1,28,37,65
41715,thewakebehindyou,,1,63,72,135
41716,randomwolf,,1,13,23,36
41717,TomTerrific,,1,79,32,111
41718,woodenturkey,,1,43,40,83
41719,rwb,,1,93,5,98
41720,migueltronix,,1,19,24,43
41721,TruthHammer,,1,215,320,535
41722,RonnieRightstuff,,1,2,2,4
41723,olliej,,1,17,31,48
41724,yourapostasy,,1,98,181,279
41725,aurrun,,1,4,2,6
41726,mrspaz,,1,28,38,66
41727,thomasw,,1,3,3,6
41728,stigglewick,,1,2,3,5
41729,toughpat,,1,7,5,12
41730,mereimmortal,,1,3,4,7
41731,ezfrag,,1,1,1,2
41732,nordic86,,1,27,27,54
41733,mikezimmer,,1,5,1,6
41734,cydril,,1,2,15,17
41735,Ferrisford,,1,303,24,327
41736,cacheson,,1,72,96,168
41737,pelletierm,,1,1,4,5
41738,jimbobhickville,,1,270,408,678
41739,Frai1ty,,1,4,5,9
41740,rpeters83,,1,10,11,21
41741,mandangalo,,1,1,1,2
41742,curtisblow,,1,1,2,3
41743,napalmdaddy,,1,11,43,54
41744,gl77,,1,2,2,4
41745,DrumMaster260,,1,5,2,7
41746,philoscience,,1,8,8,16
41747,argra,,1,2,2,4
41748,brentmc79,,1,4,2,6
41749,d00ley,,1,395,713,1108
41750,kostakrauth,,1,2,4,6
41751,ice_cold_irony,,1,6,1,7
41752,droob,,1,3,3,6
41753,camus,,1,52,6,58
41754,ardit33,,1,14,15,29
41755,voiceofgrog,,1,55,28,83
41756,acidw4rp,,1,5,8,13
41757,beardedninja,,1,3,4,7
41758,mtl_hed,,1,2,1,3
41759,bushwakko,,1,318,498,816
41760,bcash,,1,775,385,1160
41761,brimshinto,,1,1,1,2
41762,MattHock,,1,149,187,336
41763,lavagod11,,1,1,2,3
41764,hervold,,1,1,1,2
41765,pupdike,,1,59,73,132
41766,hyphen-nazi,,1,3,1,4
41767,minnabakka,,1,13,7,20
41768,TankMan3217,,1,29,42,71
41769,nerdlife,,1,68,169,237
41770,Nessie,,1,5,27,32
41771,pleasepleaseplease,,1,1,1,2
41772,w3stfa11,,1,6,8,14
41773,robrem,,1,8,13,21
41774,blunderwoman,,1,2,3,5
41775,rappin,,1,275,7,282
41776,unbelieve,,1,2,2,4
41777,Deiz,,1,105,129,234
41778,moe,,1,1,1,2
41779,uksjfsduykfvsdfv,,1,41,33,74
41780,doublec,,1,34,27,61
41781,GreySim,,1,28,47,75
41782,mikem93,,1,5,6,11
41783,Herkimer,,1,45,66,111
41784,infz,,1,37,20,57
41785,blueskydiver76,,1,51,55,106
41786,ardalan,,1,2,6,8
41787,MrNeill,,1,1,4,5
41788,MoronicUtopian,,1,17,31,48
41789,deathbob,,1,3,5,8
41790,qweqweiqwe,,1,3,4,7
41791,edisoncarter,,1,5,3,8
41792,Atashi,,1,3,1,4
41793,caust1c,,1,2,1,3
41794,asoneth,,1,1,4,5
41795,asj,,1,5,3,8
41796,rozacruce,,1,10,12,22
41797,ikky75,,1,5,8,13
41798,Wuped,,1,2,4,6
41799,game-master,,1,1,1,2
41800,DoorFrame,,1,666,449,1115
41801,miajade20,,1,1,1,2
41802,skinp,,1,5,6,11
41803,ninguem,,1,185,207,392
41804,Mazaev,,1,3,1,4
41805,teahsea,,1,1,5,6
41806,crash-dev,,1,4,6,10
41807,ndanger,,1,93,9,102
41808,cindybin,,1,21,63,84
41809,mogal10,,1,3,3,6
41810,BlankVerse,,1,772,49,821
41811,97bravo,,1,73,39,112
41812,DoctorRin,,1,17,38,55
41813,jsnx,,1,193,334,527
41814,darthnut,,1,16,13,29
41815,loath,,1,6,9,15
41816,chrissybear,,1,3,2,5
41817,scroggalog,,1,12,16,28
41818,afroisalreadyinu,,1,87,28,115
41819,hwessin,,1,3,4,7
41820,lvx23,,1,3,4,7
41821,mohawke,,1,5,1,6
41822,beaner19,,1,5,3,8
41823,akinari42,,1,11,2,13
41824,jeeeebus,,1,4,7,11
41825,jp57,,1,3,2,5
41826,cigarjack,,1,22,23,45
41827,bjmiller,,1,1,3,4
41828,dreamsubmitting,,1,2,1,3
41829,komu,,1,1,3,4
41830,nme,,1,2,1,3
41831,spitzer,,1,15,20,35
41832,BostonLow,,1,1,4,5
41833,callicles,,1,8,4,12
41834,simonvc,,1,54,41,95
41835,kitisfultly,,1,1,1,2
41836,tbhurst,,1,240,44,284
41837,Darkness12,,1,92,69,161
41838,qprtvy,,1,3,11,14
41839,silouan,,1,69,114,183
41840,robpwalker,,1,4,3,7
41841,zanmat0,,1,1,6,7
41842,Ryan256,,1,6,19,25
41843,Pilebsa,,1,1148,1063,2211
41844,_ex_,,1,28,33,61
41845,gottabekd,,1,10,14,24
41846,niqhil,,1,3,4,7
41847,OrionSmith,,1,4,4,8
41848,Bender1012,,1,8,22,30
41849,dashiel,,1,64,68,132
41850,elvisjagger,,1,21,33,54
41851,werg,,1,22,13,35
41852,drosser,,1,201,314,515
41853,bigmell,,1,1,1,2
41854,zwelch,,1,1,1,2
41855,jesnell,,1,4,3,7
41856,Thaumiel,,1,2,2,4
41857,meti,,1,2,2,4
41858,clockradio,,1,79,134,213
41859,Lryder2k6,,1,3,5,8
41860,scottiebumich,,1,1,1,2
41861,gwest,,1,4,6,10
41862,TehSlippy,,1,51,63,114
41863,onektwenty4,,1,11,12,23
41864,Yst,,1,481,479,960
41865,monkbot1,,1,89,243,332
41866,estesce,,1,6,1,7
41867,uberjooz,,1,5,2,7
41868,mothereffingteresa,,1,552,907,1459
41869,saturn266,,1,4,7,11
41870,bjacob,,1,7,4,11
41871,cvanderlinden,,1,1,6,7
41872,louie12,,1,4,2,6
41873,vermont8,,1,2,1,3
41874,joshwa,,1,107,36,143
41875,BlackNapkins,,1,10,15,25
41876,rotzeach,,1,1,4,5
41877,l0b0,,1,3,4,7
41878,jetjaguar,,1,240,404,644
41879,Vegetabl,,1,1,1,2
41880,sparrow_townshend,,1,12,3,15
41881,zentropy,,1,1,1,2
41882,vige,,1,4,7,11
41883,joelypolly,,1,1,5,6
41884,gunk,,1,1,1,2
41885,wejami,,1,23,41,64
41886,pixel1000,,1,5,2,7
41887,Azradesh,,1,6,16,22
41888,BonzoESC,,1,32,37,69
41889,hellofriends,,1,7,10,17
41890,belandil,,1,1179,1391,2570
41891,m1ss1ontomars2k4,,1,994,1729,2723
41892,Dokugumo,,1,32,33,65
41893,ahmednawaz,,1,3,10,13
41894,mickeytwist,,1,44,18,62
41895,Program_Buddhist,,1,13,2,15
41896,salmarumman,,1,1,1,2
41897,xgrue,,1,1,3,4
41898,lukego,,1,3,6,9
41899,MBlume,,1,110,61,171
41900,cgomez,,1,123,134,257
41901,BannedUser,,1,6,6,12
41902,picar0,,1,95,129,224
41903,Bomberteddy,,1,13,41,54
41904,SikWithIt,,1,125,4,129
41905,skillfull,,1,217,16,233
41906,chych,,1,17,17,34
41907,skipdog172,,1,67,58,125
41908,foundati,,1,4,10,14
41909,wreckingcru,,1,39,60,99
41910,kixx,,1,50,64,114
41911,batasrki,,1,129,70,199
41912,zombieninja,,1,1,1,2
41913,Tincho_,,1,1,1,2
41914,Hezy,,1,9,2,11
41915,bruno_metsu,,1,1,1,2
41916,Hadron,,1,3,1,4
41917,avocat,,1,1,1,2
41918,beckingh,,1,39,42,81
41919,smors,,1,17,20,37
41920,weoriusdlkfjweoiruwk,,1,2,1,3
41921,variflex,,1,1,1,2
41922,James_Johnson,,1,106,161,267
41923,wackjob,,1,6,2,8
41924,Kyrsidal,,1,1,2,3
41925,hookahey,,1,6,10,16
41926,buckX,,1,107,167,274
41927,2ndskin,,1,1,1,2
41928,yellat,,1,82,238,320
41929,ObligatoryXKCDRef,,1,1,2,3
41930,bhog,,1,35,56,91
41931,smitting,,1,5,16,21
41932,2point8,,1,61,6,67
41933,SentientGiraffe,,1,3,6,9
41934,cmyersavi,,1,2,1,3
41935,jstevewhite,,1,1,4,5
41936,Intrebud,,1,10,3,13
41937,nom_de_plume,,1,1,1,2
41938,pavehawk,,1,102,17,119
41939,kstan42,,1,1,1,2
41940,bmdan,,1,283,253,536
41941,monx,,1,12,25,37
41942,logicalstack,,1,3,3,6
41943,rickJ,,1,5,9,14
41944,zik,,1,11,12,23
41945,testerB,,1,2,4,6
41946,adam21924,,1,1,7,8
41947,iammnothere,,1,1,1,2
41948,snuuf,,1,1,1,2
41949,douchefag,,1,1,9,10
41950,thereptilezoo,,1,8,11,19
41951,fruggiedesh,,1,9,7,16
41952,generic_genus,,1,2,1,3
41953,EAREST,,1,1,1,2
41954,mattomatto,,1,124,185,309
41955,Ho66es,,1,2,3,5
41956,Skasian,,1,1,2,3
41957,albolin,,1,14,23,37
41958,curbstompery,,1,129,222,351
41959,Chris_Farley,,1,129,8,137
41960,pjjw,,1,1,1,2
41961,naasking,,1,206,406,612
41962,Narrator,,1,207,222,429
41963,phixa,,1,67,76,143
41964,scordatura,,1,558,182,740
41965,dcueva,,1,108,49,157
41966,Anderkay,,1,80,4,84
41967,in8joy,,1,86,116,202
41968,LockeL,,1,19,20,39
41969,threnody,,1,42,27,69
41970,shcirnuh,,1,3,7,10
41971,grizzydot,,1,3,2,5
41972,kudoz,,1,7,4,11
41973,komal,,1,73,110,183
41974,kminator,,1,168,377,545
41975,davidng,,1,5,2,7
41976,Avocadoes,,1,78,77,155
41977,crowbent,,1,8,9,17
41978,bellow,,1,26,3,29
41979,chewyrunt,,1,3,6,9
41980,strencher,,1,2,6,8
41981,heartsutra,,1,2,2,4
41982,predius,,1,97,102,199
41983,gmerideth,,1,11,9,20
41984,jbester,,1,2,2,4
41985,ILeftDiggforReddit,,1,615,637,1252
41986,Urizen,,1,375,355,730
41987,tabooki,,1,3,5,8
41988,pras,,1,152,187,339
41989,riverrock,,1,77,87,164
41990,rangerkozak,,1,1,2,3
41991,retrojoe,,1,40,7,47
41992,beejou,,1,37,77,114
41993,Hathadar,,1,1,1,2
41994,jhuckabee,,1,14,4,18
41995,robotcaptain,,1,19,11,30
41996,Clue,,1,2,3,5
41997,diggisdead,,1,4,2,6
41998,caveman5,,1,8,1,9
41999,NoBubbles,,1,8,9,17
42000,MagiTekSoldier,,1,117,156,273
42001,WillieJamesHuff,,1,1,1,2
42002,matrixclown,,1,127,166,293
42003,_error,,1,23,23,46
42004,tici_88,,1,6,2,8
42005,multubunu,,1,157,253,410
42006,Takfir,,1,52,32,84
42007,crawf061,,1,48,60,108
42008,satire,,1,76,170,246
42009,fahq,,1,3,1,4
42010,nuxvomica,,1,13,20,33
42011,dugmartin,,1,76,88,164
42012,black330ci,,1,2,4,6
42013,jshardy,,1,6,10,16
42014,wingedhelmet,,1,3,2,5
42015,Bwian,,1,3,7,10
42016,xynny,,1,4,1,5
42017,hsure,,1,23,29,52
42018,CodeMangler,,1,6,6,12
42019,theAngryNorse,,1,5,2,7
42020,maxburke,,1,6,4,10
42021,tomcruz,,1,20,34,54
42022,Ocin,,1,28,42,70
42023,FezWad,,1,8,26,34
42024,recoiledsnake,,1,119,100,219
42025,samwise324,,1,3,7,10
42026,TheDeerLady,,1,32,23,55
42027,jazzdonkey,,1,6,7,13
42028,cswift1,,1,15,12,27
42029,Tekmo,,1,395,519,914
42030,liberdade,,1,144,201,345
42031,nybiara,,1,1,1,2
42032,masterpo,,1,300,870,1170
42033,captainm,,1,31,59,90
42034,lordhumungus,,1,4,5,9
42035,cashflow,,1,9,9,18
42036,nypd_out_of_control,,1,3,1,4
42037,MCallanan,,1,14,2,16
42038,lookingchris,,1,44,92,136
42039,NetworkMeUp,,1,90,13,103
42040,Dodo-Bot,,1,9,3,12
42041,american_moron,,1,12,30,42
42042,ablatocinet,,1,1,1,2
42043,Enrickey,,1,6,11,17
42044,MotherFirefly,,1,10,16,26
42045,wreel,,1,35,19,54
42046,james_block,,1,86,92,178
42047,panzan,,1,48,32,80
42048,cranberrybobbie,,1,3,1,4
42049,kazooz,,1,1,4,5
42050,bprater,,1,36,36,72
42051,xan1th,,1,1,5,6
42052,TheGrammarMaoist,,1,1,1,2
42053,burntbeans,,1,9,1,10
42054,drudru,,1,46,12,58
42055,candylee,,1,41,16,57
42056,Strom_Thermite,,1,1,4,5
42057,newstart,,1,28,36,64
42058,digitizemd,,1,14,1,15
42059,majorbabu,,1,8,2,10
42060,Phlag,,1,8,5,13
42061,tnek46,,1,2,5,7
42062,kdirkes,,1,34,1,35
42063,onestab,,1,222,302,524
42064,focusfriend,,1,1,1,2
42065,shadowie,,1,139,67,206
42066,Grimm,,1,5,1,6
42067,notmyrealusername,,1,4,3,7
42068,manystrom,,1,2,1,3
42069,zyle,,1,429,503,932
42070,rovecheney08,,1,1,3,4
42071,psikic,,1,14,13,27
42072,boraca,,1,1,1,2
42073,spanner3,,1,2,5,7
42074,OSStourist,,1,2,4,6
42075,bouleuterion,,1,3,17,20
42076,Maox,,1,2,8,10
42077,sadmachine,,1,21,21,42
42078,NOWUVEDONEIT,,1,1,3,4
42079,amazed,,1,2,3,5
42080,indescription,,1,394,520,914
42081,mcdoh,,1,55,36,91
42082,tocomeunglued,,1,15,9,24
42083,jcroisant4,,1,5,5,10
42084,amedia,,1,95,186,281
42085,biosphere03,,1,21,25,46
42086,ealf,,1,237,210,447
42087,pastyquail,,1,12,33,45
42088,jerichochicago,,1,1,2,3
42089,csispy007,,1,3,2,5
42090,mnocket,,1,5,10,15
42091,zmwe,,1,5,1,6
42092,MrGrim,,1,25,11,36
42093,thinkgreen,,1,8,24,32
42094,lake-of-fire,,1,50,48,98
42095,killadyvah,,1,14,41,55
42096,MichaelJMotta,,1,12,2,14
42097,brainiac,,1,204,179,383
42098,joe_chip,,1,11,2,13
42099,dankirkd,,1,2,2,4
42100,m8urn,,1,3,1,4
42101,adjective,,1,3,1,4
42102,sr332603,,1,3,6,9
42103,telvana,,1,17,7,24
42104,tantamounted,,1,15,4,19
42105,Btw0,,1,3,7,10
42106,Spacepope6,,1,347,447,794
42107,MsBooBoo,,1,9,4,13
42108,Jsilver,,1,5,1,6
42109,tripoli,,1,2,4,6
42110,svahne,,1,1,2,3
42111,timedilation,,1,17,13,30
42112,vander25,,1,5,2,7
42113,Advocate4Health,,1,1,2,3
42114,guapoo,,1,182,209,391
42115,Joeboy,,1,48,57,105
42116,ricko70,,1,20,44,64
42117,misfit-zero,,1,2,9,11
42118,jeffoverip,,1,107,164,271
42119,p8m,,1,26,35,61
42120,PeterBB,,1,9,10,19
42121,drBrown,,1,1,4,5
42122,pledio,,1,1,2,3
42123,sstrain1,,1,7,13,20
42124,iluvatar,,1,58,63,121
42125,ewankenobi,,1,6,4,10
42126,cargirl,,1,50,13,63
42127,jules_su,,1,5,2,7
42128,melendro,,1,2,1,3
42129,whosywhatSIT,,1,4,4,8
42130,andresvr,,1,41,76,117
42131,0_o,,1,709,731,1440
42132,thetin,,1,1,18,19
42133,Austin08,,1,8,11,19
42134,Celerox,,1,3,7,10
42135,xstphnx,,1,3,10,13
42136,js79,,1,32,35,67
42137,instain_mother,,1,2,4,6
42138,emid,,1,48,63,111
42139,Diice,,1,26,32,58
42140,bogybody,,1,6,10,16
42141,kermit420,,1,4,1,5
42142,Sektor7g,,1,5,3,8
42143,crexor,,1,15,20,35
42144,jon3k,,1,2,1,3
42145,fs55,,1,3,1,4
42146,doogie92,,1,580,12,592
42147,there_are_no_results,,1,1,1,2
42148,JacobFalling,,1,1,1,2
42149,fail_nazi,,1,5,17,22
42150,pblair,,1,90,14,104
42151,bogshrink,,1,3,1,4
42152,state_of_alert,,1,599,726,1325
42153,esthero,,1,6,12,18
42154,netfluffyG,,1,261,37,298
42155,markomat,,1,23,18,41
42156,twotrees517,,1,1,13,14
42157,PSBlake,,1,19,28,47
42158,brainburger,,1,2455,2233,4688
42159,Hindu_Wardrobe,,1,66,110,176
42160,macbookair,,1,5,3,8
42161,corneeeeelius,,1,1,1,2
42162,jplord89,,1,4,3,7
42163,TheDentite,,1,168,323,491
42164,gunslinger81,,1,3,4,7
42165,rplenty,,1,3,4,7
42166,theace41,,1,2,2,4
42167,Siperia,,1,2,4,6
42168,afshin,,1,155,87,242
42169,geoffritchey,,1,1,1,2
42170,mbm,,1,49,77,126
42171,abc2018,,1,1,1,2
42172,RickvH,,1,1,1,2
42173,Popdmb,,1,32,10,42
42174,billybobmac,,1,55,103,158
42175,hassett,,1,258,428,686
42176,oddog,,1,32,5,37
42177,flif,,1,8,9,17
42178,sparkpaul,,1,7,15,22
42179,skeen,,1,238,244,482
42180,jpancake,,1,6,2,8
42181,poopyshoes,,1,3,4,7
42182,thekuroikenshi,,1,5,8,13
42183,theteamtomatos,,1,3,4,7
42184,phile19_81,,1,1,1,2
42185,Snay,,1,7,3,10
42186,Enygma42,,1,3,5,8
42187,LowFuel,,1,48,92,140
42188,chojin_82,,1,1,1,2
42189,derekslager,,1,58,34,92
42190,rayfd,,1,119,52,171
42191,venkattt,,1,35,51,86
42192,freedomcry,,1,14,36,50
42193,indiana888,,1,46,100,146
42194,aanka,,1,6,2,8
42195,thebigsquid,,1,86,99,185
42196,BrightShadow,,1,2,1,3
42197,FluidChameleon,,1,154,57,211
42198,profy,,1,1,2,3
42199,g_unit4lyfe,,1,12,5,17
42200,garf12,,1,1,3,4
42201,simonsharry,,1,1,3,4
42202,harvesterofdeath,,1,1,1,2
42203,twinspop,,1,4,16,20
42204,wgardenhire,,1,38,65,103
42205,ThatMovieAboutRobots,,1,9,13,22
42206,MrLeap,,1,35,36,71
42207,ostrichheaven,,1,12,49,61
42208,bungeman,,1,38,65,103
42209,dokein,,1,173,8,181
42210,lps41,,1,484,619,1103
42211,Mr_Spoiler,,1,22,15,37
42212,lantrix,,1,1,1,2
42213,twhiteley,,1,1,2,3
42214,olihahe,,1,1,1,2
42215,sweetbabyjames,,1,3,3,6
42216,jennmae,,1,15,3,18
42217,cop1152,,1,2,3,5
42218,violence_jakovsky,,1,1,1,2
42219,lovecrafthp,,1,13,17,30
42220,Freeky,,1,408,698,1106
42221,onetimepostaccount,,1,53,1,54
42222,a1mck,,1,1,3,4
42223,Ferrofluid,,1,230,666,896
42224,bcars,,1,62,67,129
42225,maliciousmonkey,,1,1,1,2
42226,slomotion,,1,109,124,233
42227,flopper,,1,6,1,7
42228,mtrier,,1,4,4,8
42229,badsmell,,1,4,1,5
42230,sig_UVA,,1,24,27,51
42231,Th3_C0unt,,1,1,2,3
42232,cwalk,,1,20,26,46
42233,flappinghelmet,,1,17,2,19
42234,jangophat80,,1,5,1,6
42235,cmoney805,,1,22,37,59
42236,climb0r,,1,5,5,10
42237,stuartcw,,1,112,102,214
42238,othercriteria,,1,23,44,67
42239,MadHooks,,1,233,185,418
42240,commentsforreddit,,1,407,632,1039
42241,wildnovacat9,,1,11,6,17
42242,andyjeffries,,1,7,2,9
42243,ramenramenramen,,1,11,15,26
42244,dguido,,1,9,6,15
42245,CBinCovington,,1,10,27,37
42246,Captain_0bvious,,1,3,3,6
42247,Lord_Voldemort,,1,7,7,14
42248,reject,,1,2,3,5
42249,dustingooding,,1,7,9,16
42250,uhclem,,1,42,62,104
42251,Psyko,,1,2,1,3
42252,justdawson,,1,5,3,8
42253,zeelog,,1,11,27,38
42254,lterr,,1,1,1,2
42255,yannt,,1,2,4,6
42256,mycrazies,,1,30,16,46
42257,scuzzy987,,1,1,1,2
42258,baguasquirrel,,1,71,75,146
42259,Chrisvdv,,1,1,1,2
42260,sleepydog,,1,5,6,11
42261,xyyx,,1,14,12,26
42262,jaxontre,,1,3,6,9
42263,colinme,,1,1,1,2
42264,arcang3l,,1,5,8,13
42265,barney0605,,1,26,18,44
42266,GibbieGibGiblet,,1,152,231,383
42267,iheartbbq,,1,135,131,266
42268,shiftshaping,,1,23,7,30
42269,Lams,,1,6,12,18
42270,Sabakunoneji,,1,10,7,17
42271,legutierr,,1,1,2,3
42272,wget-m,,1,2,4,6
42273,tmu,,1,11,9,20
42274,yariv,,1,2,2,4
42275,liberty4ever,,1,4,2,6
42276,TheGrammarAnarchist,,1,49,48,97
42277,Gluncher,,1,3,7,10
42278,jmrsplatt,,1,1,1,2
42279,wfolbrys,,1,2,1,3
42280,tripled153,,1,3,7,10
42281,frasmage,,1,21,12,33
42282,matt_aimonetti,,1,47,17,64
42283,anoved,,1,65,98,163
42284,bdfortin,,1,5,10,15
42285,akhenatron,,1,68,57,125
42286,dritchie,,1,1,1,2
42287,1137,,1,2,2,4
42288,peoplelover,,1,81,105,186
42289,rhoadesb2,,1,860,460,1320
42290,cracell,,1,408,733,1141
42291,rverne8vew,,1,3,2,5
42292,mishap,,1,24,2,26
42293,mulva,,1,1,1,2
42294,Radek3887,,1,4,6,10
42295,doomride,,1,11,8,19
42296,PropaGhandi,,1,7,15,22
42297,pantsoff,,1,316,475,791
42298,madposter,,1,4,1,5
42299,funkyheff,,1,6,4,10
42300,pookie,,1,2,1,3
42301,dsearson,,1,15,11,26
42302,bcrafts,,1,1,3,4
42303,brendano,,1,12,14,26
42304,writh3n,,1,1,3,4
42305,robb01,,1,310,22,332
42306,nihilo503,,1,5,1,6
42307,numix,,1,6,6,12
42308,Aldinach,,1,2,2,4
42309,osteoblastic,,1,44,71,115
42310,kaden_sotek,,1,4,10,14
42311,TheJames69,,1,43,126,169
42312,ODSTAdrianFii,,1,1,1,2
42313,electromage,,1,3,4,7
42314,Ninwa,,1,214,198,412
42315,Rette,,1,159,193,352
42316,ghosttrainhobo,,1,1,1,2
42317,passwordisusername,,1,20,14,34
42318,Gonad,,1,50,23,73
42319,ferruccio,,1,11,21,32
42320,Pooper561,,1,51,1,52
42321,RevSpitz,,1,3,2,5
42322,PerlMonk,,1,20,28,48
42323,LittleWriterGirl,,1,2,6,8
42324,Lambeau,,1,194,172,366
42325,ronsturgill,,1,11,18,29
42326,sp0radic,,1,14,26,40
42327,ryanlubner,,1,2,2,4
42328,halbe01,,1,1,2,3
42329,dailysockpuppet08129,,1,2,4,6
42330,rsk897,,1,1,1,2
42331,jonnytran,,1,78,11,89
42332,LiberalHippies11,,1,12,14,26
42333,xabermanx,,1,2,4,6
42334,passwordistheusernam,,1,1,3,4
42335,Lithium_X,,1,335,225,560
42336,km1116,,1,18,18,36
42337,brutus1964,,1,188,55,243
42338,brownbear,,1,15,9,24
42339,sfhrp,,1,1,1,2
42340,da5id1,,1,87,230,317
42341,AdmiralDave,,1,136,237,373
42342,dblclique,,1,6,6,12
42343,riklaunim,,1,7,4,11
42344,redct,,1,92,4,96
42345,fleejit,,1,2,1,3
42346,rdeal1,,1,15,3,18
42347,Asshole_Police,,1,1,1,2
42348,pedoprankster,,1,4,1,5
42349,blewsyboy,,1,6,10,16
42350,3214,,1,327,45,372
42351,mrgermy,,1,7,20,27
42352,shanejohnsoncartoons,,1,8,3,11
42353,jshark12,,1,22,1,23
42354,ericdfields,,1,1,1,2
42355,billystorm5000,,1,1,1,2
42356,unijambiste,,1,108,104,212
42357,blackdixon,,1,2,3,5
42358,frets,,1,5,7,12
42359,chrissku,,1,54,61,115
42360,jgardner,,1,2,1,3
42361,parasense,,1,8,5,13
42362,JohnnyQwest,,1,34,13,47
42363,ritadog,,1,2,1,3
42364,bangpound,,1,11,7,18
42365,mintskoal,,1,5,5,10
42366,bhasden,,1,1,1,2
42367,simulacra,,1,26,35,61
42368,sgeye,,1,1,5,6
42369,userundefined,,1,35,57,92
42370,kylestaylor,,1,2,6,8
42371,jlaurino,,1,4,2,6
42372,awright4444,,1,4,1,5
42373,civicsi98,,1,1,1,2
42374,scorpAFC,,1,50,32,82
42375,gisellehobbs,,1,1,2,3
42376,meatheltmet,,1,20,26,46
42377,wikiscootia,,1,27,30,57
42378,onemanclic,,1,5,12,17
42379,rafaeldff,,1,11,11,22
42380,brit878,,1,335,111,446
42381,BlueRubberDuck,,1,48,27,75
42382,kanagawa,,1,11,25,36
42383,bobfather123,,1,1,1,2
42384,el_pinata,,1,365,491,856
42385,CaptainOffensive,,1,1,2,3
42386,morgand,,1,2,8,10
42387,fallintothis,,1,11,15,26
42388,Frigorific,,1,131,187,318
42389,stupidgirl,,1,66,99,165
42390,justsignedforthis,,1,2,1,3
42391,smackjer,,1,1,4,5
42392,mrmulyani,,1,12,18,30
42393,brightlightmg,,1,3,4,7
42394,stargazer,,1,2,3,5
42395,maxtypezero,,1,5,4,9
42396,deliveryman,,1,2,3,5
42397,Ryushi,,1,2,6,8
42398,nachochease,,1,2,7,9
42399,klOROX-blEACh,,1,6,6,12
42400,skimmer,,1,209,384,593
42401,fishbulbx,,1,24,6,30
42402,fivus6,,1,2,2,4
42403,dsfox,,1,404,350,754
42404,udontneedaweatherman,,1,698,117,815
42405,SimonSarc,,1,10,13,23
42406,CoachMcGuirk,,1,18,3,21
42407,skygrl37,,1,166,1,167
42408,blitzwig,,1,93,124,217
42409,cconnett,,1,4,5,9
42410,strum,,1,4,5,9
42411,link2zelda,,1,449,133,582
42412,OptionDestroyer,,1,9,1,10
42413,NumNutz,,1,7,16,23
42414,nvaro,,1,7,7,14
42415,antediluvian,,1,155,211,366
42416,MacacaDesi,,1,9,3,12
42417,kayamon,,1,2,7,9
42418,sunson,,1,1,1,2
42419,Nutmegan,,1,1,2,3
42420,cryemoxkidcry,,1,18,33,51
42421,etherealG,,1,2,4,6
42422,maqr,,1,442,444,886
42423,benoa,,1,13,29,42
42424,moonwatcher222,,1,74,103,177
42425,daniel_yokomizo,,1,25,1,26
42426,seat12,,1,1,2,3
42427,LeslieBC,,1,40,26,66
42428,cxyl27,,1,38,48,86
42429,qortra,,1,115,113,228
42430,jamesmusik,,1,4,7,11
42431,TragicComic,,1,59,66,125
42432,gonz808,,1,8,14,22
42433,homealone19,,1,8,4,12
42434,geniusoftheyear,,1,7,20,27
42435,decaado,,1,12,19,31
42436,chrystie69,,1,6,5,11
42437,sentient6,,1,1,6,7
42438,Gaiadok,,1,27,67,94
42439,psych_major,,1,1,1,2
42440,apex211,,1,6,8,14
42441,willer,,1,3,4,7
42442,psreinc,,1,2,1,3
42443,redbull,,1,38,87,125
42444,memesarenotcool,,1,1,1,2
42445,turbotax,,1,1,1,2
42446,CodeMonkey1,,1,207,295,502
42447,Dagur,,1,235,370,605
42448,adventurerneil,,1,4,7,11
42449,hell0o,,1,20,15,35
42450,selimo,,1,43,13,56
42451,gamlidek,,1,8,10,18
42452,keatontaitingfong,,1,2,2,4
42453,shafik23,,1,31,2,33
42454,jmcclean,,1,11,9,20
42455,tymilu,,1,10,12,22
42456,bradym80,,1,174,208,382
42457,easyantic,,1,122,211,333
42458,joshd,,1,3,2,5
42459,Timmeh,,1,148,186,334
42460,xjm,,1,26,28,54
42461,vchakrav,,1,1,3,4
42462,devittron,,1,2,8,10
42463,davidstuart,,1,13,7,20
42464,BongoBoyee,,1,3,1,4
42465,nevenmrgan,,1,3,2,5
42466,inkline,,1,29,10,39
42467,ChickenCoupe,,1,5,15,20
42468,ccshan,,1,24,19,43
42469,rossberry,,1,7,20,27
42470,jippie13,,1,3,5,8
42471,JCE,,1,207,44,251
42472,100k,,1,2,3,5
42473,smartazz,,1,1,2,3
42474,el_duderin0,,1,2,1,3
42475,01Frederic,,1,129,26,155
42476,jeff-is-not-art,,1,6,1,7
42477,bazookajoe55,,1,15,39,54
42478,galaxym100,,1,9,18,27
42479,stevencloud,,1,2,2,4
42480,ibeffron,,1,3,1,4
42481,philosophista,,1,10,5,15
42482,copiloto,,1,7,9,16
42483,mormoned,,1,7,6,13
42484,The_Ultimate_Reality,,1,406,691,1097
42485,lifestyl3,,1,5,4,9
42486,mikesabat,,1,8,6,14
42487,zepplindog,,1,1,5,6
42488,spookylukey,,1,26,12,38
42489,10poundbrown,,1,12,49,61
42490,igowen,,1,51,31,82
42491,mrinterweb,,1,14,15,29
42492,Rathsamiar,,1,1,1,2
42493,Seawolf_87,,1,1,3,4
42494,thisisanewaccountlol,,1,1,2,3
42495,CapsLockMan,,1,1,1,2
42496,redjello,,1,6,10,16
42497,dubqnp,,1,3,12,15
42498,HerbertMcSherbert,,1,578,976,1554
42499,anotherjesse,,1,2,3,5
42500,sloppy_wade,,1,3,3,6
42501,mikkele,,1,44,52,96
42502,simman,,1,1,2,3
42503,nixterrimus,,1,2,5,7
42504,cutchyacokov,,1,2,4,6
42505,cakesy,,1,77,126,203
42506,jimshady2k1,,1,18,2,20
42507,glenra,,1,28,44,72
42508,calebcharles,,1,4,7,11
42509,jorgelo,,1,35,37,72
42510,Eoiny,,1,7,8,15
42511,spiki,,1,14,4,18
42512,bill15,,1,3,3,6
42513,itsafarce,,1,1,5,6
42514,Naxr,,1,28,48,76
42515,allertonm,,1,9,12,21
42516,FannyBatter,,1,7,4,11
42517,blindrage,,1,14,17,31
42518,chipx86,,1,3,5,8
42519,Thoz,,1,1,5,6
42520,Pbrane101,,1,3,3,6
42521,thinkaboutthat,,1,26,9,35
42522,skibberjack,,1,45,34,79
42523,krom0025,,1,17,22,39
42524,xiann,,1,2,8,10
42525,Tom22,,1,169,101,270
42526,voidspace,,1,51,76,127
42527,woolleyj,,1,3,5,8
42528,aghager,,1,3,3,6
42529,Lozzer,,1,2,9,11
42530,CircusHead,,1,3,11,14
42531,jbronn,,1,7,7,14
42532,yuzhou,,1,40,9,49
42533,brianwood,,1,1,1,2
42534,tempguest,,1,15,15,30
42535,silpol,,1,96,67,163
42536,aleborgese,,1,1,1,2
42537,knuu,,1,1,3,4
42538,fwkroon,,1,2,4,6
42539,MarkByers,,1,1843,2315,4158
42540,FiddlingFetus,,1,4,7,11
42541,drzorcon,,1,18,25,43
42542,icikle,,1,6,6,12
42543,pozorvlak,,1,650,1009,1659
42544,ppkk,,1,1,2,3
42545,B_FH,,1,20,33,53
42546,c10h14n2,,1,3,4,7
42547,passwordismyusername,,1,48,20,68
42548,jes6ica,,1,15,17,32
42549,DustinEwan,,1,1,1,2
42550,gnaritas,,1,42,86,128
42551,sans-serif,,1,41,71,112
42552,isande,,1,3,10,13
42553,rooneyrooney,,1,1,1,2
42554,jan33,,1,12,23,35
42555,Transcendentalme,,1,4,2,6
42556,snipps,,1,1,3,4
42557,fudabushi,,1,6,10,16
42558,nosex4travelingman74,,1,1,1,2
42559,munky82,,1,9,27,36
42560,gmork,,1,37,61,98
42561,ajsvin,,1,2,6,8
42562,BlahblahblahName,,1,3,4,7
42563,Cygnarite,,1,30,83,113
42564,creamypouf,,1,2,2,4
42565,EmerilLIVE,,1,6,7,13
42566,dtbelobrown,,1,4,4,8
42567,RygelXVI,,1,11,8,19
42568,emp77,,1,1,3,4
42569,tpurves,,1,5,5,10
42570,noodlez89,,1,1,1,2
42571,Hadu,,1,101,133,234
42572,AdiasAngel,,1,1,4,5
42573,Stuckbetweenstations,,1,5,7,12
42574,pensaint1,,1,1,1,2
42575,radarperkins,,1,5,14,19
42576,naturenet,,1,337,71,408
42577,tat2ts,,1,78,49,127
42578,rock24,,1,88,5,93
42579,zackola,,1,7,19,26
42580,sofacrates,,1,1,2,3
42581,prerus,,1,2,6,8
42582,unno,,1,5,10,15
42583,eddytsp,,1,2,2,4
42584,osu2002,,1,142,10,152
42585,atari_eric,,1,12,17,29
42586,flyyspitt,,1,2,6,8
42587,CorwinShiu,,1,70,61,131
42588,DeadKitten,,1,9,22,31
42589,iamnotaclown,,1,71,95,166
42590,nesloq,,1,29,12,41
42591,escalated,,1,8,18,26
42592,BeverlyHillsHousewif,,1,1,4,5
42593,psmyth,,1,2,3,5
42594,anthroadam,,1,23,41,64
42595,ebcoh,,1,20,23,43
42596,Roosevelty2,,1,1,1,2
42597,ShadeeJake,,1,2,1,3
42598,rochea,,1,2,3,5
42599,marknugent,,1,1,5,6
42600,ATT-HALF,,1,1,1,2
42601,_ak,,1,218,236,454
42602,feijai,,1,316,402,718
42603,eroverton,,1,965,1418,2383
42604,hotsessions,,1,2,7,9
42605,domh,,1,1,1,2
42606,crazysnailboy,,1,13,10,23
42607,bish_poins,,1,16,41,57
42608,DismalScience,,1,46,57,103
42609,fredklabuster,,1,7,2,9
42610,drew_b,,1,11,9,20
42611,desnotes,,1,63,52,115
42612,Littering,,1,2,3,5
42613,_Square_,,1,1,2,3
42614,revets,,1,1,2,3
42615,trustfarm,,1,1,2,3
42616,Onlygirlhere,,1,5,4,9
42617,AtlantaFalcon,,1,9,13,22
42618,jabb0,,1,430,212,642
42619,abw,,1,348,372,720
42620,kc5tja,,1,5,8,13
42621,lolzitt,,1,1,1,2
42622,barthol27,,1,611,125,736
42623,israeln,,1,1,1,2
42624,jowens,,1,5,5,10
42625,SilverMaster,,1,154,5,159
42626,geeknerd,,1,4,10,14
42627,runagate,,1,13,20,33
42628,Jeeezelouise,,1,369,206,575
42629,FUSe,,1,14,19,33
42630,MerlinIII,,1,1,1,2
42631,parched,,1,2,3,5
42632,ef4,,1,213,315,528
42633,Johnny_Cash_,,1,1,1,2
42634,hscalum,,1,1,1,2
42635,unclestiltskin,,1,1,3,4
42636,MrFlesh,,1,755,1274,2029
42637,Botunda,,1,34,17,51
42638,noahspurrier,,1,7,3,10
42639,bodhi,,1,8,12,20
42640,as177,,1,1,1,2
42641,actsasflinn,,1,1,3,4
42642,Gash77,,1,31,34,65
42643,SGeniusNinja,,1,5,6,11
42644,emilyannemurphy,,1,7,5,12
42645,westernorbit,,1,2,4,6
42646,DocMatrix,,1,10,1,11
42647,jjjjjaa,,1,21,38,59
42648,jrchin,,1,1,2,3
42649,jones3316,,1,271,257,528
42650,Jon403,,1,1,4,5
42651,leTao,,1,38,63,101
42652,Hagimir,,1,9,9,18
42653,racy_rick,,1,154,234,388
42654,hseldon10,,1,320,574,894
42655,skyline1187,,1,3,1,4
42656,delpfonik,,1,2,2,4
42657,wtanksleyjr,,1,34,62,96
42658,malefactor,,1,5,3,8
42659,Gella321,,1,231,161,392
42660,schrod,,1,49,101,150
42661,yourstupider,,1,1,2,3
42662,pauls101,,1,24,5,29
42663,rowd149,,1,280,350,630
42664,ilovejavascript,,1,1,1,2
42665,enls,,1,33,35,68
42666,roaddog,,1,83,66,149
42667,Slummervillain,,1,6,9,15
42668,YourLizardOverlord,,1,27,35,62
42669,donknuth,,1,10,10,20
42670,cmaher,,1,4,1,5
42671,winsauce,,1,3,5,8
42672,feuermelder,,1,1,2,3
42673,o1nkqng,,1,2,1,3
42674,cory849,,1,73,57,130
42675,JOKasten,,1,3,8,11
42676,orwell,,1,2,4,6
42677,eltower,,1,102,160,262
42678,skyrocker,,1,14,4,18
42679,polyeidus,,1,1,1,2
42680,orngshusrthebest,,1,5,6,11
42681,fapless,,1,12,9,21
42682,joker12345,,1,1,1,2
42683,readyteddy,,1,2,1,3
42684,Arbitraryster,,1,38,13,51
42685,hafizr,,1,53,3,56
42686,kolacheface,,1,3,2,5
42687,dog4,,1,2,1,3
42688,emeray,,1,32,35,67
42689,whatyeah3,,1,22,25,47
42690,geeeeoffff,,1,804,788,1592
42691,parenthesis,,1,4,4,8
42692,mookiemookie,,1,337,513,850
42693,cjdaniel,,1,7,15,22
42694,sheepleslave,,1,158,53,211
42695,Jugulator,,1,132,3,135
42696,lytics,,1,2,1,3
42697,Gaki,,1,51,69,120
42698,Llanwar,,1,5,5,10
42699,larryj53,,1,1,8,9
42700,claybear1216,,1,1,1,2
42701,Trunch,,1,15,11,26
42702,Niffux,,1,56,66,122
42703,mjoshi,,1,4,8,12
42704,Heyoka,,1,5,9,14
42705,sadflkjsadajkshdfa,,1,1,1,2
42706,iphun,,1,10,18,28
42707,tyler126,,1,1,1,2
42708,googletrickedme,,1,521,158,679
42709,hal9k,,1,2,1,3
42710,zuoken,,1,8,9,17
42711,chibikiba,,1,144,271,415
42712,R3V0L7,,1,6,1,7
42713,funkyboss,,1,1,2,3
42714,cdalkire,,1,1,1,2
42715,amysarah,,1,93,179,272
42716,bohjelaska,,1,1,1,2
42717,dcreemer,,1,114,84,198
42718,MooseBurgers,,1,86,34,120
42719,rmfd,,1,1,2,3
42720,twich35,,1,6,2,8
42721,vegasceincetrust,,1,2,1,3
42722,neoconsmustdie,,1,6,1,7
42723,ajehals,,1,761,1023,1784
42724,danielthepoet,,1,1,1,2
42725,fanflibble,,1,14,17,31
42726,autogynephile,,1,1,1,2
42727,urbanlatinfemale,,1,12,1,13
42728,arbitrarymixture,,1,51,81,132
42729,marcedman,,1,1,2,3
42730,kylev,,1,304,221,525
42731,shadowblade,,1,2,8,10
42732,saladbar,,1,5,9,14
42733,stitchinthyme,,1,5,2,7
42734,tevi002,,1,1,1,2
42735,majungo,,1,22,19,41
42736,Reddit_Cat,,1,1,1,2
42737,3004,,1,7,13,20
42738,BabyJesus,,1,27,48,75
42739,fahdinho,,1,117,129,246
42740,toomanylaws,,1,1,1,2
42741,Beagle17,,1,3,1,4
42742,oneliberalhoosier,,1,1,2,3
42743,base736,,1,146,242,388
42744,iphoneblowme,,1,64,32,96
42745,md12,,1,14,9,23
42746,ObamasPurpleKoolaid,,1,17,16,33
42747,revchu,,1,12,18,30
42748,chrisjones74,,1,14,23,37
42749,Magnus_Geist,,1,31,65,96
42750,xyzpdq,,1,33,51,84
42751,redson,,1,47,6,53
42752,archlich,,1,16,21,37
42753,hayzen,,1,9,21,30
42754,healthybaby,,1,1,1,2
42755,mricon,,1,13,3,16
42756,BoomDizzle,,1,21,8,29
42757,whiteman,,1,15,13,28
42758,deeplyembedded,,1,87,50,137
42759,flynne,,1,6,18,24
42760,bigpappasmurf,,1,3,8,11
42761,smurple,,1,1,1,2
42762,aprilwine,,1,2,1,3
42763,pickles46,,1,2,2,4
42764,GreenGhost88,,1,3,3,6
42765,nefigah,,1,4,6,10
42766,URGENTCAPSLOCKGUY,,1,1,1,2
42767,koavf,,1,329,230,559
42768,foocat,,1,1,4,5
42769,alexBrsdy,,1,239,85,324
42770,guyhersh,,1,19,14,33
42771,goober118,,1,1,1,2
42772,zerohalo,,1,25,16,41
42773,ExKaliiperi,,1,7,11,18
42774,CalResident,,1,6,3,9
42775,Dark1Knight,,1,30,51,81
42776,worduphomefry,,1,26,15,41
42777,hairstyled67,,1,1,1,2
42778,m4ttjirM,,1,4,1,5
42779,peasandcarrots,,1,14,14,28
42780,toord,,1,141,166,307
42781,j0hnny5,,1,1,2,3
42782,hillkiwi,,1,49,61,110
42783,sevenoutdb,,1,38,60,98
42784,raystein,,1,2,2,4
42785,CloudDrone,,1,37,131,168
42786,Cazzaquistao,,1,2,3,5
42787,shivey,,1,1,2,3
42788,GamerSix55,,1,39,3,42
42789,quanfer,,1,3,11,14
42790,atozand1to10,,1,36,70,106
42791,suranwrap,,1,1,1,2
42792,antiteam,,1,2,4,6
42793,libera_me,,1,21,34,55
42794,RobMack,,1,1,1,2
42795,007ltk,,1,1,2,3
42796,urnice,,1,3,2,5
42797,Pampy,,1,1,1,2
42798,bco,,1,6,1,7
42799,dav_k,,1,1,1,2
42800,jan_strach,,1,67,17,84
42801,Naught,,1,26,32,58
42802,supermauerbros,,1,10,12,22
42803,Yoda_Dagobah,,1,1,1,2
42804,laz,,1,10,12,22
42805,MutinusMutunus,,1,1,1,2
42806,icecoldmax,,1,17,13,30
42807,LokiSnake,,1,3,6,9
42808,crunk,,1,58,96,154
42809,slickeddie,,1,3,2,5
42810,bardamu,,1,1,3,4
42811,yonwax2,,1,3,1,4
42812,imcdona,,1,1,1,2
42813,mbarnett,,1,2,7,9
42814,jeanette3654,,1,426,503,929
42815,packman86,,1,6,10,16
42816,internetish,,1,102,17,119
42817,vixtt,,1,19,11,30
42818,hairstyleasd1,,1,1,1,2
42819,Hexagonally,,1,1,2,3
42820,f33dback,,1,37,65,102
42821,ppbottle,,1,5,1,6
42822,tie-rack,,1,51,51,102
42823,kyleflan,,1,1,2,3
42824,Islay12ut,,1,492,35,527
42825,natural_born_lusr,,1,1,1,2
42826,mrcaffeinated,,1,1,1,2
42827,molson2000,,1,19,39,58
42828,cypherpunks,,1,53,5,58
42829,bring_back_king,,1,1,4,5
42830,Fanoffun,,1,82,145,227
42831,rjcarr,,1,736,822,1558
42832,Bognar,,1,57,43,100
42833,girlxfirefly,,1,11,3,14
42834,k1ngcrimson,,1,3,1,4
42835,suyogrulz,,1,2,4,6
42836,caknuckle,,1,239,223,462
42837,synchronicity,,1,1,3,4
42838,xenotype,,1,15,18,33
42839,appiahj,,1,14,38,52
42840,nukiek,,1,16,6,22
42841,weasler7,,1,12,16,28
42842,cheesiefries,,1,27,9,36
42843,joshuasmaximus,,1,9,3,12
42844,octajon,,1,20,47,67
42845,evildeadxsp,,1,200,90,290
42846,XerxesOxalis,,1,2,1,3
42847,notfluffy,,1,18,10,28
42848,elsjaako,,1,19,34,53
42849,i_am_dylan,,1,1,1,2
42850,xkey,,1,83,82,165
42851,MrSnrub,,1,25,102,127
42852,gcube,,1,1,1,2
42853,coldxrain,,1,2,3,5
42854,Foxhound199,,1,177,288,465
42855,some_chump,,1,1,5,6
42856,martinus,,1,2,1,3
42857,romainpi,,1,2,4,6
42858,ihatecookiies,,1,64,58,122
42859,claco,,1,64,126,190
42860,Jaquestrap,,1,2,2,4
42861,smartin42,,1,2,2,4
42862,jyoung98,,1,15,2,17
42863,northbourne,,1,93,183,276
42864,frenchtoaster,,1,43,48,91
42865,Scav,,1,110,23,133
42866,GK_Jonny,,1,1,4,5
42867,sabernar,,1,3,3,6
42868,andre75,,1,4,15,19
42869,thalience,,1,21,17,38
42870,nervousnelly,,1,8,9,17
42871,spamtastik,,1,2,1,3
42872,acid_phlashback,,1,1,3,4
42873,ksilverfox,,1,181,46,227
42874,kezil,,1,1,1,2
42875,pstuart,,1,23,27,50
42876,jeansfrog,,1,2,4,6
42877,maoroo,,1,1,1,2
42878,hot_carl,,1,7,7,14
42879,TheNightMan,,1,6,1,7
42880,Talka,,1,19,15,34
42881,mayaih,,1,3,4,7
42882,Deepblu,,1,1,2,3
42883,g00dETH3R,,1,42,79,121
42884,pistacchio,,1,2,1,3
42885,azth,,1,12,7,19
42886,owesome,,1,3,2,5
42887,davidnewcomb,,1,1,1,2
42888,cheefjustice,,1,56,29,85
42889,branded,,1,155,101,256
42890,Adam87,,1,7,11,18
42891,ajnabee4u,,1,11,24,35
42892,SocratesJohnson,,1,10,4,14
42893,mithrandi,,1,3,1,4
42894,lagann12,,1,3,1,4
42895,backwebcadre,,1,5,1,6
42896,jreim,,1,2,1,3
42897,bestofluck,,1,1,4,5
42898,winkywooster,,1,95,26,121
42899,CountRob,,1,13,8,21
42900,superK,,1,2,5,7
42901,mrfurious,,1,10,9,19
42902,Nomikos,,1,56,101,157
42903,macrael,,1,3,2,5
42904,xjonathanx,,1,1,2,3
42905,undeadhobo,,1,67,84,151
42906,Smallpaul,,1,171,212,383
42907,squirrel5978,,1,22,21,43
42908,LeisureCat,,1,3,1,4
42909,choas,,1,86,44,130
42910,derecho13,,1,42,80,122
42911,WizardOfLies,,1,132,141,273
42912,lurchentsafter,,1,4,4,8
42913,Noexit,,1,239,551,790
42914,nattypol,,1,16,1,17
42915,SenorLovely,,1,1,5,6
42916,Rsardinia,,1,615,613,1228
42917,redbu11,,1,2,5,7
42918,Chaserson,,1,605,20,625
42919,neocontrash,,1,34,72,106
42920,longx223,,1,1,2,3
42921,landtuna,,1,56,78,134
42922,jkjsdhfashdf,,1,2,8,10
42923,Jimeee,,1,39,50,89
42924,Jimmy_Carter,,1,1,1,2
42925,edward_r_murrow,,1,4,8,12
42926,BigBearSac,,1,4,6,10
42927,bpaterni,,1,5,7,12
42928,hailpixel,,1,37,23,60
42929,allodoxaphobia,,1,2,1,3
42930,svolix,,1,6,8,14
42931,sencha,,1,33,12,45
42932,markfinkle,,1,1,1,2
42933,gamer31,,1,10,12,22
42934,broca,,1,6,3,9
42935,chowmeinmao,,1,13,33,46
42936,nathan12343,,1,9,14,23
42937,jenonreddit,,1,7,5,12
42938,brandx1982,,1,52,70,122
42939,mexicanpizza,,1,11,20,31
42940,hypnotikrobot,,1,78,170,248
42941,shawnbttu,,1,4,7,11
42942,BigFuzzyArchon,,1,25,37,62
42943,hcicavok,,1,1,1,2
42944,khatarnaak,,1,33,28,61
42945,majhem,,1,12,45,57
42946,mthode,,1,2,3,5
42947,jakemdoz,,1,28,16,44
42948,johnbr,,1,11,14,25
42949,collegecandy,,1,3,2,5
42950,montanajones,,1,31,115,146
42951,tickbole,,1,2,9,11
42952,nibblit,,1,4,6,10
42953,nicolelinblad,,1,8,4,12
42954,alkalinev,,1,80,79,159
42955,mahakali,,1,2,1,3
42956,pykogapmkc,,1,5,1,6
42957,JohnFuckingMcCain,,1,1,1,2
42958,jkyu88,,1,5,5,10
42959,necron99,,1,10,26,36
42960,arnar,,1,637,917,1554
42961,rustyryan,,1,15,23,38
42962,pete2532,,1,44,80,124
42963,Kronikle,,1,12,8,20
42964,coopervr,,1,4,2,6
42965,dragoon,,1,1,1,2
42966,jackarcalon,,1,21,49,70
42967,alaskarob907,,1,4,2,6
42968,Searil,,1,1,1,2
42969,august17,,1,2,3,5
42970,cactus82,,1,12,14,26
42971,mike2297,,1,3,2,5
42972,joebeck,,1,8,13,21
42973,Beachcoma,,1,110,252,362
42974,mejusthavin,,1,185,228,413
42975,sininc,,1,8,10,18
42976,AxiomShell,,1,149,216,365
42977,EarthMephit,,1,5,11,16
42978,gadlaw,,1,19,20,39
42979,goofdup,,1,24,1,25
42980,phantomgold,,1,3,6,9
42981,shotmenot,,1,42,59,101
42982,redbone,,1,2,2,4
42983,clgoh,,1,25,37,62
42984,alphafrau,,1,5,1,6
42985,ashleymarti,,1,3,8,11
42986,jmuh,,1,6,7,13
42987,basilcats,,1,1,3,4
42988,skeww,,1,48,47,95
42989,preddictit,,1,1,1,2
42990,elitexero,,1,29,80,109
42991,colorred,,1,177,293,470
42992,chris,,1,3,2,5
42993,pc9323,,1,66,1,67
42994,rht,,1,18,22,40
42995,Slavic,,1,6,1,7
42996,RobotBuddha,,1,11,25,36
42997,TheCoelacanth,,1,174,253,427
42998,InksLWC,,1,199,81,280
42999,woahh_cecs,,1,1,2,3
43000,willm,,1,33,30,63
43001,staub81,,1,85,49,134
43002,sprezzatura,,1,13,15,28
43003,starknaked1984,,1,1,1,2
43004,gary_crutchley1968,,1,1,1,2
43005,hardnutz,,1,276,148,424
43006,arghnoname,,1,24,19,43
43007,apunchline,,1,5,1,6
43008,bombastica,,1,42,60,102
43009,glastohead,,1,109,174,283
43010,eurasian,,1,8,5,13
43011,toddthefrog,,1,47,29,76
43012,Kjalnot,,1,23,18,41
43013,chemlock,,1,13,16,29
43014,ed2417,,1,12,3,15
43015,rotarhead,,1,14,18,32
43016,exomniac,,1,10,15,25
43017,joker123,,1,10,28,38
43018,soxfanpdx,,1,429,501,930
43019,sylverlokk,,1,3,1,4
43020,elektroholunder,,1,50,75,125
43021,delph,,1,286,430,716
43022,Dylan1986,,1,100,73,173
43023,expacifico,,1,1,2,3
43024,teletype,,1,12,5,17
43025,P-Frank,,1,6,11,17
43026,dpieper,,1,6,5,11
43027,glw907,,1,1,3,4
43028,cudiaco,,1,298,65,363
43029,NoblePotatoe,,1,13,25,38
43030,flow_,,1,3,4,7
43031,GermanEnglishPolice,,1,3,2,5
43032,dmsean,,1,166,246,412
43033,APock,,1,1,1,2
43034,WhattaDonkey,,1,1,1,2
43035,mauman,,1,1,3,4
43036,phyzome,,1,534,1149,1683
43037,mhh484,,1,1,1,2
43038,TexasMojo,,1,3,5,8
43039,mattblack,,3,4,2,6
43040,whiteoprah,,1,1,1,2
43041,FezMan88,,1,6,4,10
43042,orkut,,1,1,2,3
43043,bcvr,,1,20,27,47
43044,LoganSerman,,1,76,4,80
43045,unique321b,,1,1,2,3
43046,MarkFl123,,1,2,2,4
43047,Clintron,,1,1,2,3
43048,cybrspin,,1,79,19,98
43049,mjagiello,,1,27,30,57
43050,m_eiman,,1,2,3,5
43051,oilytheotter,,1,28,41,69
43052,sbenskin,,1,27,18,45
43053,Siraf,,1,129,145,274
43054,Rickert,,1,14,3,17
43055,Goladus,,1,1,2,3
43056,sheeep,,1,9,13,22
43057,NotJoeSmith,,1,32,14,46
43058,Mischi3vo,,1,3,1,4
43059,teamjimmyy,,1,7,6,13
43060,ChattyKathy,,1,3,2,5
43061,Keyframe,,1,110,103,213
43062,shriver,,1,1,7,8
43063,beardedone,,1,1,1,2
43064,MrKlatuu,,1,12,32,44
43065,arof,,1,9,19,28
43066,blackstar00,,1,7,9,16
43067,marvin,,1,17,6,23
43068,RealMaascamp,,1,6,7,13
43069,funkDoc,,1,19,27,46
43070,skatterbean,,1,2,1,3
43071,coppercrayon,,1,2,5,7
43072,Sense1ess,,1,16,55,71
43073,tjuric007,,1,3,1,4
43074,yohann,,1,5,3,8
43075,kcjameson,,1,245,236,481
43076,bkow20,,1,6,3,9
43077,heokle,,1,15,34,49
43078,KomodoDave,,1,1,1,2
43079,odd-ball,,1,1,2,3
43080,aluk,,1,3,4,7
43081,mreiland,,1,2,2,4
43082,endo99,,1,1,1,2
43083,rhinobird,,1,33,65,98
43084,jromano,,1,6,5,11
43085,deadeddie,,1,20,23,43
43086,stevebratt,,1,24,35,59
43087,dgiri101,,1,6,9,15
43088,Blueberryspies,,1,12,11,23
43089,ratedogs,,1,1,1,2
43090,SidewaysFish,,1,9,7,16
43091,filmmusiclover,,1,9,1,10
43092,asneaxl,,1,2,5,7
43093,candypant,,1,15,22,37
43094,SourSlurpee,,1,5,7,12
43095,ashground,,1,50,37,87
43096,crabperson,,1,8,13,21
43097,nirhmv,,1,1,1,2
43098,sbassin,,1,22,29,51
43099,dreamer90,,1,69,90,159
43100,Ra__,,1,1451,1925,3376
43101,BigEvil,,1,3,1,4
43102,temp_ature,,1,2,5,7
43103,DifferanceQ,,1,1,3,4
43104,jonathan881,,1,8,20,28
43105,texture,,1,954,735,1689
43106,btrettel,,1,4,10,14
43107,falsestprophet,,1,54,5,59
43108,IDownvoteJimmyCotton,,1,4,2,6
43109,ncairns,,1,12,14,26
43110,duggynyc,,1,7,6,13
43111,scarabic,,1,6,7,13
43112,browster,,1,85,112,197
43113,kingnerd,,1,14,32,46
43114,chickenwrap,,1,7,3,10
43115,Magee1205,,1,2,4,6
43116,PlanckEnergy,,1,28,27,55
43117,HawkeyeGK,,1,139,16,155
43118,limerope,,1,1,1,2
43119,jerseycityfrankie,,1,170,273,443
43120,nwii,,1,38,50,88
43121,dfskjdfsklfd,,1,3,1,4
43122,jbjake,,1,9,18,27
43123,cleverhandle,,1,4,2,6
43124,bamba1803,,1,19,8,27
43125,HumpingJack,,1,8,7,15
43126,Anttikoo,,1,35,2,37
43127,MrDoubtful,,1,3,8,11
43128,m_tayseer,,1,3,3,6
43129,Miami13,,1,10,15,25
43130,uberalles,,1,2,3,5
43131,dannykkkjames,,1,3,1,4
43132,infodoc1,,1,2,8,10
43133,azemute,,1,28,62,90
43134,jread,,1,7,12,19
43135,vasilisp,,1,3,4,7
43136,basilisk,,1,11,15,26
43137,whitedawg,,1,166,271,437
43138,tenbull,,1,120,80,200
43139,woo_hoo,,1,87,77,164
43140,Sithsteen,,1,80,46,126
43141,poisiod,,1,4,3,7
43142,mmurch03,,1,103,92,195
43143,Ivape,,1,43,84,127
43144,davidfdm,,1,1,11,12
43145,badalchemist,,1,46,49,95
43146,Ambush,,1,25,37,62
43147,Jesus_H_Christ,,1,3,1,4
43148,Biggus,,1,26,67,93
43149,dmooney1,,1,16,11,27
43150,adymo,,1,7,1,8
43151,bobthebarber,,1,1,1,2
43152,souldrift,,1,325,303,628
43153,framecontrol,,1,10,6,16
43154,otherwiseguy,,1,6,6,12
43155,BlameLayer,,1,5,12,17
43156,autista26,,1,2,4,6
43157,CanadianAsshole,,1,12,29,41
43158,schtum,,1,367,365,732
43159,mikeyarmo,,1,15,4,19
43160,edu,,1,3,1,4
43161,Postradamus,,1,39,2,41
43162,plbg32,,1,6,12,18
43163,mcwifi,,1,34,68,102
43164,dcguy12,,1,6,8,14
43165,minturn,,1,10,7,17
43166,digitalc,,1,498,668,1166
43167,technoweenie,,1,3,13,16
43168,Stormblade,,1,35,61,96
43169,battlegir,,1,4,10,14
43170,oddietaco,,1,34,18,52
43171,mrighele,,1,4,4,8
43172,GregJudysSon,,1,3,2,5
43173,nwej,,1,5,2,7
43174,xnomad,,1,5,3,8
43175,tzk,,1,32,67,99
43176,heanol,,1,2,3,5
43177,Meatshield,,1,4,7,11
43178,R031E5,,1,28,21,49
43179,slackmeister,,1,1,1,2
43180,fox_mulder,,1,55,106,161
43181,boarder4021,,1,4,4,8
43182,sosleepy,,1,2,3,5
43183,rumbling,,1,1,1,2
43184,moneyminds,,1,5,1,6
43185,irishkev,,1,98,22,120
43186,altered,,1,49,80,129
43187,vfx,,1,1,1,2
43188,killing_time,,1,51,55,106
43189,ooKmonkey,,1,4,8,12
43190,mabraham,,1,1,3,4
43191,seven11,,1,335,464,799
43192,michael12345678,,1,1,1,2
43193,schwap23,,1,36,2,38
43194,coringerr,,1,2,1,3
43195,5plus7,,1,9,10,19
43196,sickdimension,,1,132,34,166
43197,cccbreaker,,1,64,15,79
43198,JetSetWilly,,1,71,39,110
43199,davey_darling,,1,11,6,17
43200,nakmario,,1,4,8,12
43201,retroflarical,,1,20,10,30
43202,johnemdall,,1,1,4,5
43203,whistle_440,,1,2,1,3
43204,Gotttzsche,,1,115,164,279
43205,yello,,1,118,55,173
43206,fiddlechick,,1,17,15,32
43207,brandonmarlow,,1,39,12,51
43208,colorrot,,1,41,11,52
43209,MRomney,,1,2,1,3
43210,metagus,,1,1,3,4
43211,VicinSea,,1,901,754,1655
43212,mak11,,1,2,4,6
43213,Peity,,1,1,3,4
43214,pooteeweet28,,1,108,25,133
43215,divv,,1,34,80,114
43216,titsorgtfo,,1,1,1,2
43217,locoza,,1,4,3,7
43218,barbapapa666,,1,1,1,2
43219,rax_s,,1,20,23,43
43220,thetailofdogma,,1,1,1,2
43221,williamsba,,1,64,43,107
43222,nagap,,1,1,2,3
43223,SarahxJane,,1,2,11,13
43224,evilbunnyfufu,,1,5,4,9
43225,metachor,,1,30,76,106
43226,jigilous,,1,1,4,5
43227,mizan,,1,218,37,255
43228,decaff3,,1,9,10,19
43229,keystonesooner,,1,4,5,9
43230,ronflor,,1,1,2,3
43231,kor56,,1,31,43,74
43232,spectator,,1,40,1,41
43233,curtail,,1,3,1,4
43234,maneesh,,1,21,22,43
43235,towner,,1,1,1,2
43236,markandre,,1,4,8,12
43237,grandhighwonko,,1,272,732,1004
43238,chessmonkey,,1,12,16,28
43239,VanillaDeath,,1,2,2,4
43240,EvanSnyder,,1,4,2,6
43241,bloodysinuses,,1,5,2,7
43242,theXarf,,1,85,119,204
43243,adoro,,1,1,2,3
43244,rhavenn,,1,6,3,9
43245,hashcakes,,1,31,54,85
43246,GodILoveAsparagus,,1,57,52,109
43247,cowbob,,1,13,7,20
43248,Tjolo,,1,4,20,24
43249,Dubon,,1,8,20,28
43250,ty_max,,1,4,9,13
43251,bowling4meth,,1,205,408,613
43252,MothershipConnection,,1,1,3,4
43253,iKonic,,1,66,23,89
43254,tehguruofred,,1,11,7,18
43255,hturt,,1,1,3,4
43256,samgalvez,,1,467,16,483
43257,froydnj,,1,66,88,154
43258,MattTheGeek,,1,20,57,77
43259,jeebusroxors,,1,258,347,605
43260,askoruli,,1,1,3,4
43261,kokey,,1,392,608,1000
43262,misaligned,,1,2,11,13
43263,azimir,,1,33,109,142
43264,canyoudiggitman,,1,49,68,117
43265,malpingu,,1,1,3,4
43266,nicolas42,,1,4,8,12
43267,3daddict,,1,1,10,11
43268,b0b0tiken,,1,5,5,10
43269,future_pope,,1,3,2,5
43270,badr,,1,57,22,79
43271,T0RN8R,,1,4,1,5
43272,lambdanaut,,1,24,36,60
43273,2267ghy,,1,1,1,2
43274,zamolxes,,1,7,11,18
43275,GuyWithLag,,1,88,156,244
43276,Capitalismnotgreed,,1,71,89,160
43277,pertex,,1,6,3,9
43278,fremont1817,,1,6,1,7
43279,kstr,,1,29,50,79
43280,gluten-free,,1,9,2,11
43281,ChipZdarsky,,1,2,2,4
43282,tempaccount098753214,,1,1,9,10
43283,ManishSinha,,1,2,10,12
43284,mindless_puppet,,1,2,5,7
43285,astern,,1,33,52,85
43286,sayten,,1,9,4,13
43287,sugarcat,,1,6,18,24
43288,mfrager,,1,53,21,74
43289,belindakay,,1,1,1,2
43290,singleposteremacs,,1,1,1,2
43291,davraamides,,1,3,1,4
43292,workfromhomeking1,,1,27,26,53
43293,crazy2k,,1,2,6,8
43294,blindradar,,1,1,1,2
43295,GiveYouUp,,1,1,1,2
43296,Kain9787,,1,28,24,52
43297,your_computer,,1,1,1,2
43298,Sailormom,,1,29,32,61
43299,oska,,1,171,127,298
43300,spartas,,1,16,22,38
43301,Brittsmac,,1,1,5,6
43302,daughart,,1,8,18,26
43303,Uhohspaghettio,,1,8,6,14
43304,buffy4prez,,1,3,17,20
43305,shiftless,,1,5,5,10
43306,iul,,1,36,50,86
43307,AlphaX,,1,32,35,67
43308,caobhin,,1,4,8,12
43309,MCTynamite,,1,15,45,60
43310,HamburgerBarbie,,1,143,1,144
43311,agaete,,1,25,11,36
43312,MrMach5,,1,19,1,20
43313,j0hnnyb,,1,65,54,119
43314,philippejadin,,1,1,1,2
43315,Duka015,,1,15,1,16
43316,josto,,1,32,24,56
43317,PoopOnGod,,1,4,10,14
43318,dirtybastard,,1,1,1,2
43319,gidpo,,1,19,19,38
43320,agentmd,,1,2,6,8
43321,icanhasusername,,1,388,266,654
43322,GoRonnyGo,,1,4,4,8
43323,Paj0nk,,1,1,1,2
43324,trypto,,1,16,13,29
43325,Ahousai,,1,1,3,4
43326,nightgts,,1,1,1,2
43327,PaperCut_,,1,13,18,31
43328,chucker,,1,279,318,597
43329,incidently,,1,2,2,4
43330,etcshadow,,1,18,13,31
43331,avocade,,1,2,2,4
43332,MattFoley,,1,52,78,130
43333,thefro,,1,424,580,1004
43334,IcedZ,,1,42,59,101
43335,Clevtro,,1,9,16,25
43336,merfolkotpt,,1,42,6,48
43337,rakingleaves,,1,1,1,2
43338,Scytle,,1,102,10,112
43339,engram,,1,90,109,199
43340,cyrano111,,1,36,33,69
43341,pinkiemarie,,1,243,64,307
43342,jarmckenzie,,1,1,1,2
43343,durangotang,,1,7,4,11
43344,awesomepants,,1,6,4,10
43345,hhrt3456,,1,43,15,58
43346,pulvertoastman,,1,14,10,24
43347,jburkert,,1,22,39,61
43348,daivos,,1,40,32,72
43349,clinthill,,1,12,16,28
43350,Random,,1,186,217,403
43351,olpossum,,1,4,3,7
43352,Jugga,,1,1,4,5
43353,MiseBard,,1,24,47,71
43354,Tweet,,1,11,24,35
43355,eh24,,1,2,2,4
43356,LongIslandLolita,,1,7,12,19
43357,eido,,1,5,9,14
43358,buo,,1,9,18,27
43359,mortarbled,,1,128,15,143
43360,funks,,1,32,44,76
43361,patrickstickler,,1,12,27,39
43362,gigas21,,1,26,53,79
43363,Maximegalon,,1,1,1,2
43364,aliased,,1,2,2,4
43365,lpyuejfdpsstnb,,1,8,1,9
43366,redditsucksballs,,1,7,16,23
43367,daevud,,1,7,2,9
43368,cgawne,,1,13,3,16
43369,WRT,,1,13,10,23
43370,ruckgesicht,,1,48,62,110
43371,70moyo,,1,4,2,6
43372,vpoet,,1,1,1,2
43373,they_r_watching,,1,6,2,8
43374,mullacc,,1,1,6,7
43375,fathan,,1,69,73,142
43376,atn420,,1,3,4,7
43377,matts2,,1,1869,3133,5002
43378,Autoplectic,,1,1,1,2
43379,sisyphus,,1,327,500,827
43380,GSto,,1,25,9,34
43381,boolean_patrol,,1,24,53,77
43382,hoges,,1,39,38,77
43383,dwalkinafrica,,1,5,17,22
43384,dullin,,1,3,1,4
43385,gbasic24,,1,43,12,55
43386,rudynoir,,1,2,1,3
43387,areReady,,1,8,6,14
43388,salmagundii,,1,18,21,39
43389,theMrDomino,,1,9,10,19
43390,AspenLiselle,,1,2,3,5
43391,carlomrx,,1,44,1,45
43392,kingraoul3,,1,278,528,806
43393,pasbesoin,,1,49,116,165
43394,tastynaan,,1,21,6,27
43395,havesometea1,,1,508,1021,1529
43396,Astravian,,1,117,187,304
43397,ziutek,,1,6,2,8
43398,metatronscube,,1,30,77,107
43399,redbat500,,1,3,2,5
43400,softwareengineer,,1,1,2,3
43401,doobieBRO,,1,10,3,13
43402,KBax720,,1,3,1,4
43403,MrBrooks,,1,2,1,3
43404,nullroot,,1,100,167,267
43405,usrnamenottaken,,1,2,1,3
43406,MWatson,,1,12,5,17
43407,EzRiDeR,,1,17,25,42
43408,the_zero,,1,84,116,200
43409,JimmyShelter,,1,227,14,241
43410,hpoag,,1,10,9,19
43411,stifffx,,1,1,2,3
43412,Cronus6,,1,16,13,29
43413,GGLucas,,1,24,24,48
43414,ECEGatorTuro,,1,46,53,99
43415,generalk,,1,158,160,318
43416,shastert,,1,1,5,6
43417,darkpaladin,,1,193,128,321
43418,asdwwdw,,1,74,62,136
43419,projecteternity,,1,6,9,15
43420,Fraggle,,1,4,5,9
43421,Gulliver,,1,4,15,19
43422,HadleyBean,,1,3,3,6
43423,ericflo,,1,103,65,168
43424,katiew,,1,13,2,15
43425,jaslak,,1,21,11,32
43426,mouse2k,,1,13,12,25
43427,Midwest_Product,,1,648,390,1038
43428,IFelixtheCatIwer,,1,1,3,4
43429,annjellicle,,1,309,549,858
43430,duudud,,1,2,1,3
43431,immrlizard,,1,140,469,609
43432,tucadebert,,1,1,1,2
43433,cyd,,1,55,70,125
43434,not_the_FBI,,1,1,2,3
43435,ohwolfman,,1,61,28,89
43436,Cryptic0677,,1,99,159,258
43437,fatalrae,,1,12,25,37
43438,forthewin11,,1,38,2,40
43439,mockidol,,1,44,52,96
43440,essix,,1,1,1,2
43441,chuzuki,,1,15,34,49
43442,Dijkstracula,,1,13,11,24
43443,aesop921,,1,21,2,23
43444,Shorel,,1,12,58,70
43445,bettlebrox,,1,8,8,16
43446,panthrosrevenge,,1,13,12,25
43447,ahhinkle,,1,6,2,8
43448,brentathon,,1,3,1,4
43449,contradictorymonkey,,1,5,8,13
43450,PiggPhucker,,1,4,8,12
43451,sa7ouri,,1,217,155,372
43452,SparklingWiggle,,1,3,3,6
43453,krispiti,,1,1,1,2
43454,boblolbob,,1,6,3,9
43455,gypsydancer,,1,7,12,19
43456,josiefaraway,,1,3,3,6
43457,dpadular,,1,27,55,82
43458,endersdouble,,1,26,27,53
43459,CrystalCheer22,,1,6,52,58
43460,Bassdust,,1,2,5,7
43461,paradox460,,1,24,35,59
43462,ohnoihavenoname,,1,15,20,35
43463,tickingbrain,,1,139,143,282
43464,NewEnglish,,1,17,41,58
43465,emberjohnny,,1,384,21,405
43466,mkh,,1,3,2,5
43467,jraines,,1,40,52,92
43468,chri1143,,1,2,5,7
43469,redditman123,,1,5,7,12
43470,zoogr2,,1,4,8,12
43471,Lord_Xenu,,1,2,3,5
43472,thelastword,,1,1,1,2
43473,MrSt1klbak,,1,66,138,204
43474,chuck812,,1,107,21,128
43475,ckpics,,1,4,1,5
43476,nhole1,,1,2,1,3
43477,sinfurious,,1,6,5,11
43478,XxERMxX,,1,141,329,470
43479,m3ch4n15t,,1,5,9,14
43480,TranadaDay,,1,1,1,2
43481,beamin1,,1,2,1,3
43482,Applesauces,,1,82,80,162
43483,darkcard,,1,49,91,140
43484,Thor_Aackerlund,,1,1,3,4
43485,EricRes,,1,10,17,27
43486,allenp,,1,10,6,16
43487,ztaufiq,,1,2,9,11
43488,athiestcutie,,1,7,6,13
43489,skinnedmink,,1,5,11,16
43490,TheAntiChrist,,1,1,1,2
43491,IanCal,,1,104,194,298
43492,sandflea,,1,373,671,1044
43493,a1siggidy,,1,2,1,3
43494,lahuman8,,1,14,25,39
43495,anveo,,1,1,1,2
43496,Quince,,1,43,24,67
43497,zetetic,,1,31,30,61
43498,rarestwords,,1,4,11,15
43499,realstraw,,1,1,1,2
43500,cambamgt,,1,2,3,5
43501,6mDollarMan,,1,32,9,41
43502,dlds,,1,121,131,252
43503,dfk789,,1,38,57,95
43504,fideaux128,,1,3,3,6
43505,peepasaur,,1,3,4,7
43506,jojerose,,1,1,1,2
43507,sethcera,,1,5,23,28
43508,Candlemann,,1,2,2,4
43509,eeebenz,,1,5,8,13
43510,jcrawford,,1,1,1,2
43511,rooch84,,1,1,1,2
43512,jabfake,,1,1,1,2
43513,you_do_realize,,1,343,376,719
43514,michaelkeenan,,1,2,7,9
43515,MadDogTannen,,1,16,9,25
43516,AlDente,,1,258,431,689
43517,ProcrustesX,,1,89,33,122
43518,Frosty840,,1,9,26,35
43519,Causality_Loop,,1,1,1,2
43520,Spatulated,,1,20,6,26
43521,MikeHuckabee,,1,4,1,5
43522,maryriley,,1,2,2,4
43523,TomRich,,1,5,31,36
43524,nakula,,1,5,2,7
43525,revnoah,,1,24,56,80
43526,jbum,,1,1,3,4
43527,Mattyi,,1,29,57,86
43528,shhh,,1,498,33,531
43529,BostonTentacleParty,,1,5,12,17
43530,lostraven,,1,19,32,51
43531,vcharleston,,1,1,1,2
43532,dptronz,,1,171,123,294
43533,dookiemon,,1,9,13,22
43534,amc178,,1,3,4,7
43535,vduffy,,1,2,3,5
43536,ianandris,,1,10,21,31
43537,danieltalsky,,1,7,14,21
43538,99Reasons1,,1,2,2,4
43539,nixfu,,1,35,44,79
43540,dredge1981,,1,148,13,161
43541,arok,,1,1,1,2
43542,itemfour,,1,1,2,3
43543,fox1324,,1,2,3,5
43544,BigBadAl,,1,14,7,21
43545,Pilsner45,,1,2,1,3
43546,vectorz,,1,8,17,25
43547,coderdan,,1,2,2,4
43548,hukarez,,1,4,17,21
43549,ImYoric,,1,6,13,19
43550,animator,,1,1,3,4
43551,cornelius99,,1,175,80,255
43552,macduck71,,1,1,1,2
43553,sligowaths,,1,152,181,333
43554,unperfect,,1,6,15,21
43555,explodyhead,,1,103,6,109
43556,burn2much,,1,11,5,16
43557,DorkBitz,,1,5,17,22
43558,HorusTheHeretic,,1,1,2,3
43559,sogrundy,,1,9,16,25
43560,Jgallstar1,,1,5,9,14
43561,jreichel,,1,1,1,2
43562,poofbird,,1,269,81,350
43563,ice799,,1,50,12,62
43564,wiguleeds,,1,18,12,30
43565,baxx74,,1,6,9,15
43566,YourARetard,,1,2,1,3
43567,mk500,,1,1,1,2
43568,towelsoaker,,1,3,10,13
43569,armper,,1,182,286,468
43570,Tower_Of_Babel,,1,1,2,3
43571,jgrindal,,1,164,62,226
43572,har_9,,1,2,5,7
43573,Riluske,,1,20,11,31
43574,earobinson,,1,4,7,11
43575,robert001,,1,2,1,3
43576,dikini,,1,15,18,33
43577,cyaneyes,,1,2,3,5
43578,jujubetea,,1,3,4,7
43579,sigmaalgebra,,1,10,12,22
43580,stevecopley,,1,1,1,2
43581,Jwoey,,1,319,544,863
43582,allfury,,1,13,35,48
43583,PorkFlavour,,1,14,23,37
43584,be_o3,,1,16,17,33
43585,skuba,,1,5,11,16
43586,vogon,,1,6,1,7
43587,djh816,,1,155,266,421
43588,prolitico,,1,43,27,70
43589,radiks32,,1,3,4,7
43590,straylyt,,1,1,2,3
43591,mmmSoyrizo,,1,75,140,215
43592,AussieDigg3r,,1,2,3,5
43593,ouroborosity,,1,688,1250,1938
43594,eternium,,1,2,3,5
43595,cazbot,,1,19,35,54
43596,bigwig87,,1,2,3,5
43597,Hypersapien,,1,118,188,306
43598,mattycito,,1,2,3,5
43599,mp0,,1,2,5,7
43600,taybme,,1,36,41,77
43601,xjbri,,1,17,17,34
43602,hamstertamer,,1,23,19,42
43603,archon810,,1,2,4,6
43604,kndonlee,,1,9,1,10
43605,hello2you,,1,9,8,17
43606,IRememberRossPerot,,1,3,3,6
43607,dssurge,,1,19,12,31
43608,adelaarvaren,,1,54,93,147
43609,dbeckmann,,1,2,1,3
43610,jkndrkn,,1,167,141,308
43611,jabberwonk,,1,256,24,280
43612,war_is_peace,,1,5,1,6
43613,Nurotasama,,1,14,26,40
43614,oddgodd,,1,19,30,49
43615,riverScrap,,1,44,2,46
43616,Twofer,,1,5,8,13
43617,vityok,,1,35,53,88
43618,CocoLaLoca,,1,1,6,7
43619,saetaes,,1,5,3,8
43620,genericuser,,1,20,45,65
43621,joew515,,1,18,13,31
43622,kscaldef,,1,144,221,365
43623,smacfarl,,1,971,862,1833
43624,Nebu,,1,1,3,4
43625,mrjester,,1,1,3,4
43626,Jean-Paul_Sartre,,1,2,1,3
43627,rolandog,,1,2,5,7
43628,youtalkalotofsh,,1,5,10,15
43629,remleduff,,1,23,22,45
43630,tripstreet,,1,10,16,26
43631,unity2k,,1,1,1,2
43632,ies,,1,8,4,12
43633,froese,,1,53,52,105
43634,designfu,,1,1,1,2
43635,TheAmazingRedditMan,,1,2,1,3
43636,marbleriver,,1,7,10,17
43637,Unique_User_Name,,1,18,24,42
43638,bradypsmith,,1,1,3,4
43639,agatagopee,,1,2,14,16
43640,afreedman,,1,3,2,5
43641,thatmattbone,,1,20,17,37
43642,kinghajj,,1,93,104,197
43643,tuxidomasx,,1,48,16,64
43644,csliwins,,1,122,27,149
43645,IlyaKraft,,1,16,1,17
43646,jermyy,,1,1,2,3
43647,jeflin,,1,4,5,9
43648,odoylerulz,,1,2,1,3
43649,LingLing1337,,1,91,162,253
43650,snowhite7185,,1,14,13,27
43651,RationalBeaver,,1,11,10,21
43652,b0mber,,1,24,46,70
43653,Newspeak,,1,2,1,3
43654,thulasidharan2k8,,1,2,1,3
43655,ohyeahp,,1,1,1,2
43656,zetta,,1,9,10,19
43657,Legionary,,1,4,1,5
43658,Mr_Twister,,1,6,14,20
43659,yason,,1,23,6,29
43660,worship-reptiles,,1,3,1,4
43661,opieum,,1,3,2,5
43662,alecb,,1,2109,125,2234
43663,C_C_C_COMBO_BREAKER,,1,1,1,2
43664,zivtastic,,1,1,2,3
43665,wirry90210,,1,2,3,5
43666,mmilian,,1,77,9,86
43667,chaos_syndicate,,1,15,3,18
43668,b3mus3d,,1,556,538,1094
43669,YouGotServed,,1,1,3,4
43670,kewlduderules,,1,117,112,229
43671,mad_scientist,,1,95,18,113
43672,LostChild,,1,1,6,7
43673,buzaw0nk,,1,252,140,392
43674,cegsic,,1,2,2,4
43675,cochedejmu,,1,152,23,175
43676,nescontroller,,1,8,5,13
43677,xabbu,,1,13,2,15
43678,ramen_ftw,,1,72,93,165
43679,Sulky,,1,12,14,26
43680,bruinhenryd,,1,3,5,8
43681,ixxifortune,,1,1,1,2
43682,Heofz,,1,4,7,11
43683,marcronan,,1,1,1,2
43684,InternetJunkie,,1,1,3,4
43685,panxor,,1,11,15,26
43686,zookiman,,1,1,2,3
43687,crystalis,,1,78,56,134
43688,heffocheffefer,,1,358,342,700
43689,fibrecore,,1,21,35,56
43690,helvetia,,1,19,21,40
43691,fluke,,1,2,4,6
43692,stahl,,1,15,1,16
43693,tripleeddie,,1,99,43,142
43694,eskape,,1,3,2,5
43695,brentolamas,,1,18,24,42
43696,ViennaSausage,,1,2,1,3
43697,ryan_peaceworks,,1,2,1,3
43698,wraithx,,1,82,81,163
43699,cablemigrant,,1,1,4,5
43700,RegDwight,,1,23,23,46
43701,dmpk2k,,1,220,303,523
43702,thisshouldbepolitics,,1,2,1,3
43703,shortwill,,1,3,8,11
43704,milanfan,,1,4,8,12
43705,Postpawl,,1,5,8,13
43706,Captain___Obvious,,1,153,201,354
43707,Yansky,,1,2,1,3
43708,jedberg,,1,848,746,1594
43709,jefflyne,,1,1,2,3
43710,degriz,,1,180,404,584
43711,lbrandy,,1,108,78,186
43712,nickmcclendon,,1,20,4,24
43713,RPaul08,,1,24,9,33
43714,epcmedia,,1,2,4,6
43715,the-illuminator,,1,3,2,5
43716,skittlelover,,1,6,1,7
43717,jreddit,,1,605,630,1235
43718,crellec,,1,8,6,14
43719,salinon,,1,7,5,12
43720,diet_c0ke,,1,13,10,23
43721,poservarial,,1,5,7,12
43722,daveyboy22,,1,156,96,252
43723,bozzskaggs,,1,1,1,2
43724,robertswa,,1,2,6,8
43725,hpymondays,,1,773,478,1251
43726,befs,,1,4,4,8
43727,lidabob,,1,292,1,293
43728,SmokyMtnHiker,,1,31,3,34
43729,noisebleed,,1,9,10,19
43730,mini_meme,,1,10,25,35
43731,loquacious,,1,90,114,204
43732,fuzzywombat,,1,37,13,50
43733,xiga,,1,4,6,10
43734,phdonnelly,,1,36,75,111
43735,Retsejesiw,,1,9,44,53
43736,ta4ka,,1,1,1,2
43737,oorah,,1,10,20,30
43738,duddles,,1,473,286,759
43739,TheBaker,,1,31,15,46
43740,ianglese,,1,14,14,28
43741,potro,,1,26,29,55
43742,blackyoda,,1,17,24,41
43743,b0b,,1,6,20,26
43744,wogzi,,1,10,11,21
43745,jyunghit,,1,2,1,3
43746,bubble_bobble,,1,177,255,432
43747,PhillyBoyRoy,,1,6,3,9
43748,Goym,,1,1,1,2
43749,JaySunFL,,1,8,11,19
43750,jahelton81,,1,11,28,39
43751,eshemuta,,1,98,219,317
43752,jwilliamb24,,1,2,1,3
43753,cleantex,,1,1,1,2
43754,pleasantlybored,,1,2,1,3
43755,DanTilkin,,1,37,49,86
43756,rupa,,1,52,78,130
43757,djpnewton,,1,44,72,116
43758,exotics,,1,188,72,260
43759,edwardmills,,1,4,1,5
43760,superphantom,,1,10,13,23
43761,phayd,,1,5,15,20
43762,lifeofliberty,,1,12,22,34
43763,Sorento,,1,52,115,167
43764,Alpinweis,,1,31,2,33
43765,commandar,,1,51,62,113
43766,causativecorrelation,,1,1,1,2
43767,Ejir,,1,133,279,412
43768,kst9879872,,1,10,16,26
43769,Eismann,,1,98,47,145
43770,floppydrive,,1,5,3,8
43771,ALWAYS_RIGHT,,1,10,12,22
43772,fap-fap-fap,,1,10,11,21
43773,doubleE,,1,102,86,188
43774,theblackcritic,,1,24,2,26
43775,thcmagus,,1,1,4,5
43776,Rufus_22,,1,7,7,14
43777,ombi,,1,1,1,2
43778,mamra,,1,58,1,59
43779,Haddock,,1,139,260,399
43780,nathan82,,1,5,8,13
43781,blakewatters,,1,20,4,24
43782,funkah,,1,144,259,403
43783,aphexmandelbrot,,1,193,443,636
43784,Epic_Peanuts,,1,2,1,3
43785,jagu,,1,1,2,3
43786,brendakay,,1,5,1,6
43787,MattBD,,1,11,5,16
43788,stevewedig,,1,8,5,13
43789,Admiral_Ackbar,,1,22,21,43
43790,Shagata_Ganai,,1,203,395,598
43791,wazoox,,1,98,138,236
43792,rpdillon,,1,99,148,247
43793,neenernenner,,1,5,7,12
43794,tictac99,,1,1,1,2
43795,lamb8192,,1,2,6,8
43796,stupidpoopoohead,,1,1,1,2
43797,ellipticaltable,,1,3,2,5
43798,techie1980,,1,5,2,7
43799,jeebus77,,1,16,14,30
43800,IbeeX,,1,181,6,187
43801,lynchyeatspizza,,1,13,6,19
43802,jstal,,1,1,1,2
43803,cbolts,,1,4,12,16
43804,tidder90210,,1,10,8,18
43805,Chris3411444,,1,51,76,127
43806,Iamthewalrus,,1,190,184,374
43807,Internoob,,1,35,39,74
43808,slimslider,,1,6,6,12
43809,thetensor,,1,15,8,23
43810,DrJ,,1,19,20,39
43811,madhatta23,,1,2,1,3
43812,spencermiles,,1,23,1,24
43813,riemannszeros,,1,268,244,512
43814,aabbqrstp,,1,1,1,2
43815,zaaaaz,,1,238,69,307
43816,buffaloboy,,1,2,2,4
43817,britkid12,,1,15,13,28
43818,yugami,,1,60,190,250
43819,saturn825,,1,104,209,313
43820,bluehands,,1,8,16,24
43821,luster,,1,148,275,423
43822,primefactor,,1,2,5,7
43823,ronaldl79,,1,4,4,8
43824,vikingv,,1,13,15,28
43825,badfish701,,1,32,8,40
43826,IslandAce,,1,7,6,13
43827,BigNormalMan,,1,1,4,5
43828,rubberball,,1,69,153,222
43829,ebonelza,,1,8,6,14
43830,merryungulate,,1,1,1,2
43831,heisec,,1,36,1,37
43832,gameforge,,1,377,537,914
43833,alexthewriter,,1,29,4,33
43834,MrObamasQuran,,1,92,118,210
43835,GavinNH,,1,1,3,4
43836,cjasztrab,,1,6,1,7
43837,icanhasairforceone,,1,14,20,34
43838,qviqve1,,1,4,24,28
43839,Dumpser,,1,1,1,2
43840,Caternary,,1,15,26,41
43841,thedbert21,,1,2,3,5
43842,xwonka,,1,2,2,4
43843,erinlaver,,1,4,1,5
43844,redraider0016,,1,9,9,18
43845,poopsicle,,1,14,4,18
43846,ksool,,1,7,6,13
43847,flyingjay2121,,1,150,1,151
43848,5985958,,1,20,19,39
43849,oswaldheston,,1,3,7,10
43850,asianglowharold,,1,1,7,8
43851,weej,,1,17,33,50
43852,cdharrison,,1,17,3,20
43853,Coffeeee,,1,1,2,3
43854,Anathemic_Nerd,,1,6,2,8
43855,dhark,,1,155,178,333
43856,Myrv,,1,27,29,56
43857,rps5000,,1,68,8,76
43858,redditcensoredme,,1,1430,2094,3524
43859,MisterMerkin,,1,76,168,244
43860,Lifer,,1,8,4,12
43861,mark0x,,1,1,1,2
43862,alphahelix,,1,2,2,4
43863,nello1226,,1,14,47,61
43864,puffybaba,,1,85,137,222
43865,illuminatedwax,,1,663,813,1476
43866,papertiger,,1,2,8,10
43867,mcford26,,1,5,1,6
43868,lazzareth,,1,54,58,112
43869,ouistiti,,1,8,8,16
43870,ebbayartist,,1,7,1,8
43871,Excedrin,,1,23,46,69
43872,stevechy,,1,21,14,35
43873,LAWLESS,,1,1,2,3
43874,MMGuuy,,1,4,4,8
43875,Azurathus,,1,1,2,3
43876,m0neybags,,1,19,21,40
43877,xNIBx,,1,110,149,259
43878,cumdumpster,,1,30,25,55
43879,thebellmaster1x,,1,59,53,112
43880,pinkjello,,1,1,1,2
43881,josephknight,,1,4,1,5
43882,201wasan_underseajob,,1,1,2,3
43883,Rahvin,,1,2,3,5
43884,alanwj,,1,4,4,8
43885,kragensitaker,,1,52,147,199
43886,AR1ST0,,1,17,43,60
43887,daelin,,1,24,35,59
43888,lorettanall,,1,3,3,6
43889,stalepie3,,1,1,1,2
43890,donwilson,,1,46,52,98
43891,harrytuttle,,1,411,297,708
43892,ODSTSpooky,,1,23,26,49
43893,PrimeTime485,,1,4,7,11
43894,LincolnA,,1,14,7,21
43895,demeteloaf,,1,60,76,136
43896,my_nodnarb,,1,1,1,2
43897,Sulac,,1,4,4,8
43898,ismailnc,,1,2,1,3
43899,hshsh,,1,1,1,2
43900,tmwctr,,1,19,3,22
43901,bos,,1,320,84,404
43902,zinger991,,1,1,1,2
43903,Godwins_Law,,1,1,3,4
43904,galderz,,1,1,1,2
43905,pdonni,,1,24,3,27
43906,oxxiox,,1,9,1,10
43907,blueeit,,1,2,2,4
43908,poopdeck,,1,85,83,168
43909,gparadee,,1,13,4,17
43910,kprashan,,1,1,3,4
43911,cudada,,1,3,2,5
43912,SongQuoter,,1,2,6,8
43913,plasticbacon,,1,154,172,326
43914,LyddyPark,,1,4,4,8
43915,ninzee,,1,1404,108,1512
43916,LAPHOQUE,,1,1,1,2
43917,wylde21,,1,26,34,60
43918,ElXGaspeth,,1,3,5,8
43919,CharlesAndrew,,1,1,2,3
43920,madisonman,,1,22,45,67
43921,silver_lining_man,,1,36,70,106
43922,akosokof,,1,14,20,34
43923,DeepSigh,,1,6,1,7
43924,he-who-inquires,,1,15,2,17
43925,jonbuchan,,1,116,17,133
43926,Wriiight,,1,33,66,99
43927,saurabhsawant,,1,12,18,30
43928,rtfx,,1,12,10,22
43929,passwordisconfession,,1,13,2,15
43930,jdeluise,,1,2,2,4
43931,palpatine66,,1,7,7,14
43932,dangerz,,1,110,100,210
43933,spitfire451,,1,8,17,25
43934,johnpseudo,,1,9,4,13
43935,WTFalreadytaken,,1,29,42,71
43936,milkman99,,1,1,1,2
43937,Disposable99,,1,3,2,5
43938,liability11,,1,1,2,3
43939,zoidbergisgod,,1,18,18,36
43940,xolox,,1,26,27,53
43941,arctic_ninja,,1,2,9,11
43942,rbatra,,1,11,4,15
43943,wonderfibre,,1,4,5,9
43944,Captain_Sarcasm,,1,1,1,2
43945,thejaysun,,1,56,66,122
43946,Ell3,,1,2,1,3
43947,xarah,,1,13,14,27
43948,pinkyabuse,,1,97,110,207
43949,theducks,,1,3,7,10
43950,blissfisherman,,1,6,13,19
43951,lazycat,,1,266,5,271
43952,azola7,,1,5,10,15
43953,pixelglow,,1,16,21,37
43954,quantumstate,,1,5,4,9
43955,goishin,,1,12,12,24
43956,quixo,,1,61,17,78
43957,subversemon,,1,8,26,34
43958,Sharpe_27,,1,100,29,129
43959,tchhailo,,1,10,1,11
43960,bigstevec,,1,304,223,527
43961,braindancer,,1,15,23,38
43962,doughoyte,,1,3,2,5
43963,kamander,,1,1,1,2
43964,halfmexi,,1,5,1,6
43965,Zyzzbaluba,,1,1,3,4
43966,Lungs,,1,18,25,43
43967,sarcascio,,1,14,26,40
43968,TwoBirds,,1,36,1,37
43969,monocle612,,1,1,1,2
43970,bigsim,,1,1,1,2
43971,BRCampbell,,1,32,46,78
43972,bloggerp,,1,29,1,30
43973,rkern,,1,2,3,5
43974,iragaines,,1,3,9,12
43975,johnny2bad,,1,1,2,3
43976,aupeters,,1,25,48,73
43977,wmc,,1,20,28,48
43978,garrettj,,1,15,15,30
43979,mitzman,,1,3,6,9
43980,literal,,1,1,3,4
43981,chickelnoodensoup,,1,1,1,2
43982,ball122506,,1,2,1,3
43983,junius,,1,6,8,14
43984,aquateen,,1,7,4,11
43985,kgbdrop,,1,4,7,11
43986,yellowbugs,,1,1,1,2
43987,qsvans,,1,2,6,8
43988,kommissar,,1,14,14,28
43989,mrpatriotic,,1,1,1,2
43990,0x68,,1,1,3,4
43991,jaxspider,,1,288,633,921
43992,barc0001,,1,267,300,567
43993,pasesak22,,1,1,2,3
43994,danweber,,1,1086,757,1843
43995,Rozencrantz,,1,1,8,9
43996,moodle7,,1,1,1,2
43997,altenergy,,1,8,7,15
43998,genericgeek,,1,13,18,31
43999,talentlessclown,,1,1,2,3
44000,cindymaywho,,1,2,2,4
44001,rotel967,,1,2,1,3
44002,shaggy25,,1,6,8,14
44003,jeffp12,,1,54,23,77
44004,friezes,,1,2,1,3
44005,hitsman,,1,989,246,1235
44006,permaculture,,1,798,1443,2241
44007,vutkolh,,1,1,1,2
44008,billyvnilly,,1,2,7,9
44009,Scotiva,,1,11,25,36
44010,ladytrompetista,,1,65,87,152
44011,canadianguy,,1,88,132,220
44012,Grand_Nagus_Zek,,1,10,17,27
44013,needtologinnowand,,1,10,30,40
44014,lamagna,,1,10,1,11
44015,surfwax95,,1,235,259,494
44016,joshrice,,1,9,14,23
44017,seksignome,,1,21,35,56
44018,bleah325,,1,1,2,3
44019,sweetpea2008,,1,1,1,2
44020,uggedal,,1,373,94,467
44021,toddtomlinson,,1,1,6,7
44022,liquidwax,,1,1,1,2
44023,coglethorpe,,1,113,20,133
44024,noodleIncident,,1,2,2,4
44025,meron5,,1,7,4,11
44026,0utput,,1,1,1,2
44027,Lhyzz,,1,4,1,5
44028,poltergeis,,1,11,9,20
44029,caution2thewind,,1,10,11,21
44030,Engramft,,1,1,2,3
44031,niilantey,,1,1,1,2
44032,snowgirl144,,1,1,1,2
44033,cleancut2,,1,6,2,8
44034,tedf23982,,1,59,87,146
44035,Lady_Liberty,,1,10,13,23
44036,fhsm,,1,2,2,4
44037,munkypepper10,,1,1,1,2
44038,RonPaulTouchedMe,,1,545,267,812
44039,calvinbroadus,,1,1,5,6
44040,batosai,,1,4,1,5
44041,cjeris,,1,3,5,8
44042,littlegarth,,1,4,5,9
44043,bugg,,1,1218,39,1257
44044,devilinthedetails,,1,2,1,3
44045,aphoenix,,1,21,23,44
44046,void2487,,1,2,4,6
44047,gx5ilver,,1,59,90,149
44048,Rudzz34,,1,1,3,4
44049,j4mm3d,,1,24,23,47
44050,bulldog20,,1,12,8,20
44051,manixrock,,1,106,139,245
44052,M2K360,,1,1,1,2
44053,moonzilla,,1,895,1311,2206
44054,cberman,,1,307,465,772
44055,harryb6,,1,59,28,87
44056,Sillern,,1,3,5,8
44057,phase,,1,5,7,12
44058,yabcok,,1,9,3,12
44059,SirNiceFellow,,1,4,5,9
44060,erg,,1,23,25,48
44061,trevc2,,1,1,2,3
44062,ArthurCravan,,1,11,20,31
44063,x4096,,1,2,3,5
44064,relient05,,1,3,3,6
44065,rethin,,1,7,7,14
44066,pdovy,,1,5,6,11
44067,starshippooper,,1,1,1,2
44068,amvickers,,1,4,7,11
44069,SodiumKPump,,1,896,1100,1996
44070,Designthing,,1,4,21,25
44071,whaknrd,,1,12,2,14
44072,docholiday,,1,274,291,565
44073,filter88,,1,1,1,2
44074,haxxormaster,,1,83,130,213
44075,maarack,,1,1,1,2
44076,QueenBeeCassi,,1,91,27,118
44077,mikemcg,,1,17,26,43
44078,skittles15,,1,126,19,145
44079,neon,,1,46,49,95
44080,tested911,,1,1,1,2
44081,cmemove,,1,4,1,5
44082,jsn,,1,13,12,25
44083,cwbruce1,,1,9,9,18
44084,undescendedtentacles,,1,3,6,9
44085,the3rdsam,,1,14,9,23
44086,LousyTourist,,1,11,20,31
44087,alexchambana,,1,171,106,277
44088,kraftmatic,,1,245,236,481
44089,rav3nous,,1,1,5,6
44090,removeya,,1,15,24,39
44091,keedt,,1,2,5,7
44092,eatbacon,,1,41,11,52
44093,NecromancyBlack,,1,1,1,2
44094,matt_damon,,1,1,3,4
44095,asdf512tx,,1,1,2,3
44096,hotgrl23,,1,33,62,95
44097,Shabaz,,1,1,2,3
44098,unreasonablefaith,,1,406,43,449
44099,pazna,,1,36,40,76
44100,alapoet,,1,68,3,71
44101,kindall,,1,389,627,1016
44102,danieldrehmer,,1,5,25,30
44103,joe73,,1,1,2,3
44104,sabetts,,1,290,424,714
44105,cipherprime,,1,240,429,669
44106,panic,,1,271,243,514
44107,demarz,,1,21,36,57
44108,rajulkabir,,1,4,7,11
44109,fizzatbeyond,,1,14,4,18
44110,chs,,1,3,11,14
44111,EarBucket,,1,42,80,122
44112,quobobo,,1,67,88,155
44113,greenpower,,1,1,1,2
44114,PopeBenedictXVI,,1,3,1,4
44115,samth0,,1,8,9,17
44116,Impu12,,1,3,5,8
44117,tmiltznc,,1,268,11,279
44118,evilbob,,1,7,5,12
44119,JaredR,,1,1,3,4
44120,painted82,,1,64,65,129
44121,darkrayne,,1,19,42,61
44122,1page,,1,1,2,3
44123,GeekAlerts,,1,1,3,4
44124,carlosz,,1,21,2,23
44125,satanloveskale,,1,16,6,22
44126,greymatter42,,1,1,2,3
44127,mossmaal,,1,11,9,20
44128,oasihdg,,1,1,1,2
44129,CaptainExcess,,1,1,2,3
44130,jlmcfarl,,1,1,1,2
44131,blisk,,1,156,263,419
44132,Elleanee,,1,32,31,63
44133,katalysis,,1,44,22,66
44134,thecouch,,1,21,46,67
44135,morituri,,1,39,81,120
44136,evox777,,1,32,42,74
44137,weekendwarrior,,1,6,15,21
44138,crepitus,,1,21,40,61
44139,mistikofor,,1,1,1,2
44140,seanm74,,1,3,8,11
44141,jerryparid,,1,8,7,15
44142,bowl_haircut,,1,13,49,62
44143,mypasswordisstupid,,1,17,21,38
44144,darkstar999,,1,226,62,288
44145,jerechos,,1,171,105,276
44146,Subhoney,,1,2,6,8
44147,rhumber,,1,78,42,120
44148,billehunt,,1,5,1,6
44149,EmperialK,,1,2,14,16
44150,oughgh,,1,2,4,6
44151,macdude,,1,42,32,74
44152,Lurking_Grue,,1,375,568,943
44153,xk0der,,1,1,2,3
44154,nikec,,1,107,3,110
44155,syspig,,1,16,21,37
44156,dools,,1,5,3,8
44157,dongerty,,1,25,10,35
44158,aliubin2,,1,1,3,4
44159,Orchestral,,1,7,17,24
44160,rej1587,,1,12,6,18
44161,wolfshirt,,1,388,111,499
44162,LAngeDuFoyeur,,1,7,10,17
44163,gjones,,1,21,2,23
44164,likk23,,1,1,3,4
44165,duhduh,,1,2,2,4
44166,donniex7,,1,7,10,17
44167,DarkyHelmety,,1,191,215,406
44168,dustball23,,1,1,2,3
44169,kingofbigmac,,1,30,4,34
44170,sintaxi,,1,29,25,54
44171,aliasone,,1,6,8,14
44172,Trentw,,1,1,1,2
44173,nopointinnames,,1,7,5,12
44174,dipshizzle,,1,11,6,17
44175,Odersky,,1,2,4,6
44176,complexmath,,1,6,11,17
44177,goldmonkey007,,1,7,6,13
44178,Chaubunagungamaugg,,1,108,98,206
44179,lowrads,,1,288,647,935
44180,thedzigner,,1,1,2,3
44181,Percept,,1,146,239,385
44182,SlimFastForYou,,1,237,388,625
44183,DocCottle,,1,21,41,62
44184,supercanuck,,1,145,136,281
44185,citizenkahn,,1,2,12,14
44186,CloseTheCode,,1,2,4,6
44187,wounded625,,1,11,19,30
44188,spudickle,,1,8,5,13
44189,bh_tokyo,,1,32,50,82
44190,x0melissa0x,,1,2,4,6
44191,____________,,1,1,1,2
44192,eliminator,,1,12,7,19
44193,derpderpderp,,1,1,1,2
44194,DownmodMeNazis,,1,2,2,4
44195,phishtree,,1,53,56,109
44196,kturtle11,,1,5,24,29
44197,wilsonx81,,1,67,104,171
44198,Otter,,1,4,2,6
44199,Adagio,,1,14,9,23
44200,imnotarobot,,1,17,21,38
44201,qwerty,,1,5,7,12
44202,stinky613,,1,4,10,14
44203,jjc4good,,1,1,1,2
44204,elfofdoriath9,,1,101,96,197
44205,sammyson242,,1,5,13,18
44206,XzistenZ,,1,1,6,7
44207,awh,,1,1,1,2
44208,jmcdannel,,1,1,1,2
44209,giffen,,1,5,2,7
44210,gamecock,,1,75,91,166
44211,limer,,1,2,1,3
44212,damunzy,,1,92,149,241
44213,gngstrMNKY,,1,32,20,52
44214,santino333,,1,1,1,2
44215,20081227,,1,1,1,2
44216,blm03,,1,12,4,16
44217,emosorines,,1,550,479,1029
44218,puraceta,,1,80,59,139
44219,artvandeleigh,,1,4,6,10
44220,lisainla,,1,2,2,4
44221,superterran,,1,3,2,5
44222,cmoockery,,1,1,1,2
44223,daco,,1,3,5,8
44224,skankedout,,1,105,260,365
44225,throw_away_account,,1,3,5,8
44226,miketheburrito,,1,10,10,20
44227,zeabeth,,1,15,9,24
44228,mac71,,1,54,43,97
44229,sbmon,,1,1,1,2
44230,isarl,,1,21,33,54
44231,OMGbatman,,1,58,52,110
44232,jinic,,1,10,6,16
44233,badgrammar,,1,7,11,18
44234,cycles,,1,69,112,181
44235,lynxia,,1,1,1,2
44236,RadicalBender,,1,7,2,9
44237,Barbie_Thomas,,1,3,1,4
44238,mackstann,,1,394,266,660
44239,sh_hs,,1,3,13,16
44240,mf4633,,1,430,199,629
44241,dlb-nick,,1,2,1,3
44242,xorandor,,1,216,65,281
44243,ericpp,,1,1,2,3
44244,etoipi,,1,33,22,55
44245,jigglebilly,,1,8,31,39
44246,brianfair,,1,547,54,601
44247,KenDowns,,1,4,9,13
44248,Amargosa,,1,2,13,15
44249,habbadash,,1,850,894,1744
44250,YYYY,,1,18,43,61
44251,demontoy,,1,5,9,14
44252,lish,,1,3,5,8
44253,rhcp330,,1,11,9,20
44254,yermom,,1,64,58,122
44255,PhilxBefore,,1,27,27,54
44256,brownie4590,,1,1,1,2
44257,xunil,,1,1,1,2
44258,Foreverbrainless,,1,2,2,4
44259,markashworth,,1,1,1,2
44260,DIGG_IS_FOX,,1,259,232,491
44261,janrito,,1,9,10,19
44262,Vzzbxx,,1,63,103,166
44263,ChrisWalsh,,1,9,15,24
44264,shenanigoat,,1,80,19,99
44265,Goose42,,1,8,2,10
44266,McCallister,,1,2,4,6
44267,bobweber,,1,2,3,5
44268,COindependent,,1,8,1,9
44269,lazyboy401,,1,1,1,2
44270,Oncey,,1,17,22,39
44271,qwentch,,1,5,1,6
44272,StarJonz,,1,1,2,3
44273,kara_zor-el,,1,3,5,8
44274,forkon,,1,1,1,2
44275,suspectdevice,,1,11,14,25
44276,woozefa,,1,2,15,17
44277,inn0,,1,8,29,37
44278,absolut696,,1,196,201,397
44279,junglelady,,1,8,15,23
44280,justsomeguy123,,1,1,1,2
44281,jharper,,1,17,10,27
44282,Hinph,,1,18,15,33
44283,mothereffingtheresa,,1,542,957,1499
44284,britesprite,,1,26,9,35
44285,cameronobscura,,1,1,4,5
44286,tomfoolery9,,1,1,1,2
44287,swift4096,,1,47,7,54
44288,pi_star,,1,7,6,13
44289,L4m3r,,1,5,3,8
44290,fyl8000,,1,2,4,6
44291,ageedoy,,1,4,9,13
44292,alexanderadp,,1,3,2,5
44293,ehwhat,,1,20,30,50
44294,Kilgore44,,1,19,6,25
44295,toothygrim,,1,2,1,3
44296,laurao16,,1,18,4,22
44297,redsteakraw,,1,1,3,4
44298,eirikso,,1,5,1,6
44299,SirCyrus,,1,20,9,29
44300,revelationary,,1,3,1,4
44301,metamorph,,1,3,4,7
44302,PendragnNERO,,1,1,3,4
44303,arturoman,,1,45,52,97
44304,dutchmcnubb1,,1,1,4,5
44305,WhinerMcWhiney,,1,1,1,2
44306,dorel,,1,98,203,301
44307,motravo,,1,69,44,113
44308,mre5765,,1,214,329,543
44309,Milton123,,1,3,13,16
44310,redditsuxx,,1,174,118,292
44311,ff4marvel,,1,21,24,45
44312,gavdoy,,1,2,1,3
44313,syntagma,,1,1,2,3
44314,Sneetches,,1,7,11,18
44315,ZoeStephenson,,1,1,1,2
44316,bobthevirus,,1,5,1,6
44317,gartca,,1,1,1,2
44318,wertyuidjj,,1,4,16,20
44319,dammage,,1,36,32,68
44320,westcoaster,,1,57,48,105
44321,rizzn,,1,2,4,6
44322,iconjack,,1,17,9,26
44323,peterhgregory,,1,43,1,44
44324,blueboy77,,1,2,2,4
44325,kyyla,,1,58,36,94
44326,lilymac76,,1,6,5,11
44327,dpetillo,,1,3,6,9
44328,repoman,,1,143,256,399
44329,WalterBright,,1,147,121,268
44330,LedFire,,1,1,3,4
44331,DougTGN,,1,23,41,64
44332,synthpop,,1,1168,852,2020
44333,BoxerBurn,,1,10,32,42
44334,jackduluoz,,1,4,2,6
44335,redditer009,,1,2,3,5
44336,beastrabban,,1,477,848,1325
44337,Cartosys,,1,20,15,35
44338,nnydarko,,1,46,79,125
44339,crickets,,1,66,72,138
44340,darkner,,1,1,1,2
44341,komodo,,1,118,35,153
44342,atlben76,,1,3,6,9
44343,sockdoll,,1,89,199,288
44344,RobertIsbell,,1,1,8,9
44345,bwilkes,,1,1,2,3
44346,ThePain,,1,43,40,83
44347,VitaliyBSD,,1,3,1,4
44348,hairstyled678,,1,1,1,2
44349,noletrain,,1,206,12,218
44350,ncbaz,,1,4,1,5
44351,ddelony1,,1,1,3,4
44352,empraptor,,1,23,45,68
44353,31d1,,1,16,13,29
44354,herbber,,1,15,21,36
44355,Red-Sox,,1,2,9,11
44356,chick1,,1,60,6,66
44357,jojoman02,,1,1,1,2
44358,Stevew123,,1,27,5,32
44359,mharriger,,1,87,44,131
44360,RedDyeNumber4,,1,1097,1259,2356
44361,charlieee,,1,7,3,10
44362,Ponches,,1,11,15,26
44363,enkid,,1,151,216,367
44364,cha0s,,1,23,38,61
44365,ctscradle08,,1,5,9,14
44366,fsagus,,1,1,4,5
44367,thebigshuck1,,1,2,2,4
44368,cameldrv,,1,15,10,25
44369,ptan1,,1,222,38,260
44370,john1973,,1,2,4,6
44371,kwaalude,,1,4,6,10
44372,fritz2,,1,3,3,6
44373,Ribonucleic,,1,44,11,55
44374,BritishLogicPolice,,1,2,1,3
44375,nix0n,,1,82,82,164
44376,Haspel,,1,2,2,4
44377,knde,,1,51,50,101
44378,imexius,,1,43,40,83
44379,danny,,1,52,79,131
44380,Burdette4,,1,14,3,17
44381,pubjames,,1,450,269,719
44382,ahare,,1,2,2,4
44383,clrwpi,,1,19,26,45
44384,uknownothing,,1,2,6,8
44385,Snork_Porkin,,1,4,4,8
44386,maelfyn,,1,197,130,327
44387,timtastic,,1,3,3,6
44388,djrocksteady,,1,64,137,201
44389,shopperchops,,1,10,20,30
44390,kakerjak,,1,4,5,9
44391,danthefourth,,1,2,2,4
44392,tehmarko,,1,5,9,14
44393,jdwpom,,1,69,125,194
44394,Irwin_Fletcher,,1,3,2,5
44395,oomlout,,1,5,2,7
44396,davebrk,,1,3,9,12
44397,rcadestaint,,1,21,47,68
44398,grandalf,,1,78,100,178
44399,no-lard,,1,13,28,41
44400,aflawinlogic,,1,4,7,11
44401,amix3k,,1,1,1,2
44402,drsubtle,,1,18,32,50
44403,Mordalfus,,1,15,8,23
44404,grime,,1,1,2,3
44405,mrwall2005,,1,1,2,3
44406,FizzBitch,,1,175,212,387
44407,sudjnabjj,,1,57,6,63
44408,prunch,,1,3,1,4
44409,Schaefer33,,1,2,2,4
44410,bk1insf,,1,25,18,43
44411,jarober61,,1,1,1,2
44412,solo_froglet,,1,2,1,3
44413,dannydale,,1,20,102,122
44414,rmc,,1,21,30,51
44415,whozurdaddy,,1,176,201,377
44416,gavalope,,1,2,5,7
44417,beeswax,,1,3,2,5
44418,WittyUsername,,1,14,32,46
44419,jvargaszabo,,1,1,11,12
44420,elmorte,,1,38,58,96
44421,KrazyA1pha,,1,39,54,93
44422,mossblaser,,1,95,182,277
44423,onceonly,,1,3,1,4
44424,00Dan,,1,7,7,14
44425,neop,,1,3,5,8
44426,inimino,,1,1,2,3
44427,corillis,,1,2,6,8
44428,wildsalmon,,1,22,9,31
44429,clarkin2,,1,21,8,29
44430,yaemes,,1,16,23,39
44431,scubaguybill,,1,10,18,28
44432,niveknhoj,,1,10,9,19
44433,philonius,,1,1,2,3
44434,arabesque911,,1,8,4,12
44435,cowgirljess,,1,5,10,15
44436,authorityaction,,1,2,1,3
44437,thing01,,1,10,9,19
44438,johnybutts,,1,1,1,2
44439,Charming_Boy,,1,1,1,2
44440,stoic,,1,10,20,30
44441,stphnclysmth,,1,80,140,220
44442,surlier,,1,3,2,5
44443,jassie,,1,49,3,52
44444,private_dumbass,,1,1,1,2
44445,BaconatedGrapefruit,,1,12,9,21
44446,smeltzertron,,1,1,1,2
44447,e8ght,,1,1,1,2
44448,ElReek,,1,2,1,3
44449,kushman,,1,23,25,48
44450,YourHero,,1,1,1,2
44451,bankonmyth,,1,6,8,14
44452,inmate8188,,1,3,4,7
44453,adewhite,,1,5,5,10
44454,Zibeltor,,1,4,4,8
44455,fouadz,,1,15,11,26
44456,alen_ribic,,1,29,8,37
44457,jokull,,1,42,40,82
44458,hoov,,1,15,19,34
44459,cl52059,,1,156,14,170
44460,mp3geek,,1,10,16,26
44461,toxicvarn90,,1,295,274,569
44462,incaseyoucare,,1,43,44,87
44463,your_father_speaking,,1,2,2,4
44464,leedaflea,,1,2,1,3
44465,cedaf,,1,7,6,13
44466,yiannis13,,1,3,1,4
44467,TortoiseT,,1,13,23,36
44468,Botim2,,1,4,37,41
44469,iusedqu1nn,,1,193,1,194
44470,ayton,,1,2,6,8
44471,danita,,1,1,8,9
44472,menrightsrights,,1,3,1,4
44473,pranavnegandhi,,1,6,5,11
44474,yoki_au,,1,134,161,295
44475,MissCoccins,,1,52,16,68
44476,pzskc383,,1,1,1,2
44477,Elsie_Sie,,1,1,2,3
44478,uninformed_reddit,,1,1,1,2
44479,ian_reddit,,1,1,3,4
44480,officerfarva,,1,5,10,15
44481,beh_aiin,,1,53,20,73
44482,happyhappyhappy,,1,68,11,79
44483,cloondog,,1,53,62,115
44484,foothompson,,1,1,2,3
44485,Oubaassehonne,,1,119,203,322
44486,sm84581,,1,6,8,14
44487,gordo_l,,1,1,4,5
44488,model_citizen,,1,6,10,16
44489,mrtrevin,,1,229,415,644
44490,tiktaalink,,1,7,20,27
44491,chia_pet,,1,6,13,19
44492,ohmytyisis,,1,10,4,14
44493,DarkEyedGirl,,1,2,1,3
44494,sarevok9,,1,159,152,311
44495,SevRogers,,1,3,12,15
44496,cheics,,1,1,5,6
44497,Kellster,,1,14,7,21
44498,lou,,1,71,103,174
44499,EhScuzi,,1,5,7,12
44500,gvol,,1,3,8,11
44501,Drevor,,1,187,135,322
44502,chz,,1,69,73,142
44503,magnus,,1,3,15,18
44504,namelessone,,1,1,1,2
44505,theundersigned,,1,63,87,150
44506,ohyeaaah,,1,2,2,4
44507,IncurvatusInSe,,1,1,1,2
44508,cometoloveseeing,,1,21,22,43
44509,iLens,,1,6,15,21
44510,NightChips,,1,4,4,8
44511,donbueno,,1,326,415,741
44512,ICOrthogonal,,1,34,26,60
44513,psilokan,,1,61,115,176
44514,garg,,1,1081,954,2035
44515,yamshi,,1,61,126,187
44516,SteveBloke,,1,1,1,2
44517,neportocala,,1,13,3,16
44518,Crafts,,1,29,43,72
44519,tactics,,1,306,463,769
44520,onesun43,,1,14,4,18
44521,nickburlett,,1,50,18,68
44522,batgirl007,,1,31,1,32
44523,ripsta,,1,198,240,438
44524,kaosfere,,1,161,129,290
44525,neoprenewidget,,1,16,32,48
44526,cpepinc,,1,1,6,7
44527,stopit,,1,185,171,356
44528,skeptilingus,,1,5,4,9
44529,GunTech,,1,5,2,7
44530,kolektiv,,1,10,17,27
44531,mabbikeel,,1,1,3,4
44532,HawkHawkGoose,,1,1,1,2
44533,mushpuppy,,1,138,264,402
44534,omglazers,,1,152,255,407
44535,okidokedork,,1,42,42,84
44536,pindooca,,1,1,3,4
44537,voodoobru,,1,1,1,2
44538,jacodt,,1,5,1,6
44539,QuinnFazigu,,1,222,363,585
44540,Tallon,,1,99,90,189
44541,TGMais,,1,156,239,395
44542,christpunchers,,1,142,111,253
44543,superman101,,1,1,3,4
44544,lol-dongs,,1,180,155,335
44545,uteunawaytay,,1,1580,2721,4301
44546,k-h,,1,11,18,29
44547,esquimaux73,,1,3,4,7
44548,rossto,,1,74,88,162
44549,stelly,,1,1,1,2
44550,tyham,,1,16,24,40
44551,austin356,,1,46,2,48
44552,tjangaard,,1,13,1,14
44553,zagaberoo,,1,4,19,23
44554,TehOompa,,1,8,8,16
44555,SamIyam,,1,42,30,72
44556,eckle,,1,1,1,2
44557,zingbat,,1,1,3,4
44558,fonik,,1,12,26,38
44559,avatar382,,1,1,1,2
44560,konkeydong,,1,105,172,277
44561,storyuk,,1,10,6,16
44562,zwaldowski,,1,215,325,540
44563,canadug,,1,134,117,251
44564,SvendOlaf,,1,1,1,2
44565,SpaceInvadingMonkeys,,1,43,62,105
44566,SeeZee,,1,3,2,5
44567,jonny_boy27,,1,2,1,3
44568,fjsdakfl,,1,6,11,17
44569,darkbeanie,,1,34,59,93
44570,paintist,,1,114,159,273
44571,redobsess,,1,3,4,7
44572,arachnd,,1,15,23,38
44573,ReligionOfPeace,,1,310,977,1287
44574,Aeropike2011,,1,1,1,2
44575,faderus,,1,108,77,185
44576,gabrielsburg,,1,6,6,12
44577,Moelman,,1,4,1,5
44578,shocs,,1,99,16,115
44579,milos31,,1,223,3,226
44580,podbaydoor,,1,1,1,2
44581,peanut42,,1,34,33,67
44582,Cazaquistao,,1,1,1,2
44583,chuyeow,,1,3,2,5
44584,z0manifest,,1,2,11,13
44585,Faceface,,1,7,15,22
44586,OrMaybe,,1,3,4,7
44587,robato,,1,4,5,9
44588,Radoman,,1,523,344,867
44589,chrizel,,1,33,21,54
44590,threethousandgt,,1,6,11,17
44591,lizzydoodle,,1,11,19,30
44592,hillary2014,,1,1,1,2
44593,MoreInStore,,1,42,47,89
44594,Sarahelca,,1,2,1,3
44595,stickboy144,,1,4,9,13
44596,eldumbasso,,1,2,3,5
44597,bigfoot17,,1,2,4,6
44598,telemkor,,1,35,7,42
44599,Pamphleteer,,1,94,102,196
44600,jayhawk03,,1,4,3,7
44601,Dug565,,1,1,1,2
44602,jmoore63,,1,36,1,37
44603,Pipliest,,1,4,6,10
44604,landryraccoon,,1,7,11,18
44605,scaredofbears,,1,46,72,118
44606,scioglilingua,,1,1,2,3
44607,smug_faced_crowd,,1,10,14,24
44608,abalashov,,1,1,1,2
44609,artimaeis,,1,19,28,47
44610,texaspaid,,1,29,49,78
44611,hep516,,1,1,3,4
44612,taraist,,1,28,41,69
44613,sporrow,,1,106,76,182
44614,audiored,,1,53,95,148
44615,smellotron,,1,28,54,82
44616,craigiest,,1,28,18,46
44617,indieandy,,1,31,41,72
44618,markastafford,,1,1,2,3
44619,valardur,,1,11,25,36
44620,HugeRedBear,,1,7,6,13
44621,ijostl,,1,3,4,7
44622,runtheplacered,,1,7,7,14
44623,bumbledraven,,1,2,3,5
44624,shane111,,1,2,1,3
44625,crazyape123,,1,2,2,4
44626,boblol123,,1,61,44,105
44627,bopolissimus,,1,1,3,4
44628,misterstormcrow,,1,145,203,348
44629,lineer,,1,6,2,8
44630,subredditor,,1,143,156,299
44631,ApathyVsRadicalism,,1,1,3,4
44632,ventomareiro,,1,19,23,42
44633,duyn,,1,15,11,26
44634,alanVolta,,1,1,2,3
44635,littlegreenwheels,,1,2,2,4
44636,loveandlight,,1,132,232,364
44637,TheColonel,,1,1220,1487,2707
44638,Ivatar,,1,2,3,5
44639,roberto1,,1,2,6,8
44640,jespeach,,1,8,14,22
44641,serenader,,1,4,10,14
44642,llnk,,1,15,24,39
44643,BigBladder,,1,1,1,2
44644,McSly,,1,27,34,61
44645,vandahm,,1,9,11,20
44646,jrhuggins,,1,22,33,55
44647,easymovet,,1,9,12,21
44648,danbiking,,1,13,7,20
44649,railk,,1,4,5,9
44650,fucking_god,,1,1,1,2
44651,seliopou,,1,46,25,71
44652,zenphp,,1,5,6,11
44653,Claymore_ws,,1,18,13,31
44654,jossmyth,,1,12,1,13
44655,monk_e_boy,,1,50,60,110
44656,mkr,,1,5,5,10
44657,jbcrail,,1,16,1,17
44658,markovich04,,1,1,3,4
44659,Junior77,,1,123,33,156
44660,LaffyTaffyWrapper,,1,1,2,3
44661,monsda,,1,283,330,613
44662,Gordon_Shumway,,1,72,98,170
44663,scorched03,,1,1,3,4
44664,emkay,,1,66,7,73
44665,marhathoda,,1,100,142,242
44666,Macoo,,1,1,2,3
44667,jkhatter12,,1,3,2,5
44668,sundog1973,,1,10,8,18
44669,reesmaxwell,,1,2,1,3
44670,The_Rectifier,,1,15,35,50
44671,Lizaarrd,,1,2,2,4
44672,yogy,,1,2,3,5
44673,2Tech,,1,8,6,14
44674,JordanOnSports,,1,2,1,3
44675,sumerit,,1,28,71,99
44676,ahmara,,1,17,1,18
44677,blufox,,1,4,9,13
44678,DeathToTheSystem,,1,1,2,3
44679,vanderhuge,,1,19,14,33
44680,jack_alexander,,1,1610,709,2319
44681,mama-mia,,1,2,1,3
44682,shopvavavoom,,1,16,11,27
44683,redditex,,1,5,4,9
44684,Roach55,,1,131,192,323
44685,LessThan3,,1,29,47,76
44686,morefioo,,1,24,1,25
44687,skerlo,,1,1,1,2
44688,phillstac3,,1,297,350,647
44689,greenearthbuild,,1,1,2,3
44690,TJ11240,,1,82,28,110
44691,pkrumins,,1,1381,433,1814
44692,RogueCoder,,1,34,69,103
44693,toaster_fun,,1,166,107,273
44694,tony1kenobi,,1,2,5,7
44695,aschapm,,1,86,111,197
44696,irishjayhawk,,1,9,7,16
44697,ALLGLORYTOHYPNOTOAD,,1,1,1,2
44698,toodor,,1,1,1,2
44699,tora,,1,3,1,4
44700,tflash2612,,1,2,1,3
44701,aeneas07,,1,7,4,11
44702,bemo56,,1,27,66,93
44703,spider_monkey,,1,2,6,8
44704,tlhorset,,1,3,1,4
44705,BroDavii,,1,224,341,565
44706,Amendmen7,,1,140,198,338
44707,born4thesurf,,1,77,29,106
44708,nicholaihel,,1,3,1,4
44709,hibyefriend,,1,4,8,12
44710,basil_seal,,1,13,37,50
44711,assortednut,,1,21,43,64
44712,sharpsight2,,1,255,422,677
44713,devperson,,1,7,26,33
44714,notarebel,,1,30,20,50
44715,militant,,1,357,462,819
44716,SocialSandwich,,1,19,14,33
44717,rhesus48,,1,2,4,6
44718,bob401,,1,4,5,9
44719,wuger,,1,4,6,10
44720,HumanSockPuppet,,1,286,384,670
44721,mezziah,,1,14,38,52
44722,masterstephen,,1,1,1,2
44723,sooner_bluff,,1,2,2,4
44724,highstead,,1,94,132,226
44725,volomike,,1,59,87,146
44726,godwheel,,1,9,1,10
44727,red40,,1,1,1,2
44728,1Marc,,1,2,1,3
44729,elegylegacy,,1,28,33,61
44730,hrung,,1,60,64,124
44731,i_am_insane,,1,12,21,33
44732,sagewah,,1,2,6,8
44733,garethkeenan,,1,105,141,246
44734,scaryberry,,1,3,1,4
44735,puck342,,1,1,2,3
44736,whatevs,,1,1,1,2
44737,pej,,1,1,3,4
44738,Just_Jonny,,1,1,1,2
44739,joel_osteen,,1,7,11,18
44740,__wxc__,,1,1,1,2
44741,wasdwasd,,1,2,5,7
44742,alexdelattre,,1,1,1,2
44743,ForgToor,,1,1,1,2
44744,JohnJYates,,1,1,1,2
44745,dynebolik,,1,1,1,2
44746,garyr_h,,1,707,826,1533
44747,fade911,,1,4,10,14
44748,fleece,,1,60,102,162
44749,sassthis,,1,2,4,6
44750,RonningPaul,,1,21,7,28
44751,fuzzythinker,,1,1,1,2
44752,holygoat,,1,59,141,200
44753,Tack122,,1,287,446,733
44754,rishmish,,1,27,15,42
44755,xethus,,1,8,10,18
44756,Mephisto_,,1,2,4,6
44757,photobasement,,1,1,1,2
44758,superpop,,1,9,11,20
44759,JoePrey,,1,83,101,184
44760,wrongsideup,,1,4,13,17
44761,48522,,1,8,10,18
44762,bob301,,1,12,18,30
44763,teddywookie,,1,1,2,3
44764,Casey-Tech,,1,4,3,7
44765,concious,,1,1,2,3
44766,crellis,,1,2,5,7
44767,chr0nic21,,1,11,17,28
44768,rakeswell,,1,6,4,10
44769,brianhammond,,1,2,1,3
44770,imdead,,1,1,1,2
44771,tas783,,1,4,3,7
44772,what_in_tarnations,,1,2,1,3
44773,FireBred,,1,5,9,14
44774,sorrydaijin,,1,20,29,49
44775,aussiegolfer,,1,184,301,485
44776,eclipsegum,,1,7,9,16
44777,God8myhomework,,1,255,410,665
44778,ajwest,,1,201,114,315
44779,tncdavid,,1,1,1,2
44780,sybrandy,,1,2,5,7
44781,syoung,,1,23,28,51
44782,robbies531,,1,18,34,52
44783,Ewong,,1,38,16,54
44784,flug32,,1,20,18,38
44785,emorockstar,,1,6,5,11
44786,LEE4,,1,2,1,3
44787,kagey61,,1,2,9,11
44788,1995,,1,1,1,2
44789,kirilll7,,1,3,3,6
44790,tholex,,1,93,82,175
44791,DevTopics,,1,45,3,48
44792,shizitz,,1,5,3,8
44793,CommandPrompt,,1,14,27,41
44794,skynex66,,1,1,1,2
44795,savona,,1,3,3,6
44796,6StringSam,,1,6,1,7
44797,seanimal,,1,2,1,3
44798,bushwacker,,1,3,7,10
44799,waynepwr,,1,436,69,505
44800,greywolf31,,1,9,11,20
44801,dorotixel,,1,27,3,30
44802,poeblu,,1,6,11,17
44803,naska,,1,229,163,392
44804,degron,,1,12,18,30
44805,mynamewastaken,,1,1,4,5
44806,Splatterhouse,,1,63,105,168
44807,arronsky,,1,46,17,63
44808,revdroog,,1,30,43,73
44809,wildnaresh,,1,1,6,7
44810,pro547,,1,8,8,16
44811,aaminics,,1,7,16,23
44812,kismet,,1,49,39,88
44813,amafukwit,,1,14,48,62
44814,greediculous,,1,1,3,4
44815,hatchington,,1,108,138,246
44816,plup,,1,46,79,125
44817,michaelrush,,1,3,2,5
44818,Scrumb,,1,2,4,6
44819,abends,,1,9,26,35
44820,mugen612,,1,24,53,77
44821,BlueRenner,,1,54,57,111
44822,davidpack,,1,132,50,182
44823,skippygrrl,,1,30,7,37
44824,elpres,,1,42,2,44
44825,justatempaccount,,1,1,1,2
44826,Brock-O,,1,4,2,6
44827,Tony2Nice,,1,1,1,2
44828,allmybase,,1,9,7,16
44829,thirwell,,1,2,28,30
44830,SurpriseButtsex,,1,11,13,24
44831,swombat,,1,94,90,184
44832,soaringeagle,,1,16,13,29
44833,crackduck,,1,603,798,1401
44834,badbrains,,1,5,6,11
44835,pranksterturtle,,1,19,38,57
44836,brianatee,,1,4,1,5
44837,ethereel,,1,1,3,4
44838,lezardbreton,,1,2,2,4
44839,myotheredditaccount,,1,2,2,4
44840,titebuds,,1,3,8,11
44841,cansbunsandpins,,1,17,42,59
44842,eugeneloanguy,,1,1,2,3
44843,dipset,,1,2,1,3
44844,iKs279,,1,1,2,3
44845,e2mtt,,1,2,1,3
44846,kyki,,1,11,15,26
44847,ebow,,1,2,5,7
44848,bohogirl1,,1,34,83,117
44849,nedkelly136,,1,1,1,2
44850,democrat69,,1,1,1,2
44851,time4dancing80,,1,6,1,7
44852,winterflower,,1,1,1,2
44853,kkkjkjj,,1,7,14,21
44854,tow,,1,1,1,2
44855,Tchortle,,1,4,1,5
44856,cosmopolos,,1,19,6,25
44857,TarBurger,,1,3,6,9
44858,groomy,,1,10,1,11
44859,effigies,,1,87,148,235
44860,lispm,,1,142,196,338
44861,pandaeraser,,1,1,4,5
44862,DiamondGFX,,1,10,5,15
44863,pvrogue,,1,2,4,6
44864,bozena,,1,17,9,26
44865,kpw1179,,1,102,95,197
44866,nifs,,1,1,1,2
44867,mattius,,1,92,34,126
44868,I_Supply_Facts,,1,9,11,20
44869,Hussell,,1,1,4,5
44870,greydit,,1,5,9,14
44871,atrommer,,1,31,64,95
44872,arsefeckdrink,,1,2,3,5
44873,chuckieduckie,,1,2,7,9
44874,phisherben,,1,36,74,110
44875,essie,,1,31,92,123
44876,ObieJazz,,1,13,21,34
44877,roxya,,1,2,3,5
44878,amblin,,1,3,8,11
44879,duckandcover,,1,1,1,2
44880,apostre,,1,2,1,3
44881,RevHalofan,,1,39,48,87
44882,dailymoolah,,1,1,1,2
44883,BadFurDay,,1,59,63,122
44884,ristretto_dreams,,1,6,9,15
44885,Niek,,1,4,1,5
44886,groanad,,1,4,13,17
44887,Banko,,1,157,223,380
44888,icegrillz,,1,2,8,10
44889,SenorAnderson,,1,1,5,6
44890,wrttnwrd,,1,2,1,3
44891,moss,,1,8,13,21
44892,alcoholiday,,1,3,7,10
44893,justindrake,,1,2,3,5
44894,neutronium,,1,2,7,9
44895,rhedwolf,,1,32,46,78
44896,Klarkshroder,,1,2,1,3
44897,Prometheusx,,1,18,20,38
44898,Im-postle-able,,1,22,16,38
44899,UPMODDED,,1,3,4,7
44900,KurtP,,1,51,55,106
44901,bixby1,,1,264,40,304
44902,bjarte77,,1,24,9,33
44903,matefactor,,1,44,23,67
44904,andibabi,,1,37,74,111
44905,trader_dave,,1,1,1,2
44906,TheGambit,,1,132,14,146
44907,martinshiver,,1,1,1,2
44908,noseguy,,1,35,56,91
44909,goodness,,1,150,204,354
44910,peon1234,,1,18,46,64
44911,maxie7482,,1,11,8,19
44912,jgentgesdo,,1,1,2,3
44913,MotherNature,,1,2,2,4
44914,chimobayo,,1,36,72,108
44915,bobthejanitor,,1,6,3,9
44916,afallucco,,1,7,24,31
44917,libs0n,,1,17,22,39
44918,barrybe,,1,85,100,185
44919,ralfonso,,1,1,4,5
44920,kittyhawkstyle,,1,2,1,3
44921,ErikCartman,,1,10,15,25
44922,reddypasta,,1,132,206,338
44923,esnible,,1,5,8,13
44924,fdsfas13,,1,2,4,6
44925,andrewkhui,,1,2,5,7
44926,Ja1GuRuD3Va0m,,1,87,63,150
44927,Eever,,1,3,5,8
44928,zarrobot,,1,14,22,36
44929,Anotherbrick,,1,3,21,24
44930,lisperama,,1,1,1,2
44931,ipinkus,,1,4,8,12
44932,shimrit,,1,178,101,279
44933,AllenJB83,,1,9,16,25
44934,loefflerorama,,1,20,30,50
44935,jeltzz,,1,4,3,7
44936,EmbarassingStory,,1,1,1,2
44937,scobrown,,1,1,2,3
44938,snottynose,,1,2,3,5
44939,achille,,1,11,7,18
44940,ebswift,,1,2,1,3
44941,KaBlammoBoom,,1,24,5,29
44942,thoand,,1,2,4,6
44943,ctkrohn,,1,7,8,15
44944,RickRoll,,1,12,16,28
44945,AbbasJin,,1,31,31,62
44946,SearchRank,,1,10,4,14
44947,o0o,,1,173,398,571
44948,h4mrtime,,1,1,1,2
44949,e1eventh,,1,6,4,10
44950,psionicken,,1,13,11,24
44951,lalop,,1,190,229,419
44952,GuruOfReason,,1,5,2,7
44953,fredsanford,,1,4,3,7
44954,warp,,1,2,1,3
44955,fivestarsoul,,1,43,89,132
44956,nosocks,,1,14,27,41
44957,harveymushman,,1,8,9,17
44958,ordord00,,1,2,1,3
44959,mcao,,1,8,7,15
44960,allantanusa,,1,1,1,2
44961,petepete,,1,52,89,141
44962,itzhero,,1,12,5,17
44963,BovingdonBug,,1,21,54,75
44964,dur23,,1,64,128,192
44965,TehLockes,,1,8,15,23
44966,desultir,,1,28,14,42
44967,rmac54,,1,4,6,10
44968,Solitarian,,1,3,18,21
44969,MPankau,,1,2,3,5
44970,lynn,,1,507,854,1361
44971,garys,,1,5,1,6
44972,martey,,1,2,1,3
44973,yuhndke,,1,1,1,2
44974,bnmathm,,1,156,116,272
44975,hahahahahaha,,1,36,43,79
44976,apocalip,,1,3,2,5
44977,Entropy_,,1,6,7,13
44978,baraka-,,1,1,1,2
44979,sal139,,1,2,1,3
44980,afrojap,,1,4,13,17
44981,indigosin8,,1,269,338,607
44982,greedo,,1,12,21,33
44983,stevehussein,,1,1,1,2
44984,havig,,1,1,3,4
44985,J0nes,,1,1,4,5
44986,LeviNovey,,1,151,4,155
44987,AlLnAtuRalX,,1,242,140,382
44988,LETMESHOWU,,1,69,86,155
44989,doomrabbit,,1,16,30,46
44990,thatch,,1,350,37,387
44991,ChurchHatesTucker,,1,19,53,72
44992,chaschas,,1,5,1,6
44993,myhand,,1,3,3,6
44994,POTUS,,1,20,24,44
44995,chmod777,,1,23,51,74
44996,SuperSneaks,,1,7,10,17
44997,psogle,,1,1946,222,2168
44998,IronWolve,,1,294,441,735
44999,tomfaulhaber,,1,1,1,2
45000,Occulus,,1,1,1,2
45001,anttirt,,1,45,69,114
45002,Decados,,1,3,6,9
45003,aparrish1,,1,1,1,2
45004,disaster_area45,,1,61,64,125
45005,thebm,,1,46,45,91
45006,generic_user1,,1,4,23,27
45007,dr_landrew_5,,1,15,5,20
45008,steve1673,,1,1,1,2
45009,joe_ally,,1,10,21,31
45010,kingbenny,,1,33,64,97
45011,mooted,,1,6,10,16
45012,lowmagnet,,1,8,22,30
45013,sockpuppy,,1,25,16,41
45014,ktan12,,1,6,16,22
45015,PaulThomas87,,1,38,16,54
45016,papabear420,,1,1,4,5
45017,fmota,,1,117,167,284
45018,Marauder,,1,8,8,16
45019,ahabeger,,1,5,14,19
45020,johnnywatkins,,1,432,49,481
45021,HeavyFed,,1,1,1,2
45022,Mark_Logan,,1,53,59,112
45023,iggle2,,1,7,8,15
45024,vinnl,,1,20,12,32
45025,crocafella,,1,1,1,2
45026,ludwig1024,,1,164,286,450
45027,circulate,,1,146,77,223
45028,changwufei801,,1,1,1,2
45029,rate-my-annoyingness,,1,66,156,222
45030,johnjannotti,,1,1,2,3
45031,soylent_spam,,1,2,2,4
45032,sinope,,1,2,1,3
45033,ashmodai,,1,227,397,624
45034,bartel,,1,4,16,20
45035,rmuser,,1,9335,1668,11003
45036,danteembermage,,1,21,19,40
45037,Skippy989,,1,4,3,7
45038,moderater,,1,3,7,10
45039,Philll,,1,17,12,29
45040,Sourcefor,,1,17,16,33
45041,kiffy,,1,4,8,12
45042,Orolokarr,,1,81,93,174
45043,h0dg3s,,1,1828,3405,5233
45044,Sunday_Bunday,,1,14,4,18
45045,Baramin,,1,18,21,39
45046,kirwenj,,1,1,1,2
45047,haydukelives,,1,90,160,250
45048,yaxriifgyn,,1,33,70,103
45049,patticus,,1,3,8,11
45050,gustavl,,1,4,1,5
45051,camilleamber,,1,4,5,9
45052,ziptiespec,,1,6,1,7
45053,pseudologue,,1,17,17,34
45054,BubbaJimbo,,1,78,157,235
45055,leverne,,1,1,7,8
45056,robconery,,1,1,1,2
45057,gmbel,,1,379,158,537
45058,caled,,1,69,51,120
45059,tortus,,1,229,226,455
45060,humbleboaster,,1,20,71,91
45061,Tony_F_Reaves,,1,1,5,6
45062,firepunk,,1,289,414,703
45063,reddiculous,,1,33,19,52
45064,hgsfgx,,1,3,1,4
45065,digital19,,1,116,257,373
45066,theyguru,,1,2,2,4
45067,sverrejoh,,1,12,8,20
45068,sbchapm,,1,36,44,80
45069,astaboy,,1,1,2,3
45070,mindkiller317,,1,60,84,144
45071,bvttf,,1,3,6,9
45072,helot,,1,28,10,38
45073,rhamphoryncus,,1,2,5,7
45074,oceansize,,1,1,2,3
45075,abrielle36991,,1,1,1,2
45076,dwm1129,,1,129,5,134
45077,TheMilkMen,,1,1,2,3
45078,ameo,,1,575,113,688
45079,southswellsurfer,,1,3,1,4
45080,dooglesan,,1,52,45,97
45081,patoh,,1,3,5,8
45082,TheGrammarBolshevik,,1,172,307,479
45083,bennybenners,,1,81,174,255
45084,alragusa,,1,16,24,40
45085,saturn_lad,,1,1,1,2
45086,abramN,,1,4,10,14
45087,DaveDragon,,1,21,64,85
45088,raubry,,1,107,258,365
45089,CaseyCCC,,1,14,29,43
45090,McGarnacle,,1,5,16,21
45091,broadcloak,,1,10,25,35
45092,bigflexy,,1,59,99,158
45093,mechanical_marksy,,1,1,1,2
45094,Jigz,,1,11,29,40
45095,AnthonyInsanity,,1,2,3,5
45096,econnally,,1,1,1,2
45097,screenname,,1,24,30,54
45098,prophet3point0,,1,4,3,7
45099,elija_craig,,1,35,49,84
45100,bredren,,1,62,9,71
45101,mrsinkieminstrel,,1,4,8,12
45102,sulayman,,1,11,4,15
45103,nyc_guy_57,,1,1,1,2
45104,Zorkblat,,1,81,2,83
45105,tolland,,1,10,14,24
45106,daole,,1,8,15,23
45107,jmzhodge,,1,43,12,55
45108,bgeron,,1,83,103,186
45109,apexaviour,,1,5,7,12
45110,raywert,,1,5,4,9
45111,helm,,1,187,350,537
45112,blaquebile,,1,6,3,9
45113,rickmatt,,1,357,86,443
45114,queenmoweeny,,1,194,63,257
45115,Oreyn,,1,7,9,16
45116,biwook,,1,75,10,85
45117,barlaam,,1,183,11,194
45118,sesquipedalian,,1,1,6,7
45119,neocons,,1,15,50,65
45120,elk67,,1,5,11,16
45121,waml,,1,2,2,4
45122,jackoffsky,,1,1,1,2
45123,RedditGirlfriend,,1,14,1,15
45124,justkaren,,1,3,2,5
45125,josiahq,,1,20,14,34
45126,headdesk,,1,10,34,44
45127,LawlingFenix,,1,6,4,10
45128,Bluur,,1,90,76,166
45129,ig1,,1,83,25,108
45130,drew6r19,,1,9,2,11
45131,BobGaffney,,1,1197,1712,2909
45132,zoopzoopzoop,,1,1,1,2
45133,gt1329a,,1,6,9,15
45134,g33kfu,,1,3,4,7
45135,sw17ch,,1,330,400,730
45136,caseinpoint,,1,4,1,5
45137,nihilogic,,1,1,1,2
45138,SpecialKlvl23,,1,317,131,448
45139,Nate_W,,1,398,464,862
45140,MMX,,1,85,83,168
45141,bgholt1970,,1,1136,86,1222
45142,Relativity2,,1,18,51,69
45143,dubdub2,,1,5,1,6
45144,aennil,,1,213,326,539
45145,dodos,,1,10,11,21
45146,tayto,,1,41,49,90
45147,dearabby,,1,23,19,42
45148,boghani,,1,8,21,29
45149,blackbow,,1,2,11,13
45150,C0FFEE,,1,1,1,2
45151,max3o6,,1,4,1,5
45152,bammbamm85,,1,4,6,10
45153,ButtScratcher,,1,47,54,101
45154,knotweed,,1,3,1,4
45155,mgv64,,1,45,76,121
45156,Lylepalooza,,1,7,6,13
45157,kmi187,,1,33,62,95
45158,to_play_us_out,,1,12,20,32
45159,jdcollins,,1,31,77,108
45160,sheeprevolution,,1,744,1222,1966
45161,severeon,,1,1,1,2
45162,varodan,,1,5,10,15
45163,dropkickninja,,1,12,27,39
45164,Hi1202,,1,1,1,2
45165,TomSwirly,,1,75,87,162
45166,fthead9,,1,74,6,80
45167,mbesh,,1,1,3,4
45168,adpowers,,1,3,4,7
45169,Wenix,,1,14,22,36
45170,grogan,,1,5,1,6
45171,arkanes,,1,3,4,7
45172,orthogonality,,1,505,550,1055
45173,twotime,,1,222,259,481
45174,lpxxfaintxx,,1,145,39,184
45175,someguyatwork,,1,3,6,9
45176,Histrel,,1,15,44,59
45177,notsol337,,1,1,1,2
45178,Sp00ns,,1,6,9,15
45179,Kid97GTS,,1,2,6,8
45180,headinthegame,,1,14,2,16
45181,slider527,,1,1,1,2
45182,kancgab,,1,1,1,2
45183,tjwarren,,1,2,2,4
45184,dr_eiff,,1,5,2,7
45185,deathofregret,,1,33,26,59
45186,seertaak,,1,1,2,3
45187,egearman,,1,8,11,19
45188,nkuvu,,1,66,95,161
45189,dduong16,,1,30,2,32
45190,rjrebel75,,1,1,2,3
45191,endofworld,,1,382,552,934
45192,raymyers,,1,5,16,21
45193,Facepunch,,1,144,12,156
45194,coc,,1,26,40,66
45195,DavidDuke,,1,1,2,3
45196,syn-,,1,1,1,2
45197,furry8,,1,757,805,1562
45198,lagomorph,,1,5,4,9
45199,Oculus,,1,3,1,4
45200,RyGuyX,,1,1,1,2
45201,chetansastry,,1,3,5,8
45202,wtjones,,1,54,107,161
45203,jscipione,,1,3,2,5
45204,coachz,,1,3,6,9
45205,libertariangenius,,1,1,4,5
45206,MrTea,,1,1,12,13
45207,LukeHoersten,,1,11,4,15
45208,iSpeakMyMind,,1,9,19,28
45209,jamess,,1,1,1,2
45210,findyourownpath,,1,15,12,27
45211,wbendick,,1,206,86,292
45212,Chimpelol,,1,25,26,51
45213,svdasein,,1,11,18,29
45214,MrCalifornia,,1,279,144,423
45215,jlt6666,,1,2,7,9
45216,kindoblue,,1,5,1,6
45217,r3publik,,1,1,2,3
45218,shazzam,,1,37,59,96
45219,poortiming,,1,38,14,52
45220,anotherusername2,,1,8,10,18
45221,redbo,,1,48,66,114
45222,mrmacdude,,1,1,1,2
45223,redb2112,,1,6,4,10
45224,Boner,,1,3,3,6
45225,Raithlin,,1,49,3,52
45226,kloidster,,1,1,1,2
45227,rymaster,,1,13,5,18
45228,TheOnlyInvictus,,1,12,16,28
45229,TunnelingHorror,,1,11,1,12
45230,AMerrickanGirl,,1,2161,2121,4282
45231,SassyPants,,1,1,1,2
45232,equark,,1,4,4,8
45233,deckone,,1,4,4,8
45234,wootup,,1,192,54,246
45235,BillC,,1,1,1,2
45236,corporatehuman,,1,59,52,111
45237,nugwin,,1,1,4,5
45238,ajslamka,,1,3,7,10
45239,blinkin,,1,535,108,643
45240,ddfreedom,,1,159,259,418
45241,muneeeeeb,,1,2,1,3
45242,sedeas,,1,1,1,2
45243,anonymous_hero,,1,66,120,186
45244,livingimpaired,,1,385,233,618
45245,heya,,1,1,1,2
45246,madcow44820,,1,67,115,182
45247,prockcore,,1,357,372,729
45248,SummerGlau,,1,25,13,38
45249,graysilver,,1,33,34,67
45250,niks1101,,1,3,4,7
45251,VerbalRadiation,,1,10,9,19
45252,bewareofratnesh,,1,10,3,13
45253,luffs,,1,26,15,41
45254,harrybozack,,1,132,154,286
45255,casspa,,1,29,13,42
45256,mrpitt,,1,1,3,4
45257,greenanji,,1,17,30,47
45258,PstScrpt,,1,1,5,6
45259,kibbutz,,1,6,9,15
45260,radient,,1,3,4,7
45261,cxp,,1,1,1,2
45262,jehiah,,1,2,1,3
45263,tmn4,,1,18,11,29
45264,freun989,,1,2,3,5
45265,oumerisha,,1,7,4,11
45266,bccThis,,1,7,20,27
45267,lda,,1,5,1,6
45268,eddy_42,,1,3,3,6
45269,umbrae,,1,130,194,324
45270,jesskat,,1,49,108,157
45271,dedalist,,1,16,6,22
45272,skippy,,1,12,20,32
45273,randomcharacters123,,1,6,35,41
45274,GreetingsADM,,1,4,3,7
45275,savedarfurcoalition,,1,2,1,3
45276,BurnTees,,1,159,192,351
45277,KernelViolator,,1,2,10,12
45278,addie25,,1,322,60,382
45279,Santos_L_Halper,,1,146,204,350
45280,skx,,1,2,6,8
45281,retsoced,,1,1,2,3
45282,SkaakS,,1,5,1,6
45283,darceygrey,,1,74,11,85
45284,pbaehr,,1,2,3,5
45285,binary,,1,77,56,133
45286,flavanol,,1,4,6,10
45287,WhereIsCheney,,1,1,2,3
45288,MaverickDesign,,1,33,1,34
45289,planetmatt,,1,24,43,67
45290,unreal0500,,1,2,1,3
45291,skorpan,,1,8,23,31
45292,balachthon,,1,9,15,24
45293,adsk,,1,1,1,2
45294,ator_fighting_eagle,,1,46,56,102
45295,daRoach,,1,81,153,234
45296,witt,,1,68,68,136
45297,AnotherGeek,,1,3,2,5
45298,mzitt11,,1,5,1,6
45299,Adumbrations,,1,12,12,24
45300,amitch56,,1,82,67,149
45301,dcatts,,1,9,15,24
45302,ivdkleyn,,1,37,12,49
45303,sriraminhell,,1,16,5,21
45304,chicagojacobs,,1,2,1,3
45305,vitummedicinus,,1,433,243,676
45306,CaptainMidnight,,1,26,12,38
45307,destino,,1,1,1,2
45308,explodingwumpus,,1,1,4,5
45309,Illah,,1,189,161,350
45310,msdesireeg,,1,741,949,1690
45311,freeyourcrt,,1,15,12,27
45312,silout,,1,116,68,184
45313,workroom,,1,199,229,428
45314,PatonLewis,,1,14,28,42
45315,juggrnaut,,1,1,1,2
45316,obsidian468,,1,363,507,870
45317,jal648,,1,3,2,5
45318,ratbert,,1,40,74,114
45319,cloud4197,,1,136,251,387
45320,Richeh,,1,631,1046,1677
45321,dabizi,,1,299,438,737
45322,rbnfsh,,1,74,56,130
45323,drshortyd,,1,2,8,10
45324,argggh,,1,7,9,16
45325,knuckboy,,1,7,24,31
45326,Whoopsii,,1,2,1,3
45327,Steve9852,,1,14,10,24
45328,Prozn,,1,14,16,30
45329,vacantmentality,,1,1,1,2
45330,curlytree,,1,6,3,9
45331,asdyt,,1,2,5,7
45332,glickman,,1,1,1,2
45333,gnarled,,1,1,5,6
45334,anescient,,1,530,658,1188
45335,uiopzxcv,,1,2,4,6
45336,kschaller,,1,4,6,10
45337,used2digg,,1,78,81,159
45338,DarkJesus,,1,1,2,3
45339,astonished,,1,9,1,10
45340,euccastro,,1,6,10,16
45341,asfhgfa,,1,4,6,10
45342,l2daless,,1,9,23,32
45343,ikazuchi,,1,4,3,7
45344,JaySherman,,1,3,3,6
45345,yuropeen,,1,117,52,169
45346,champs,,1,19,2,21
45347,NullAndVoid,,1,2,2,4
45348,nastynafki,,1,5,4,9
45349,Sparkles,,1,6,10,16
45350,AngryDuck,,1,30,23,53
45351,chunkypunkyboy,,1,32,47,79
45352,Gadianton,,1,5,10,15
45353,rvt,,1,7,1,8
45354,traviserickson,,1,2,4,6
45355,Mommar,,1,2,1,3
45356,tomrwest15,,1,1,1,2
45357,occelot,,1,40,21,61
45358,KaZaDuum,,1,2,1,3
45359,gumitdead,,1,1,2,3
45360,Danceswithwires,,1,15,25,40
45361,OneAndOnlySnob,,1,254,363,617
45362,fuf,,1,58,67,125
45363,Soniji,,1,248,4,252
45364,StevenHodson,,1,49,1,50
45365,alanp,,1,8,2,10
45366,DoctorSlump,,1,2,5,7
45367,tom83,,1,6,10,16
45368,NoahSwayne,,1,101,24,125
45369,holysocks,,1,301,424,725
45370,steady_str,,1,21,40,61
45371,zcbyrnes,,1,1,1,2
45372,berne,,1,3,2,5
45373,hokkos,,1,92,90,182
45374,Pootzen,,1,13,7,20
45375,p_o,,1,3,5,8
45376,haiduz,,1,451,511,962
45377,O7Z,,1,25,8,33
45378,leoca77,,1,1,2,3
45379,cricketbones,,1,16,19,35
45380,moriquendo,,1,814,823,1637
45381,K_Rambo34,,1,1,2,3
45382,Aminmadani,,1,4,2,6
45383,intelex,,1,21,23,44
45384,LuciusTheAss,,1,8,9,17
45385,Lumarin,,1,99,143,242
45386,kidford,,1,115,189,304
45387,truocchio,,1,2,7,9
45388,Corgana,,1,56,31,87
45389,littlealbatross,,1,61,158,219
45390,breaume,,1,4,2,6
45391,patrickvannypan,,1,3,2,5
45392,rayban68,,1,17,45,62
45393,mavroprovato,,1,3,2,5
45394,reddig,,1,1,1,2
45395,Solima,,1,24,20,44
45396,gordo4s,,1,4,27,31
45397,tempname,,1,5,8,13
45398,feckinCunght,,1,84,40,124
45399,biffbobsen,,1,64,125,189
45400,johnriven,,1,3,4,7
45401,Rob,,1,88,10,98
45402,willfe,,1,50,84,134
45403,dev09,,1,2,3,5
45404,AStarr,,1,2,5,7
45405,Tokkii,,1,63,108,171
45406,xTRUMANx,,1,631,584,1215
45407,mouseinahaze,,1,8,11,19
45408,absolutelytrue,,1,21,16,37
45409,PellePeloton,,1,7,3,10
45410,hig,,1,7,12,19
45411,windchyme50,,1,5,9,14
45412,woodlawn,,1,1,2,3
45413,freehunter,,1,89,135,224
45414,tom_cruise_is_TIGHT,,1,5,8,13
45415,simonmar,,1,16,3,19
45416,dewmugg,,1,3,1,4
45417,bntly,,1,19,19,38
45418,libroll,,1,7,6,13
45419,mmsullivan,,1,7,5,12
45420,nobamama,,1,71,48,119
45421,pdross1,,1,1,6,7
45422,JoeKirk,,1,6,6,12
45423,shortyjacobs,,1,12,17,29
45424,sylvie1,,1,2,1,3
45425,RAc163,,1,25,2,27
45426,oniTony,,1,104,27,131
45427,semafor,,1,25,37,62
45428,gondomwing,,1,11,5,16
45429,trbeaber,,1,33,58,91
45430,mayobutter,,1,79,66,145
45431,tetuphenay,,1,9,5,14
45432,penguinv,,1,43,87,130
45433,throop77,,1,181,320,501
45434,RexManningDay,,1,630,1146,1776
45435,anko_painting,,1,6,3,9
45436,fahcredit,,1,33,34,67
45437,CanadianNinja,,1,115,125,240
45438,Hate,,1,13,15,28
45439,IAmNotBigL,,1,1,6,7
45440,mrtdot,,1,4,8,12
45441,fryman,,1,81,116,197
45442,meatsack,,1,26,33,59
45443,cedelson,,1,279,172,451
45444,DMBT,,1,9,1,10
45445,Rickr00ler,,1,1,1,2
45446,hosiawak,,1,4,1,5
45447,Eleglac,,1,93,125,218
45448,LanternBearer,,1,542,1286,1828
45449,iscander,,1,1,2,3
45450,mbiggs,,1,1,1,2
45451,Justanothercoverup,,1,285,15,300
45452,gfryesc,,1,43,51,94
45453,groby,,1,40,74,114
45454,jemroc,,1,5,9,14
45455,ben4evah,,1,16,22,38
45456,casta,,1,3,3,6
45457,renauldo56,,1,10,6,16
45458,redditer041,,1,6,4,10
45459,ipearx,,1,7,13,20
45460,graciosa,,1,16,18,34
45461,matzero,,1,1,2,3
45462,PurpleMan,,1,35,6,41
45463,mrhungry,,1,6,8,14
45464,clarknova9,,1,4,3,7
45465,rickracer777,,1,26,32,58
45466,onetruejp,,1,328,536,864
45467,mickythec,,1,1,1,2
45468,Outrigger8,,1,5,4,9
45469,jotho,,1,1,1,2
45470,FordJano,,1,40,90,130
45471,paperwasp,,1,212,22,234
45472,neosapiens,,1,1,2,3
45473,Duncan_Idaho,,1,58,116,174
45474,daleharvey,,1,14,23,37
45475,bitdiddle,,1,1,7,8
45476,webster1,,1,95,15,110
45477,ravenbladex,,1,3,2,5
45478,crispee,,1,25,24,49
45479,readerofreddit,,1,1,1,2
45480,nekteknik,,1,1,7,8
45481,benad,,1,1,1,2
45482,bloaded,,1,7,11,18
45483,elvisthepelvis,,1,4,2,6
45484,yy633013,,1,1,3,4
45485,kengruven,,1,1,4,5
45486,wooptoo,,1,4,14,18
45487,ekahsan,,1,1,1,2
45488,hatevalyum,,1,7,2,9
45489,jdk,,1,132,178,310
45490,pyromonkey,,1,2,4,6
45491,Ravenaru,,1,12,29,41
45492,blackestblue,,1,5,7,12
45493,snifty,,1,428,540,968
45494,vagmi,,1,33,7,40
45495,tornadic,,1,37,2,39
45496,skevimc,,1,13,23,36
45497,gridbug,,1,58,30,88
45498,Kolibri,,1,187,269,456
45499,nathanlaw,,1,3,9,12
45500,TAKESTHINGSTOOFAR,,1,1,1,2
45501,amatriain,,1,13,22,35
45502,Odd_Bloke,,1,66,27,93
45503,Hovertruck,,1,85,126,211
45504,holmeszk,,1,7,2,9
45505,raldi,,1,476,361,837
45506,kai7162,,1,1,1,2
45507,bburg,,1,18,22,40
45508,jppowerstroke,,1,1,1,2
45509,unrulymob,,1,2,3,5
45510,RATM,,1,12,6,18
45511,mbcharbonneau,,1,2,3,5
45512,Ford42,,1,10,18,28
45513,gaze,,1,15,15,30
45514,anthropoid,,1,12,20,32
45515,ot2,,1,8,25,33
45516,Spiritglue,,1,3,3,6
45517,StiflyStiferson,,1,3,16,19
45518,JPOnion,,1,288,476,764
45519,klassik,,1,4,3,7
45520,terath,,1,5,8,13
45521,kovu,,1,1,1,2
45522,jjquave,,1,147,138,285
45523,Arjibuh,,1,87,123,210
45524,oherrala,,1,47,2,49
45525,GrouchoRedditor,,1,4,2,6
45526,amila,,1,52,15,67
45527,twine,,1,30,26,56
45528,fwork,,1,320,399,719
45529,msing,,1,32,65,97
45530,twinklestar,,1,261,16,277
45531,radix,,1,1,1,2
45532,facilis,,1,38,64,102
45533,kellogg,,1,34,33,67
45534,mrbo,,1,10,8,18
45535,akruvi,,1,92,100,192
45536,apotheon,,1,1000,928,1928
45537,flashman2006,,1,23,18,41
45538,SenorCardgage,,1,69,36,105
45539,infinitecat,,1,32,61,93
45540,bhb6790,,1,1,1,2
45541,allenizabeth,,1,470,587,1057
45542,baz,,1,7,23,30
45543,Gudranx,,1,5,5,10
45544,askhole,,1,3,3,6
45545,justsomeguy987,,1,10,16,26
45546,liamville,,1,54,76,130
45547,geniusfreak,,1,27,46,73
45548,Zaniac,,1,28,33,61
45549,phragmatic,,1,7,19,26
45550,photokeith,,1,435,432,867
45551,pholm,,1,120,132,252
45552,SomeBloke,,1,21,28,49
45553,nowarabx,,1,1,1,2
45554,jestopher,,1,11,32,43
45555,andrewsmith1986,,1,6,3,9
45556,RonPaulSucksDik4Coke,,1,1,6,7
45557,Parrot132,,1,1,1,2
45558,clintecker,,1,15,7,22
45559,grazny,,1,59,60,119
45560,stargazer858,,1,2,1,3
45561,guyusj,,1,1,2,3
45562,Nave,,1,10,9,19
45563,verb0ten,,1,166,174,340
45564,i_h8_r3dd1t,,1,410,439,849
45565,kubenzi,,1,68,78,146
45566,krawdizzle,,1,1,1,2
45567,ddrogba,,1,1,1,2
45568,lcmatt,,1,14,14,28
45569,El_Biffo,,1,3,2,5
45570,hellow4,,1,73,21,94
45571,Masapena,,1,16,35,51
45572,smrdka,,1,6,8,14
45573,lovelace,,1,1,1,2
45574,swimmerstud,,1,56,35,91
45575,spaghettiman,,1,3,4,7
45576,eebee,,1,1,4,5
45577,gusintemecula,,1,9,22,31
45578,jonathandclark,,1,1,1,2
45579,Mattie,,1,111,77,188
45580,saytheobvious,,1,3,1,4
45581,deephair,,1,46,3,49
45582,Kardlonoc,,1,893,1706,2599
45583,parcivale,,1,787,897,1684
45584,Killawatt,,1,49,103,152
45585,Duelist,,1,3,4,7
45586,likelystory,,1,7,7,14
45587,SirGrok,,1,3,1,4
45588,zeljana,,1,33,5,38
45589,gawainjones,,1,7,8,15
45590,fuji76,,1,13,3,16
45591,serpentjaguar,,1,495,750,1245
45592,ross456,,1,1,1,2
45593,wodha,,1,7,1,8
45594,sonicon,,1,54,96,150
45595,w43l,,1,1,8,9
45596,tdyer,,1,1,1,2
45597,patrickjst,,1,1,1,2
45598,Drulian,,1,33,31,64
45599,kjb877,,1,22,24,46
45600,gda,,1,77,168,245
45601,salvia_d,,1,731,214,945
45602,jjimmy,,1,1,1,2
45603,IvoJacome,,1,2,2,4
45604,sstomek,,1,2,1,3
45605,goodtower,,1,3,3,6
45606,theory_of_everything,,1,3,11,14
45607,nestoras,,1,14,40,54
45608,fyl799,,1,4,4,8
45609,r44s,,1,3,1,4
45610,nsrivast,,1,40,21,61
45611,Stijn,,1,23,16,39
45612,pawnstorm,,1,19,28,47
45613,kbaribeau,,1,1,3,4
45614,kngspook,,1,1,3,4
45615,Barleyman,,1,4,1,5
45616,zdiv,,1,2,1,3
45617,soulpurpose,,1,9,5,14
45618,dwdyer,,1,4,7,11
45619,narpas,,1,53,119,172
45620,wstein,,1,6,8,14
45621,halvfet,,1,1,1,2
45622,detonatenz,,1,21,26,47
45623,ahmadamaj,,1,4,5,9
45624,muumuuuu,,1,2,1,3
45625,wes1,,1,4,3,7
45626,lordnuri,,1,3,11,14
45627,jupaneanu,,1,1385,41,1426
45628,sschudel,,1,4,15,19
45629,Goondick,,1,4,3,7
45630,xkaupx,,1,5,10,15
45631,FamousPerson,,1,4,5,9
45632,tizenkotoko,,1,35,73,108
45633,maggit,,1,65,49,114
45634,newsbaby,,1,4,4,8
45635,lonebear,,1,2,2,4
45636,frankofbos,,1,42,4,46
45637,zubinmadon,,1,257,249,506
45638,notyouravgjoel,,1,16,23,39
45639,BarristaEnFlambe,,1,20,32,52
45640,Nagarjuna3,,1,3,10,13
45641,Mr_Splashypants,,1,1,1,2
45642,REDDIT_MAN_98_points,,1,1,4,5
45643,unclesaamm,,1,3,3,6
45644,elliotb,,1,1,1,2
45645,christocracy,,1,5,12,17
45646,FreeRadical08,,1,48,36,84
45647,myv,,1,2,3,5
45648,Mycolostomybagleaked,,1,262,234,496
45649,drgreg911,,1,3,2,5
45650,PsychoGod,,1,44,66,110
45651,thelmajanemax,,1,6,4,10
45652,nitwitty,,1,1,1,2
45653,ctronci,,1,5,3,8
45654,drtchock,,1,19,24,43
45655,soar,,1,246,583,829
45656,thaddio,,1,4,5,9
45657,tpark,,1,23,27,50
45658,johnb647,,1,1,3,4
45659,starboogie,,1,26,7,33
45660,leanny,,1,2,1,3
45661,nextofpumpkin,,1,952,1225,2177
45662,kanned,,1,12,14,26
45663,DRPSET,,1,2,1,3
45664,dapperdan,,1,23,26,49
45665,trave,,1,51,84,135
45666,random_words,,1,4,4,8
45667,joethepeacock,,1,127,46,173
45668,WitchKing,,1,1,1,2
45669,pull_the_other_one,,1,15,20,35
45670,nominolo,,1,62,71,133
45671,adt,,1,16,25,41
45672,NeimanJ,,1,102,14,116
45673,new_bedlam,,1,159,235,394
45674,romke,,1,4,3,7
45675,tratari,,1,8,15,23
45676,mekarank,,1,1,1,2
45677,freedomgoose,,1,1,4,5
45678,thrain2,,1,2,3,5
45679,agoldin,,1,9,17,26
45680,temp12345,,1,3,2,5
45681,graha,,1,17,2,19
45682,ericisshort,,1,2,3,5
45683,FeedMePlease,,1,153,303,456
45684,donjaime,,1,18,17,35
45685,MilkMoney,,1,68,13,81
45686,Okitaz,,1,167,62,229
45687,Kixie,,1,2,3,5
45688,tuigdoilgheas,,1,2,5,7
45689,Lythic,,1,1,1,2
45690,rtb,,1,17,18,35
45691,alpinesol,,1,50,29,79
45692,destraht,,1,3,2,5
45693,taleril,,1,6,6,12
45694,addeleon,,1,13,20,33
45695,ciano,,1,3,11,14
45696,kerritaylor85,,1,12,2,14
45697,ih8linux,,1,7,8,15
45698,lern_too_spel,,1,52,50,102
45699,ChrisTheCat,,1,2,1,3
45700,b0b157,,1,1,7,8
45701,taylorfate,,1,1,1,2
45702,j0rge,,1,23,1,24
45703,andreiradudan,,1,20,4,24
45704,Fluid_Mechanics,,1,7,12,19
45705,JonBuoy,,1,11,2,13
45706,metroid23,,1,8,6,14
45707,popthatcorn,,1,26,4,30
45708,dion_dock,,1,1,1,2
45709,zoltan2357,,1,3,3,6
45710,useless_idiot,,1,213,259,472
45711,eikenberry,,1,20,17,37
45712,jftuga,,1,1,2,3
45713,johnpickens,,1,19,27,46
45714,Temp3st,,1,20,24,44
45715,MrBadAdvice,,1,1,1,2
45716,paulhuts,,1,3,3,6
45717,jakepoz,,1,2,4,6
45718,hyperfusion,,1,4,4,8
45719,sloppy,,1,2,19,21
45720,akumasun,,1,23,47,70
45721,Super-King,,1,6,2,8
45722,tamarind2,,1,3,1,4
45723,Awperator,,1,38,33,71
45724,Thomas_Dolby,,1,20,36,56
45725,ratchet,,1,2,2,4
45726,teeyee,,1,72,1,73
45727,asgromo,,1,10,9,19
45728,orangesunshine,,1,5,6,11
45729,oso45,,1,4,6,10
45730,t0t0r0,,1,2,1,3
45731,Mickay2541,,1,1,1,2
45732,collinT,,1,1,1,2
45733,LogicalTingle,,1,2,5,7
45734,wauter,,1,8,8,16
45735,campingcar,,1,23,16,39
45736,harrybalsick,,1,7,8,15
45737,tommyroo,,1,15,23,38
45738,pwnghis_khan,,1,8,9,17
45739,lolalivia,,1,48,54,102
45740,guru,,1,89,5,94
45741,rainer511,,1,5,7,12
45742,5656d5656dv56,,1,1,1,2
45743,yters,,1,46,46,92
45744,progoz,,1,1,2,3
45745,danielstoner,,1,54,9,63
45746,accelerape,,1,4,2,6
45747,timesink,,1,4,6,10
45748,mattelmore,,1,2,2,4
45749,DutchAnon,,1,4,2,6
45750,UncleLiberal,,1,16,28,44
45751,joachimb,,1,2,1,3
45752,TheAngryToaster,,1,1,2,3
45753,gumjo,,1,14,26,40
45754,missty,,1,8,4,12
45755,michael_dorfman,,1,2,4,6
45756,reddit_god,,1,37,50,87
45757,Paqza,,1,42,66,108
45758,chunky_bacon,,1,724,1685,2409
45759,nokiili,,1,4,3,7
45760,mattstreet,,1,2,3,5
45761,mrbrownstone,,1,3,5,8
45762,garnet13ajg,,1,189,298,487
45763,jcapote,,1,27,27,54
45764,fleecerobot,,1,7,2,9
45765,sunev,,1,9,3,12
45766,petrilli,,1,26,23,49
45767,george_dubya,,1,1,1,2
45768,WordReich,,1,5,15,20
45769,skay,,1,223,255,478
45770,tdsfp,,1,51,1,52
45771,Baked,,1,1,1,2
45772,zemookmook,,1,7,13,20
45773,dagraybehl,,1,9,9,18
45774,durendal,,1,1,2,3
45775,BillyBlight,,1,3,4,7
45776,markhp2,,1,4,1,5
45777,ramdac,,1,12,30,42
45778,Dred,,1,175,215,390
45779,neogohan,,1,66,54,120
45780,slimwiththetiltedbri,,1,83,99,182
45781,Autotrappic,,1,68,103,171
45782,jacbo,,1,2,5,7
45783,lex0r,,1,7,13,20
45784,psychometry,,1,968,1193,2161
45785,NamelessForce,,1,3,4,7
45786,nivvis,,1,1,2,3
45787,Atman00,,1,1,4,5
45788,Fauropitotto,,1,247,417,664
45789,murl56,,1,24,31,55
45790,badfeng,,1,10,7,17
45791,polarbear128,,1,19,26,45
45792,mjhkid,,1,65,31,96
45793,bennypowers,,1,1,1,2
45794,d415,,1,2,6,8
45795,random5328238052583,,1,14,14,28
45796,OctopusRex,,1,50,58,108
45797,DLMSweet,,1,2,9,11
45798,krazykrumz3,,1,2,1,3
45799,MikeSeth,,1,1027,1102,2129
45800,3049843098,,1,2,1,3
45801,aaron114,,1,5,3,8
45802,aeroeri,,1,14,23,37
45803,kuromimi,,1,2,4,6
45804,TrollinAintEasy,,1,1,2,3
45805,Fyurstart3r,,1,3,2,5
45806,xaco,,1,44,71,115
45807,scraptabulous,,1,1,5,6
45808,bostonpaul,,1,2,1,3
45809,themadthinker,,1,145,50,195
45810,nightmarchers,,1,5,8,13
45811,BellicoseBaby,,1,31,40,71
45812,toba,,1,13,36,49
45813,brycon,,1,10,14,24
45814,satirewagon,,1,1,1,2
45815,jedaro,,1,15,26,41
45816,dancingqueen,,1,1,1,2
45817,winterkoninkje,,1,28,11,39
45818,fundudeme,,1,15,9,24
45819,adiggconvert,,1,43,51,94
45820,vastrightwing,,1,23,30,53
45821,annalatrina,,1,82,57,139
45822,infraspace,,1,13,25,38
45823,frigo,,1,18,12,30
45824,rmyeid,,1,11,2,13
45825,ghdiel,,1,240,204,444
45826,destructure,,1,1,3,4
45827,zombiecohagen,,1,2,3,5
45828,rubbleman,,1,1,1,2
45829,soreff,,1,16,27,43
45830,allscoop,,1,37,1,38
45831,cookiemonsterism,,1,16,31,47
45832,oopsydaisy,,1,5,9,14
45833,anarchistica,,1,396,626,1022
45834,defproc,,1,440,713,1153
45835,Wadsworth,,1,104,122,226
45836,mkdir,,1,9,12,21
45837,WorstCoderEver,,1,30,31,61
45838,duncanmak,,1,3,4,7
45839,trans_canada,,1,13,15,28
45840,javaroast,,1,1,1,2
45841,dannyhw,,1,26,20,46
45842,vulpes,,1,27,21,48
45843,Wraith,,1,40,77,117
45844,phatmikey,,1,32,37,69
45845,notian,,1,14,13,27
45846,limit2012,,1,1,1,2
45847,jellyfishes,,1,42,37,79
45848,rubymaverick,,1,7,2,9
45849,abcmanu,,1,77,10,87
45850,poopsix,,1,70,101,171
45851,live52,,1,315,595,910
45852,kaddar,,1,2,11,13
45853,imissthe1980s,,1,26,22,48
45854,ed19,,1,101,146,247
45855,bwahaha,,1,64,98,162
45856,armooo,,1,1,1,2
45857,enfuego96,,1,3,9,12
45858,edheil,,1,51,61,112
45859,bully12v,,1,9,9,18
45860,davel_jonez,,1,5,9,14
45861,ChillyBill12,,1,2,3,5
45862,Borgesandme,,1,10,13,23
45863,rollingRook,,1,64,12,76
45864,enjoythis,,1,21,27,48
45865,dt07red,,1,17,52,69
45866,ladydoctorofminds,,1,37,31,68
45867,Michael_Bolton,,1,1,1,2
45868,lazybug,,1,1,1,2
45869,aussie_bob,,1,603,581,1184
45870,kingofpenguins,,1,5,4,9
45871,jeannaimard,,1,481,656,1137
45872,josephgrossberg,,1,3,4,7
45873,infraredflower,,1,7,3,10
45874,cybernet,,1,5,2,7
45875,mythic,,1,128,137,265
45876,Ch1mpy,,1,66,76,142
45877,kagemusha,,1,70,97,167
45878,notParanoid,,1,87,179,266
45879,dagfari,,1,347,492,839
45880,mbrowne,,1,160,252,412
45881,JeffTHEroosteR,,1,1,3,4
45882,watcher,,1,336,80,416
45883,dmilor,,1,48,43,91
45884,paulydidntdoit,,1,1,3,4
45885,redsoxchic,,1,5,5,10
45886,Philiosophe,,1,36,44,80
45887,hk_newbie,,1,3,5,8
45888,flyingscauncher,,1,66,36,102
45889,vjdc,,1,1,1,2
45890,Iainzor,,1,5,14,19
45891,disljenko,,1,20,2,22
45892,needsmoarlulz,,1,131,128,259
45893,chadsworkPC,,1,1,1,2
45894,Deimorz,,1,1,3,4
45895,melito,,1,3,1,4
45896,mudgen,,1,60,14,74
45897,mc_,,1,2,1,3
45898,sakashvilli,,1,3,8,11
45899,Djatha,,1,18,25,43
45900,ivor,,1,9,10,19
45901,darjen,,1,354,415,769
45902,hippiefahrzeug,,1,1,3,4
45903,quark,,1,4,6,10
45904,The_Real_NSA,,1,1,1,2
45905,draicone,,1,14,6,20
45906,malignantz,,1,1,3,4
45907,amoeba,,1,71,136,207
45908,sfw,,1,4,2,6
45909,aredditgirl,,1,3,2,5
45910,cousinmeril,,1,2,6,8
45911,tulioz,,1,4,1,5
45912,nobleexperiment,,1,38,48,86
45913,TwoDeuces,,1,1,2,3
45914,birdFEEDER,,1,4,3,7
45915,webappsec,,1,7,1,8
45916,Shorties,,1,8,13,21
45917,tincansandtwine,,1,29,30,59
45918,starkravingblah,,1,100,10,110
45919,brelind,,1,8,4,12
45920,metsman913,,1,4,3,7
45921,note2self,,1,4,11,15
45922,capnrob,,1,6,4,10
45923,AezZea,,1,2,2,4
45924,ShitOnRickard5,,1,41,71,112
45925,robert314,,1,4,1,5
45926,alumi,,1,6,9,15
45927,jcenters,,1,26,32,58
45928,omt,,1,13,6,19
45929,gbeier,,1,8,8,16
45930,mariastella,,1,2,4,6
45931,audio-logical,,1,2,10,12
45932,absurdlyobfuscated,,1,2,4,6
45933,TrojanMan,,1,1,2,3
45934,LaszloKv,,1,57,70,127
45935,clarkismyname,,1,20,9,29
45936,kagreenie1,,1,2,5,7
45937,dmpayton,,1,12,14,26
45938,phenoch,,1,1,1,2
45939,ninevolt,,1,12,33,45
45940,chalva,,1,3,2,5
45941,fschofield,,1,1,1,2
45942,joelrw,,1,449,82,531
45943,MaskOfTheSun,,1,18,11,29
45944,oes3,,1,13,2,15
45945,RAS1398,,1,94,197,291
45946,badhill,,1,12,3,15
45947,jangobugsy,,1,23,32,55
45948,eggshen,,1,5,15,20
45949,Ender15,,1,110,153,263
45950,wise_monty,,1,86,1,87
45951,sonofabitch,,1,21,20,41
45952,OmegaChicken,,1,3,1,4
45953,jonsonroth,,1,28,6,34
45954,Tillermo,,1,1,6,7
45955,macknitwell,,1,12,21,33
45956,SmallCranes,,1,2,1,3
45957,TheFalseOswalds,,1,27,6,33
45958,oliwer,,1,18,30,48
45959,rswinkler,,1,2,3,5
45960,scex,,1,6,10,16
45961,thearthur,,1,5,10,15
45962,HRP,,1,4,1,5
45963,redditer006,,1,3,4,7
45964,mactac,,1,240,15,255
45965,xeon1,,1,70,7,77
45966,Applemacbookpro,,1,20,34,54
45967,oldgregg,,1,1,1,2
45968,mmmChicken,,1,12,17,29
45969,ronnie_paul,,1,6,6,12
45970,cheaa,,1,1,2,3
45971,belhamster,,1,39,3,42
45972,plasteredlyric,,1,14,22,36
45973,memebreather,,1,6,20,26
45974,lethalman,,1,81,28,109
45975,uvadave,,1,17,16,33
45976,SpiderCross,,1,7,2,9
45977,joblesspirate,,1,12,23,35
45978,dndnd,,1,10,6,16
45979,GarageMc,,1,119,196,315
45980,meijin,,1,36,6,42
45981,sigbjorn,,1,4,2,6
45982,EdgerErnst,,1,446,114,560
45983,dotnetperls,,1,1,2,3
45984,rlilly,,1,10,1,11
45985,market_hacker,,1,1,3,4
45986,Walls,,1,34,35,69
45987,BigGrayBeast,,1,1,1,2
45988,stardust2000,,1,63,10,73
45989,dobbs_studio,,1,1,1,2
45990,klystron,,1,5,12,17
45991,ProximaC,,1,992,1542,2534
45992,chopchop,,1,176,54,230
45993,dougmcvay,,1,15,1,16
45994,edgarde,,1,31,73,104
45995,dullyouth,,1,1,3,4
45996,jfgelinas,,1,2,1,3
45997,joejonson,,1,3,1,4
45998,travist120,,1,23,1,24
45999,squidgee,,1,10,12,22
46000,cwright,,1,213,8,221
46001,nouseforanickname,,1,18,7,25
46002,mortgage-foreclosure,,1,24,21,45
46003,a2800276,,1,7,8,15
46004,dyrenh,,1,26,41,67
46005,theproductguy,,1,2,1,3
46006,efs,,1,6,2,8
46007,kellysmith,,1,61,72,133
46008,Valency,,1,18,7,25
46009,powersurge,,1,22,16,38
46010,mk_ultra,,1,3,1,4
46011,nulltype0,,1,1,1,2
46012,RepoOne,,1,3,3,6
46013,Zlik1987,,1,2,2,4
46014,MasterSparky,,1,5,2,7
46015,unewsman01,,1,5,9,14
46016,grammarstasi,,1,1,1,2
46017,dswingley,,1,25,2,27
46018,fakeleft,,1,7,31,38
46019,geeksaresexy,,1,1,2,3
46020,NSFR,,1,8,25,33
46021,reckless8594,,1,40,39,79
46022,akx,,1,4,4,8
46023,elperdedor,,1,1,1,2
46024,jfm3,,1,17,12,29
46025,ecochildsplay,,1,88,13,101
46026,bjsalami,,1,8,13,21
46027,froggy3262,,1,54,3,57
46028,lizarb,,1,943,25,968
46029,dizzo72,,1,2,1,3
46030,keck,,1,73,120,193
46031,nshunter,,1,69,48,117
46032,Bones423,,1,1,4,5
46033,pchiusano,,1,103,22,125
46034,number6,,1,478,1054,1532
46035,bassalt,,1,156,51,207
46036,go_pstop,,1,3,1,4
46037,memecat,,1,1,1,2
46038,ghhardy,,1,3,3,6
46039,Geordie_LaFarge,,1,167,271,438
46040,surrient,,1,2,3,5
46041,gameguy56,,1,180,290,470
46042,obb,,1,26,42,68
46043,badkins79,,1,7,5,12
46044,JayBlRD,,1,99,170,269
46045,jeshkah,,1,6,7,13
46046,Isamoor,,1,5,3,8
46047,beager,,1,72,97,169
46048,katanasun,,1,1,1,2
46049,owo,,1,83,43,126
46050,krunk7,,1,1,1,2
46051,barryqq,,1,4,1,5
46052,whitesilence,,1,2,2,4
46053,BoogerPresley,,1,7,16,23
46054,jon,,1,14,4,18
46055,gtttssyd,,1,6,10,16
46056,bastardo,,1,115,210,325
46057,freerein,,1,5,6,11
46058,pinguis,,1,17,27,44
46059,epithet,,1,36,71,107
46060,s1l1c0n3,,1,2,2,4
46061,mimiro,,1,3,2,5
46062,bprajapa,,1,1,7,8
46063,alastormoody,,1,11,13,24
46064,BrendanSheehan,,1,205,411,616
46065,incubii,,1,6,9,15
46066,bageloid,,1,38,64,102
46067,diggitySC,,1,28,5,33
46068,PussySnatcher,,1,174,209,383
46069,bitdamaged,,1,26,33,59
46070,rkirkpatrick,,1,5,6,11
46071,drhmd124,,1,1,1,2
46072,kewlsites,,1,1,1,2
46073,inefekt,,1,30,33,63
46074,Owan,,1,14,32,46
46075,Sumguy42,,1,1,3,4
46076,ControlSix,,1,22,47,69
46077,antoinedurr,,1,1,2,3
46078,entropic,,1,52,133,185
46079,skilian,,1,2,5,7
46080,RussWellen,,1,76,4,80
46081,lintonkewsijohnson,,1,11,10,21
46082,quintessential,,1,5,6,11
46083,frankhinton,,1,1,4,5
46084,Joe_Clarks_Lawyer,,1,1,2,3
46085,erasmosis,,1,30,59,89
46086,bgutz,,1,3,3,6
46087,kksm19820117,,1,25,9,34
46088,martyf,,1,71,51,122
46089,smashey,,1,52,103,155
46090,FlorentG,,1,55,27,82
46091,Alphaman88,,1,64,119,183
46092,Noink,,1,143,94,237
46093,Faldane,,1,3,1,4
46094,runeinalya,,1,24,60,84
46095,huffer,,1,21,23,44
46096,greeenpro,,1,1,2,3
46097,EFG,,1,870,788,1658
46098,Ndel,,1,19,13,32
46099,jak2yak,,1,6,1,7
46100,WATERISRUNBYTHEGOVT,,1,4,3,7
46101,nelsongauthier,,1,16,9,25
46102,123412341234,,1,16,72,88
46103,louisvillegeek,,1,4,3,7
46104,Gargan,,1,1,2,3
46105,swimsfast99,,1,5,3,8
46106,eyenetics,,1,2,5,7
46107,glparramatta,,1,116,5,121
46108,sskkrajak,,1,1,1,2
46109,i_am_nicky_haflinger,,1,3,4,7
46110,cyangcn,,1,20,5,25
46111,pimpness525,,1,4,2,6
46112,thequux,,1,5,17,22
46113,sippindrank,,1,4,29,33
46114,hherbzilla,,1,17,14,31
46115,firepoiboy,,1,5,2,7
46116,ghettopia,,1,21,43,64
46117,biomath,,1,8,1,9
46118,kikaluca,,1,5,9,14
46119,dietermacht,,1,1,2,3
46120,mwilke,,1,158,211,369
46121,silvestre,,1,61,8,69
46122,Mighterbump,,1,1,1,2
46123,dboyd,,1,14,13,27
46124,exhiled,,1,1,2,3
46125,protothomas,,1,16,7,23
46126,suplicant,,1,18,1,19
46127,the4iron,,1,6,11,17
46128,reventlov,,1,14,25,39
46129,interhuss,,1,7,3,10
46130,bd31,,1,50,52,102
46131,AnotherLurker,,1,5,7,12
46132,jjwitty,,1,2,1,3
46133,twoboysathome,,1,1,1,2
46134,BrunoX,,1,1,2,3
46135,crapuser1963,,1,4,4,8
46136,styless,,1,6,12,18
46137,json684,,1,1,5,6
46138,everynamewastaken,,1,18,23,41
46139,barackoblogger,,1,373,43,416
46140,uberamd,,1,323,271,594
46141,foxyphoenix,,1,4,2,6
46142,808blogger,,1,5,4,9
46143,2008_Man,,1,1,2,3
46144,inkyimp,,1,1,1,2
46145,bcc,,1,1,1,2
46146,createanew,,1,2,1,3
46147,PsyanideInk,,1,9,10,19
46148,viraptor,,1,93,65,158
46149,jozwiakjohn,,1,2,2,4
46150,0xdefec8,,1,86,68,154
46151,type102,,1,7,23,30
46152,anti_dentite,,1,49,48,97
46153,antirez,,1,142,127,269
46154,thesubmitter,,1,10,3,13
46155,ronpaulsux,,1,1,2,3
46156,unsaneroot,,1,1,3,4
46157,borramakot,,1,16,26,42
46158,yourpopquizkid,,1,131,144,275
46159,fearimas,,1,66,24,90
46160,abhik,,1,62,101,163
46161,dlsspy,,1,244,332,576
46162,kevin61,,1,2,1,3
46163,hello,,1,11,22,33
46164,imaverick,,1,1,3,4
46165,broucks,,1,1,1,2
46166,segrev,,1,11,11,22
46167,LeChuck,,1,364,226,590
46168,Xoya,,1,10,10,20
46169,meatgrinder,,1,3,3,6
46170,danima,,1,1,1,2
46171,GPnZPl,,1,74,72,146
46172,zoomzoom83,,1,1028,808,1836
46173,Mutton,,1,10,8,18
46174,IrishJoe,,1,389,792,1181
46175,shatterly,,1,54,75,129
46176,historycycles,,1,43,5,48
46177,factcheck,,1,1,1,2
46178,Moschops,,1,2,4,6
46179,doesnotunderstand,,1,3,3,6
46180,noaliasneeded,,1,1,1,2
46181,silyputdy,,1,2,5,7
46182,NewWorldOrder,,1,1,4,5
46183,mark-e-mark,,1,4,9,13
46184,butlertd,,1,48,59,107
46185,weneedsound,,1,2,2,4
46186,tornadohead,,1,16,12,28
46187,masnevets,,1,12,5,17
46188,waxxie,,1,1,1,2
46189,no_you_didnt,,1,1,1,2
46190,headchecked,,1,3,5,8
46191,trolldownmodmetohell,,1,125,11,136
46192,Mr_Zero,,1,335,369,704
46193,ginstrom,,1,7,10,17
46194,evolve236,,1,2,3,5
46195,SquirrelyWhirly,,1,2,4,6
46196,alanmagid,,1,1,1,2
46197,SolarBear,,1,9,20,29
46198,Disturbia,,1,1,1,2
46199,Bort74,,1,5,5,10
46200,petresq,,1,1,1,2
46201,unicornologist,,1,7,17,24
46202,shirizvi,,1,3,2,5
46203,tesseracter,,1,258,412,670
46204,diecast,,1,77,156,233
46205,hyprkd,,1,3,2,5
46206,soyko,,1,36,59,95
46207,HenkPoley,,1,204,450,654
46208,cowpunk52,,1,54,15,69
46209,DownVotesMakeMeHorny,,1,8,5,13
46210,shawnofthedead,,1,19,21,40
46211,ssj4megaman,,1,1,1,2
46212,jayunit,,1,11,14,25
46213,haihaibai,,1,1,2,3
46214,shimamoto,,1,15,22,37
46215,jwl23,,1,1,1,2
46216,jwbernier2,,1,29,28,57
46217,foible,,1,1,9,10
46218,ice101a,,1,2,2,4
46219,Lawen,,1,1,1,2
46220,doublethink,,1,4,1,5
46221,vcxz1,,1,12,24,36
46222,messup000,,1,6,2,8
46223,sakri,,1,181,92,273
46224,ThatSomaliGuy,,1,8,10,18
46225,Yeroc,,1,1,3,4
46226,ghost11,,1,5,4,9
46227,shacklefordrusty,,1,10,6,16
46228,JonGretar,,1,6,13,19
46229,ykaw97,,1,1,1,2
46230,sideshowian,,1,30,12,42
46231,spacemeat,,1,2,1,3
46232,athorpedo,,1,64,137,201
46233,bifftradwell,,1,10,22,32
46234,severedcross,,1,22,14,36
46235,bleidl,,1,1,1,2
46236,janus303,,1,12,1,13
46237,atatat,,1,21,20,41
46238,cainpitt,,1,14,12,26
46239,Uncle-Bob,,1,19,18,37
46240,alright,,1,1,1,2
46241,naveloc,,1,2,1,3
46242,kombitwen,,1,2,1,3
46243,agentdcooper,,1,5,4,9
46244,MonicaShi,,1,313,5,318
46245,smitty22,,1,82,104,186
46246,whatthehell9,,1,14,17,31
46247,ezran,,1,16,3,19
46248,winzippy,,1,28,16,44
46249,PermaSolutions,,1,28,3,31
46250,dcowboy,,1,2,4,6
46251,celticeric,,1,48,83,131
46252,mormagli,,1,4,13,17
46253,jogloran,,1,13,22,35
46254,Thinksforfun,,1,372,213,585
46255,SagaLhan,,1,8,7,15
46256,nerdland,,1,1,2,3
46257,y_gingras,,1,28,23,51
46258,sdlee,,1,7,9,16
46259,malloc,,1,155,265,420
46260,spyd3rweb,,1,115,250,365
46261,technomancy,,1,80,147,227
46262,IcedPenguin,,1,1,1,2
46263,tsuru,,1,27,24,51
46264,ByronMackelroy,,1,4,3,7
46265,Hargrove,,1,3,1,4
46266,-_-,,1,79,123,202
46267,grandericca,,1,2,1,3
46268,aesova,,1,2,10,12
46269,cadr,,1,10,22,32
46270,cjjsteele,,1,7,4,11
46271,nobodyman,,1,4,4,8
46272,soakes,,1,22,34,56
46273,sinisterduck,,1,2,1,3
46274,playeren,,1,17,39,56
46275,jimgaudet,,1,10,3,13
46276,stephengeorge,,1,2,7,9
46277,squerl,,1,10,9,19
46278,the_slowpoke,,1,23,32,55
46279,mwittlief,,1,1,1,2
46280,tomonly,,1,51,23,74
46281,crumbsmashT,,1,1,1,2
46282,kdfrawg,,1,4,8,12
46283,ChunkyLaguna,,1,15,35,50
46284,come_down_david,,1,2,1,3
46285,HenryCruz,,1,53,2,55
46286,philhassey,,1,9,4,13
46287,antisense,,1,50,8,58
46288,simonk,,1,5,4,9
46289,sendmefunnystuff,,1,4,4,8
46290,jollywhitegiant,,1,6,9,15
46291,PaulAtreides,,1,1,1,2
46292,musered,,1,1,1,2
46293,metalmoon,,1,33,42,75
46294,biggsuccess,,1,1,1,2
46295,zenrenity,,1,24,12,36
46296,wintheday,,1,8,5,13
46297,jmail69,,1,427,787,1214
46298,UrbanDEV,,1,4,21,25
46299,bradfitz,,1,16,19,35
46300,zzoomzzoomzzoom,,1,8,2,10
46301,f0nd004u,,1,274,444,718
46302,joshcarter,,1,1,3,4
46303,spinlock,,1,190,298,488
46304,justinlilly,,1,6,2,8
46305,wearevotingyes,,1,66,7,73
46306,Manthem,,1,15,1,16
46307,rushmc1,,1,5,5,10
46308,rdicker,,1,79,83,162
46309,jemminger,,1,167,245,412
46310,trasputin,,1,12,19,31
46311,MattyH,,1,63,27,90
46312,FatesUrinal,,1,7,12,19
46313,sharjeel,,1,6,1,7
46314,roguetue,,1,13,14,27
46315,jabber,,1,2,3,5
46316,hikarudo,,1,1,1,2
46317,jeremy,,1,7,15,22
46318,LissaJ,,1,1,3,4
46319,goggwah,,1,2,2,4
46320,Riman34,,1,51,117,168
46321,colcob,,1,140,159,299
46322,FeloniaChampagne,,1,208,352,560
46323,endoverender,,1,3,7,10
46324,allahuakbar79,,1,758,288,1046
46325,knsmr,,1,5,4,9
46326,mab98122,,1,4,10,14
46327,cleverkid,,1,168,342,510
46328,vilnius,,1,4,4,8
46329,HCACAC,,1,1,1,2
46330,JackAcid,,1,1,2,3
46331,bubasmith,,1,2,1,3
46332,khavark,,1,9,5,14
46333,chriscox,,1,4,6,10
46334,chadmill3r,,1,24,30,54
46335,Benzona,,1,260,318,578
46336,mcavoy76,,1,1,1,2
46337,bandolier,,1,273,90,363
46338,cskozmo,,1,3,3,6
46339,bsdfish,,1,12,8,20
46340,fix3r,,1,3,8,11
46341,jml94,,1,209,65,274
46342,phreadom,,1,14,8,22
46343,dali,,1,4,3,7
46344,mousegrade,,1,1,1,2
46345,Tribecallednick,,1,2,1,3
46346,incodwetrust,,1,3,5,8
46347,bsitty,,1,5,5,10
46348,astroturf,,1,31,51,82
46349,JQSauvage,,1,7,11,18
46350,fishstickz,,1,58,1,59
46351,translurker,,1,5,3,8
46352,selfstarter,,1,5,2,7
46353,cpuenvy,,1,1,1,2
46354,FANGO,,1,566,677,1243
46355,aldarion,,1,16,28,44
46356,dimgn,,1,1,2,3
46357,TylerBlue,,3,3,6,9
46358,groug,,1,9,25,34
46359,Pyroman82,,1,1,1,2
46360,imfat,,1,23,17,40
46361,izzycat,,1,174,292,466
46362,csgordon,,1,2,6,8
46363,kookoobear,,1,8,3,11
46364,mpeters13,,1,5,4,9
46365,Riemann,,1,2,4,6
46366,KJEveryday,,1,25,23,48
46367,masonlee,,1,4,6,10
46368,libinpan,,1,2,1,3
46369,Yashkir,,1,16,15,31
46370,STE_V_P,,1,1,3,4
46371,msadgrove,,1,1,4,5
46372,Useless,,1,81,132,213
46373,bostich,,1,3,3,6
46374,JoeTheProgrammer,,1,23,36,59
46375,nfinite79,,1,7,19,26
46376,DukunSakti,,1,30,5,35
46377,pippy,,1,62,76,138
46378,bonafidebob,,1,2,1,3
46379,HigheR,,1,3,3,6
46380,theanimation,,1,78,47,125
46381,toasterweasel,,1,41,62,103
46382,whobutsb,,1,2,8,10
46383,petervk,,1,1,2,3
46384,AMACTASTIC55k,,1,51,81,132
46385,tungsten,,1,42,93,135
46386,boyfarrell,,1,5,8,13
46387,fruitbaticus,,1,30,25,55
46388,Politico,,1,5,8,13
46389,cdub,,1,79,127,206
46390,fatgirls,,1,1,2,3
46391,chrysb,,1,327,13,340
46392,jamiiecb,,1,4,8,12
46393,DKS,,1,23,20,43
46394,Hecks,,1,4,7,11
46395,tonyclifton,,1,51,57,108
46396,rdewalt,,1,38,48,86
46397,cputney,,1,3,5,8
46398,pygstasis,,1,2,3,5
46399,matiasklein,,1,383,2,385
46400,mattyandco,,1,3,5,8
46401,r3c1pr0city,,1,2,2,4
46402,repiret,,1,66,110,176
46403,gxti_,,1,2,1,3
46404,omgosh,,1,95,123,218
46405,Greasy,,1,247,46,293
46406,Jethrokill,,1,55,64,119
46407,ovoutland,,1,86,139,225
46408,MKE1138,,1,4,3,7
46409,smelendez,,1,17,19,36
46410,barcodez,,1,130,51,181
46411,bcroq,,1,17,1,18
46412,jessinamercy,,1,2,2,4
46413,UnitedModerate,,1,105,105,210
46414,igfoo,,1,14,1,15
46415,chux52,,1,8,18,26
46416,jjb123,,1,53,45,98
46417,leddit669,,1,3,6,9
46418,mistyriver,,1,64,107,171
46419,IDrinkYourMilkshake,,1,2,1,3
46420,thequantumflux,,1,6,26,32
46421,the_sheeple_waker,,1,1,1,2
46422,etaoin,,1,1,1,2
46423,iceman989,,1,2,1,3
46424,Laughsatyou,,1,5,11,16
46425,Stingo,,1,219,2,221
46426,nwow,,1,2,4,6
46427,jalada,,1,5,4,9
46428,gnarly,,1,1,1,2
46429,dexter1,,1,9,6,15
46430,pxa270,,1,68,22,90
46431,StarkRavingChad,,1,53,56,109
46432,modigitz,,1,2,2,4
46433,thevarsity,,1,2,2,4
46434,Newtrino,,1,7,9,16
46435,kolas,,1,1,1,2
46436,DarkDIscordian,,1,5,8,13
46437,LeBain,,1,1,1,2
46438,hugthevegan,,1,6,7,13
46439,BobbleBobble,,1,9,5,14
46440,srikanthmeenakshi,,1,33,6,39
46441,thethorn,,1,7,4,11
46442,iso3200,,1,5,4,9
46443,johnbrownks,,1,40,2,42
46444,golyadkin,,1,25,67,92
46445,lemming,,1,209,370,579
46446,xeren,,1,1,3,4
46447,Pootananny,,1,1,1,2
46448,polebridge,,1,6,2,8
46449,reddittookme,,1,75,129,204
46450,naughtymonkey69,,1,38,54,92
46451,wolfzero,,1,424,668,1092
46452,rabbiccu,,1,6,11,17
46453,yellowjacketcoder,,1,50,52,102
46454,pedomorphic,,1,13,26,39
46455,fadi420,,1,13,6,19
46456,jimma,,1,2,3,5
46457,SamuelDr,,1,16,24,40
46458,triedntrue,,1,2,4,6
46459,chrisclan1903,,1,1,9,10
46460,Epetaizana,,1,48,65,113
46461,EyesBlu,,1,1,1,2
46462,iscariotwon,,1,34,44,78
46463,nonnymoose,,1,5,1,6
46464,APOCALYPTICFUCKFEST,,1,7,20,27
46465,hotwingbias,,1,957,405,1362
46466,darntastic,,1,137,154,291
46467,wuzzard,,1,20,21,41
46468,themisanthrope,,1,262,362,624
46469,cuj0,,1,4,8,12
46470,alalal,,1,4,8,12
46471,whao,,1,22,18,40
46472,v01c30fr3a50n,,1,6,11,17
46473,TheHobo42,,1,1,3,4
46474,Redmushroom,,1,41,50,91
46475,dagro,,1,1,1,2
46476,jester02k,,1,3,10,13
46477,sibilant-ess,,1,93,164,257
46478,zoziw,,1,33,21,54
46479,sethg,,1,39,69,108
46480,jrettin08,,1,1,1,2
46481,jtra,,1,30,29,59
46482,Davisourus,,1,108,94,202
46483,ChrisOz,,1,1,5,6
46484,corinney,,1,6,4,10
46485,waveringhobbit,,1,33,31,64
46486,dugb,,1,3,1,4
46487,JimXugle,,1,90,144,234
46488,bradle,,1,2,8,10
46489,rapope001,,1,7,9,16
46490,bob11235,,1,22,55,77
46491,shoombabi,,1,189,210,399
46492,markovnikov,,1,6,3,9
46493,dminor9,,1,2,4,6
46494,williadc,,1,8,20,28
46495,pastordan,,1,2,1,3
46496,zj5u3n3,,1,20,18,38
46497,sonanz,,1,1,7,8
46498,rabidfurby,,1,4,4,8
46499,dreman,,1,79,29,108
46500,zushiba,,1,10,25,35
46501,carpart,,1,5,3,8
46502,LolitaChiquita,,1,1,1,2
46503,notlad,,1,1,1,2
46504,mohitgupta,,1,2,1,3
46505,virga,,1,38,22,60
46506,mike73737,,1,1,1,2
46507,rxchatters,,1,4,7,11
46508,panicbombs,,1,19,15,34
46509,Whim,,1,12,12,24
46510,lectrick,,1,438,709,1147
46511,MegaManSE,,1,6,5,11
46512,lordcrimmeh,,1,1,4,5
46513,the87boy,,1,5,6,11
46514,trachea,,1,25,22,47
46515,redcsh,,1,2,1,3
46516,fantasticFlan,,1,34,69,103
46517,Grimalkin,,1,1177,841,2018
46518,crazyhippyguy,,1,2,1,3
46519,DogtorEvil,,1,12,15,27
46520,erdie721,,1,103,27,130
46521,tomdoggett,,1,13,21,34
46522,email,,1,100,128,228
46523,kija,,1,3,7,10
46524,voyagerfan5761,,1,44,53,97
46525,mfryc,,1,2,6,8
46526,nerdduer,,1,1,1,2
46527,dnindza,,1,10,12,22
46528,octalespresso,,1,54,123,177
46529,ignore_me,,1,8,44,52
46530,annieface,,1,9,17,26
46531,trymelolr,,1,17,1,18
46532,saldane,,1,1,1,2
46533,forgetu,,1,83,18,101
46534,md81544,,1,41,76,117
46535,jgallagher721,,1,1,1,2
46536,jester340,,1,1,2,3
46537,theinsectgod,,1,1,2,3
46538,LoadPuller,,1,30,137,167
46539,0point,,1,12,18,30
46540,d0_ob,,1,304,337,641
46541,darthdaddy,,1,21,6,27
46542,BrickSalad,,1,433,756,1189
46543,aucourant,,1,4,5,9
46544,WasabiBomb,,1,9,3,12
46545,gfarfl,,1,4,3,7
46546,harry321,,1,48,55,103
46547,videzlamer,,1,14,10,24
46548,ramdaskm,,1,19,42,61
46549,qrios,,1,39,32,71
46550,redafa,,1,5,8,13
46551,zoweee,,1,17,36,53
46552,chicagosnafu,,1,1,1,2
46553,fcanas,,1,22,41,63
46554,frankidadio,,1,7,9,16
46555,crazyfist,,1,15,17,32
46556,Exit,,1,8,13,21
46557,Eijin,,1,279,421,700
46558,nihil161,,1,11,16,27
46559,WorcesterM,,1,60,134,194
46560,ezrydn,,1,1,1,2
46561,rrubin5,,1,1,1,2
46562,krystyin,,1,2,1,3
46563,dcoutts,,1,17,29,46
46564,Phibbsy,,1,3,12,15
46565,coblenis,,1,1,1,2
46566,inrelief,,1,15,29,44
46567,Amberkins,,1,1,1,2
46568,neatopat,,1,153,113,266
46569,but_I_eated_it,,1,31,25,56
46570,bigtech,,1,165,231,396
46571,gezgin,,1,135,28,163
46572,danmuz,,1,1,1,2
46573,kirkland,,1,14,15,29
46574,throwaway,,1,222,310,532
46575,lazed_and_confused,,1,154,90,244
46576,notmynormalaccount,,1,5,2,7
46577,AnyColourYouLike,,1,4,2,6
46578,DearSergio,,1,6,6,12
46579,narziss,,1,1,3,4
46580,logan_capaldo,,1,202,365,567
46581,Angry_Grammarian,,1,33,25,58
46582,05caniffa,,1,1,6,7
46583,kevinh243432,,1,3,4,7
46584,semi_colon,,1,227,146,373
46585,sri1025,,1,37,3,40
46586,stephenflanagan,,1,4,6,10
46587,hbop,,1,14,16,30
46588,craig12,,1,3,4,7
46589,dudermcgavin,,1,4,4,8
46590,srikanth1k,,1,11,29,40
46591,gimpy454,,1,5,8,13
46592,jerryF,,1,69,171,240
46593,an_exscientologist,,1,5,14,19
46594,Svelmoe,,1,4,4,8
46595,jtbrubaker,,1,3,3,6
46596,IAMIAM,,1,26,5,31
46597,nokia123,,1,6,3,9
46598,ambrose6969,,1,2,1,3
46599,dabhaid,,1,90,79,169
46600,freerider,,1,61,34,95
46601,gtfbfan,,1,1,3,4
46602,_pi,,1,86,122,208
46603,mattowings,,1,1,4,5
46604,leek,,1,68,50,118
46605,ikon,,1,6,14,20
46606,mattucf,,1,15,30,45
46607,codeman122281,,1,1,1,2
46608,nkathman,,1,2,2,4
46609,creiht,,1,24,8,32
46610,netshade,,1,2,3,5
46611,johnkicks,,1,2,5,7
46612,slurpme,,1,606,982,1588
46613,dsol,,1,44,46,90
46614,loicl,,1,6,20,26
46615,nerdalert,,1,1,3,4
46616,taoofthe777,,1,3,1,4
46617,subterfu9e,,1,1,1,2
46618,docsavage96,,1,172,422,594
46619,alapanacran,,1,260,1,261
46620,frederich,,1,2,5,7
46621,thehellandback,,1,237,38,275
46622,MagicWishMonkey,,1,155,190,345
46623,beatmaster23,,1,7,6,13
46624,dokkah,,1,4,3,7
46625,newsbulletin,,1,98,67,165
46626,eggertm,,1,12,23,35
46627,zimbu,,1,6,7,13
46628,souledge,,1,2,2,4
46629,jasonn,,1,5,10,15
46630,Skolanthropy,,1,3,9,12
46631,Lindsjam,,1,6,4,10
46632,tgbanks,,1,37,1,38
46633,kelsey_leigh,,1,38,44,82
46634,OdinYgg,,1,15,18,33
46635,jdetc,,1,1,1,2
46636,hector_villalobos,,1,53,5,58
46637,therna4,,1,31,41,72
46638,psycop,,1,11,58,69
46639,josiah,,1,6,2,8
46640,guruz,,1,1,1,2
46641,bagoftricks,,1,8,8,16
46642,vennatorr,,1,3,9,12
46643,tgoff,,1,9,17,26
46644,Puntas13,,1,57,95,152
46645,reelactor,,1,5,6,11
46646,barbear3,,1,103,8,111
46647,aranach,,1,5,17,22
46648,nramenta,,1,5,9,14
46649,acidmoose,,1,2,1,3
46650,fliffr,,1,2,5,7
46651,michaelreddit,,1,1,2,3
46652,bobbykyn,,1,60,121,181
46653,heptadecagram,,1,222,301,523
46654,fishpillow,,1,5,14,19
46655,debtfreerevolution,,1,7,3,10
46656,mikelieman,,1,26,54,80
46657,wynand,,1,2,4,6
46658,tbaker13,,1,16,1,17
46659,cooleyandy,,1,1,6,7
46660,plancton,,1,1,2,3
46661,modix,,1,28,40,68
46662,snowboarder04,,1,1,3,4
46663,kmgraba,,1,12,19,31
46664,aal,,1,3,2,5
46665,John_SIDNEY_McCain,,1,2,1,3
46666,reelectnoone,,1,22,4,26
46667,rats99ass,,1,483,255,738
46668,tqless,,1,3,7,10
46669,URanINSTRUMENT,,1,1,3,4
46670,spuur,,1,193,270,463
46671,ilovegays,,1,2,1,3
46672,random007,,1,1,1,2
46673,inept,,1,17,36,53
46674,congofriends,,1,2,2,4
46675,Jofeshenry,,1,16,8,24
46676,nypen,,1,23,30,53
46677,muzthe42nd,,1,54,51,105
46678,zygotene,,1,1,1,2
46679,proudcanadianeh,,1,468,229,697
46680,sadboy,,1,5,13,18
46681,MrRed,,1,2,6,8
46682,robroe,,1,3,3,6
46683,fixxxer,,1,1,1,2
46684,metagame,,1,4,2,6
46685,regulati0n,,1,1,1,2
46686,stevehl42,,1,4,3,7
46687,Jafishman,,1,2,1,3
46688,jugalator,,1,867,1091,1958
46689,crazy_horce,,1,27,36,63
46690,LOLTEHINTARWEB,,1,47,99,146
46691,rgladwell,,1,11,11,22
46692,innerpenguin,,1,107,53,160
46693,j4ded,,1,6,11,17
46694,fuhkinglou,,1,2,2,4
46695,Linkerator,,1,1,1,2
46696,Bobwise,,1,288,215,503
46697,itsmeront,,1,17,3,20
46698,hobbs,,1,1,1,2
46699,dalziel,,1,184,30,214
46700,crucifi3d,,1,1,2,3
46701,LizaP,,1,16,27,43
46702,lemmycaution,,1,1,1,2
46703,mikkom,,1,267,268,535
46704,availle,,1,6,5,11
46705,NMom,,1,27,1,28
46706,axemachine,,1,1,4,5
46707,ASUSasquatch,,1,1,1,2
46708,AskBitterman,,1,61,5,66
46709,JTPalm,,1,74,11,85
46710,daggity,,1,219,329,548
46711,performance,,1,71,112,183
46712,ChainsawRadio,,1,25,41,66
46713,paulsondan,,1,1,2,3
46714,cvrc,,1,3,12,15
46715,kevev,,1,10,16,26
46716,sanguivor,,1,14,3,17
46717,larryobrien,,1,3,3,6
46718,vaginator,,1,17,9,26
46719,omfgninja,,1,843,563,1406
46720,bombtea,,1,1,1,2
46721,Sarmacid,,1,2,3,5
46722,JimmyE,,1,3,1,4
46723,mobyhead,,1,1,2,3
46724,cschneid,,1,263,427,690
46725,alan-dean,,1,3,4,7
46726,oxowowmom,,1,4,3,7
46727,tzigane,,1,15,6,21
46728,jfcshow,,1,2,2,4
46729,kohno214,,1,1,3,4
46730,Lodoss,,1,19,20,39
46731,semperfido,,1,2,8,10
46732,lllurker,,1,2,3,5
46733,ThatsSoLana,,1,70,113,183
46734,wolfsktaag,,1,8,12,20
46735,winstonsmithgo,,1,7,1,8
46736,Anachronox0666,,1,121,45,166
46737,grantbee,,1,1,3,4
46738,everyone_is_a_robot,,1,27,60,87
46739,Admiral_Obvious,,1,1,1,2
46740,titolaser,,1,7,10,17
46741,gbills,,1,1,1,2
46742,mattevans,,1,388,24,412
46743,mobiuschic42,,1,49,73,122
46744,hdcs,,1,50,90,140
46745,Speff,,1,42,57,99
46746,LuciWiz,,1,2,3,5
46747,wormfist,,1,7,11,18
46748,obiefernandez,,1,7,2,9
46749,FREEFREEFREE,,1,7,5,12
46750,GregorCZ,,1,165,161,326
46751,Ssquared22,,1,6,6,12
46752,crnflke,,1,4,8,12
46753,Billiam1975,,1,535,376,911
46754,piratetelecast,,1,157,176,333
46755,gtg409y,,1,5,6,11
46756,pennyfx,,1,181,55,236
46757,JayyMan,,1,4,5,9
46758,myddrn,,1,114,180,294
46759,Captain-Ironic,,1,2,5,7
46760,tobsn,,1,57,26,83
46761,domesticmouse,,1,1,2,3
46762,anelson,,1,2,1,3
46763,madmoose,,1,5,9,14
46764,bnikolictech,,1,13,5,18
46765,jjmichaud,,1,40,15,55
46766,colleenmarystone,,1,2,1,3
46767,IsotopeOrange,,1,1,2,3
46768,GrandMoffTarkin,,1,10,8,18
46769,inigo_montoya,,1,33,59,92
46770,vr19976,,1,3,2,5
46771,restriction,,1,1,3,4
46772,7aylor,,1,101,143,244
46773,HughJass,,1,13,15,28
46774,sputz,,1,88,79,167
46775,fierarul,,1,84,99,183
46776,planet808,,1,2,1,3
46777,solson,,1,102,8,110
46778,dmaclean,,1,1,1,2
46779,karlhungus03,,1,2,1,3
46780,bloohurry,,1,2,3,5
46781,maxwalker,,1,1,3,4
46782,Bavaron,,1,6,4,10
46783,ooorrr,,1,1,2,3
46784,imreddiru,,1,1,1,2
46785,liberty4all,,1,119,94,213
46786,null_vector,,1,18,29,47
46787,chaoticsynergy,,1,2,3,5
46788,ressu,,1,2,3,5
46789,ooboo111,,1,2,1,3
46790,redsquirrel,,1,3,1,4
46791,besst,,1,9,31,40
46792,lukasmach,,1,24,21,45
46793,ryan7575,,1,32,31,63
46794,fsadfasdfsa,,1,1,2,3
46795,DanRisinger,,1,5,3,8
46796,t3rmv3locity,,1,1,1,2
46797,mpgilmore,,1,2,2,4
46798,tazer,,1,5,3,8
46799,peterzero,,1,14,11,25
46800,NotFake,,1,2,8,10
46801,rer0tsaz,,1,25,36,61
46802,nzeeshan,,1,757,442,1199
46803,hikingisfun,,1,65,34,99
46804,-Borfo-,,1,24,42,66
46805,OpenMIKE,,1,1,7,8
46806,drinksnapple,,1,1,1,2
46807,actionscripture,,1,16,20,36
46808,hewhodoes,,1,2,7,9
46809,boat,,1,5,9,14
46810,garye9695,,1,1,1,2
46811,malph,,1,1,1,2
46812,Saydrah,,1,2848,1033,3881
46813,aludwin,,1,24,45,69
46814,askspike,,1,3,2,5
46815,arjung,,1,18,16,34
46816,yuh,,1,181,131,312
46817,everclearbeer,,1,1,1,2
46818,hiffy,,1,418,550,968
46819,roxet,,1,23,19,42
46820,o25667,,1,2,4,6
46821,mikaelstaldal,,1,19,25,44
46822,starchild718,,1,1,1,2
46823,guillebravo6,,1,534,82,616
46824,SND_Crow,,1,268,384,652
46825,RockFromDot,,1,81,38,119
46826,thisracetodie,,1,4,5,9
46827,Starch,,1,213,230,443
46828,katowich,,1,1,1,2
46829,ElDiablo909,,1,1,1,2
46830,GeneralChaos,,1,6,4,10
46831,goodhairsE,,1,1,1,2
46832,HiDigger,,1,1,2,3
46833,wastelands,,1,222,229,451
46834,slantysideways,,1,5,6,11
46835,valnour,,1,3,6,9
46836,badgerboy,,1,10,1,11
46837,BannerBearer,,1,55,132,187
46838,tchesko,,1,1,1,2
46839,brentlewiis,,1,3,1,4
46840,monkeybird,,1,49,96,145
46841,gloopyest,,1,3,3,6
46842,schmendrick,,1,76,110,186
46843,denver38,,1,88,85,173
46844,wizpig64,,1,4,4,8
46845,peggyblah,,1,51,97,148
46846,negatroyd,,1,1,1,2
46847,dermdoc,,1,6,11,17
46848,opqdonut,,1,1,2,3
46849,socioblogo,,1,3,6,9
46850,jburksme,,1,4,6,10
46851,zora666,,1,7,11,18
46852,sitemarker,,1,4,1,5
46853,molasse,,1,15,14,29
46854,The_LORD,,1,5,8,13
46855,Calvin_the_Bold,,1,137,114,251
46856,trentrez,,1,16,15,31
46857,Set_it_right,,1,38,39,77
46858,oddmanout,,1,1146,1370,2516
46859,IQue,,1,93,55,148
46860,Ron_Epp,,1,20,41,61
46861,hngovr,,1,10,41,51
46862,HankTavish,,1,6,10,16
46863,creative4w3,,1,2,5,7
46864,patrycja1,,1,1,1,2
46865,Muggi,,1,6,4,10
46866,chetg,,1,2,11,13
46867,kalazar,,1,310,338,648
46868,greaterking,,1,2,1,3
46869,Ajju,,1,124,95,219
46870,teval,,1,174,207,381
46871,chrxs,,1,106,98,204
46872,adoarns,,1,70,97,167
46873,EggnogAssassin,,1,54,52,106
46874,balazsbela,,1,13,24,37
46875,RageX,,1,9,10,19
46876,Spanglegluppet,,1,582,382,964
46877,protell,,1,492,83,575
46878,billawesome,,1,15,2,17
46879,reenymal,,1,11,1,12
46880,vamosscorcho,,1,58,77,135
46881,pdebie,,1,1,1,2
46882,kldf,,1,1,1,2
46883,jimjimbay,,1,10,7,17
46884,greeen_,,1,22,21,43
46885,psec,,1,58,4,62
46886,lilmissgenius200,,1,2,6,8
46887,forming,,1,12,32,44
46888,pooslinger,,1,6,3,9
46889,daysi,,1,567,874,1441
46890,nitroy2k,,1,4,1,5
46891,erikmack,,1,17,19,36
46892,IAteUrMama,,1,42,9,51
46893,elector69,,1,1,1,2
46894,franktank2008,,1,1,1,2
46895,Barttd,,1,4,3,7
46896,steveuk51,,1,10,3,13
46897,packetguy,,1,115,274,389
46898,_neutrino,,1,3,3,6
46899,timewarp,,1,364,504,868
46900,btakita,,1,43,47,90
46901,ringm,,1,89,129,218
46902,Grakiko,,1,83,182,265
46903,tflo729,,1,1,1,2
46904,nazi-cop,,1,1,2,3
46905,chiarafox,,1,8,2,10
46906,amfortas,,1,1,3,4
46907,jadertots,,1,1,1,2
46908,tehl3x,,1,12,10,22
46909,kinetics,,1,12,39,51
46910,guy231,,1,62,126,188
46911,stuntant,,1,3,2,5
46912,swampsparrow,,1,5508,1008,6516
46913,leonard_koan,,1,78,65,143
46914,un-mercy,,1,1,1,2
46915,mizled,,1,32,8,40
46916,CerpinTaxt101,,1,1,1,2
46917,onoj,,1,1,2,3
46918,youjani,,1,2,2,4
46919,lani,,1,37,150,187
46920,disposable,,1,1,4,5
46921,silentjudas,,1,3,3,6
46922,nporiord,,1,1,1,2
46923,spin0,,1,1,1,2
46924,ideonode,,1,355,333,688
46925,eightballart,,1,1,1,2
46926,wackoman,,1,26,37,63
46927,dean16,,1,17,11,28
46928,dingobongo,,1,2,4,6
46929,grigri,,1,22,37,59
46930,brotherxiao,,1,3,3,6
46931,pavel_lishin,,1,1259,1620,2879
46932,harrycary,,1,1,2,3
46933,danboh6,,1,2,4,6
46934,Ninjazn,,1,1,11,12
46935,space_cowboy,,1,17,22,39
46936,danvk,,1,6,10,16
46937,lelechuck,,1,140,178,318
46938,xyzzy9000,,1,1,3,4
46939,codejunki,,1,21,13,34
46940,marky125,,1,8,16,24
46941,ardil,,1,24,44,68
46942,asragov,,1,6,5,11
46943,Pangloss09,,1,12,11,23
46944,Neuroscoot,,1,64,128,192
46945,redlantern,,1,18,15,33
46946,mike_carmichael,,1,2,3,5
46947,niki78,,1,4,3,7
46948,ether_reddit,,1,35,61,96
46949,rjst01,,1,11,11,22
46950,conceptkid,,1,1,2,3
46951,flickchic,,1,40,7,47
46952,Nacky,,1,1,2,3
46953,Eecks,,1,7,11,18
46954,JenM,,1,155,176,331
46955,robhutten,,1,84,75,159
46956,qghy2,,1,3,1,4
46957,Geee,,1,4,2,6
46958,Seiesnalli,,1,2,3,5
46959,rubielred,,3,1,3,4
46960,beedude,,1,1,1,2
46961,Tman158,,1,84,2,86
46962,SoleilR,,1,1,1,2
46963,max999,,1,1,1,2
46964,dkordik,,1,46,43,89
46965,whoreallyreallycares,,1,229,105,334
46966,dora_explorer,,1,397,656,1053
46967,g2petter,,1,223,172,395
46968,Philluminati,,1,822,1047,1869
46969,fatlus,,1,2,4,6
46970,kitschpatrol,,1,1,1,2
46971,08ronpaul08,,1,26,19,45
46972,moopie,,1,12,24,36
46973,ziadbc,,1,8,3,11
46974,CliffClaven,,1,9,15,24
46975,metaspore,,1,6,6,12
46976,shmi,,1,238,273,511
46977,fathed,,1,47,80,127
46978,lmao,,1,2,1,3
46979,garbonauta,,1,2,2,4
46980,Moofed,,1,5,5,10
46981,jrandom,,1,200,340,540
46982,mynameisharsha,,1,19,14,33
46983,atomicpuffball,,1,172,93,265
46984,SpankMyMetroid,,1,1,1,2
46985,SpungoMcBungo,,1,75,51,126
46986,neuro99,,1,4,7,11
46987,inarsla,,1,6,8,14
46988,rosconotorigina,,1,14,46,60
46989,klassica,,1,61,10,71
46990,D43513393R,,1,17,7,24
46991,LightSpeed,,1,2,2,4
46992,falsedichotomy,,1,1,1,2
46993,Dauntless,,1,230,182,412
46994,rosetta_stoned,,1,10,16,26
46995,choad,,1,104,100,204
46996,zha4fh,,1,1,1,2
46997,november5th,,1,11,9,20
46998,charmless,,1,4,9,13
46999,mmmweed,,1,9,5,14
47000,bobbyz,,1,6,4,10
47001,LouBrishus,,1,1,1,2
47002,PSPNiels,,1,1,1,2
47003,StrangeQuark,,1,96,96,192
47004,josuesalazar,,1,1,1,2
47005,musicman827,,1,3,1,4
47006,rosimom,,1,1,1,2
47007,arsgeek,,1,341,32,373
47008,smackfu,,1,193,269,462
47009,silarulz,,1,5,2,7
47010,TiengAnh,,1,3,10,13
47011,wats8976,,1,110,109,219
47012,plumby,,1,205,310,515
47013,shawnshine,,1,3,3,6
47014,Gareth321,,1,31,32,63
47015,grammar_corrector,,1,7,7,14
47016,Purpperp,,1,1,1,2
47017,Wellsy,,1,7,9,16
47018,Rendeiro,,1,7,4,11
47019,webguy88,,1,5,5,10
47020,frayjoker,,1,11,14,25
47021,lachiemx,,1,267,400,667
47022,monolar,,1,53,99,152
47023,clifthered,,1,20,7,27
47024,djbelieve,,1,2,4,6
47025,TooCold,,1,3,6,9
47026,omphaloskepsis,,1,2,5,7
47027,kindler,,1,2,2,4
47028,42omle,,1,462,418,880
47029,omnipotent1,,1,8,10,18
47030,cc81,,1,462,437,899
47031,letsdothisagain,,1,360,191,551
47032,ergomnemonicism,,1,21,27,48
47033,Dead_Horse,,1,3,6,9
47034,Coolmac,,1,43,14,57
47035,frantk,,1,142,191,333
47036,Stu8912,,1,11,5,16
47037,carcinogen,,1,23,25,48
47038,tom2275,,1,5,5,10
47039,dugr,,1,7,12,19
47040,dexo,,1,1,1,2
47041,Nash13,,1,43,59,102
47042,thetaxman,,1,21,6,27
47043,ClayDavis,,1,1,1,2
47044,konryd,,1,1,1,2
47045,volatile_vixen,,1,15,11,26
47046,Gipetto,,1,3,6,9
47047,danh,,1,43,1,44
47048,nmintt,,1,12,15,27
47049,sythe,,1,11,22,33
47050,MJG2007,,1,1,3,4
47051,vsiva68,,1,1,1,2
47052,petir,,1,3,2,5
47053,maximelt,,1,10,2,12
47054,jonxblaze,,1,185,22,207
47055,aikibiades,,1,1,1,2
47056,blackbrrr,,1,84,69,153
47057,blubberfest,,1,141,118,259
47058,motox16,,1,1,1,2
47059,constitutionranger,,1,62,129,191
47060,jpkutner,,1,38,26,64
47061,tayssir,,1,38,54,92
47062,pbaseball24,,1,3,1,4
47063,SlowMotionWalter,,1,25,66,91
47064,busybeth105,,1,3,14,17
47065,brisywisy,,1,63,65,128
47066,beeforchicken,,1,4,2,6
47067,your-god,,1,2,5,7
47068,xarahfos,,1,1,1,2
47069,SergantSubtle,,1,4,6,10
47070,wedgiey1,,1,126,78,204
47071,positron98,,1,11,6,17
47072,Citizen_McCain,,1,1,1,2
47073,GinnyCu2,,1,1,1,2
47074,yuthe,,1,1,2,3
47075,mazzlemizzle,,1,6,1,7
47076,burkha,,1,1,2,3
47077,agaelebe,,1,4,1,5
47078,Damrey,,1,91,78,169
47079,geocar,,1,196,293,489
47080,Demiurge11,,1,85,78,163
47081,nelsormensch,,1,26,22,48
47082,tdh,,1,7,1,8
47083,Authenticating,,1,1,1,2
47084,Sibilantjoe,,1,8,22,30
47085,maven911,,1,39,19,58
47086,masked_interrupt,,1,57,48,105
47087,mindplunge,,1,1,1,2
47088,remotedevice,,1,51,55,106
47089,modelman,,1,1,1,2
47090,EpicDragon,,1,4,2,6
47091,oiccool,,1,29,14,43
47092,Captain_Underpants,,1,3,5,8
47093,badbatz,,1,2,1,3
47094,Kingvash,,1,1,5,6
47095,MMarquit,,1,78,11,89
47096,Breadhook,,1,20,25,45
47097,mtxblau,,1,151,213,364
47098,domjuandotcom,,1,6,1,7
47099,palmyra,,1,16,7,23
47100,god_made_molesters,,1,1,1,2
47101,hyperbad,,1,1,2,3
47102,cisasteelersfan,,1,2,4,6
47103,procrastinator65,,1,3,1,4
47104,GrammarIsForNazis,,1,75,150,225
47105,VACO,,1,5,8,13
47106,starmatt,,1,2,1,3
47107,Tarustwins,,1,4,1,5
47108,ohemeffgee,,1,284,251,535
47109,BarryOontheDownLow,,1,2,1,3
47110,beam,,1,2,5,7
47111,jbrowley,,1,9,24,33
47112,ristin,,1,923,1564,2487
47113,karmaVS,,1,18,34,52
47114,wuzzup,,1,70,83,153
47115,eldenbishop,,1,6,14,20
47116,gleemie,,1,103,73,176
47117,mrsnorris,,1,3,3,6
47118,internet_badass,,1,34,20,54
47119,xoexohexox,,1,4,7,11
47120,ladytomorrow,,1,92,107,199
47121,christianjb,,1,686,682,1368
47122,j0hnsd,,1,650,1471,2121
47123,Emanresu435,,1,2,2,4
47124,60secs,,1,142,219,361
47125,himeraz,,1,5,17,22
47126,mikefairbank,,1,4,2,6
47127,fenny69,,1,26,55,81
47128,trevxenemy,,1,175,24,199
47129,yogiri,,1,9,12,21
47130,nCn,,1,10,39,49
47131,jimmytree,,1,1,3,4
47132,garflesnarfle,,1,2,2,4
47133,isjhe,,1,6,3,9
47134,shoota,,1,3,3,6
47135,RP-on-AF1,,1,65,104,169
47136,l00ky,,1,27,1,28
47137,fleebo,,1,2,1,3
47138,narancs,,1,42,40,82
47139,sir_francis_drake,,1,2,2,4
47140,twister6284,,1,55,68,123
47141,timedancer,,1,1,3,4
47142,jezmck,,1,406,499,905
47143,CaptainPicard,,1,4,2,6
47144,humpmonkey,,1,14,28,42
47145,nonrecursive,,1,45,37,82
47146,Palamer,,1,2,2,4
47147,WendyLRogers,,1,81,56,137
47148,swampfarmer,,1,20,70,90
47149,Dirvid,,1,2,1,3
47150,tofusimon,,1,50,22,72
47151,othermike,,1,1,1,2
47152,fukgod,,1,7,16,23
47153,ech230,,1,2,4,6
47154,ehsu,,1,3,1,4
47155,Benjamin_Sisko,,1,2,1,3
47156,Disliked,,1,51,26,77
47157,gburri,,1,5,7,12
47158,entitysix,,1,3,6,9
47159,steenacakes,,1,2,2,4
47160,mocgbr,,1,1,3,4
47161,sexaddictdude,,1,4,1,5
47162,h07r0d,,1,6,5,11
47163,thornist,,1,44,47,91
47164,knom,,1,9,3,12
47165,kking254,,1,13,29,42
47166,ranten,,1,3,2,5
47167,drewantarctic,,1,200,366,566
47168,catbert,,1,3,5,8
47169,lcg019,,1,1,1,2
47170,Gargot,,1,17,4,21
47171,verytres,,1,43,2,45
47172,devlavaca,,1,4,11,15
47173,Motherhead,,1,70,47,117
47174,gehsty,,1,2,3,5
47175,Element_22,,1,45,47,92
47176,fozzymandias,,1,268,296,564
47177,stuartlea1,,1,3,2,5
47178,OsamaReilly,,1,2,4,6
47179,e40,,1,233,270,503
47180,jbert,,1,259,342,601
47181,rast3r,,1,17,13,30
47182,BryantJB,,1,2,2,4
47183,slight,,1,2,2,4
47184,futurestate,,1,70,199,269
47185,sosueme,,1,103,154,257
47186,amgine,,1,2,4,6
47187,paperclip,,1,2,6,8
47188,________________,,1,21,22,43
47189,nate48,,1,3,5,8
47190,glocalization,,1,2,2,4
47191,saffron,,1,5,5,10
47192,Mithel,,1,38,70,108
47193,metl_lord,,1,17,24,41
47194,Wayside,,1,341,225,566
47195,filthgrinder,,1,2,8,10
47196,crackamacka,,1,1,5,6
47197,tlynn,,1,12,10,22
47198,lookatmypeepee,,1,35,91,126
47199,papa_nato,,1,1,2,3
47200,antonova,,1,1,1,2
47201,theatrus,,1,71,98,169
47202,pyxis,,1,35,63,98
47203,blood_ninja,,1,1,2,3
47204,dhuff,,1,1,1,2
47205,mdesjardins,,1,1,1,2
47206,lektran,,1,12,21,33
47207,stinkypete9,,1,2,2,4
47208,robbiedance8,,1,1,3,4
47209,Ulvund,,1,207,25,232
47210,ewingpatriarch,,1,8,3,11
47211,ubuwalker31,,1,106,95,201
47212,koldewyse,,1,257,59,316
47213,reasonableBeing,,1,3,11,14
47214,yendi,,1,1,3,4
47215,STOP_HAMMERTIME,,1,33,45,78
47216,MrDerk,,1,8,7,15
47217,pacheco,,1,1,2,3
47218,ataraxia,,1,101,27,128
47219,birlinn,,1,50,106,156
47220,doitlive,,1,6,4,10
47221,derwisch,,1,103,177,280
47222,mtaylor769,,1,18,37,55
47223,luccid,,1,14,3,17
47224,hobbes19,,1,7,33,40
47225,stevemegson,,1,13,7,20
47226,exposing_feminism,,1,1,1,2
47227,walnutmon,,1,4,1,5
47228,silenoz357,,1,8,18,26
47229,AK47blues,,1,263,285,548
47230,UKDave,,1,134,23,157
47231,Syini666,,1,14,12,26
47232,brenoKHAKI,,3,2,2,4
47233,kraegm,,1,1,2,3
47234,bremsstrahlung,,1,4,5,9
47235,bsanford,,1,3,2,5
47236,readerszone,,1,92,1,93
47237,theknife,,1,1,1,2
47238,rossyhyndman,,1,1,1,2
47239,weave2k0,,1,2,3,5
47240,loch_raven,,1,4,1,5
47241,alternity,,1,7,59,66
47242,CFHQYH,,1,59,143,202
47243,Leo_Tolstoy,,1,2,1,3
47244,M_Rock,,1,246,76,322
47245,mazin,,1,10,8,18
47246,Mooker,,1,20,5,25
47247,inotropin,,1,1,1,2
47248,charlier,,1,2,4,6
47249,5-4-3-2-1-bang,,1,110,151,261
47250,rboymtj,,1,241,141,382
47251,chimpish,,1,1,7,8
47252,geldedus,,1,15,8,23
47253,policyHaxor,,1,10,2,12
47254,Mmil09,,1,1,3,4
47255,roidberg,,1,12,47,59
47256,derkaas,,1,140,194,334
47257,kovak,,1,1,5,6
47258,conradofs,,1,4,3,7
47259,lolpicard,,1,44,68,112
47260,dakk12,,1,133,85,218
47261,mthmchris,,1,249,238,487
47262,pb77,,1,1,3,4
47263,mattheww,,1,1,1,2
47264,lhadlum,,1,5,15,20
47265,meester-burns,,1,1,2,3
47266,Snes91,,1,1,1,2
47267,djnoha,,1,2,3,5
47268,snorque,,1,4,5,9
47269,swansonc,,1,27,15,42
47270,addit,,1,4,22,26
47271,joshr137,,1,18,42,60
47272,evariste,,1,30,32,62
47273,smithandjohnson,,1,20,2,22
47274,samfoo,,1,33,31,64
47275,bgoetz,,1,4,5,9
47276,calebegg,,1,1,2,3
47277,harryballsagna,,1,710,1101,1811
47278,BikeShmuck,,1,1,1,2
47279,thepulse,,1,1,1,2
47280,tmmmandm,,1,1,3,4
47281,Maxwell_S_Mart,,1,64,77,141
47282,TerriblePoet,,1,10,25,35
47283,gepardcv,,1,10,3,13
47284,liquidtension,,1,33,47,80
47285,kkreddit,,1,3,1,4
47286,andrev,,1,14,5,19
47287,profburnz,,1,7,8,15
47288,SpaceMonitor,,1,94,154,248
47289,shastafir,,1,4,12,16
47290,Avarith,,1,2,5,7
47291,dami2550,,1,13,18,31
47292,serjean,,1,2,1,3
47293,stroptek,,1,101,49,150
47294,IheartDaRegion,,1,35,67,102
47295,mattv212232,,1,33,51,84
47296,grumdrig,,1,6,11,17
47297,avalanche142,,1,5,1,6
47298,quartermann,,1,32,51,83
47299,l1ghtning,,1,13,35,48
47300,nalfien,,1,103,58,161
47301,joshbudde,,1,13,6,19
47302,CreepyKid,,1,1,1,2
47303,cheetah007,,1,70,7,77
47304,MattFaus,,1,1,1,2
47305,kevinkr,,1,9,20,29
47306,BlueOrange,,1,44,17,61
47307,vaporstun,,1,1,2,3
47308,cocoaeyes,,1,2,9,11
47309,RaldisPuppet,,1,32,40,72
47310,rushouse,,1,37,21,58
47311,jadero,,1,35,55,90
47312,vikramkeskar,,1,4,4,8
47313,pocketreviews,,1,70,71,141
47314,brool,,1,4,16,20
47315,Nimmy,,1,1,1,2
47316,makepizzanotwar,,1,1,1,2
47317,Deadbolt11,,1,1,1,2
47318,australasia,,1,56,61,117
47319,cphuntington97,,1,59,71,130
47320,nem,,1,1,1,2
47321,abigalerogers,,1,2,4,6
47322,irishomac,,1,1,1,2
47323,jeremyfirth,,1,18,28,46
47324,damiensith,,1,2,2,4
47325,flycrg,,1,117,195,312
47326,Flavour666,,1,11,15,26
47327,idunnoanything,,1,1,1,2
47328,brianwc,,1,60,11,71
47329,itzmattu,,1,8,5,13
47330,gilimas,,1,1,1,2
47331,FrankHope,,1,22,23,45
47332,sqrt7744,,1,8,13,21
47333,__jim__,,1,4,6,10
47334,raharu,,1,12,20,32
47335,sangoma,,1,48,66,114
47336,growinglotus,,1,642,885,1527
47337,naich,,1,37,40,77
47338,stevvooe,,1,38,47,85
47339,jimbo_jones,,1,95,141,236
47340,subspacer,,1,24,34,58
47341,dumnbunny,,1,22,38,60
47342,jfaith,,1,1,2,3
47343,hyp3r,,1,29,38,67
47344,vadimm,,1,254,80,334
47345,gimmeit,,1,1,1,2
47346,ENRICOs,,1,440,558,998
47347,rex5249,,1,57,116,173
47348,107reasonswhy,,1,4,5,9
47349,joshj,,1,7,9,16
47350,IlIl,,1,7,3,10
47351,littlewolfen,,1,1,10,11
47352,mikeflynn,,1,1,3,4
47353,reverendfrag4,,1,799,1139,1938
47354,Neo991lb,,1,1,2,3
47355,Kristi_beauty,,1,1,1,2
47356,daretelayam,,1,86,79,165
47357,HandsomeRuss,,1,13,13,26
47358,yinzhen,,1,50,52,102
47359,taxman23,,1,10,4,14
47360,rbernet,,1,1,1,2
47361,tomp2,,1,1,1,2
47362,SalsaShark,,1,1,2,3
47363,chillywilly,,1,1,1,2
47364,00RAH,,1,6,4,10
47365,wkcochran123,,1,1,4,5
47366,avagoyle,,1,11,10,21
47367,nopenogod,,1,131,101,232
47368,shiz3,,1,44,3,47
47369,nappingkitteh,,1,13,13,26
47370,protoypeangel,,1,1,1,2
47371,cricket6689,,1,3,5,8
47372,Fjolle,,1,6,8,14
47373,nusuth,,1,96,165,261
47374,sanantonian,,1,1,2,3
47375,badlyspawnedboy,,1,8,19,27
47376,dlowy1766,,1,4,1,5
47377,harow,,1,79,115,194
47378,foole,,1,28,47,75
47379,cow4263,,1,3,10,13
47380,AttackingHobo,,1,697,796,1493
47381,maths,,1,5,3,8
47382,daybreaker,,1,61,68,129
47383,Lisbeth8,,1,1,1,2
47384,phantomtails,,1,27,17,44
47385,Icantremembermypass,,1,13,12,25
47386,Donut,,1,6,8,14
47387,BlakeStone,,1,1,2,3
47388,Kattborste,,1,17,24,41
47389,goonmaster,,1,78,70,148
47390,bentley,,1,50,32,82
47391,darkael,,1,15,16,31
47392,majek04,,1,56,11,67
47393,beprogress,,1,1,7,8
47394,leachja,,1,47,52,99
47395,harbeas,,1,68,129,197
47396,mattbond1970,,1,1,1,2
47397,eto_samoe,,1,4,1,5
47398,Jojje22,,1,27,28,55
47399,JustACat,,1,2,3,5
47400,JC513,,1,21,27,48
47401,blarghhh,,1,1,3,4
47402,misterbeebeebee,,1,4,4,8
47403,jacobmile,,1,1,1,2
47404,tfaing,,1,21,5,26
47405,Hedgehog2006,,1,395,161,556
47406,hpp,,1,2,1,3
47407,sabailos,,1,1,1,2
47408,AlienCoder,,1,34,6,40
47409,staticz,,1,1,1,2
47410,definitivre,,1,1,1,2
47411,witness142,,1,11,4,15
47412,bertramredneck,,1,137,513,650
47413,Broadway,,1,1,2,3
47414,nickatnite101,,1,274,383,657
47415,zero1234,,1,1,1,2
47416,taleinat,,1,3,2,5
47417,WorldWebIII,,1,21,5,26
47418,adam23,,1,1,1,2
47419,championbeginner,,1,1,4,5
47420,xhhux,,1,92,175,267
47421,nitrogen76,,1,9,5,14
47422,redeyeblog,,1,5,1,6
47423,Wensleydale,,1,169,256,425
47424,trny3,,1,18,17,35
47425,alexjordan,,1,2,1,3
47426,D4wn0ff473,,1,9,18,27
47427,sheepforwheat,,1,62,38,100
47428,DeadlyCouncil,,1,1,3,4
47429,somebodyscoming,,1,7,1,8
47430,raklar,,1,1,5,6
47431,definitelynot,,1,129,6,135
47432,greendestiny,,1,35,42,77
47433,FunkyHat112,,1,77,123,200
47434,cindyvinea,,1,2,1,3
47435,deb1961,,1,2,4,6
47436,j_shanks,,1,17,27,44
47437,anarchoanarchist,,1,4,2,6
47438,Madalina13,,1,71,1,72
47439,MadMastaZ,,1,1,2,3
47440,VikingLumberjack,,1,1,4,5
47441,mizake,,1,20,43,63
47442,gumuz,,1,70,5,75
47443,stwice,,1,1,6,7
47444,courane,,1,91,23,114
47445,eternal512,,1,11,24,35
47446,vspazv,,1,7,23,30
47447,traxxas,,1,124,145,269
47448,eyabs,,1,14,5,19
47449,astrolabe,,1,96,80,176
47450,waugsqueke,,1,5,3,8
47451,probablycorey,,1,54,35,89
47452,madgrafx,,1,35,53,88
47453,quaff,,1,6,6,12
47454,Rianur,,1,1,2,3
47455,peruytu,,1,1,1,2
47456,intronink,,1,4,11,15
47457,tsoo,,1,3,5,8
47458,quasimongo,,1,14,35,49
47459,tuli,,1,27,63,90
47460,cogburn,,1,2,3,5
47461,euphoriajoca,,1,197,28,225
47462,SenaMarie,,1,74,106,180
47463,DarkQuest,,1,26,38,64
47464,aredridel,,1,1,2,3
47465,AgnesScottie,,1,13,13,26
47466,fireandicefuel,,1,10,7,17
47467,impomatic,,1,1,1,2
47468,Tphile,,1,18,30,48
47469,JShap,,1,17,5,22
47470,CaptainPigfucker,,1,11,12,23
47471,JebusJuice,,1,7,5,12
47472,scooticery,,1,24,21,45
47473,free_man,,1,162,131,293
47474,NoodleMan,,1,153,9,162
47475,cusbard,,1,5,21,26
47476,ubrayj02,,1,82,125,207
47477,mypasswordismom,,1,3,2,5
47478,colinbg,,1,2,3,5
47479,LarryLard,,1,154,226,380
47480,Bittermike,,1,15,6,21
47481,vlooming,,1,1,9,10
47482,porcupinetree69,,1,10,8,18
47483,Benana,,1,1,3,4
47484,ReallyPissedOff,,1,12,18,30
47485,djn,,1,4,23,27
47486,beel24,,1,6,5,11
47487,mxhyway,,1,6,4,10
47488,r00k,,1,76,8,84
47489,neutronbob,,1,183,60,243
47490,photoduder,,1,1,1,2
47491,AshtonKoocher,,1,6,6,12
47492,cre,,1,1,1,2
47493,infodivaMLIS,,1,448,35,483
47494,yakineko,,1,1,1,2
47495,JudyD,,1,1,1,2
47496,mykodacon,,1,2,2,4
47497,antonulrich,,1,165,199,364
47498,andreweff,,1,4,7,11
47499,tnv,,1,2,1,3
47500,Beanbones,,1,9,5,14
47501,amazingdisgrace,,1,3,2,5
47502,plucas,,1,16,24,40
47503,ZexMarquies01,,1,3,1,4
47504,blinkofaneye,,1,6,2,8
47505,bromanct,,1,34,29,63
47506,apartition,,1,1,1,2
47507,tehfink,,1,10,20,30
47508,IamJAX,,1,1,1,2
47509,zzbzq,,1,64,97,161
47510,macemillion,,1,4,4,8
47511,centinall,,1,247,299,546
47512,JizzGargler,,1,9,4,13
47513,wroscoe,,1,1,1,2
47514,aaargh,,1,19,56,75
47515,mephi_s,,1,5,3,8
47516,Ghozt,,1,71,7,78
47517,briggsb,,1,119,2,121
47518,starbork,,1,397,255,652
47519,ArtlessDodger,,1,22,31,53
47520,mpierre,,1,68,158,226
47521,AlanInVancouverBC,,1,1,4,5
47522,NSFW,,1,4,5,9
47523,jvining3,,1,9,4,13
47524,Cpt_Picard,,1,1,1,2
47525,moreoriginalthanthat,,1,71,136,207
47526,flyingfredcurry,,1,42,117,159
47527,nimms,,1,3,4,7
47528,ky13,,1,1,1,2
47529,Slayer714,,1,27,48,75
47530,notomniscient,,1,2,1,3
47531,davidbau,,1,2,2,4
47532,memesterbater,,1,7,3,10
47533,Chisaku,,1,58,78,136
47534,urkeee,,1,18,9,27
47535,dnc,,1,18,50,68
47536,robcrocker,,1,82,97,179
47537,drblue,,1,4,8,12
47538,oscarmg,,1,20,15,35
47539,mcalliph,,1,1,1,2
47540,jtputnam,,1,7,1,8
47541,Moon1234,,1,70,123,193
47542,goltrpoat,,1,37,59,96
47543,definition,,1,18,28,46
47544,cafiend,,1,25,39,64
47545,fng,,1,1,1,2
47546,crayoner,,1,3,2,5
47547,mattryan50,,1,10,7,17
47548,ViennaSoysage,,1,1,1,2
47549,jkh77,,1,70,157,227
47550,surgeandoj,,1,2,16,18
47551,Sibelius,,1,60,152,212
47552,hengels,,1,8,6,14
47553,fastlanefast,,1,7,2,9
47554,wozza96,,1,54,112,166
47555,GranDaddy,,1,226,157,383
47556,Cand1date,,1,210,375,585
47557,endustry,,1,9,19,28
47558,raxor1331,,1,2,2,4
47559,paulofmandown,,1,57,108,165
47560,gigamike,,1,8,2,10
47561,dsl_man,,1,90,138,228
47562,flyfisher,,1,1,1,2
47563,alecrose,,1,34,28,62
47564,reconbot,,1,57,75,132
47565,Depafro,,1,13,16,29
47566,Poot_N_Tate,,1,367,208,575
47567,killeryugi,,1,1,3,4
47568,coldsoup,,1,2,2,4
47569,Kuonji,,1,4,5,9
47570,JTM,,1,1,1,2
47571,inan2917,,1,8,8,16
47572,anawolken,,1,14,16,30
47573,crammy,,1,1,1,2
47574,DamonClifford,,1,3,5,8
47575,cionide,,1,5,9,14
47576,nixuselevenswang,,1,2,1,3
47577,InternalAffairs,,1,1,1,2
47578,assratio,,1,51,71,122
47579,danielh_,,1,1,4,5
47580,glatts,,1,111,165,276
47581,jonno2007,,1,2,3,5
47582,MattDamon,,1,1,3,4
47583,podppl,,1,3,5,8
47584,CharlesnMambo,,1,2,5,7
47585,delvach,,1,50,98,148
47586,Cockstr,,1,1,1,2
47587,In_R_Tic_U_L8,,1,10,14,24
47588,gdogfunkyfresh,,1,3,4,7
47589,foobarbazquux,,1,14,2,16
47590,Traveler2112,,1,2,8,10
47591,tommytallarico,,1,1,1,2
47592,cmarrs85,,1,1,1,2
47593,chaddles,,1,91,219,310
47594,operandyohtweeeeeeee,,1,3,4,7
47595,johankool,,1,2,4,6
47596,hohead,,1,24,16,40
47597,anonjoe,,1,5,7,12
47598,ORSM,,1,2,3,5
47599,Silverfuel,,1,1,2,3
47600,cj5,,1,32,51,83
47601,BuddhaJ,,1,16,7,23
47602,yodelie,,1,4,3,7
47603,AmberinaDawn,,1,11,30,41
47604,hpr122i,,1,11,30,41
47605,lawtree,,1,2,3,5
47606,evilblade,,1,3,2,5
47607,fun1ne,,1,330,646,976
47608,no_I_dont_think_so,,1,1,3,4
47609,shantm79,,1,174,216,390
47610,jeezfrk,,1,7,7,14
47611,Pedrobss,,1,1,1,2
47612,slamare247,,1,370,615,985
47613,invise,,1,1,1,2
47614,IkoIkoComic,,1,649,797,1446
47615,The10thNazgul,,1,3,10,13
47616,Favourite,,1,115,130,245
47617,BrianNowhere,,1,243,234,477
47618,fuckingThingSucks,,1,1,1,2
47619,911WasntAnOutsideJob,,1,5,15,20
47620,poe9514,,1,1,1,2
47621,yorkydee,,1,20,77,97
47622,davepeck,,1,25,26,51
47623,AmericaX,,1,5,1,6
47624,smryan,,1,1,1,2
47625,timtim2021,,1,6,9,15
47626,mean7gene,,1,20,15,35
47627,thekid42,,1,2,4,6
47628,queztone,,1,2,4,6
47629,redbat,,1,12,13,25
47630,gurugirl,,1,13,10,23
47631,fland033,,1,1,3,4
47632,villan,,1,1,1,2
47633,SlorLUVR99,,1,6,13,19
47634,treelemon,,1,2,2,4
47635,ethornquist,,1,1,2,3
47636,Lazarus176,,1,5,2,7
47637,DrGirlfriend,,1,82,88,170
47638,morphet,,1,36,22,58
47639,theclasp,,1,4,2,6
47640,TheNanny612,,1,7,17,24
47641,apeweek,,1,144,222,366
47642,genneth,,1,1,2,3
47643,racc0on7,,1,45,71,116
47644,alban987,,1,7,3,10
47645,wireframejesus,,1,1,5,6
47646,achterlijk,,1,3,7,10
47647,RandoM_ChancE,,1,2,2,4
47648,l0l,,1,102,145,247
47649,air0day,,1,56,4,60
47650,spitzanator,,1,51,57,108
47651,PissedOff2008,,1,50,96,146
47652,escapeartist,,1,97,281,378
47653,rocor,,1,14,31,45
47654,allthegoodonestaken,,1,9,7,16
47655,mcchrischuck,,1,25,7,32
47656,pmb,,1,21,8,29
47657,thecrumb,,1,1,1,2
47658,SenorJason,,1,4,6,10
47659,leppie,,1,96,139,235
47660,xmay,,1,3,8,11
47661,Hwee,,1,6,8,14
47662,kitakhyber,,1,14,20,34
47663,picoligance,,1,16,13,29
47664,thomas_h,,1,2,1,3
47665,bolognium,,1,33,55,88
47666,Zum_Horizont,,1,4,13,17
47667,aristofon,,1,12,16,28
47668,oliw,,1,15,6,21
47669,GenghisJuan,,1,2,5,7
47670,bawheid,,1,72,119,191
47671,crash86,,1,38,55,93
47672,scummyatty,,1,4,2,6
47673,reddjake,,1,29,31,60
47674,JustJonny,,1,578,1012,1590
47675,Crazy_Horse,,1,31,40,71
47676,kborah,,1,1,1,2
47677,YaoPau,,1,155,189,344
47678,funparko,,1,6,1,7
47679,FreddieFreeloader,,1,1,1,2
47680,phalnax,,1,6,3,9
47681,stewisgross,,1,1,1,2
47682,thecitizens911,,1,22,44,66
47683,Bzelm1021,,1,1,1,2
47684,marssaxman,,1,1,1,2
47685,regularstrength,,1,1,1,2
47686,Coqui,,1,2,1,3
47687,babblefrog,,1,25,54,79
47688,asdfzxcvzxcv,,1,6,7,13
47689,SingerSirCoda,,1,66,95,161
47690,grin23,,1,8,17,25
47691,phrackattack,,1,1,1,2
47692,pantherdash,,1,12,19,31
47693,JCMichel,,1,4,1,5
47694,teromajusa,,1,6,3,9
47695,jtraub,,1,5,3,8
47696,holywood,,1,1,4,5
47697,severedfragile,,1,771,520,1291
47698,ThaneEichenauer,,1,10,5,15
47699,buss,,1,44,17,61
47700,JEFF_IS_FAKE,,1,1,2,3
47701,kawai,,1,19,25,44
47702,jlivni,,1,1,1,2
47703,squidont,,1,5,6,11
47704,TheLord,,1,3,11,14
47705,eugenejen,,1,3,5,8
47706,paktopia,,1,2,4,6
47707,pdongen,,1,41,46,87
47708,boblet_squared,,1,2,1,3
47709,wanklerotaryengine,,1,1,8,9
47710,theoscheiner,,1,7,12,19
47711,spubass,,1,7,11,18
47712,fractalorc,,1,6,4,10
47713,mypostsweredeleted,,1,1,1,2
47714,callamack,,1,20,4,24
47715,Speechless83,,1,2,1,3
47716,bushdid911,,1,3,3,6
47717,Raff001,,1,1,3,4
47718,thekidsunited,,1,1,10,11
47719,redditmoniker,,1,12,21,33
47720,wotomo,,1,7,3,10
47721,kleffy,,1,438,242,680
47722,Araucaria,,1,18,24,42
47723,bradlauster,,1,3,4,7
47724,barnaby-jones,,1,11,25,36
47725,tmdg,,1,2,2,4
47726,trazor,,1,17,3,20
47727,AdonalFoyle,,1,3,5,8
47728,efox,,1,40,5,45
47729,closetchef,,1,11,18,29
47730,JackSeoul,,1,6,9,15
47731,beefer,,1,1,3,4
47732,schmuckle,,1,2,3,5
47733,temp1010101,,1,3,2,5
47734,ttt8701,,1,1,2,3
47735,chromespi,,1,5,6,11
47736,patterned,,1,11,16,27
47737,lagged,,1,2,3,5
47738,piki,,1,1,2,3
47739,Seefor,,1,263,330,593
47740,trianglechoke,,1,11,4,15
47741,shitcovereddick,,1,456,933,1389
47742,sccordova,,1,3,2,5
47743,GGAllin,,1,5,1,6
47744,wangchong,,1,386,15,401
47745,nowwithbleach,,1,1,1,2
47746,Salti,,1,8,9,17
47747,sysop073,,1,122,275,397
47748,karirhy,,1,1,6,7
47749,ianfine,,1,1,1,2
47750,procrastitron,,1,119,182,301
47751,michaelra,,1,7,2,9
47752,huxrules,,1,2,2,4
47753,sevenoftoine,,1,2,1,3
47754,wallaman2005,,1,2,2,4
47755,Lighioana,,1,29,21,50
47756,aprilchild,,1,6,5,11
47757,andkore,,1,43,55,98
47758,drmohundro,,1,1,4,5
47759,btbalance,,1,5,9,14
47760,amixxima,,1,2,3,5
47761,-Oleg-,,1,1,2,3
47762,chewbaccawasawookie,,1,2,7,9
47763,straatfiter,,1,1,2,3
47764,b1ffw3bst3r,,1,1,4,5
47765,Publius82,,1,59,173,232
47766,proudpuki,,1,4,2,6
47767,scottbruin,,1,164,191,355
47768,vitalAscension,,1,1,8,9
47769,deadflagblues,,1,9,12,21
47770,joshcandoit4,,1,28,50,78
47771,hitek1,,1,3,1,4
47772,rickytickytappy,,1,132,225,357
47773,shudmeyer,,1,23,33,56
47774,dustyBin23,,1,145,154,299
47775,tellyousomeday,,1,1,1,2
47776,bburton,,1,2,1,3
47777,mysticreddit,,1,94,135,229
47778,drawkbox,,1,248,436,684
47779,badjoke33,,1,495,767,1262
47780,buddychrist,,1,5,9,14
47781,tsiolkovsky,,1,41,1,42
47782,yarc,,1,2,1,3
47783,jaywalker32,,1,13,37,50
47784,llimllib,,1,1730,513,2243
47785,joojoo,,1,5,8,13
47786,ibisum,,1,277,430,707
47787,kraetos,,1,46,49,95
47788,hanlect,,1,1,6,7
47789,Doug_Vitale,,1,10,8,18
47790,unkorrupted,,1,309,414,723
47791,shzad,,1,1,2,3
47792,jiphex,,1,13,9,22
47793,Hidas462,,1,10,15,25
47794,jamescoleuk,,1,5,6,11
47795,bobmatnyc,,1,18,20,38
47796,DanCorb,,1,47,10,57
47797,dogb60,,1,1,1,2
47798,Xiphorian,,1,533,475,1008
47799,bobdobolina,,1,13,22,35
47800,TruFunkSoulja,,1,1,2,3
47801,ebauman,,1,10,8,18
47802,konrad_,,1,2,2,4
47803,ligniteman,,1,7,11,18
47804,Doomdoomkittydoom,,1,378,951,1329
47805,ryoping,,1,2,4,6
47806,adaminc,,1,403,737,1140
47807,hedberg12,,1,2,4,6
47808,Professor-Farnsworth,,1,3,2,5
47809,robby1066,,1,1,3,4
47810,mojoey,,1,1,2,3
47811,mctink,,1,1,1,2
47812,jeffd,,1,3,1,4
47813,spintriae,,1,39,52,91
47814,Meme_Police,,1,19,7,26
47815,sammy_dumpster,,1,29,51,80
47816,IQRange,,1,95,69,164
47817,mistaxe,,1,1,1,2
47818,slurmsMcKenzie,,1,29,1,30
47819,Rocky_Raccoon,,1,2,6,8
47820,sese68,,1,2,1,3
47821,youareafraud,,1,53,40,93
47822,svaha,,1,13,29,42
47823,Querencia,,1,1,2,3
47824,black_bart_II,,1,2,1,3
47825,sotopheavy,,1,206,397,603
47826,uep,,1,357,495,852
47827,laggedreaction,,1,4,7,11
47828,fareedy,,1,75,109,184
47829,hofo,,1,28,42,70
47830,1787,,1,16,48,64
47831,187ninjuh,,1,13,13,26
47832,behavedave,,1,1,1,2
47833,redninja2000,,1,33,35,68
47834,drspanklebum,,1,80,78,158
47835,GManPCTT,,1,4,2,6
47836,tyllyn,,1,11,2,13
47837,yoyop,,1,9,2,11
47838,Transtrollist,,1,2,1,3
47839,ReaverXai,,1,69,50,119
47840,imonreddit,,1,131,66,197
47841,royalpineapple,,1,16,39,55
47842,lanceatherton,,1,311,2,313
47843,creeky,,1,1,1,2
47844,jlandrith,,1,1,1,2
47845,cyrusdh,,1,388,334,722
47846,garymich,,1,6,6,12
47847,darsee,,1,2,1,3
47848,horndude77,,1,5,7,12
47849,YarvinTheFish,,1,1,7,8
47850,Hourglass,,1,1,1,2
47851,johnmcgary,,1,2,1,3
47852,bakagaigin,,1,2,2,4
47853,guder,,1,33,25,58
47854,treberif,,1,2,2,4
47855,mnordhoff,,1,4,9,13
47856,Cybermaster,,1,1,2,3
47857,woohoo47,,1,53,81,134
47858,jladams,,1,87,23,110
47859,ketralnis,,1,1105,694,1799
47860,saiftk,,1,24,20,44
47861,uriel,,1,1017,1120,2137
47862,dhnaranjo,,1,2,5,7
47863,proobert,,1,1,2,3
47864,banjomike,,1,7,13,20
47865,kscrimsher,,1,28,97,125
47866,namlinh,,1,16,5,21
47867,DamienWind,,1,254,352,606
47868,shortbusgeek,,1,17,4,21
47869,twomonkeysayoyo,,1,11,17,28
47870,terribad,,1,1,1,2
47871,Quaro,,1,128,25,153
47872,yagni,,1,11,9,20
47873,napoleongold,,1,5,10,15
47874,lordatlas,,1,16,3,19
47875,mostapha,,1,8,7,15
47876,keepITliberal,,1,2,1,3
47877,ajopaul,,1,25,15,40
47878,TheLocoYoko,,1,82,86,168
47879,farlizzle,,1,1,1,2
47880,dnm,,1,128,172,300
47881,durdn,,1,31,4,35
47882,Baghdad_Bob,,1,1,5,6
47883,meltman,,1,41,27,68
47884,sundowntg,,1,3,2,5
47885,bayleo,,1,108,115,223
47886,becked,,1,3,3,6
47887,breddy,,1,167,150,317
47888,netsearcher,,1,165,239,404
47889,hollywoodjane,,1,2,4,6
47890,Cygal,,1,31,3,34
47891,joojie,,1,5,7,12
47892,rogozjin,,1,279,37,316
47893,seddu,,1,15,2,17
47894,zaatar,,1,11,4,15
47895,grosskur,,1,8,7,15
47896,johnnyneverdies,,1,7,19,26
47897,PDLan,,1,3,3,6
47898,gotbock,,1,20,13,33
47899,Sinudeity,,1,5,11,16
47900,aacool,,1,11,1,12
47901,ClanPanda,,1,350,277,627
47902,onedinio,,1,1,5,6
47903,ronito,,1,76,18,94
47904,gdi22,,1,1,2,3
47905,DkkD,,1,1,4,5
47906,mementori,,1,2,3,5
47907,smokeshack,,1,99,115,214
47908,xturmn8r,,1,6,11,17
47909,michaeltherobot,,1,8,2,10
47910,trumpy303,,1,85,1,86
47911,kryptkpr,,1,29,35,64
47912,SammyDaSlug,,1,2,2,4
47913,tic,,1,40,54,94
47914,pixel105,,1,52,88,140
47915,tyrsson,,1,86,128,214
47916,pricees,,1,2,3,5
47917,theyareallcrooks,,1,1,1,2
47918,androo87,,1,15,15,30
47919,dsmyte,,1,109,117,226
47920,AFairJudgement,,1,5,8,13
47921,stumblingblock,,1,2,3,5
47922,Shambles,,1,20,42,62
47923,Rhycore,,1,1,1,2
47924,bacchus101,,1,94,136,230
47925,tyler,,1,4,7,11
47926,dailyrorschach,,1,14,15,29
47927,ikonoclasm,,1,59,88,147
47928,Quote,,1,1,2,3
47929,theodicy,,1,128,154,282
47930,armitages,,1,9,3,12
47931,Connels,,1,27,21,48
47932,vinyl_,,1,12,13,25
47933,waahuli,,1,5,7,12
47934,dsdsds,,1,20,47,67
47935,daddyc00l,,1,26,42,68
47936,tpate,,1,13,4,17
47937,jje,,1,4,1,5
47938,wzpgsr,,1,3,13,16
47939,gabe_,,1,1,2,3
47940,Brian,,1,105,169,274
47941,webspell,,1,1,2,3
47942,endecotp,,1,3,3,6
47943,pnin,,1,1,6,7
47944,nothanksimjewish,,1,3,2,5
47945,sliverman,,1,17,5,22
47946,returno,,1,2,7,9
47947,XTA,,1,4,10,14
47948,jakec,,1,3,2,5
47949,CognitoErgoSum,,1,10,20,30
47950,absurdobot,,1,11,17,28
47951,curtisb,,1,74,33,107
47952,hellodarshan,,1,93,8,101
47953,akula_akula,,1,9,17,26
47954,Hellshock,,1,4,8,12
47955,cheech26,,1,1,2,3
47956,robotevil,,1,573,432,1005
47957,euklides,,1,98,92,190
47958,avsportland,,1,2,2,4
47959,kleptofphnica20093,,1,18,20,38
47960,forkqueue,,1,16,18,34
47961,ninja_zombie,,1,616,420,1036
47962,WardOnTheWeb,,1,7,18,25
47963,pootedesu,,1,37,79,116
47964,joncash,,1,368,322,690
47965,cows,,1,14,9,23
47966,perplex79,,1,6,4,10
47967,mourning,,1,2,1,3
47968,crwoodman,,1,3,4,7
47969,ianmccurdy,,1,27,55,82
47970,martinjlogan,,1,1,1,2
47971,jcgregorio,,1,7,5,12
47972,Sophocles,,1,20,17,37
47973,copkiller,,1,2,1,3
47974,hober,,1,125,6,131
47975,noetic,,1,4,5,9
47976,wpjmurray,,1,3,2,5
47977,dom085,,1,18,31,49
47978,JasonPeck,,1,1,1,2
47979,Saunawombat,,1,2,3,5
47980,sdwrage,,1,3,1,4
47981,fallinup,,1,18,23,41
47982,jdubs333,,1,62,72,134
47983,Damien666,,1,2,2,4
47984,mineson,,1,2,2,4
47985,democrattotheend,,1,2,2,4
47986,hoosier45678,,1,17,34,51
47987,Buck_Malibu,,1,736,713,1449
47988,benito78,,1,1,2,3
47989,sugarape,,1,2,2,4
47990,wabbiteh,,1,19,15,34
47991,theseitz,,1,8,32,40
47992,Reddit_Police,,1,1,1,2
47993,CashOverAss,,1,6,5,11
47994,squashbelly,,1,28,47,75
47995,classicresort,,1,2,2,4
47996,allenshillfarm,,1,2,2,4
47997,shapedbyregret,,1,35,47,82
47998,dogten,,1,2,1,3
47999,safety_inspector,,1,1,1,2
48000,astralbody,,1,3,4,7
48001,Ghostline,,1,11,13,24
48002,IanMcGreene,,1,2,2,4
48003,drillpalin,,1,83,7,90
48004,hopstar,,1,169,251,420
48005,kwade,,1,36,27,63
48006,meuc,,1,2,1,3
48007,dln,,1,13,12,25
48008,infamousjre,,1,2,4,6
48009,ifm1989,,1,13,25,38
48010,Plasmatica,,1,178,169,347
48011,paigematter,,1,21,39,60
48012,shoc,,1,83,79,162
48013,xkcdsucks,,1,1,2,3
48014,sooner577,,1,2,1,3
48015,capi10,,1,3,4,7
48016,teilo,,1,2,2,4
48017,JasonFalls,,1,5,6,11
48018,IHP,,1,3,4,7
48019,CAPS_LOCK,,1,1,1,2
48020,cj23creh,,1,31,37,68
48021,mowza214,,1,1,3,4
48022,greyfade,,1,1,6,7
48023,billndotnet,,1,1,2,3
48024,chrismr,,1,76,85,161
48025,physivic,,1,12,36,48
48026,caydieu,,1,14,19,33
48027,md304,,1,91,40,131
48028,rmeddy,,1,1,1,2
48029,beautiful_noise,,1,83,52,135
48030,xkcd,,1,414,211,625
48031,HowTheWestWasOne,,1,8,13,21
48032,petedawes,,1,12,21,33
48033,bigt0128,,1,22,23,45
48034,Thorolac,,1,16,8,24
48035,chradcliffe,,1,3,1,4
48036,defjamz,,1,1,3,4
48037,rez410,,1,8,2,10
48038,cripwark,,1,8,8,16
48039,Digitalburn,,1,8,8,16
48040,TheCheat,,1,5,6,11
48041,PoorLeno,,1,49,60,109
48042,eredicator,,1,1,4,5
48043,Joe_Six-Pack,,1,14,16,30
48044,NJalien,,1,3,6,9
48045,BerserkerVoter,,1,1,1,2
48046,liquen,,1,60,1,61
48047,kordath,,1,10,3,13
48048,anicol,,1,1,1,2
48049,serpent,,1,8,8,16
48050,positivepnl,,1,1,1,2
48051,newmejersey,,1,1,2,3
48052,meehawl,,1,7,10,17
48053,GNG,,1,4,2,6
48054,O1O1O1,,1,3,7,10
48055,jilseng4,,1,75,161,236
48056,gshark27,,1,23,25,48
48057,zamolxis,,1,7,9,16
48058,gabriellocke,,1,30,58,88
48059,catguy,,1,12,20,32
48060,JPM,,1,29,40,69
48061,chiefmonkey,,1,171,208,379
48062,onthestairs,,1,6,2,8
48063,gubernatorialism,,1,2,4,6
48064,ahimsaplease,,1,39,8,47
48065,ickysticky,,1,3,2,5
48066,YME1280,,1,9,9,18
48067,rubinlinux,,1,12,7,19
48068,elendae,,1,40,12,52
48069,TEMPESTWIND,,1,2,1,3
48070,djrollsroyce,,1,145,15,160
48071,bakineggs,,1,1,1,2
48072,melaos,,1,5,8,13
48073,tmart,,1,10,2,12
48074,dRedN,,1,1,1,2
48075,LestroCliche,,1,80,17,97
48076,semajblue,,3,1,3,4
48077,MrSpoilers,,1,2,5,7
48078,twinklestar2007,,1,15,23,38
48079,posterchild,,1,25,67,92
48080,emailyourbuddy,,1,7,28,35
48081,jarotar,,1,182,102,284
48082,Takteek,,1,130,142,272
48083,greenrd,,1,578,687,1265
48084,donjoe0,,1,1,1,2
48085,diadem,,1,48,58,106
48086,aloysiusf,,1,2,3,5
48087,l0pr0file,,1,19,19,38
48088,neonsphinx,,1,41,57,98
48089,arxch126,,1,2,7,9
48090,boost,,1,2,4,6
48091,rsb62188,,1,1,1,2
48092,rjb138,,1,1,1,2
48093,lechero,,1,3,3,6
48094,catfishjenkins,,1,67,31,98
48095,karlk79,,1,1,1,2
48096,moonhoaxcoznostarpix,,1,9,19,28
48097,dude59,,1,2,2,4
48098,perpetualdoubt,,1,126,61,187
48099,m1st3rAn0nym0us,,1,1,1,2
48100,asdfdrum,,1,2,6,8
48101,kalramly,,1,3,2,5
48102,zeepee,,1,1,2,3
48103,aydiosmio,,1,3,1,4
48104,hottytoddy99,,1,30,50,80
48105,dragonandante,,1,33,75,108
48106,brainflake,,1,14,2,16
48107,pogla,,1,2,3,5
48108,pmg2007,,1,61,14,75
48109,Altras,,1,276,48,324
48110,beanland,,1,13,11,24
48111,ns2103,,1,19,50,69
48112,PopeyeDoyle,,1,25,40,65
48113,bluetrust,,1,47,65,112
48114,Enigme,,1,1,2,3
48115,crazymunch,,1,327,286,613
48116,WantonDistraction,,1,60,41,101
48117,ArmchairActivist,,1,16,23,39
48118,DEATHANGELBABY,,1,1,1,2
48119,gregburd,,1,2,1,3
48120,omaca,,1,26,25,51
48121,dododge,,1,31,100,131
48122,vonadler,,1,84,117,201
48123,aloeveraone,,1,32,36,68
48124,flynth99,,1,75,96,171
48125,beseecheth,,1,1,3,4
48126,dadood,,1,1,1,2
48127,aww,,1,1,3,4
48128,tritium6,,1,311,456,767
48129,WaterDragon,,1,419,691,1110
48130,lucid_point,,1,8,15,23
48131,dvm,,1,2,3,5
48132,abhijithg,,1,1,2,3
48133,swisha_beatz,,1,16,51,67
48134,reddmaher,,1,102,10,112
48135,jabby81,,1,7,10,17
48136,drguildo,,1,153,87,240
48137,antmanguitar,,1,12,24,36
48138,makis,,1,13,24,37
48139,azuriel,,1,120,16,136
48140,Mrmunchies,,1,3,6,9
48141,electricfoxx,,1,105,168,273
48142,no9,,1,10,13,23
48143,lpew,,1,5,6,11
48144,denidzo,,1,46,74,120
48145,routeflap,,1,2,2,4
48146,oursland,,1,62,69,131
48147,mousemaker,,1,1,1,2
48148,mrbravo,,1,1,1,2
48149,skerit,,1,159,213,372
48150,scorpiond,,1,1,1,2
48151,OneRudeComment,,1,1,1,2
48152,__Jesus__,,1,2,3,5
48153,travisu,,1,2,3,5
48154,wardley,,1,70,2,72
48155,umbepo,,1,9,4,13
48156,Jcrafton,,1,1,1,2
48157,ixid,,1,320,431,751
48158,mayorOFcrawford,,1,8,6,14
48159,NPT,,1,1,1,2
48160,newswiseguy,,1,1,1,2
48161,adresaklumea,,1,23,28,51
48162,smittten,,1,1,1,2
48163,singleposter,,1,2,29,31
48164,bloodguard,,1,35,65,100
48165,michael123,,1,170,16,186
48166,dangermouse,,1,2,1,3
48167,nosophorus,,1,1,3,4
48168,monoboyzmom,,1,1,2,3
48169,Alliance,,1,6,8,14
48170,fofightmeto,,1,29,8,37
48171,edithsan,,1,14,16,30
48172,xChosen1x,,1,8,14,22
48173,madbeans,,1,3,2,5
48174,bsmntbombdood,,1,4,10,14
48175,freqhz,,1,1,12,13
48176,BillionFace,,1,14,10,24
48177,Setu_Aus,,1,31,37,68
48178,jeff666,,1,14,34,48
48179,J-Ro,,1,2752,262,3014
48180,pyrelite,,1,2,1,3
48181,trivial,,1,683,787,1470
48182,catastrophic,,1,6,10,16
48183,liferebootdotcom,,1,1,1,2
48184,hadaka,,1,30,37,67
48185,VnlaThndr775,,1,99,245,344
48186,b1indsamurai,,1,47,2,49
48187,imonitor,,1,4,2,6
48188,McGuirk,,1,247,299,546
48189,sasmith,,1,3,4,7
48190,isohead,,1,26,15,41
48191,dontbejack,,1,147,278,425
48192,allscan,,1,3,4,7
48193,tbone28,,1,13,15,28
48194,feverish,,1,3,5,8
48195,samf,,1,27,32,59
48196,motookimura,,1,2,1,3
48197,eldiablito,,1,2,4,6
48198,prefsaver,,1,66,113,179
48199,jhorsley3,,1,2,1,3
48200,nullynull,,1,53,225,278
48201,junkytrunks,,1,27,42,69
48202,frezned,,1,11,13,24
48203,chimchim321,,1,2,7,9
48204,emrikol,,1,11,7,18
48205,paulkallol,,1,158,43,201
48206,psly4mne,,1,1,8,9
48207,MrJoeSmith2,,1,13,10,23
48208,Cloroxxorzz,,1,1,8,9
48209,Mattcwu,,1,4,11,15
48210,macaddictg4,,1,31,18,49
48211,RobKohr,,1,2,1,3
48212,cardinality_zero,,1,6,19,25
48213,Presuminged,,1,3,3,6
48214,FreeMcKilt,,1,38,12,50
48215,Biohacker,,1,36,1,37
48216,brunt2,,1,961,1555,2516
48217,rodolfos,,1,3,2,5
48218,kupaka,,1,2,10,12
48219,jsj1971,,1,175,8,183
48220,Doctor_Evil,,1,4,8,12
48221,black2night,,1,10,3,13
48222,notgod,,1,1,1,2
48223,meara,,1,23,8,31
48224,mipadi,,1,169,153,322
48225,priapism,,1,1,1,2
48226,ianmack,,1,1,1,2
48227,Oldeyes,,1,5,6,11
48228,seekerOfLight,,1,4,1,5
48229,oxymor00n,,1,25,3,28
48230,coollettuce,,1,287,248,535
48231,Phrag,,1,160,294,454
48232,Ajenthavoc,,1,83,126,209
48233,jtjin,,1,51,74,125
48234,baadshahfk,,1,227,87,314
48235,ralf1,,1,12,19,31
48236,vapourizethis,,1,14,24,38
48237,rmwb,,1,2,7,9
48238,gum11,,1,52,69,121
48239,bob73,,1,1,4,5
48240,ShipOffFools,,1,4,12,16
48241,rodarmor,,1,19,8,27
48242,r121,,1,58,95,153
48243,b33rgy,,1,8,9,17
48244,watchmesuck,,1,9,12,21
48245,heapoverflowbm,,1,1,1,2
48246,KevP,,1,15,10,25
48247,wimpel,,1,1,2,3
48248,MisplacedKarma,,1,2,1,3
48249,Leeroy_Jewkins,,1,6,9,15
48250,xasper8,,1,14,32,46
48251,individual61,,1,36,59,95
48252,mrpoopypantss,,1,15,4,19
48253,valkyrie123,,1,41,64,105
48254,clintmemo,,1,23,28,51
48255,RedRightHand,,1,4,6,10
48256,gnubian,,1,2,3,5
48257,fredgarvin,,1,1,2,3
48258,wernerpm,,1,1,5,6
48259,zweistein,,1,6,11,17
48260,thinkalone,,1,11,28,39
48261,ForestFelineSage,,1,2,2,4
48262,masterofsockpuppets,,1,1,1,2
48263,MrFoo42,,1,4,1,5
48264,elblanco,,1,28,85,113
48265,covidiu,,1,16,25,41
48266,wbonner,,1,124,18,142
48267,magicdonkey1,,1,13,1,14
48268,renosaz,,1,68,75,143
48269,Dark-Dx,,1,966,1812,2778
48270,Caiocow,,1,15,31,46
48271,suckerpunch,,1,5,4,9
48272,couchlock,,1,9,12,21
48273,rushtomsawyer,,1,3,1,4
48274,Mark4483,,1,3,5,8
48275,Pradico,,1,10,8,18
48276,beachchair,,1,44,61,105
48277,jonx_rainer,,1,80,90,170
48278,Roknine,,1,17,10,27
48279,wwabc,,1,1098,1172,2270
48280,steve93,,1,135,231,366
48281,joe_fishfish,,1,56,66,122
48282,assteroid,,1,269,369,638
48283,llama-lime,,1,67,68,135
48284,lamaw,,1,13,3,16
48285,flaurens,,1,1,1,2
48286,nitramk,,1,78,131,209
48287,johnfredcee,,1,33,32,65
48288,karly_marxinogue,,1,2,5,7
48289,Btrash,,1,1,2,3
48290,unimatrixzero,,1,12,13,25
48291,powlette,,1,92,21,113
48292,Ajaxxx,,1,1,4,5
48293,rivers_,,1,3,4,7
48294,in_the_event,,1,45,19,64
48295,og_sandiego,,1,167,28,195
48296,bobbyfiend,,1,29,75,104
48297,Splatterh0use,,1,38,114,152
48298,manelvf,,1,2,1,3
48299,selfishselfcentered,,1,36,64,100
48300,maven007,,1,1,3,4
48301,Circa_Lucid,,1,2,7,9
48302,jigglesworth,,1,1,1,2
48303,stvspl,,1,204,418,622
48304,pintong,,1,98,115,213
48305,liminaltimes,,1,384,592,976
48306,Shrimps,,1,1,1,2
48307,FuryofThor86,,1,3,1,4
48308,djtedman111,,1,1,1,2
48309,MasonM,,1,51,50,101
48310,riecon,,1,1,5,6
48311,AlphaWolf,,1,3,7,10
48312,arfrank,,1,2,2,4
48313,inandjo,,1,2,1,3
48314,obie25,,1,5,1,6
48315,AccountPolice,,1,5,12,17
48316,jl008h,,1,1,1,2
48317,XtaI,,1,2,2,4
48318,Kellymaya,,1,61,41,102
48319,obelisk45,,1,27,42,69
48320,jrdorkin,,1,4,1,5
48321,witty_username,,1,57,15,72
48322,Formaldehyde,,1,37,34,71
48323,indu_san,,1,30,84,114
48324,joe_archer,,1,44,52,96
48325,jayathecat,,1,19,13,32
48326,Inuyasha44720,,1,1,1,2
48327,djphibes,,1,5,15,20
48328,dfuse,,1,87,169,256
48329,p0dg3s,,1,1,1,2
48330,magilla,,1,45,2,47
48331,jfischer,,1,4,8,12
48332,dropd2na,,1,6,2,8
48333,freddya,,1,6,2,8
48334,foco2001,,1,3,7,10
48335,kieranelby,,1,20,32,52
48336,sane_middle,,1,15,14,29
48337,P33KAJ3W,,1,8,24,32
48338,collision,,1,16,13,29
48339,vomjom,,1,13,13,26
48340,hatfield42,,1,15,23,38
48341,ygrof,,1,3,1,4
48342,devonian,,1,1,1,2
48343,fuglystick,,1,155,325,480
48344,shebangdotat,,1,81,101,182
48345,Indeed,,1,41,15,56
48346,Portlander,,1,147,166,313
48347,Toolazy2work,,1,3,2,5
48348,popeyoni,,1,1,4,5
48349,taitbp,,1,16,10,26
48350,b0dhi,,1,35,77,112
48351,atothek302,,1,29,13,42
48352,Twidget831,,1,1,2,3
48353,aumana,,1,11,17,28
48354,shermint,,1,2,3,5
48355,madzor,,1,2,3,5
48356,bobconan,,1,45,40,85
48357,crmaki,,1,105,127,232
48358,chupi,,1,1,5,6
48359,CodeFreak,,1,3,13,16
48360,emilyquinn,,1,50,9,59
48361,pejo,,1,1,2,3
48362,d6chung,,1,23,14,37
48363,wickedsteve,,1,223,364,587
48364,CounterCointelPro,,1,3,6,9
48365,Indyhouse,,1,553,213,766
48366,muffinmix,,1,27,77,104
48367,fredrikj,,1,43,62,105
48368,korjagun,,1,99,121,220
48369,FaberfoX,,1,1,2,3
48370,Shmurk,,1,50,75,125
48371,Hukeshy,,1,86,88,174
48372,smulloni,,1,1,1,2
48373,MarketUrbanism,,1,2,5,7
48374,Murple,,1,11,27,38
48375,loudasthesun,,1,401,161,562
48376,weasel925,,1,23,40,63
48377,esotic,,1,1,1,2
48378,gyfcms,,1,27,58,85
48379,Ayavaron,,1,59,91,150
48380,bandman614,,1,100,150,250
48381,moyly,,1,2,5,7
48382,jofer,,1,7,4,11
48383,qwe1234,,1,248,354,602
48384,mint_jelly,,1,3,10,13
48385,rmss,,1,5,2,7
48386,vowels,,1,6,7,13
48387,cgibbard,,1,151,269,420
48388,lazzeri,,1,155,131,286
48389,intergalacticninja,,1,1,1,2
48390,illusio,,1,1,1,2
48391,Knucklecallus,,1,3,3,6
48392,compostellas,,1,1,1,2
48393,Boobjob4u,,1,1,5,6
48394,iros,,1,2,2,4
48395,CaptainCharisma,,1,14,49,63
48396,abc2013,,1,19,20,39
48397,mike_dark,,1,104,303,407
48398,umibozu,,1,254,246,500
48399,pacsurf,,1,6,9,15
48400,emag,,1,64,135,199
48401,zeptillian,,1,1,1,2
48402,particle,,1,24,23,47
48403,RickHendershot,,1,2,1,3
48404,PresElectObama,,1,2,1,3
48405,sleet,,1,6,10,16
48406,melindapresto,,1,2,2,4
48407,d280z,,1,8,5,13
48408,greatgregg,,1,15,14,29
48409,unsatisfactory,,1,2,4,6
48410,Wickity,,1,2,4,6
48411,stankytofu,,1,12,1,13
48412,jackolythe,,1,5,11,16
48413,Clark76,,1,29,49,78
48414,pmezher,,1,5,2,7
48415,drjuandekon,,1,36,3,39
48416,AnythingApplied,,1,30,63,93
48417,pheinz,,1,2,2,4
48418,iceman_,,1,9,11,20
48419,entheogenic,,1,2,5,7
48420,welcometotheinternet,,1,3,4,7
48421,Grue,,1,649,903,1552
48422,Protophobic,,1,215,227,442
48423,SnowFire,,1,2,10,12
48424,blackhatzen,,1,9,1,10
48425,jeeg,,1,15,4,19
48426,wary,,1,5,14,19
48427,ChristianBk,,1,2,6,8
48428,neverender,,1,40,25,65
48429,jdpowers,,1,14,7,21
48430,SaeedArtist,,1,21,2,23
48431,gtllama,,1,2,5,7
48432,feureau,,1,11,20,31
48433,mikhon,,1,2,1,3
48434,alexacto,,1,24,55,79
48435,helpsfo,,1,2,3,5
48436,frog52,,1,1,2,3
48437,steppenwolf86,,1,33,75,108
48438,srgmpdns,,1,13,16,29
48439,mitsuhiko,,1,118,148,266
48440,Chalain,,1,1,1,2
48441,boffo,,1,17,11,28
48442,joseph177,,1,98,243,341
48443,drjanek,,1,14,24,38
48444,fkkker,,1,2,2,4
48445,burny97236,,1,3,8,11
48446,elizinthemorning,,1,106,114,220
48447,antpuncher,,1,5,4,9
48448,dugbybugby,,1,2,3,5
48449,Massif,,1,13,13,26
48450,Anktech,,1,1,1,2
48451,jamesishere,,1,154,22,176
48452,mlgoss,,1,198,281,479
48453,ineedmoresleep,,1,31,29,60
48454,Khendroc,,1,356,779,1135
48455,daftnebula,,1,2,4,6
48456,rrenaud,,1,60,47,107
48457,pedo2,,1,3,3,6
48458,jrj,,1,4,5,9
48459,chubs66,,1,77,145,222
48460,reneky,,1,49,9,58
48461,thinkbeforedo,,1,6,7,13
48462,eldormilon,,1,6,12,18
48463,AtheistMedicineMan69,,1,1,1,2
48464,raimesh,,1,1,5,6
48465,bali-song,,1,12,15,27
48466,lrpiccolo,,1,33,22,55
48467,Zoltair,,1,23,37,60
48468,Orangutan,,1,1436,551,1987
48469,fadmmatt,,1,4,11,15
48470,GeneralMaximus,,1,15,1,16
48471,humpaaacactus,,1,9,18,27
48472,beeker,,1,3,6,9
48473,philsci,,1,1,2,3
48474,kendrahwithanh,,1,29,41,70
48475,optiman,,1,3,3,6
48476,thorrx,,1,11,17,28
48477,Garetht,,1,2,5,7
48478,brandiene,,1,2,6,8
48479,cpverne,,1,1,1,2
48480,gooby,,1,1,1,2
48481,vanillashake,,1,2,4,6
48482,essjay24,,1,1,3,4
48483,Hechus,,1,4,2,6
48484,brianh2244,,1,1,1,2
48485,neoronin,,1,3200,110,3310
48486,sh1bb,,1,1,1,2
48487,wkinney,,1,2,1,3
48488,dserfaty,,1,2,7,9
48489,mayherz,,1,2,2,4
48490,starrydynamo,,1,4,7,11
48491,thedward,,1,37,49,86
48492,martythemaniak,,1,10,18,28
48493,CWmike,,1,252,3,255
48494,imcnoshain,,1,2,1,3
48495,btfh,,1,5,7,12
48496,nedw,,1,10,14,24
48497,ezkl,,1,32,11,43
48498,pwnagebrotice,,1,6,5,11
48499,comand,,1,16,17,33
48500,chocdrop,,1,3,2,5
